//MAP CONVERTED BY dmm2tgm.py THIS HEADER COMMENT PREVENTS RECONVERSION, DO NOT REMOVE
"a" = (
/turf/template_noop,
/area/template_noop)
"c" = (
/turf/open/floor/plating/asteroid/whitesands/dried/lit,
/area/template_noop)
"e" = (
/turf/open/floor/plating/asteroid/whitesands/lit,
/area/template_noop)
"f" = (
/obj/effect/spawner/lootdrop/twentypercentpucespawn,
/turf/open/floor/plating/asteroid/whitesands/dried/lit,
/area/template_noop)
"k" = (
/turf/open/water/whitesands,
/area/template_noop)
"l" = (
/obj/effect/spawner/lootdrop/fourtywsfauna,
/turf/open/floor/plating/asteroid/whitesands/lit,
/area/template_noop)
"n" = (
/obj/effect/spawner/lootdrop/fiftycavefern,
/turf/open/floor/plating/asteroid/whitesands/lit,
/area/template_noop)

(1,1,1) = {"
c
f
e
k
k
a
"}
(2,1,1) = {"
e
k
k
k
n
e
"}
(3,1,1) = {"
c
n
k
k
k
f
"}
(4,1,1) = {"
a
f
l
f
f
f
"}
