//MAP CONVERTED BY dmm2tgm.py THIS HEADER COMMENT PREVENTS RECONVERSION, DO NOT REMOVE
"a" = (
/turf/template_noop,
/area/template_noop)
"c" = (
/turf/open/water/whitesands,
/area/template_noop)
"e" = (
/turf/open/floor/plating/asteroid/whitesands/lit,
/area/template_noop)
"f" = (
/obj/effect/spawner/lootdrop/twentypercentpucespawn,
/turf/open/floor/plating/asteroid/whitesands/dried/lit,
/area/template_noop)
"k" = (
/obj/effect/spawner/lootdrop/fiftycavefern,
/turf/open/floor/plating/asteroid/whitesands/lit,
/area/template_noop)
"l" = (
/obj/effect/spawner/lootdrop/fourtywsfauna,
/turf/open/floor/plating/asteroid/whitesands/dried/lit,
/area/template_noop)
"m" = (
/obj/effect/spawner/lootdrop/seventyrock,
/turf/open/floor/plating/asteroid/whitesands/lit,
/area/template_noop)
"n" = (
/turf/closed/mineral/random/whitesands/lit,
/area/template_noop)
"v" = (
/turf/closed/mineral/random/volcanic,
/area/template_noop)
"I" = (
/obj/effect/spawner/lootdrop/seventyrock,
/turf/open/floor/plating/asteroid/whitesands/dried/lit,
/area/template_noop)
"L" = (
/turf/open/floor/plating/asteroid/whitesands/dried/lit,
/area/template_noop)
"U" = (
/obj/effect/spawner/lootdrop/fourtywsfauna,
/turf/open/floor/plating/asteroid/whitesands/lit,
/area/template_noop)

(1,1,1) = {"
a
a
a
a
a
a
a
a
a
a
a
a
n
n
a
a
"}
(2,1,1) = {"
a
a
a
a
a
a
a
a
a
a
n
n
n
n
a
a
"}
(3,1,1) = {"
a
a
a
a
a
a
a
a
a
n
v
v
v
n
n
a
"}
(4,1,1) = {"
a
a
a
a
a
a
a
a
n
v
v
v
v
n
n
n
"}
(5,1,1) = {"
a
a
a
a
a
a
a
a
n
v
v
v
v
n
n
n
"}
(6,1,1) = {"
a
a
a
a
a
a
n
n
n
n
v
n
n
n
a
a
"}
(7,1,1) = {"
a
a
a
a
a
a
a
n
e
c
c
c
e
n
a
a
"}
(8,1,1) = {"
a
a
a
a
a
n
I
e
e
c
c
c
m
a
a
a
"}
(9,1,1) = {"
a
a
a
a
a
n
e
U
c
c
c
c
f
n
a
a
"}
(10,1,1) = {"
a
a
a
a
n
L
k
c
c
c
c
c
n
n
a
a
"}
(11,1,1) = {"
a
a
a
n
a
f
n
n
c
c
c
k
n
a
a
a
"}
(12,1,1) = {"
a
a
a
a
n
c
n
c
c
c
c
f
a
a
a
a
"}
(13,1,1) = {"
a
a
a
n
e
c
c
c
c
c
f
a
n
a
a
a
"}
(14,1,1) = {"
a
a
n
n
e
c
c
c
n
f
l
a
a
a
a
a
"}
(15,1,1) = {"
a
a
n
f
c
c
c
c
c
f
n
a
a
a
a
a
"}
(16,1,1) = {"
a
a
n
I
c
c
c
c
e
L
n
a
a
a
a
a
"}
(17,1,1) = {"
a
a
n
e
c
c
c
c
f
I
a
a
a
a
a
a
"}
(18,1,1) = {"
a
a
f
e
c
c
c
c
f
n
a
a
a
a
a
a
"}
(19,1,1) = {"
a
I
f
c
c
c
c
e
n
a
a
a
a
a
a
a
"}
(20,1,1) = {"
a
e
e
c
c
e
c
f
a
a
a
a
a
a
a
a
"}
(21,1,1) = {"
a
e
c
k
c
c
f
L
a
a
a
a
a
a
a
a
"}
(22,1,1) = {"
a
e
c
c
U
e
L
a
a
a
a
a
a
a
a
a
"}
(23,1,1) = {"
I
e
c
e
c
e
a
a
a
a
a
a
a
a
a
a
"}
(24,1,1) = {"
e
e
c
c
c
f
a
a
a
a
a
a
a
a
a
a
"}
(25,1,1) = {"
e
c
e
c
e
I
a
a
a
a
a
a
a
a
a
a
"}
(26,1,1) = {"
e
e
e
c
e
a
a
a
a
a
a
a
a
a
a
a
"}
(27,1,1) = {"
e
k
I
f
a
a
a
a
a
a
a
a
a
a
a
a
"}
