//MAP CONVERTED BY dmm2tgm.py THIS HEADER COMMENT PREVENTS RECONVERSION, DO NOT REMOVE
"a" = (
/turf/template_noop,
/area/template_noop)
"c" = (
/turf/open/floor/plating/asteroid/whitesands/lit,
/area/template_noop)
"e" = (
/obj/effect/spawner/random/twentypercentpucespawn,
/turf/open/floor/plating/asteroid/whitesands/dried/lit,
/area/template_noop)
"f" = (
/obj/effect/spawner/random/fourtywsfauna,
/turf/open/floor/plating/asteroid/whitesands/lit,
/area/template_noop)
"k" = (
/obj/effect/spawner/random/fiftycavefern,
/turf/open/floor/plating/asteroid/whitesands/lit,
/area/template_noop)
"l" = (
/turf/open/water/whitesands,
/area/template_noop)
"n" = (
/turf/closed/mineral/random/whitesands/lit,
/area/template_noop)

(1,1,1) = {"
a
a
e
n
n
"}
(2,1,1) = {"
a
e
l
l
e
"}
(3,1,1) = {"
n
c
k
l
e
"}
(4,1,1) = {"
c
f
c
n
a
"}
(5,1,1) = {"
a
k
a
a
a
"}
