//MAP CONVERTED BY dmm2tgm.py THIS HEADER COMMENT PREVENTS RECONVERSION, DO NOT REMOVE
"a" = (
/turf/template_noop,
/area/template_noop)
"c" = (
/turf/open/floor/plating/asteroid/whitesands/dried/lit,
/area/template_noop)
"e" = (
/obj/effect/spawner/lootdrop/twentypercentpucespawn,
/turf/open/floor/plating/asteroid/whitesands/dried/lit,
/area/template_noop)
"f" = (
/obj/effect/spawner/lootdrop/fourtywsfauna,
/turf/open/floor/plating/asteroid/whitesands/lit,
/area/template_noop)
"k" = (
/obj/effect/spawner/lootdrop/fiftycavefern,
/turf/open/floor/plating/asteroid/whitesands/lit,
/area/template_noop)
"l" = (
/turf/open/water/whitesands,
/area/template_noop)
"m" = (
/obj/effect/spawner/lootdrop/seventyrock,
/turf/open/floor/plating/asteroid/whitesands/lit,
/area/template_noop)
"n" = (
/turf/closed/mineral/random/whitesands/lit,
/area/template_noop)
"u" = (
/obj/effect/spawner/lootdrop/fiftycavefern,
/turf/open/floor/plating/asteroid/whitesands/dried/lit,
/area/template_noop)
"v" = (
/turf/open/floor/plating/asteroid/whitesands/lit,
/area/template_noop)
"w" = (
/obj/effect/spawner/lootdrop/twentypercentpucespawn,
/obj/effect/spawner/lootdrop/fourtywsfauna,
/turf/open/floor/plating/asteroid/whitesands/dried/lit,
/area/template_noop)

(1,1,1) = {"
a
a
c
c
e
l
l
"}
(2,1,1) = {"
a
a
f
e
l
l
v
"}
(3,1,1) = {"
a
c
k
l
l
v
v
"}
(4,1,1) = {"
a
e
l
l
l
v
w
"}
(5,1,1) = {"
a
e
l
l
l
k
e
"}
(6,1,1) = {"
n
n
k
l
l
l
n
"}
(7,1,1) = {"
a
n
m
l
l
e
n
"}
(8,1,1) = {"
a
a
a
e
u
n
a
"}
(9,1,1) = {"
a
a
a
a
n
n
a
"}
