//MAP CONVERTED BY dmm2tgm.py THIS HEADER COMMENT PREVENTS RECONVERSION, DO NOT REMOVE
"a" = (
/turf/template_noop,
/area/template_noop)
"c" = (
/obj/effect/spawner/random/twentypercentpucespawn,
/turf/open/floor/plating/asteroid/whitesands/dried/lit,
/area/template_noop)
"e" = (
/turf/open/floor/plating/asteroid/whitesands/dried/lit,
/area/template_noop)
"f" = (
/obj/effect/spawner/random/fourtywsfauna,
/turf/open/floor/plating/asteroid/whitesands/lit,
/area/template_noop)
"k" = (
/turf/open/water/whitesands,
/area/template_noop)
"l" = (
/obj/effect/spawner/random/fiftycavefern,
/turf/open/floor/plating/asteroid/whitesands/lit,
/area/template_noop)
"n" = (
/turf/open/floor/plating/asteroid/whitesands/lit,
/area/template_noop)

(1,1,1) = {"
a
a
e
a
a
"}
(2,1,1) = {"
a
c
f
n
e
"}
(3,1,1) = {"
n
c
k
l
a
"}
(4,1,1) = {"
a
n
c
c
a
"}
