//MAP CONVERTED BY dmm2tgm.py THIS HEADER COMMENT PREVENTS RECONVERSION, DO NOT REMOVE
"a" = (
/turf/template_noop,
/area/template_noop)
"c" = (
/obj/effect/spawner/random/twentypercentpucespawn,
/turf/open/floor/plating/asteroid/whitesands/dried/lit,
/area/template_noop)
"e" = (
/obj/effect/spawner/random/fourtywsfauna,
/turf/open/floor/plating/asteroid/whitesands/dried/lit,
/area/template_noop)
"f" = (
/turf/open/floor/plating/asteroid/whitesands/lit,
/area/template_noop)
"k" = (
/turf/open/water/whitesands,
/area/template_noop)
"l" = (
/obj/effect/spawner/random/fiftycavefern,
/turf/open/floor/plating/asteroid/whitesands/lit,
/area/template_noop)
"m" = (
/turf/open/floor/plating/asteroid/whitesands/dried/lit,
/area/template_noop)
"n" = (
/obj/effect/spawner/random/fiftycavefern,
/turf/open/floor/plating/asteroid/whitesands/dried/lit,
/area/template_noop)

(1,1,1) = {"
a
a
m
a
"}
(2,1,1) = {"
a
f
n
a
"}
(3,1,1) = {"
c
k
f
e
"}
(4,1,1) = {"
a
k
k
c
"}
(5,1,1) = {"
c
k
f
f
"}
(6,1,1) = {"
e
f
k
c
"}
(7,1,1) = {"
a
l
k
f
"}
(8,1,1) = {"
a
k
c
a
"}
