//MAP CONVERTED BY dmm2tgm.py THIS HEADER COMMENT PREVENTS RECONVERSION, DO NOT REMOVE
"a" = (
/turf/template_noop,
/area/template_noop)
"c" = (
/turf/open/floor/plating/asteroid/whitesands/lit,
/area/template_noop)
"e" = (
/obj/effect/spawner/random/twentypercentpucespawn,
/turf/open/floor/plating/asteroid/whitesands/dried/lit,
/area/template_noop)
"f" = (
/obj/effect/spawner/random/twentypercentpucespawn,
/obj/effect/spawner/random/twentypercentpucespawn,
/turf/open/floor/plating/asteroid/whitesands/dried/lit,
/area/template_noop)
"k" = (
/turf/open/water/whitesands,
/area/template_noop)
"l" = (
/obj/effect/spawner/random/fiftycavefern,
/turf/open/floor/plating/asteroid/whitesands/lit,
/area/template_noop)
"m" = (
/turf/open/floor/plating/asteroid/whitesands/dried/lit,
/area/template_noop)
"n" = (
/obj/effect/spawner/random/fourtywsfauna,
/turf/open/floor/plating/asteroid/whitesands/lit,
/area/template_noop)

(1,1,1) = {"
a
k
c
a
"}
(2,1,1) = {"
c
l
k
e
"}
(3,1,1) = {"
e
k
k
e
"}
(4,1,1) = {"
f
k
l
n
"}
(5,1,1) = {"
a
m
m
a
"}
