//MAP CONVERTED BY dmm2tgm.py THIS HEADER COMMENT PREVENTS RECONVERSION, DO NOT REMOVE
"a" = (
/turf/template_noop,
/area/template_noop)
"c" = (
/turf/open/water/whitesands,
/area/template_noop)
"e" = (
/turf/open/floor/plating/asteroid/whitesands/lit,
/area/template_noop)
"f" = (
/obj/effect/spawner/random/fiftycavefern,
/turf/open/floor/plating/asteroid/whitesands/dried/lit,
/area/template_noop)
"k" = (
/obj/effect/spawner/random/twentypercentpucespawn,
/turf/open/floor/plating/asteroid/whitesands/dried/lit,
/area/template_noop)
"m" = (
/turf/open/floor/plating/asteroid/whitesands/dried/lit,
/area/template_noop)
"n" = (
/obj/effect/spawner/random/seventyrock,
/turf/open/floor/plating/asteroid/whitesands/lit,
/area/template_noop)
"v" = (
/obj/effect/spawner/random/fiftycavefern,
/turf/open/floor/plating/asteroid/whitesands/lit,
/area/template_noop)
"w" = (
/obj/effect/spawner/random/fourtywsfauna,
/turf/open/floor/plating/asteroid/whitesands/lit,
/area/template_noop)

(1,1,1) = {"
a
a
c
k
m
m
a
"}
(2,1,1) = {"
a
f
c
c
n
k
k
"}
(3,1,1) = {"
a
e
c
c
c
w
c
"}
(4,1,1) = {"
e
c
c
c
c
c
e
"}
(5,1,1) = {"
e
e
e
c
c
c
n
"}
(6,1,1) = {"
a
n
k
c
c
k
m
"}
(7,1,1) = {"
a
a
c
c
v
e
a
"}
