//MAP CONVERTED BY dmm2tgm.py THIS HEADER COMMENT PREVENTS RECONVERSION, DO NOT REMOVE
"a" = (
/turf/open/space/basic,
/area/space)
"J" = (
/turf/open/floor/plating/asteroid/airless,
/area/space)
"L" = (
/turf/closed/mineral,
/area/space)

(1,1,1) = {"
a
a
a
a
a
a
a
a
a
a
a
a
a
a
a
a
a
a
a
a
a
a
a
a
a
a
a
a
a
a
a
a
a
a
a
a
a
a
a
a
a
a
a
a
J
a
a
a
a
a
a
J
a
a
a
J
J
a
a
a
J
J
J
a
J
J
a
J
J
a
J
J
J
a
a
a
a
a
a
a
a
a
a
a
a
a
a
a
a
a
a
a
a
a
a
"}
(2,1,1) = {"
a
a
a
a
a
a
a
a
a
a
a
a
a
a
a
a
a
a
a
a
a
a
a
a
a
a
a
a
a
a
a
a
a
a
a
a
a
a
a
a
a
a
a
a
J
J
J
J
J
J
J
a
J
J
a
a
a
a
a
J
J
J
J
J
J
J
a
J
J
J
J
J
J
J
a
a
a
a
a
a
a
a
a
a
a
a
a
a
a
a
a
a
a
a
a
"}
(3,1,1) = {"
a
a
a
a
a
a
a
a
a
a
a
a
a
a
a
a
a
a
a
a
a
L
L
a
a
a
a
a
a
a
L
L
L
L
L
L
L
L
L
L
L
L
a
a
a
J
J
J
J
J
J
J
J
J
a
a
J
J
J
J
J
J
J
J
J
J
J
J
J
J
J
J
J
J
L
L
L
L
L
L
a
L
a
L
L
L
a
a
a
a
a
a
a
a
a
"}
(4,1,1) = {"
a
a
a
a
a
a
a
a
a
a
a
J
L
L
J
J
J
a
L
L
L
L
L
L
L
a
a
L
L
L
L
L
L
L
L
L
L
L
L
L
L
L
a
J
J
J
J
J
J
J
J
J
J
J
J
J
J
J
J
J
J
J
J
J
J
J
J
J
J
J
J
L
L
L
L
L
L
L
L
L
L
L
L
L
L
L
L
L
L
L
L
a
a
a
a
"}
(5,1,1) = {"
a
a
a
a
a
a
a
a
a
a
J
J
J
J
L
L
L
L
L
L
L
L
L
L
L
L
L
L
L
L
L
L
L
L
L
L
L
L
L
L
L
L
L
L
L
a
J
J
J
J
J
J
J
J
J
J
J
J
J
J
J
J
J
J
J
J
J
J
J
J
L
L
L
L
L
L
L
L
L
L
L
L
L
L
L
L
L
L
L
J
J
L
a
a
a
"}
(6,1,1) = {"
a
a
a
a
a
a
a
a
a
J
J
L
L
L
L
L
L
L
L
L
L
L
L
L
L
L
L
L
L
L
L
L
L
L
L
L
L
L
L
L
L
L
L
L
L
L
a
L
L
L
L
L
J
J
J
J
J
J
J
J
L
J
L
J
L
L
L
L
L
L
L
L
L
L
L
L
L
L
L
L
L
L
L
L
L
L
L
L
L
L
L
J
a
a
a
"}
(7,1,1) = {"
a
a
a
a
a
a
a
a
J
J
L
L
L
L
L
L
L
L
L
L
L
L
L
L
L
L
L
L
L
L
L
L
L
L
L
L
L
L
L
L
L
L
L
L
L
L
L
L
L
L
J
L
J
L
J
J
L
L
L
L
L
L
L
L
L
L
J
L
J
L
J
J
L
L
L
L
L
L
L
L
L
L
L
L
L
L
L
L
L
L
L
L
L
a
a
"}
(8,1,1) = {"
a
a
a
a
a
a
a
J
J
J
L
L
L
L
L
L
L
L
L
L
L
L
L
L
L
L
L
L
L
L
L
L
L
L
L
L
L
L
L
L
L
L
L
L
L
L
L
L
L
L
L
L
L
J
J
J
J
J
J
L
L
L
L
L
L
J
L
L
J
L
L
L
L
L
L
L
L
L
L
L
L
L
L
L
L
L
L
L
L
L
L
L
L
a
a
"}
(9,1,1) = {"
a
a
a
a
a
a
J
J
L
L
L
L
L
L
L
L
L
L
L
L
L
L
L
L
L
L
L
L
L
L
L
L
L
L
L
L
L
L
L
L
L
L
L
L
L
L
L
L
L
L
L
L
J
J
L
J
J
J
L
L
L
L
L
J
J
J
L
L
L
L
L
L
L
L
L
L
L
L
L
L
L
L
L
L
L
L
L
L
L
L
L
L
L
J
a
"}
(10,1,1) = {"
a
a
a
a
a
a
J
J
L
L
L
L
L
L
L
L
L
L
L
L
L
L
L
L
L
L
L
L
L
L
L
L
L
L
L
L
L
L
L
L
L
L
L
L
L
L
L
L
L
L
L
L
L
J
L
J
L
L
L
J
J
L
L
L
L
L
L
L
L
L
L
L
L
L
L
L
L
L
L
L
L
L
L
L
L
L
L
L
L
L
L
L
L
J
a
"}
(11,1,1) = {"
a
a
a
a
a
a
J
L
L
L
L
L
L
L
L
L
L
L
L
L
L
L
L
L
L
L
L
L
L
L
L
L
L
L
L
L
L
L
L
L
L
L
L
L
L
L
L
L
L
L
L
L
J
J
J
J
L
L
L
L
L
J
L
L
L
L
L
L
L
L
L
L
L
L
L
L
L
L
L
L
L
L
L
L
L
L
L
L
L
J
L
L
J
J
a
"}
(12,1,1) = {"
a
a
a
a
a
a
J
L
L
L
L
L
L
L
L
L
L
L
L
L
L
L
L
L
L
L
L
L
L
L
L
L
L
L
L
L
J
J
J
L
L
L
L
L
L
L
L
L
L
L
J
J
L
J
L
J
L
L
J
J
J
L
L
J
J
J
J
J
J
L
J
L
J
J
J
L
L
L
L
L
L
L
L
L
L
L
L
L
L
J
J
J
J
a
a
"}
(13,1,1) = {"
a
a
a
a
J
J
L
L
L
L
L
L
L
L
L
L
L
L
L
L
L
L
L
L
L
L
L
L
L
L
L
L
L
L
L
L
L
L
J
L
L
L
L
L
L
L
L
L
L
J
J
L
L
J
J
L
J
J
L
L
J
J
J
L
J
L
J
J
J
L
J
J
J
J
L
L
L
L
L
L
L
L
L
L
L
L
L
L
J
J
L
L
L
a
a
"}
(14,1,1) = {"
a
a
a
a
J
a
L
L
L
L
L
L
L
J
J
J
L
L
L
L
L
L
L
L
L
L
L
L
L
L
L
L
L
L
J
L
L
L
J
L
L
L
L
L
L
L
L
L
J
L
J
L
L
L
L
L
L
L
L
L
L
L
L
J
L
J
J
L
J
J
J
J
L
L
L
L
L
L
L
L
L
L
L
L
L
L
L
J
J
L
L
L
L
L
a
"}
(15,1,1) = {"
a
a
a
a
J
J
L
L
L
L
L
L
L
L
L
L
J
L
L
L
L
L
L
L
L
L
L
L
L
L
L
L
J
J
J
J
J
L
L
L
L
L
L
L
L
L
L
L
J
J
L
J
L
J
J
L
L
L
L
L
L
L
L
L
L
J
J
L
J
L
J
L
L
L
L
L
L
L
J
J
L
L
L
L
L
L
L
L
L
L
L
L
L
L
a
"}
(16,1,1) = {"
a
a
a
a
J
J
L
L
L
L
L
L
J
J
J
L
J
J
J
L
L
L
L
L
L
L
L
L
L
L
L
L
L
L
L
L
L
J
J
J
L
L
L
L
L
L
L
L
L
L
L
L
L
L
J
J
L
L
L
J
L
J
J
J
L
L
L
L
J
L
J
J
L
J
J
L
L
L
L
J
L
L
L
L
L
L
L
L
L
L
L
L
L
L
a
"}
(17,1,1) = {"
a
a
a
a
J
J
J
L
L
L
L
L
J
J
L
L
J
J
J
L
L
L
L
L
L
L
L
L
L
J
J
L
L
L
L
L
L
L
L
L
L
J
J
L
L
L
L
J
L
L
L
L
L
L
J
L
L
J
J
J
L
J
L
J
J
J
J
J
J
L
L
J
L
L
L
L
L
L
L
L
L
J
L
L
L
L
L
L
L
L
L
L
L
L
a
"}
(18,1,1) = {"
a
a
a
a
J
J
L
L
L
L
L
L
J
J
L
L
J
J
J
L
L
L
L
L
L
L
L
L
L
L
L
L
L
L
L
L
L
L
L
L
L
L
J
L
L
L
L
J
L
L
L
L
L
L
L
J
L
L
L
L
L
L
L
L
L
L
L
L
L
L
L
L
L
L
L
L
J
J
L
L
L
J
L
L
L
L
L
L
L
L
L
L
L
L
a
"}
(19,1,1) = {"
a
a
a
a
J
J
L
L
L
L
L
L
J
J
J
L
J
J
J
L
J
L
L
L
L
L
L
L
L
J
L
L
L
L
L
L
L
L
L
L
L
L
L
L
L
L
L
J
L
L
L
L
L
L
L
J
L
L
L
L
L
L
L
L
L
L
L
L
L
L
L
L
L
L
L
L
J
L
L
L
J
J
J
L
L
L
L
L
L
L
L
L
L
L
a
"}
(20,1,1) = {"
a
a
a
a
a
J
L
L
L
L
L
L
L
L
L
L
J
J
J
L
L
L
L
L
L
L
L
L
L
L
L
L
L
L
L
L
L
L
L
L
L
L
L
L
L
L
J
J
J
L
L
L
L
L
L
L
L
L
L
L
L
L
L
L
L
J
L
L
L
L
L
L
L
L
L
L
J
L
L
L
J
J
L
J
L
L
L
L
L
L
L
L
L
L
a
"}
(21,1,1) = {"
a
a
a
a
a
J
L
L
L
L
L
L
L
L
L
J
J
J
J
J
J
J
J
J
L
L
L
L
L
L
L
L
L
L
L
L
L
L
L
L
L
L
L
L
L
L
L
J
J
L
J
L
L
L
L
L
L
L
L
L
L
L
L
L
J
L
L
L
L
L
L
L
L
L
L
L
L
L
J
J
J
L
J
J
L
L
L
L
L
L
L
L
L
L
a
"}
(22,1,1) = {"
a
a
a
a
J
L
L
L
L
L
L
L
L
L
L
L
L
L
L
L
L
L
J
L
J
J
J
L
J
L
L
J
L
L
L
L
L
L
L
L
L
L
L
L
L
L
L
L
L
J
J
J
L
L
L
L
L
L
L
L
L
L
L
J
J
L
L
L
L
L
L
L
L
L
L
L
L
J
L
L
J
J
J
L
J
L
L
L
L
L
L
L
L
a
a
"}
(23,1,1) = {"
a
a
a
a
J
L
L
L
L
L
L
L
L
L
L
L
L
J
L
J
J
L
J
L
J
J
L
L
L
L
L
L
L
L
J
L
L
L
L
L
L
L
L
L
L
L
L
L
L
L
L
L
L
J
L
L
L
L
L
L
L
L
J
L
L
L
L
L
L
L
L
L
J
L
L
L
J
J
J
L
L
J
J
L
L
L
L
L
L
L
L
L
L
a
a
"}
(24,1,1) = {"
a
a
a
a
L
L
L
L
L
L
L
L
L
L
L
L
L
L
L
L
L
L
J
L
L
L
L
L
L
L
L
L
L
L
L
L
J
L
L
L
L
L
L
L
L
L
L
L
L
L
L
L
L
L
J
L
L
L
L
L
J
J
L
L
L
L
L
L
L
L
L
J
L
L
L
L
J
J
L
J
J
J
J
L
L
L
L
L
L
L
L
L
L
a
a
"}
(25,1,1) = {"
a
a
a
J
J
L
L
L
L
L
L
L
L
L
L
L
L
L
L
L
L
L
L
L
L
L
L
L
L
L
L
L
L
L
L
J
J
L
L
L
L
L
L
L
L
L
L
L
L
L
L
L
L
L
L
L
J
L
J
J
J
L
L
L
L
L
L
L
L
L
J
L
J
L
L
J
J
J
J
L
J
J
J
L
L
L
L
L
L
L
L
L
L
a
a
"}
(26,1,1) = {"
a
a
a
J
L
L
L
L
L
L
L
L
L
L
L
L
L
L
L
L
L
L
J
J
L
L
L
L
L
L
L
L
L
L
L
J
L
L
L
J
J
L
L
L
L
L
L
L
L
L
L
L
L
L
L
L
L
L
L
L
L
L
L
L
L
L
L
L
L
L
J
J
L
L
L
L
J
J
L
L
L
J
J
L
L
L
L
L
L
L
L
L
L
a
a
"}
(27,1,1) = {"
a
a
a
J
L
L
L
L
L
L
L
L
L
L
L
L
L
L
L
L
L
L
J
L
L
L
L
L
L
L
L
L
L
J
J
J
L
L
J
L
J
L
L
L
L
L
L
L
L
L
L
L
L
L
L
L
L
L
L
L
L
L
L
L
L
L
L
L
L
L
L
L
L
L
J
J
J
J
J
L
J
L
L
L
L
L
L
L
L
L
L
L
L
a
a
"}
(28,1,1) = {"
a
a
a
J
L
L
L
L
L
L
L
L
L
L
L
L
L
L
L
L
L
L
L
L
L
L
L
L
L
L
L
L
J
J
J
J
J
L
L
L
L
L
L
L
L
L
L
L
L
L
L
L
L
L
L
L
L
L
L
L
L
L
L
L
L
L
L
L
J
L
L
L
L
L
J
L
L
J
J
J
J
L
L
L
L
L
L
L
L
L
L
L
L
a
a
"}
(29,1,1) = {"
a
a
a
J
L
L
L
L
L
L
L
L
L
L
L
L
L
L
L
L
L
L
L
L
L
L
L
L
L
L
L
J
J
J
J
L
L
L
L
L
J
L
L
L
L
L
L
L
L
L
L
L
L
L
L
L
L
L
L
L
L
L
L
L
L
L
L
L
L
L
L
J
L
L
J
L
J
J
J
J
L
L
L
L
L
L
L
L
L
L
L
L
L
L
L
"}
(30,1,1) = {"
a
a
a
J
L
L
L
L
L
L
L
L
L
L
L
L
L
L
L
L
L
L
L
L
L
L
L
L
L
L
L
J
J
J
L
L
J
L
L
L
L
L
L
L
L
L
L
L
L
L
L
L
L
L
L
L
L
L
L
L
L
L
L
L
L
L
L
L
L
L
L
L
L
J
J
L
J
J
J
J
L
L
L
L
L
L
L
L
L
L
L
a
a
a
L
"}
(31,1,1) = {"
a
a
a
L
L
L
L
L
L
L
L
L
L
L
L
L
L
L
L
L
L
L
L
L
L
L
L
L
L
L
L
L
J
L
L
J
L
L
J
L
L
L
L
L
L
L
L
L
L
L
L
L
L
L
L
L
L
L
L
L
L
L
L
L
L
L
L
L
L
L
L
J
L
J
J
J
J
L
J
J
L
L
L
L
L
L
L
L
L
L
L
a
a
L
L
"}
(32,1,1) = {"
a
a
a
L
L
L
L
L
L
L
L
L
L
L
L
L
L
L
L
L
L
L
L
L
L
L
L
L
L
L
J
J
L
L
L
L
L
L
J
L
L
L
L
L
L
L
L
L
L
J
J
L
L
L
L
L
L
L
L
L
L
L
L
L
L
L
L
J
J
L
L
J
L
J
L
L
L
J
L
J
L
L
L
L
L
L
L
L
L
L
L
J
J
L
L
"}
(33,1,1) = {"
a
a
a
L
L
L
L
L
L
L
L
L
L
L
L
L
L
L
L
J
L
L
L
L
L
L
L
L
L
L
L
L
L
L
J
L
L
L
J
J
L
L
L
L
L
L
L
L
J
J
L
L
L
L
L
L
L
L
L
L
L
L
L
L
L
L
L
L
L
L
L
J
L
J
L
L
J
J
L
J
J
L
L
L
L
L
L
L
L
L
J
J
J
L
L
"}
(34,1,1) = {"
a
a
a
L
L
L
L
L
L
L
L
L
L
L
L
L
L
L
L
L
L
L
L
L
L
L
L
L
J
J
L
L
L
L
L
L
L
L
J
J
L
L
L
L
L
L
L
L
J
L
L
L
L
L
L
L
L
L
L
L
L
L
L
L
L
L
L
L
L
L
L
L
L
J
L
L
J
J
J
J
J
L
L
L
L
L
L
L
L
L
J
J
J
a
L
"}
(35,1,1) = {"
a
a
a
L
L
L
L
L
L
L
L
L
L
L
L
L
L
L
L
L
L
J
L
L
L
L
L
L
J
J
J
L
J
L
L
L
L
L
J
L
L
L
L
L
L
L
L
L
L
L
L
L
L
J
L
L
L
L
L
L
L
L
L
L
L
L
J
L
L
L
L
J
J
J
L
J
J
J
J
L
L
L
L
L
L
L
L
L
L
L
L
L
J
a
L
"}
(36,1,1) = {"
a
a
a
L
L
L
L
L
L
L
L
L
L
L
L
L
L
L
L
L
L
L
L
J
L
L
L
L
L
L
J
J
L
L
L
L
L
L
L
L
L
L
L
L
L
L
L
L
L
L
L
L
L
J
J
L
L
L
L
L
L
L
L
L
L
L
J
L
L
L
L
J
J
J
L
L
J
L
J
L
L
L
L
L
L
L
L
L
L
L
L
a
J
a
L
"}
(37,1,1) = {"
a
a
a
L
L
L
L
L
L
L
L
L
J
L
L
J
L
L
L
L
L
L
L
L
L
L
L
L
L
L
J
J
L
L
L
L
L
L
L
L
L
L
L
L
L
L
L
L
L
L
L
J
J
J
J
J
J
J
L
L
L
L
L
L
L
L
L
L
L
L
L
L
L
L
L
J
J
J
J
L
L
L
L
L
L
L
L
L
L
L
L
L
a
a
a
"}
(38,1,1) = {"
a
a
a
J
L
J
L
J
J
L
J
L
L
J
L
L
L
L
L
L
L
L
L
L
L
L
J
J
J
L
L
J
J
L
L
L
L
L
L
L
L
L
L
L
L
L
L
L
L
L
L
J
J
J
J
J
J
J
J
L
L
L
L
L
L
L
L
L
L
L
L
J
J
J
J
L
J
J
L
J
L
L
L
L
L
J
L
L
L
L
L
L
a
a
L
"}
(39,1,1) = {"
a
a
a
J
J
J
J
J
L
J
J
J
J
J
J
L
L
L
L
L
L
L
L
L
L
L
J
L
J
L
L
J
J
J
L
L
L
L
L
L
L
L
L
L
L
L
L
J
L
L
L
J
J
J
J
J
J
J
J
L
L
L
L
L
L
L
L
L
L
L
J
L
J
L
J
L
J
J
L
L
J
L
L
L
L
J
L
L
L
L
L
L
L
a
a
"}
(40,1,1) = {"
a
a
a
J
L
J
L
J
J
L
L
J
L
J
J
L
L
L
L
L
L
L
L
L
L
L
L
J
L
L
L
L
J
J
L
L
L
L
L
L
L
L
L
L
L
L
J
J
L
L
L
J
L
J
J
J
J
J
J
J
J
L
L
L
L
L
L
L
L
L
J
L
J
L
J
J
L
J
J
J
L
L
L
L
J
J
L
L
L
L
L
L
L
a
a
"}
(41,1,1) = {"
a
a
a
J
L
J
L
J
J
L
J
L
J
J
J
L
L
L
L
L
L
L
L
L
L
L
J
J
L
L
L
J
L
L
J
L
L
L
L
L
L
L
L
L
L
J
L
L
L
L
L
J
J
J
J
J
J
J
J
J
J
L
L
L
L
L
L
L
L
J
L
L
J
J
J
J
J
L
J
J
J
L
L
L
J
L
L
L
L
L
L
a
a
a
a
"}
(42,1,1) = {"
a
a
a
J
J
J
J
L
J
J
J
J
J
J
L
L
L
L
L
L
L
L
L
L
L
J
J
L
L
L
J
L
J
L
L
L
L
L
L
L
L
L
L
J
J
J
J
J
L
L
J
J
J
J
J
J
J
J
J
J
J
L
L
J
L
L
J
J
J
J
L
J
J
J
J
L
J
L
L
J
J
L
L
L
L
L
L
L
L
L
L
a
a
a
a
"}
(43,1,1) = {"
a
a
a
J
L
J
J
J
L
L
L
J
L
L
L
L
L
L
L
L
L
L
L
L
L
L
L
L
L
L
L
L
J
L
L
L
L
L
L
L
L
J
J
J
L
L
J
J
L
L
J
J
J
J
J
J
J
J
J
J
J
L
J
J
L
J
J
J
L
J
L
J
J
J
J
J
J
J
J
J
J
L
L
L
J
L
L
L
L
L
L
L
L
a
a
"}
(44,1,1) = {"
a
a
a
J
L
L
J
J
J
J
J
J
L
J
J
J
L
L
L
L
L
L
L
L
L
L
L
J
L
L
L
J
L
L
L
L
L
L
L
L
L
J
L
J
J
J
L
J
L
L
J
J
J
J
J
J
J
J
J
J
J
L
J
L
L
L
L
L
L
L
L
L
L
L
L
J
L
J
J
J
L
J
L
J
J
L
L
L
L
L
L
L
L
a
a
"}
(45,1,1) = {"
a
a
a
J
J
J
J
J
L
J
L
L
L
L
L
L
L
L
J
J
L
L
L
L
L
L
L
L
L
L
L
L
J
L
L
L
L
L
L
L
L
J
J
L
J
J
L
L
L
L
J
J
J
J
J
J
J
L
J
J
L
L
L
L
L
L
L
L
L
L
L
L
L
L
L
J
J
L
J
L
J
J
L
L
L
L
L
L
L
L
L
L
L
a
a
"}
(46,1,1) = {"
a
a
a
L
L
L
L
L
J
L
J
J
J
J
L
L
L
L
L
L
J
L
L
L
L
L
L
L
L
J
L
L
L
L
L
L
L
L
L
J
J
L
L
J
J
L
L
L
L
J
J
J
J
J
J
J
J
J
J
J
L
J
J
L
L
L
L
L
L
L
L
L
L
L
J
J
J
J
J
L
J
L
L
L
L
L
L
L
L
L
L
L
L
a
L
"}
(47,1,1) = {"
a
a
a
L
L
L
L
L
L
L
L
J
J
L
L
L
L
L
L
L
L
J
L
L
L
L
L
L
L
L
L
L
L
J
L
L
L
L
L
L
L
L
J
J
J
L
J
L
J
L
L
J
J
J
J
L
J
J
J
L
L
J
J
L
L
L
L
L
L
L
L
L
L
L
J
J
J
J
L
L
L
L
L
L
L
L
L
L
L
L
L
L
L
a
L
"}
(48,1,1) = {"
a
a
a
J
L
L
L
J
L
J
J
L
L
L
L
L
L
L
L
L
L
L
L
L
L
L
L
L
L
L
L
L
L
L
L
L
L
L
L
L
L
J
J
J
L
L
L
L
J
L
J
J
J
J
J
J
J
L
J
J
J
J
L
L
L
L
L
L
L
L
L
L
L
L
L
J
J
L
J
J
L
L
L
L
L
L
L
L
L
L
L
L
L
a
L
"}
(49,1,1) = {"
a
a
a
J
L
L
L
L
L
L
L
L
L
L
L
L
L
L
L
L
L
L
L
L
L
L
L
L
L
L
L
L
J
L
J
J
L
L
L
L
L
J
L
J
J
L
L
L
J
J
L
J
J
J
J
L
L
J
J
L
J
L
L
L
L
L
L
L
L
L
L
L
L
J
J
J
J
J
J
J
J
L
L
L
L
L
L
L
L
L
L
L
L
a
L
"}
(50,1,1) = {"
a
a
a
J
L
L
L
L
L
L
L
L
L
L
L
L
L
L
L
L
L
L
L
L
L
L
L
L
L
L
L
L
L
L
L
J
L
L
L
L
J
L
J
L
L
L
L
L
L
L
L
L
L
L
L
J
J
J
L
J
J
L
L
L
L
L
L
L
L
L
L
L
L
J
J
J
L
J
J
L
L
L
L
L
L
L
L
L
L
L
L
L
L
L
L
"}
(51,1,1) = {"
a
a
a
J
J
L
L
L
L
L
L
L
L
L
L
L
L
L
L
L
L
L
L
L
L
L
L
L
L
L
L
L
L
L
L
L
L
L
L
L
J
J
J
J
J
L
L
L
L
L
L
L
L
L
L
L
J
L
L
J
L
L
L
L
L
L
L
L
L
L
L
L
L
L
J
J
J
J
L
L
L
L
L
L
L
L
L
L
L
L
L
L
L
L
L
"}
(52,1,1) = {"
a
a
a
J
J
L
L
L
L
L
L
L
J
J
L
L
J
L
L
L
L
L
L
L
L
L
L
L
L
L
L
L
L
L
L
J
L
L
L
J
J
L
L
L
J
J
L
L
L
L
J
L
L
L
J
L
J
J
L
L
L
L
L
L
L
L
L
L
L
L
L
L
J
L
L
J
J
J
J
J
L
L
L
L
L
L
L
L
L
L
L
a
a
a
a
"}
(53,1,1) = {"
a
a
a
J
J
L
L
L
L
L
J
J
L
J
J
J
L
L
L
L
L
L
L
L
L
L
L
L
L
L
L
L
L
L
J
J
L
L
L
L
L
J
L
J
L
J
J
L
L
L
J
L
L
J
L
J
L
L
J
L
L
L
L
L
L
L
L
L
L
L
L
L
J
J
L
L
L
L
J
J
L
L
L
L
L
L
L
L
L
L
L
a
a
a
a
"}
(54,1,1) = {"
a
a
a
a
L
L
L
J
L
L
J
L
J
J
J
L
L
L
L
L
L
L
L
L
L
L
L
L
L
L
L
L
L
L
L
J
L
L
L
L
J
J
J
L
J
J
L
L
L
L
J
L
J
L
L
J
J
J
L
L
L
L
L
L
L
L
L
L
L
L
L
L
J
L
L
L
L
J
L
L
L
L
L
L
L
L
L
J
L
L
L
L
L
a
a
"}
(55,1,1) = {"
a
a
a
a
J
J
J
J
L
J
J
J
J
L
L
L
L
J
J
L
L
L
L
L
L
L
L
L
L
L
L
L
L
L
L
J
J
J
L
J
L
J
J
L
J
L
L
L
L
L
J
J
L
L
L
L
L
L
L
L
L
L
L
L
L
L
L
L
L
L
L
L
J
L
J
L
L
L
J
L
J
L
L
L
L
L
L
L
L
L
L
L
L
a
a
"}
(56,1,1) = {"
a
a
a
a
J
L
J
L
J
J
J
J
J
L
L
J
J
J
L
L
L
L
L
L
L
L
L
L
L
L
L
L
L
L
L
J
J
L
L
L
L
L
L
J
J
L
L
L
L
L
L
L
L
L
L
J
L
J
L
L
L
L
L
L
L
L
L
L
L
L
L
L
L
L
L
L
J
L
L
J
J
L
L
L
L
L
L
L
L
L
L
L
L
a
a
"}
(57,1,1) = {"
a
a
a
a
a
L
J
J
J
J
J
L
L
L
J
J
J
L
L
L
L
L
L
L
L
L
L
L
L
L
L
L
L
L
J
L
L
J
L
L
L
L
L
J
L
L
L
L
L
L
L
L
L
J
J
J
L
L
L
L
L
L
L
L
L
L
L
L
L
L
L
L
L
L
J
L
J
J
J
J
L
L
L
L
L
L
L
L
L
L
L
L
L
a
a
"}
(58,1,1) = {"
a
a
a
a
J
L
J
J
J
L
L
L
J
J
J
L
J
L
L
L
L
L
L
L
L
L
L
L
L
L
L
L
J
L
L
L
L
L
L
L
L
L
L
J
L
L
L
L
L
L
L
L
L
L
L
L
L
L
L
L
L
L
L
L
L
L
L
L
L
J
J
J
L
L
J
J
J
L
J
J
L
L
L
L
L
L
L
L
L
L
L
L
L
a
a
"}
(59,1,1) = {"
a
a
a
J
J
J
L
L
L
L
L
L
L
L
L
J
J
J
L
L
J
J
L
L
L
L
L
L
L
L
L
L
L
L
L
L
L
L
L
L
L
L
L
L
L
L
L
L
L
L
L
L
L
L
L
L
L
L
L
L
L
L
L
L
L
L
L
L
L
L
L
L
L
L
L
L
L
J
L
J
L
L
L
L
L
L
L
L
L
L
L
L
L
L
a
"}
(60,1,1) = {"
a
a
a
J
J
J
L
L
L
L
L
L
L
L
J
J
L
L
L
J
L
L
J
L
L
L
L
L
L
L
L
L
L
L
L
L
L
L
L
L
L
L
L
L
L
L
L
L
L
L
L
L
L
L
L
L
L
L
L
L
L
L
L
L
L
L
L
L
L
L
J
L
L
L
J
J
J
J
L
J
L
L
L
L
L
L
L
L
L
L
L
L
L
L
a
"}
(61,1,1) = {"
a
a
a
J
J
J
L
L
L
L
L
L
L
L
J
J
J
J
L
L
L
J
J
J
J
L
L
L
L
L
L
L
L
L
L
L
L
L
L
L
L
L
L
L
L
L
L
L
L
L
L
L
L
L
L
L
L
L
L
L
L
L
L
L
L
L
L
L
L
L
L
L
L
J
L
J
L
J
L
L
L
L
L
L
L
J
L
L
L
L
L
L
L
L
a
"}
(62,1,1) = {"
a
a
a
J
J
L
L
L
L
L
L
L
L
L
J
J
L
L
L
J
L
J
L
L
L
L
L
L
L
L
L
L
L
L
L
L
L
L
L
J
L
L
L
L
L
L
L
L
L
L
L
L
L
L
L
L
L
L
L
L
L
L
L
L
L
L
J
L
L
L
L
L
L
J
L
L
L
J
J
L
L
L
L
L
J
J
L
L
L
L
L
L
L
L
a
"}
(63,1,1) = {"
a
a
a
J
J
J
L
L
L
L
L
L
J
L
L
L
L
J
L
L
L
L
L
J
L
L
L
L
L
L
L
L
L
L
L
L
L
L
L
L
L
L
L
L
L
L
L
L
L
L
L
L
L
L
L
L
L
L
L
L
L
L
L
L
L
L
L
L
L
L
J
L
J
J
L
J
J
J
L
L
L
L
L
L
J
J
L
L
L
L
L
L
L
L
a
"}
(64,1,1) = {"
a
a
a
a
J
L
L
L
L
L
L
L
L
L
L
J
J
L
L
J
J
L
L
L
L
L
L
L
L
L
L
L
L
L
L
L
L
L
L
L
L
L
L
L
L
L
L
L
L
L
L
J
J
J
J
L
L
L
L
L
L
L
L
L
L
J
L
L
L
L
L
L
L
J
J
J
J
J
L
L
L
L
L
L
L
J
L
L
L
L
L
L
L
L
a
"}
(65,1,1) = {"
a
a
a
a
J
L
L
J
J
L
L
L
L
L
L
L
L
J
J
L
L
L
L
L
L
L
L
L
L
L
L
L
L
L
L
L
L
L
L
L
L
L
L
L
L
L
L
L
L
L
L
J
J
J
J
L
L
L
L
L
L
L
L
L
L
J
L
L
L
L
L
J
J
J
L
J
J
L
L
L
L
L
L
L
L
J
L
L
L
L
L
L
L
a
a
"}
(66,1,1) = {"
a
a
a
J
J
J
L
L
L
J
L
L
L
L
L
L
J
L
J
L
L
L
L
J
J
L
L
J
J
L
L
L
L
L
L
L
L
L
L
L
L
J
L
L
L
L
L
L
L
L
L
L
L
L
L
L
L
L
L
L
L
L
L
L
L
L
L
L
L
L
L
J
J
J
J
J
J
L
L
L
L
L
L
J
L
J
L
L
L
L
L
L
L
a
a
"}
(67,1,1) = {"
a
a
a
a
J
L
L
L
L
J
L
L
L
L
L
L
L
L
L
L
L
L
L
J
L
L
J
L
L
L
L
L
L
L
L
L
L
L
L
L
L
L
L
L
L
L
L
L
L
L
L
L
L
L
L
L
L
L
L
L
L
L
L
J
L
L
L
L
L
L
L
J
L
J
J
L
J
L
L
L
L
L
L
J
L
L
L
L
L
L
L
L
a
a
a
"}
(68,1,1) = {"
a
a
a
J
J
L
L
L
L
L
J
L
L
L
J
L
J
L
L
L
L
L
L
J
L
J
L
L
L
L
L
L
L
L
L
L
L
L
L
L
L
L
L
L
L
L
L
L
L
L
L
L
L
L
L
L
L
L
L
L
L
L
L
L
L
L
L
L
L
L
L
J
J
J
L
L
L
L
L
L
L
L
L
L
J
L
L
L
L
L
L
L
a
a
a
"}
(69,1,1) = {"
a
a
a
a
J
J
L
L
L
J
J
L
J
L
J
J
L
L
L
L
L
J
L
J
L
L
L
L
L
L
L
L
L
L
L
L
L
L
L
L
L
L
L
J
L
L
L
L
L
L
L
L
L
L
L
L
L
L
L
L
L
L
L
L
L
L
L
L
J
L
J
J
L
J
L
L
L
L
L
L
L
L
L
L
L
L
L
L
L
L
L
L
a
a
a
"}
(70,1,1) = {"
a
a
a
J
a
J
L
L
L
J
J
L
L
L
J
L
L
L
L
L
J
J
J
L
J
J
J
J
L
L
L
L
L
L
L
L
L
L
L
L
L
L
L
L
J
J
L
L
L
L
L
L
L
L
L
L
L
L
L
L
L
L
L
L
L
L
L
L
J
J
L
J
L
L
L
L
L
L
L
L
L
L
L
J
L
L
L
L
L
L
L
L
a
a
a
"}
(71,1,1) = {"
a
a
a
J
J
J
L
L
L
L
J
L
L
L
L
L
L
L
L
J
J
J
J
L
L
J
J
L
L
L
L
L
L
L
L
L
L
L
L
L
L
L
L
L
L
J
L
L
L
L
L
L
L
L
L
L
L
L
L
L
L
L
L
L
L
L
L
J
J
J
J
L
L
L
L
L
L
L
L
L
L
L
J
L
L
L
L
L
L
L
L
L
a
a
a
"}
(72,1,1) = {"
a
a
a
J
J
J
L
L
L
L
L
L
L
L
L
L
L
L
L
L
J
L
L
J
L
L
J
L
L
L
L
L
L
L
L
L
L
L
L
L
L
L
L
L
L
L
J
L
J
L
L
L
L
L
L
L
L
L
L
L
L
L
L
L
L
L
L
L
J
L
L
L
L
L
L
L
L
L
L
L
L
L
L
L
L
L
L
L
L
L
L
L
a
a
a
"}
(73,1,1) = {"
a
a
a
a
J
J
L
L
L
L
L
L
L
L
L
L
L
L
L
L
L
L
L
L
J
L
L
L
J
L
J
J
L
L
L
L
L
L
L
L
L
L
L
L
L
L
L
J
L
L
L
L
L
L
L
L
L
L
L
L
L
L
L
L
L
L
L
J
J
L
L
L
L
L
L
L
L
L
L
L
J
L
J
J
L
L
L
L
L
L
L
L
L
a
a
"}
(74,1,1) = {"
a
a
a
a
a
J
L
L
L
L
L
L
L
L
L
L
L
L
L
L
L
J
J
J
L
J
L
L
J
J
L
L
L
L
L
L
L
L
L
L
L
L
L
L
L
J
J
L
L
L
L
L
L
L
L
L
L
L
L
L
L
L
L
L
L
J
J
J
L
L
L
L
L
L
L
L
L
L
L
L
L
J
J
L
L
L
L
L
L
L
L
L
L
L
a
"}
(75,1,1) = {"
a
a
a
a
J
J
L
J
J
L
L
L
L
L
L
L
L
L
L
J
L
L
J
J
J
L
J
J
J
L
L
L
L
L
L
L
L
L
L
L
L
L
L
L
J
L
L
L
J
J
J
L
J
J
J
L
L
L
L
L
L
L
L
L
L
J
L
L
L
L
L
L
L
L
L
L
L
L
L
L
J
L
L
L
L
L
L
L
L
L
L
L
L
L
a
"}
(76,1,1) = {"
a
a
a
a
J
J
J
L
J
J
J
J
L
L
J
L
J
L
L
L
L
L
J
J
J
J
J
J
J
L
L
J
J
L
L
L
L
L
L
L
L
J
J
L
J
J
L
L
L
L
L
L
J
L
L
L
L
L
L
L
L
L
L
L
L
L
L
L
L
L
L
L
L
L
L
J
L
L
J
L
J
L
L
L
L
L
L
L
L
L
L
L
L
a
a
"}
(77,1,1) = {"
a
a
a
a
J
J
J
J
J
J
L
L
L
L
L
J
J
J
L
J
J
L
J
L
J
L
J
J
J
L
J
J
J
J
L
L
L
L
L
L
J
J
L
L
L
L
L
L
L
J
J
L
J
L
L
L
L
L
L
L
L
L
J
L
L
L
L
L
L
L
L
L
L
L
L
L
L
L
J
J
J
L
L
L
L
L
L
L
L
L
L
L
L
a
a
"}
(78,1,1) = {"
a
a
a
a
J
J
J
J
L
J
L
L
L
L
J
J
J
J
L
L
J
J
L
L
L
J
L
J
L
L
L
J
J
L
L
L
L
L
L
L
L
L
L
L
J
J
J
J
J
J
J
J
J
J
L
L
L
L
L
L
L
L
L
J
L
L
L
L
L
L
L
L
L
L
L
L
L
L
J
J
L
L
L
L
L
L
L
L
L
L
L
L
L
a
L
"}
(79,1,1) = {"
a
a
a
a
J
J
J
J
J
L
L
L
L
L
J
J
L
J
J
J
J
L
L
J
J
J
J
L
L
J
J
J
L
L
L
L
L
L
L
L
L
L
L
L
J
J
J
J
J
J
L
L
J
L
L
L
L
L
L
L
L
L
L
L
J
L
L
L
L
L
L
L
L
L
L
L
L
J
L
L
L
L
L
L
L
L
L
L
L
L
L
a
a
a
L
"}
(80,1,1) = {"
a
a
a
a
J
J
J
J
L
L
L
L
L
L
L
J
J
J
J
L
J
L
J
J
J
J
L
L
J
J
J
L
L
L
L
L
L
L
L
L
L
L
L
J
L
L
L
L
J
L
L
L
J
L
L
L
L
L
L
L
L
L
L
L
L
J
J
L
L
L
L
L
L
L
L
L
J
J
L
L
L
L
L
L
L
L
L
L
L
L
L
a
J
a
a
"}
(81,1,1) = {"
a
a
a
a
J
J
J
L
L
L
L
L
L
L
L
L
L
J
L
L
L
J
J
J
J
L
J
J
J
L
L
L
L
L
L
L
L
L
L
L
L
L
L
L
L
L
J
J
J
L
J
J
J
L
L
L
L
L
L
L
L
L
L
L
L
L
L
L
L
L
L
L
L
L
L
J
L
L
L
L
L
L
L
L
L
L
L
L
L
L
J
J
J
a
a
"}
(82,1,1) = {"
a
a
a
a
J
J
J
J
L
L
L
L
L
L
L
L
L
L
L
L
L
L
L
J
J
J
L
J
L
L
L
L
L
L
L
L
L
L
L
L
L
L
L
L
L
J
J
J
J
L
J
J
L
L
L
L
L
L
L
L
L
L
L
L
L
L
L
L
L
L
L
L
L
L
L
L
L
L
L
L
L
L
L
L
L
L
L
L
L
J
J
L
J
a
a
"}
(83,1,1) = {"
a
a
a
a
a
a
a
J
L
L
L
L
L
L
L
L
L
L
L
L
L
L
L
L
J
J
J
L
L
L
L
L
J
J
J
L
L
L
L
L
L
L
L
J
J
J
J
J
J
J
J
L
L
L
J
L
J
L
L
L
L
L
L
L
L
L
L
L
L
L
L
L
L
L
L
L
L
L
L
L
L
L
L
L
L
L
L
L
J
L
J
J
L
a
a
"}
(84,1,1) = {"
a
a
a
a
a
a
a
L
J
L
L
L
L
L
L
L
L
L
L
L
L
L
L
L
J
J
J
L
J
J
L
L
L
J
L
L
L
L
L
L
L
L
L
L
J
J
L
J
J
J
J
L
J
L
L
L
J
L
L
L
L
L
L
L
L
L
L
L
L
L
L
L
L
L
L
L
L
L
L
L
L
L
L
L
L
L
L
L
J
J
L
J
J
J
a
"}
(85,1,1) = {"
a
a
a
a
a
a
a
a
J
J
J
L
L
L
L
L
L
L
L
L
L
L
L
L
L
L
L
L
L
L
J
L
L
L
L
L
L
L
L
L
L
L
L
L
J
J
J
J
J
J
J
L
L
L
L
L
L
L
L
L
L
L
L
L
L
L
L
L
L
L
L
L
L
L
L
L
L
L
L
L
L
L
L
L
L
L
L
J
J
L
J
J
J
a
a
"}
(86,1,1) = {"
a
a
a
a
a
a
a
a
a
J
J
J
L
L
L
L
L
L
L
L
L
L
L
L
L
L
L
L
J
L
L
L
L
L
L
L
L
L
L
L
L
L
L
J
J
J
J
J
J
L
J
L
L
L
L
L
L
L
L
L
L
L
L
L
L
L
L
L
L
L
L
L
L
L
L
L
L
L
L
L
L
L
L
L
L
L
L
J
L
L
J
J
J
a
a
"}
(87,1,1) = {"
a
a
a
a
a
a
a
a
a
a
J
a
J
L
L
L
L
L
L
L
L
L
L
L
L
L
L
L
L
L
L
L
L
L
L
L
L
L
L
L
L
L
L
J
J
J
J
J
J
L
J
L
L
L
L
L
L
L
L
L
L
L
L
L
L
L
L
L
L
L
L
L
L
L
L
L
L
L
L
L
L
L
L
L
L
L
J
J
J
J
J
J
L
a
a
"}
(88,1,1) = {"
a
a
a
a
a
a
a
a
a
a
a
J
J
J
L
L
L
L
L
L
L
L
L
L
L
L
L
L
L
L
L
L
L
L
L
L
L
L
L
L
L
L
L
L
J
L
L
L
L
J
J
J
L
L
L
L
L
L
L
L
L
L
L
L
L
L
L
L
L
L
L
L
L
L
L
L
L
L
L
L
L
L
L
L
L
J
J
L
J
J
J
J
a
a
a
"}
(89,1,1) = {"
a
a
a
a
a
a
a
a
a
a
a
a
J
J
L
L
L
L
L
L
L
L
L
L
L
L
L
L
L
L
L
L
L
L
L
J
L
L
L
L
L
L
J
L
J
J
L
L
L
J
J
J
J
L
L
L
L
L
L
L
L
L
L
L
L
L
L
L
L
L
L
a
a
a
a
a
a
a
a
a
a
L
L
L
L
J
J
J
J
J
L
J
a
a
a
"}
(90,1,1) = {"
a
a
a
a
a
a
a
a
a
a
a
a
a
a
a
J
J
a
L
L
L
L
L
L
L
L
L
L
L
L
L
L
L
J
J
J
J
J
L
L
L
J
J
J
J
J
J
L
J
J
J
J
J
L
L
L
L
L
a
a
a
a
a
L
L
L
L
L
L
a
a
a
a
a
a
a
a
a
a
a
a
a
a
a
J
a
a
J
J
J
J
a
a
a
a
"}
(91,1,1) = {"
a
a
a
a
a
a
a
a
a
a
a
a
a
a
a
a
a
a
a
a
a
a
a
a
a
a
a
a
a
a
a
a
a
a
a
a
a
a
a
a
a
a
a
a
a
a
a
a
a
a
a
a
a
a
a
a
a
a
a
a
a
a
a
a
a
a
a
a
a
a
a
a
a
a
a
a
a
a
a
a
a
a
a
a
a
a
a
a
a
a
a
a
a
a
a
"}
(92,1,1) = {"
a
a
a
a
a
a
a
a
a
a
a
a
a
a
a
a
a
a
a
a
a
a
a
a
a
a
a
a
a
a
a
a
a
a
a
a
L
a
a
L
L
L
L
a
a
a
a
a
a
a
a
L
L
L
L
a
a
a
a
a
a
a
a
a
a
a
a
a
a
a
a
a
J
a
a
a
a
a
a
a
a
a
a
a
a
a
a
a
a
a
a
a
a
a
a
"}
(93,1,1) = {"
a
a
a
a
a
a
a
a
a
a
a
a
a
a
a
a
a
a
a
a
a
a
a
a
a
a
a
a
a
a
a
a
a
a
a
a
a
a
a
a
a
a
a
a
a
a
a
a
a
a
a
a
a
a
a
a
a
a
a
a
a
a
a
a
a
a
a
a
a
a
a
a
a
a
a
a
a
a
a
a
a
a
a
a
a
a
a
a
a
a
a
a
a
a
a
"}
(94,1,1) = {"
a
a
a
a
a
a
a
a
a
a
a
a
a
a
a
a
a
a
a
a
a
a
a
a
a
a
a
a
a
a
a
a
a
a
a
a
a
a
a
a
a
a
a
a
a
a
a
a
a
a
a
a
a
a
a
a
a
a
a
a
a
a
a
a
a
a
a
a
a
a
a
a
a
a
a
a
a
a
a
a
a
a
a
a
a
a
a
a
a
a
a
a
a
a
a
"}
(95,1,1) = {"
a
a
a
a
a
a
a
a
a
a
a
a
a
a
a
a
a
a
a
a
a
a
a
a
a
a
a
a
a
a
a
a
a
a
a
a
a
a
a
a
a
a
a
a
a
a
a
a
a
a
a
a
a
a
a
a
a
a
a
a
a
a
a
a
a
a
a
a
a
a
a
a
a
a
a
a
a
a
a
a
a
a
a
a
a
a
a
a
a
a
a
a
a
a
a
"}
