//MAP CONVERTED BY dmm2tgm.py THIS HEADER COMMENT PREVENTS RECONVERSION, DO NOT REMOVE
"d" = (
/obj/structure/elevator_platform,
/obj/structure/fake_plastitanium_wall,
/turf/template_noop,
/area/template_noop)
"g" = (
/obj/structure/elevator_platform/tile/tech,
/obj/machinery/status_display/elevator{
	pixel_y = 28
	},
/turf/template_noop,
/area/template_noop)
"j" = (
/obj/structure/elevator_platform/tile/dark,
/obj/structure/crate_shelf{
	capacity = 2
	},
/turf/template_noop,
/area/template_noop)
"x" = (
/obj/structure/elevator_platform/tile/dark,
/obj/structure/chair/bench/red/directional/north,
/turf/template_noop,
/area/template_noop)
"A" = (
/obj/structure/elevator_platform/tile/dark,
/obj/structure/fake_plastitanium_wall,
/turf/template_noop,
/area/template_noop)
"D" = (
/obj/machinery/light/floor,
/obj/structure/elevator_platform/tile/tech,
/turf/template_noop,
/area/template_noop)
"F" = (
/obj/structure/elevator_platform/tile/dark,
/obj/structure/chair/bench/red/directional/south,
/turf/template_noop,
/area/template_noop)
"L" = (
/obj/structure/elevator_platform/tile/tech,
/turf/template_noop,
/area/template_noop)
"V" = (
/obj/structure/elevator_platform/tile/dark,
/obj/structure/crate_shelf{
	capacity = 2
	},
/obj/machinery/elevator_floor_button{
	layer = 2.91;
	pixel_x = -20;
	dir = 4;
	pixel_y = 3
	},
/turf/template_noop,
/area/template_noop)

(1,1,1) = {"
d
g
D
L
d
"}
(2,1,1) = {"
L
L
j
L
L
"}
(3,1,1) = {"
D
x
A
F
D
"}
(4,1,1) = {"
L
L
V
L
L
"}
(5,1,1) = {"
d
g
D
L
d
"}
