//MAP CONVERTED BY dmm2tgm.py THIS HEADER COMMENT PREVENTS RECONVERSION, DO NOT REMOVE
"a" = (
/obj/machinery/light/floor,
/obj/structure/elevator_platform/tile/tech,
/turf/template_noop,
/area/template_noop)
"d" = (
/obj/structure/elevator_platform/tile/tech,
/obj/machinery/status_display/elevator{
	pixel_y = 28
	},
/obj/structure/chair/bench/red/directional/east,
/turf/template_noop,
/area/template_noop)
"e" = (
/obj/structure/elevator_platform/tile/dark,
/turf/template_noop,
/area/template_noop)
"g" = (
/obj/structure/elevator_platform/tile/tech,
/obj/machinery/status_display/elevator{
	pixel_y = 28
	},
/turf/template_noop,
/area/template_noop)
"n" = (
/obj/structure/elevator_platform/tile/tech,
/turf/template_noop,
/area/template_noop)
"t" = (
/obj/structure/elevator_platform,
/obj/structure/fake_plastitanium_wall,
/turf/template_noop,
/area/template_noop)
"A" = (
/obj/structure/elevator_platform/tile/dark,
/obj/structure/fake_plastitanium_wall,
/turf/template_noop,
/area/template_noop)
"F" = (
/obj/structure/elevator_platform/tile/dark,
/obj/machinery/elevator_floor_button{
	pixel_y = 22;
	layer = 2.91
	},
/turf/template_noop,
/area/template_noop)
"Q" = (
/obj/structure/elevator_platform/tile/tech,
/obj/structure/crate_shelf{
	capacity = 2
	},
/turf/template_noop,
/area/template_noop)
"V" = (
/obj/structure/elevator_platform/tile/tech,
/obj/structure/chair/bench/red/directional/east,
/turf/template_noop,
/area/template_noop)

(1,1,1) = {"
t
d
a
V
t
"}
(2,1,1) = {"
n
n
e
n
Q
"}
(3,1,1) = {"
a
e
A
F
a
"}
(4,1,1) = {"
n
n
e
n
Q
"}
(5,1,1) = {"
t
g
a
n
t
"}
