//MAP CONVERTED BY dmm2tgm.py THIS HEADER COMMENT PREVENTS RECONVERSION, DO NOT REMOVE
"a" = (
/obj/structure/elevator_platform,
/turf/template_noop,
/area/template_noop)
"c" = (
/obj/structure/crate_shelf{
	capacity = 2
	},
/obj/structure/elevator_platform/tile/tech,
/obj/machinery/light/dim/directional/east,
/obj/structure/railing/thin{
	dir = 5;
	layer = 2.7
	},
/turf/template_noop,
/area/template_noop)
"d" = (
/obj/structure/elevator_platform/tile/dark,
/obj/structure/railing/thin/corner{
	dir = 8
	},
/turf/template_noop,
/area/template_noop)
"e" = (
/obj/structure/elevator_platform,
/obj/structure/table,
/obj/item/radio/intercom/table{
	dir = 1;
	pixel_x = 0;
	pixel_y = 0
	},
/turf/template_noop,
/area/template_noop)
"h" = (
/obj/structure/elevator_platform,
/obj/structure/railing/thin/corner,
/turf/template_noop,
/area/template_noop)
"i" = (
/obj/structure/elevator_platform,
/obj/structure/railing/thin/corner{
	dir = 1
	},
/turf/template_noop,
/area/template_noop)
"k" = (
/obj/structure/elevator_platform/tile/dark,
/turf/template_noop,
/area/template_noop)
"p" = (
/obj/machinery/light/dim/directional/west,
/obj/structure/elevator_platform/tile/tech,
/obj/structure/railing/thin{
	dir = 9
	},
/turf/template_noop,
/area/template_noop)
"s" = (
/obj/structure/elevator_platform/tile/dark,
/obj/structure/railing/thin/corner{
	dir = 1
	},
/turf/template_noop,
/area/template_noop)
"B" = (
/obj/machinery/elevator_floor_button{
	pixel_y = 0;
	dir = 8;
	pixel_x = 19
	},
/obj/structure/chair/bench/blue/directional/west,
/obj/structure/elevator_platform/tile/dark,
/obj/structure/railing/thin{
	dir = 4
	},
/turf/template_noop,
/area/template_noop)
"J" = (
/obj/structure/elevator_platform,
/obj/structure/railing/thin/corner{
	dir = 4
	},
/turf/template_noop,
/area/template_noop)
"K" = (
/obj/structure/elevator_platform,
/obj/structure/railing/thin/corner{
	dir = 8
	},
/turf/template_noop,
/area/template_noop)
"L" = (
/obj/structure/chair/bench/blue/directional/west,
/obj/structure/elevator_platform/tile/dark,
/obj/machinery/status_display/elevator{
	pixel_x = 32
	},
/obj/structure/railing/thin{
	dir = 4
	},
/turf/template_noop,
/area/template_noop)
"M" = (
/obj/machinery/light/dim/directional/west,
/obj/structure/elevator_platform/tile/tech,
/obj/structure/railing/thin{
	dir = 10
	},
/turf/template_noop,
/area/template_noop)
"S" = (
/obj/structure/crate_shelf{
	capacity = 2
	},
/obj/structure/elevator_platform/tile/tech,
/obj/machinery/light/dim/directional/east,
/obj/structure/railing/thin{
	dir = 6
	},
/turf/template_noop,
/area/template_noop)

(1,1,1) = {"
p
s
k
d
M
"}
(2,1,1) = {"
i
k
k
k
K
"}
(3,1,1) = {"
a
a
e
a
a
"}
(4,1,1) = {"
J
k
k
k
h
"}
(5,1,1) = {"
c
L
B
L
S
"}
