//MAP CONVERTED BY dmm2tgm.py THIS HEADER COMMENT PREVENTS RECONVERSION, DO NOT REMOVE
"aa" = (
/turf/template_noop,
/area/template_noop)
"am" = (
/obj/structure/disposalpipe/segment{
	dir = 6
	},
/turf/closed/wall/r_wall)
"an" = (
/obj/structure/disposalpipe/segment{
	dir = 10
	},
/turf/closed/wall/r_wall)
"ao" = (
/obj/structure/disposalpipe/segment{
	dir = 6
	},
/turf/open/floor/plating)
"ap" = (
/obj/structure/disposalpipe/segment{
	dir = 10
	},
/turf/open/floor/plating)
"aq" = (
/obj/structure/disposalpipe/trunk,
/obj/structure/disposaloutlet{
	dir = 1
	},
/turf/open/floor/plating)
"ar" = (
/obj/structure/disposalpipe/segment{
	invisibility = 101
	},
/obj/effect/turf_decal/corner/opaque/yellow,
/obj/effect/turf_decal/corner/opaque/yellow{
	dir = 1
	},
/obj/effect/turf_decal/corner/opaque/yellow{
	dir = 8
	},
/obj/effect/turf_decal/corner/opaque/yellow{
	dir = 4
	},
/turf/open/indestructible{
	icon_state = "darkfull";
	wet = 8
	})
"as" = (
/obj/effect/mob_spawn/human/corpse/damaged,
/obj/effect/decal/cleanable/blood/old,
/obj/structure/disposalpipe/segment{
	invisibility = 101
	},
/obj/effect/turf_decal/corner/opaque/yellow,
/obj/effect/turf_decal/corner/opaque/yellow{
	dir = 1
	},
/obj/effect/turf_decal/corner/opaque/yellow{
	dir = 8
	},
/obj/effect/turf_decal/corner/opaque/yellow{
	dir = 4
	},
/turf/open/indestructible{
	icon_state = "darkfull";
	wet = 8
	})
"at" = (
/obj/structure/disposalpipe/segment{
	dir = 6
	},
/obj/effect/turf_decal/corner/opaque/yellow,
/obj/effect/turf_decal/corner/opaque/yellow{
	dir = 1
	},
/obj/effect/turf_decal/corner/opaque/yellow{
	dir = 8
	},
/obj/effect/turf_decal/corner/opaque/yellow{
	dir = 4
	},
/turf/open/indestructible{
	icon_state = "darkfull";
	wet = 8
	})
"au" = (
/obj/structure/disposalpipe/segment{
	invisibility = 101
	},
/turf/open/floor/plating)
"av" = (
/obj/structure/disposalpipe/sorting/mail/flip{
	dir = 1;
	sortType = 3
	},
/turf/closed/wall/r_wall)
"aw" = (
/obj/structure/window/reinforced,
/obj/structure/disposalpipe/segment{
	invisibility = 101
	},
/turf/open/floor/plating)
"ax" = (
/obj/effect/decal/cleanable/food/pie_smudge,
/obj/structure/disposalpipe/segment{
	invisibility = 101
	},
/obj/effect/turf_decal/corner/opaque/yellow,
/obj/effect/turf_decal/corner/opaque/yellow{
	dir = 1
	},
/obj/effect/turf_decal/corner/opaque/yellow{
	dir = 8
	},
/obj/effect/turf_decal/corner/opaque/yellow{
	dir = 4
	},
/turf/open/indestructible{
	icon_state = "darkfull";
	wet = 8
	})
"ay" = (
/obj/structure/disposalpipe/segment{
	dir = 5
	},
/obj/effect/decal/cleanable/dirt,
/obj/effect/turf_decal/corner/opaque/yellow,
/obj/effect/turf_decal/corner/opaque/yellow{
	dir = 1
	},
/obj/effect/turf_decal/corner/opaque/yellow{
	dir = 8
	},
/obj/effect/turf_decal/corner/opaque/yellow{
	dir = 4
	},
/turf/open/indestructible{
	icon_state = "darkfull";
	wet = 8
	})
"az" = (
/obj/structure/disposalpipe/segment{
	dir = 4;
	invisibility = 101
	},
/obj/effect/decal/cleanable/dirt,
/obj/effect/turf_decal/corner/opaque/yellow,
/obj/effect/turf_decal/corner/opaque/yellow{
	dir = 1
	},
/obj/effect/turf_decal/corner/opaque/yellow{
	dir = 8
	},
/obj/effect/turf_decal/corner/opaque/yellow{
	dir = 4
	},
/turf/open/indestructible{
	icon_state = "darkfull";
	wet = 8
	})
"aA" = (
/obj/structure/disposalpipe/segment{
	dir = 4;
	invisibility = 101
	},
/obj/effect/turf_decal/corner/opaque/yellow,
/obj/effect/turf_decal/corner/opaque/yellow{
	dir = 1
	},
/obj/effect/turf_decal/corner/opaque/yellow{
	dir = 8
	},
/obj/effect/turf_decal/corner/opaque/yellow{
	dir = 4
	},
/turf/open/indestructible{
	icon_state = "darkfull";
	wet = 8
	})
"aB" = (
/obj/structure/disposalpipe/segment{
	dir = 9
	},
/obj/effect/turf_decal/corner/opaque/yellow,
/obj/effect/turf_decal/corner/opaque/yellow{
	dir = 1
	},
/obj/effect/turf_decal/corner/opaque/yellow{
	dir = 8
	},
/obj/effect/turf_decal/corner/opaque/yellow{
	dir = 4
	},
/turf/open/indestructible{
	icon_state = "darkfull";
	wet = 8
	})
"aC" = (
/obj/effect/turf_decal/corner/opaque/yellow,
/obj/effect/turf_decal/corner/opaque/yellow{
	dir = 1
	},
/obj/effect/turf_decal/corner/opaque/yellow{
	dir = 8
	},
/obj/effect/turf_decal/corner/opaque/yellow{
	dir = 4
	},
/turf/open/indestructible{
	icon_state = "darkfull";
	wet = 8
	})
"aD" = (
/obj/effect/decal/cleanable/dirt,
/obj/effect/turf_decal/corner/opaque/yellow,
/obj/effect/turf_decal/corner/opaque/yellow{
	dir = 1
	},
/obj/effect/turf_decal/corner/opaque/yellow{
	dir = 8
	},
/obj/effect/turf_decal/corner/opaque/yellow{
	dir = 4
	},
/turf/open/indestructible{
	icon_state = "darkfull";
	wet = 8
	})
"aE" = (
/obj/effect/decal/cleanable/cobweb/cobweb2,
/obj/effect/turf_decal/corner/opaque/yellow,
/obj/effect/turf_decal/corner/opaque/yellow{
	dir = 1
	},
/obj/effect/turf_decal/corner/opaque/yellow{
	dir = 8
	},
/obj/effect/turf_decal/corner/opaque/yellow{
	dir = 4
	},
/turf/open/indestructible{
	icon_state = "darkfull";
	wet = 8
	})
"aF" = (
/obj/structure/disposalpipe/segment{
	dir = 4;
	invisibility = 101
	},
/obj/effect/decal/cleanable/cobweb,
/obj/effect/turf_decal/corner/opaque/yellow,
/obj/effect/turf_decal/corner/opaque/yellow{
	dir = 1
	},
/obj/effect/turf_decal/corner/opaque/yellow{
	dir = 8
	},
/obj/effect/turf_decal/corner/opaque/yellow{
	dir = 4
	},
/turf/open/indestructible{
	icon_state = "darkfull";
	wet = 8
	})
"aG" = (
/obj/structure/disposalpipe/segment{
	dir = 5
	},
/obj/effect/turf_decal/corner/opaque/yellow,
/obj/effect/turf_decal/corner/opaque/yellow{
	dir = 1
	},
/obj/effect/turf_decal/corner/opaque/yellow{
	dir = 8
	},
/obj/effect/turf_decal/corner/opaque/yellow{
	dir = 4
	},
/turf/open/indestructible{
	icon_state = "darkfull";
	wet = 8
	})
"aH" = (
/obj/structure/disposalpipe/segment{
	dir = 9
	},
/obj/effect/decal/cleanable/dirt,
/obj/effect/turf_decal/corner/opaque/yellow,
/obj/effect/turf_decal/corner/opaque/yellow{
	dir = 1
	},
/obj/effect/turf_decal/corner/opaque/yellow{
	dir = 8
	},
/obj/effect/turf_decal/corner/opaque/yellow{
	dir = 4
	},
/turf/open/indestructible{
	icon_state = "darkfull";
	wet = 8
	})
"aI" = (
/obj/structure/disposalpipe/segment{
	dir = 5
	},
/obj/item/bikehorn,
/obj/effect/turf_decal/corner/opaque/yellow,
/obj/effect/turf_decal/corner/opaque/yellow{
	dir = 1
	},
/obj/effect/turf_decal/corner/opaque/yellow{
	dir = 8
	},
/obj/effect/turf_decal/corner/opaque/yellow{
	dir = 4
	},
/turf/open/indestructible{
	icon_state = "darkfull";
	wet = 8
	})
"aJ" = (
/obj/structure/disposalpipe/segment{
	dir = 5
	},
/turf/closed/wall/r_wall)
"aK" = (
/obj/structure/disposalpipe/segment{
	dir = 4;
	invisibility = 101
	},
/obj/effect/decal/cleanable/food/pie_smudge,
/obj/effect/turf_decal/corner/opaque/yellow,
/obj/effect/turf_decal/corner/opaque/yellow{
	dir = 1
	},
/obj/effect/turf_decal/corner/opaque/yellow{
	dir = 8
	},
/obj/effect/turf_decal/corner/opaque/yellow{
	dir = 4
	},
/turf/open/indestructible{
	icon_state = "darkfull";
	wet = 8
	})
"aL" = (
/obj/structure/disposalpipe/segment{
	dir = 4;
	invisibility = 101
	},
/turf/closed/wall/r_wall)
"aM" = (
/obj/structure/disposalpipe/segment{
	dir = 10
	},
/obj/effect/turf_decal/corner/opaque/yellow,
/obj/effect/turf_decal/corner/opaque/yellow{
	dir = 1
	},
/obj/effect/turf_decal/corner/opaque/yellow{
	dir = 8
	},
/obj/effect/turf_decal/corner/opaque/yellow{
	dir = 4
	},
/turf/open/indestructible{
	icon_state = "darkfull";
	wet = 8
	})
"aO" = (
/obj/item/bikehorn,
/obj/structure/disposalpipe/segment{
	dir = 4;
	invisibility = 101
	},
/obj/effect/turf_decal/corner/opaque/yellow,
/obj/effect/turf_decal/corner/opaque/yellow{
	dir = 1
	},
/obj/effect/turf_decal/corner/opaque/yellow{
	dir = 8
	},
/obj/effect/turf_decal/corner/opaque/yellow{
	dir = 4
	},
/turf/open/indestructible{
	icon_state = "darkfull";
	wet = 8
	})
"aP" = (
/obj/structure/disposalpipe/segment{
	dir = 4;
	invisibility = 101
	},
/turf/open/floor/plating)
"aS" = (
/obj/structure/disposalpipe/segment{
	dir = 9
	},
/turf/open/floor/plating)
"aT" = (
/obj/effect/decal/cleanable/dirt,
/obj/structure/disposalpipe/segment{
	invisibility = 101
	},
/obj/effect/turf_decal/corner/opaque/yellow,
/obj/effect/turf_decal/corner/opaque/yellow{
	dir = 1
	},
/obj/effect/turf_decal/corner/opaque/yellow{
	dir = 8
	},
/obj/effect/turf_decal/corner/opaque/yellow{
	dir = 4
	},
/turf/open/indestructible{
	icon_state = "darkfull";
	wet = 8
	})
"aU" = (
/obj/effect/spawner/structure/window/reinforced,
/turf/open/floor/plating)
"aV" = (
/obj/structure/disposalpipe/segment{
	dir = 10
	},
/obj/effect/decal/cleanable/dirt,
/obj/effect/turf_decal/corner/opaque/yellow,
/obj/effect/turf_decal/corner/opaque/yellow{
	dir = 1
	},
/obj/effect/turf_decal/corner/opaque/yellow{
	dir = 8
	},
/obj/effect/turf_decal/corner/opaque/yellow{
	dir = 4
	},
/turf/open/indestructible{
	icon_state = "darkfull";
	wet = 8
	})
"aW" = (
/obj/item/bikehorn,
/obj/effect/decal/cleanable/dirt,
/obj/structure/disposalpipe/segment{
	invisibility = 101
	},
/obj/effect/turf_decal/corner/opaque/yellow,
/obj/effect/turf_decal/corner/opaque/yellow{
	dir = 1
	},
/obj/effect/turf_decal/corner/opaque/yellow{
	dir = 8
	},
/obj/effect/turf_decal/corner/opaque/yellow{
	dir = 4
	},
/turf/open/indestructible{
	icon_state = "darkfull";
	wet = 8
	})
"aX" = (
/obj/structure/disposalpipe/trunk{
	dir = 4
	},
/obj/structure/disposaloutlet{
	dir = 8
	},
/turf/open/floor/plating)
"aY" = (
/obj/item/bikehorn,
/obj/structure/disposalpipe/segment{
	invisibility = 101
	},
/obj/effect/turf_decal/corner/opaque/yellow,
/obj/effect/turf_decal/corner/opaque/yellow{
	dir = 1
	},
/obj/effect/turf_decal/corner/opaque/yellow{
	dir = 8
	},
/obj/effect/turf_decal/corner/opaque/yellow{
	dir = 4
	},
/turf/open/indestructible{
	icon_state = "darkfull";
	wet = 8
	})
"aZ" = (
/obj/structure/disposalpipe/segment{
	dir = 4;
	invisibility = 101
	},
/obj/effect/turf_decal/corner/opaque/red,
/obj/effect/turf_decal/corner/opaque/red{
	dir = 8
	},
/obj/effect/turf_decal/corner/opaque/red{
	dir = 4
	},
/obj/effect/turf_decal/corner/opaque/red{
	dir = 1
	},
/turf/open/indestructible{
	icon_state = "darkfull";
	wet = 8
	})
"ba" = (
/obj/effect/decal/cleanable/food/pie_smudge,
/obj/effect/turf_decal/corner/opaque/yellow,
/obj/effect/turf_decal/corner/opaque/yellow{
	dir = 1
	},
/obj/effect/turf_decal/corner/opaque/yellow{
	dir = 8
	},
/obj/effect/turf_decal/corner/opaque/yellow{
	dir = 4
	},
/turf/open/indestructible{
	icon_state = "darkfull";
	wet = 8
	})
"bb" = (
/obj/structure/disposalpipe/segment{
	dir = 4;
	invisibility = 101
	},
/turf/open/indestructible{
	icon_state = "white"
	})
"bc" = (
/obj/structure/disposalpipe/segment{
	dir = 6
	},
/obj/effect/decal/cleanable/dirt,
/obj/effect/turf_decal/corner/opaque/yellow,
/obj/effect/turf_decal/corner/opaque/yellow{
	dir = 1
	},
/obj/effect/turf_decal/corner/opaque/yellow{
	dir = 8
	},
/obj/effect/turf_decal/corner/opaque/yellow{
	dir = 4
	},
/turf/open/indestructible{
	icon_state = "darkfull";
	wet = 8
	})
"bd" = (
/obj/structure/disposalpipe/segment{
	dir = 4;
	invisibility = 101
	},
/obj/structure/table,
/obj/item/paper/crumpled/bloody/ruins/lavaland/clown_planet/escape,
/obj/item/pen/fourcolor,
/turf/open/indestructible{
	icon_state = "white"
	})
"be" = (
/obj/structure/disposalpipe/segment{
	dir = 4;
	invisibility = 101
	},
/obj/structure/table,
/obj/item/flashlight/lamp/bananalamp,
/turf/open/indestructible{
	icon_state = "white"
	})
"bf" = (
/obj/structure/disposalpipe/segment{
	dir = 10
	},
/obj/effect/decal/cleanable/food/pie_smudge,
/obj/effect/turf_decal/corner/opaque/yellow,
/obj/effect/turf_decal/corner/opaque/yellow{
	dir = 1
	},
/obj/effect/turf_decal/corner/opaque/yellow{
	dir = 8
	},
/obj/effect/turf_decal/corner/opaque/yellow{
	dir = 4
	},
/turf/open/indestructible{
	icon_state = "darkfull";
	wet = 8
	})
"bg" = (
/obj/structure/disposalpipe/segment{
	dir = 4;
	invisibility = 101
	},
/obj/item/pickaxe,
/turf/open/indestructible{
	icon_state = "white"
	})
"bh" = (
/obj/structure/disposalpipe/segment{
	dir = 6
	},
/turf/open/indestructible{
	icon_state = "white"
	})
"bi" = (
/obj/structure/disposalpipe/segment{
	dir = 10
	},
/turf/open/indestructible{
	icon_state = "white"
	})
"bk" = (
/obj/structure/disposalpipe/segment{
	invisibility = 101
	},
/obj/machinery/light/small/directional/west{
	brightness = 3
	},
/turf/open/indestructible{
	icon_state = "white"
	})
"bm" = (
/obj/structure/disposalpipe/segment{
	dir = 5
	},
/turf/open/indestructible{
	icon_state = "white"
	})
"bn" = (
/obj/structure/disposalpipe/segment{
	dir = 9
	},
/turf/open/indestructible{
	icon_state = "white"
	})
"bp" = (
/turf/closed/mineral/bananium)
"bq" = (
/obj/item/pickaxe,
/turf/open/indestructible{
	icon_state = "white"
	})
"br" = (
/turf/open/indestructible{
	icon_state = "white"
	})
"bs" = (
/obj/structure/disposalpipe/segment{
	dir = 6
	},
/obj/effect/turf_decal/corner/opaque/red,
/obj/effect/turf_decal/corner/opaque/red{
	dir = 8
	},
/obj/effect/turf_decal/corner/opaque/red{
	dir = 4
	},
/obj/effect/turf_decal/corner/opaque/red{
	dir = 1
	},
/turf/open/indestructible{
	icon_state = "darkfull";
	wet = 8
	})
"bt" = (
/obj/structure/disposalpipe/segment{
	dir = 5
	},
/turf/open/floor/plating)
"bu" = (
/obj/item/bikehorn,
/obj/structure/disposalpipe/segment{
	dir = 10
	},
/obj/effect/turf_decal/corner/opaque/yellow,
/obj/effect/turf_decal/corner/opaque/yellow{
	dir = 1
	},
/obj/effect/turf_decal/corner/opaque/yellow{
	dir = 8
	},
/obj/effect/turf_decal/corner/opaque/yellow{
	dir = 4
	},
/turf/open/indestructible{
	icon_state = "darkfull";
	wet = 8
	})
"bx" = (
/obj/effect/decal/cleanable/cobweb,
/obj/effect/turf_decal/corner/opaque/red,
/obj/effect/turf_decal/corner/opaque/red{
	dir = 8
	},
/obj/effect/turf_decal/corner/opaque/red{
	dir = 4
	},
/obj/effect/turf_decal/corner/opaque/red{
	dir = 1
	},
/turf/open/indestructible{
	icon_state = "darkfull";
	wet = 8
	})
"by" = (
/obj/structure/disposalpipe/segment,
/obj/effect/turf_decal/corner/opaque/yellow,
/obj/effect/turf_decal/corner/opaque/yellow{
	dir = 1
	},
/obj/effect/turf_decal/corner/opaque/yellow{
	dir = 8
	},
/obj/effect/turf_decal/corner/opaque/yellow{
	dir = 4
	},
/turf/open/indestructible{
	icon_state = "darkfull";
	wet = 8
	})
"bz" = (
/obj/machinery/disposal/deliveryChute{
	dir = 1
	},
/obj/structure/disposalpipe/trunk,
/turf/open/indestructible{
	icon_state = "white"
	})
"bA" = (
/obj/effect/turf_decal/corner/opaque/red,
/obj/effect/turf_decal/corner/opaque/red{
	dir = 8
	},
/obj/effect/turf_decal/corner/opaque/red{
	dir = 4
	},
/obj/effect/turf_decal/corner/opaque/red{
	dir = 1
	},
/turf/open/indestructible{
	icon_state = "darkfull";
	wet = 8
	})
"bB" = (
/turf/open/indestructible/sound{
	icon_state = "bananium";
	name = "bananium floor";
	sound = 'sound/effects/clownstep1.ogg';
	wet = 16
	})
"bC" = (
/obj/structure/disposalpipe/junction/yjunction{
	dir = 1;
	invisibility = 101
	},
/obj/effect/decal/cleanable/dirt,
/obj/effect/turf_decal/corner/opaque/yellow,
/obj/effect/turf_decal/corner/opaque/yellow{
	dir = 1
	},
/obj/effect/turf_decal/corner/opaque/yellow{
	dir = 8
	},
/obj/effect/turf_decal/corner/opaque/yellow{
	dir = 4
	},
/turf/open/indestructible{
	icon_state = "darkfull";
	wet = 8
	})
"bD" = (
/obj/structure/mecha_wreckage/honker,
/obj/structure/disposalpipe/segment{
	dir = 4;
	invisibility = 101
	},
/turf/open/floor/plating)
"bE" = (
/obj/effect/decal/cleanable/oil,
/obj/structure/disposalpipe/segment{
	dir = 10
	},
/turf/open/floor/plating)
"bF" = (
/obj/effect/decal/cleanable/cobweb/cobweb2,
/turf/open/indestructible/sound{
	icon_state = "bananium";
	name = "bananium floor";
	sound = 'sound/effects/clownstep1.ogg';
	wet = 16
	})
"bH" = (
/obj/effect/decal/cleanable/dirt,
/turf/open/indestructible/sound{
	icon_state = "bananium";
	name = "bananium floor";
	sound = 'sound/effects/clownstep1.ogg';
	wet = 16
	})
"bI" = (
/obj/effect/mob_spawn/human/corpse/damaged,
/obj/effect/decal/cleanable/blood/old,
/obj/effect/turf_decal/corner/opaque/yellow{
	dir = 8
	},
/obj/effect/turf_decal/corner/opaque/yellow{
	dir = 1
	},
/obj/effect/turf_decal/corner/opaque/yellow,
/obj/effect/turf_decal/corner/opaque/yellow{
	dir = 4
	},
/turf/open/indestructible{
	icon_state = "darkfull";
	wet = 8
	})
"bK" = (
/obj/structure/disposalpipe/segment{
	dir = 9
	},
/obj/effect/turf_decal/corner/opaque/red,
/obj/effect/turf_decal/corner/opaque/red{
	dir = 8
	},
/obj/effect/turf_decal/corner/opaque/red{
	dir = 4
	},
/obj/effect/turf_decal/corner/opaque/red{
	dir = 1
	},
/turf/open/indestructible{
	icon_state = "darkfull";
	wet = 8
	})
"bL" = (
/obj/item/reagent_containers/food/drinks/trophy/gold_cup,
/obj/structure/table/glass,
/turf/open/floor/carpet)
"bM" = (
/turf/open/floor/carpet)
"bN" = (
/obj/machinery/disposal/deliveryChute,
/obj/structure/disposalpipe/trunk{
	dir = 1
	},
/turf/open/floor/carpet)
"bO" = (
/obj/effect/decal/cleanable/cobweb,
/turf/open/indestructible/sound{
	icon_state = "bananium";
	name = "bananium floor";
	sound = 'sound/effects/clownstep1.ogg';
	wet = 16
	})
"bP" = (
/obj/structure/statue/bananium/clown,
/turf/open/floor/carpet)
"bQ" = (
/obj/structure/table/glass,
/obj/item/grown/bananapeel/bluespace,
/turf/open/floor/carpet)
"bR" = (
/obj/structure/table/glass,
/obj/item/clothing/shoes/clown_shoes/banana_shoes,
/turf/open/floor/carpet)
"bS" = (
/obj/item/coin/bananium,
/obj/item/coin/bananium,
/obj/item/coin/bananium,
/obj/item/coin/bananium,
/obj/machinery/light/small/directional/west,
/turf/open/floor/carpet)
"bT" = (
/obj/structure/table/glass,
/obj/item/reagent_containers/spray/waterflower/superlube,
/turf/open/floor/carpet)
"bU" = (
/obj/item/bikehorn/airhorn,
/turf/open/floor/carpet)
"bV" = (
/obj/structure/table/glass,
/obj/item/gun/magic/staff/honk,
/turf/open/floor/carpet)
"bW" = (
/obj/item/bikehorn,
/turf/open/indestructible/sound{
	icon_state = "bananium";
	name = "bananium floor";
	sound = 'sound/effects/clownstep1.ogg';
	wet = 16
	})
"bY" = (
/obj/effect/mob_spawn/human/corpse/damaged,
/obj/effect/decal/cleanable/blood/old,
/turf/open/indestructible/sound{
	icon_state = "bananium";
	name = "bananium floor";
	sound = 'sound/effects/clownstep1.ogg';
	wet = 16
	})
"bZ" = (
/obj/machinery/door/airlock/bananium,
/turf/open/indestructible/sound{
	icon_state = "bananium";
	name = "bananium floor";
	sound = 'sound/effects/clownstep1.ogg';
	wet = 16
	})
"ca" = (
/obj/item/bikehorn,
/obj/effect/decal/cleanable/dirt,
/turf/open/indestructible/sound{
	icon_state = "bananium";
	name = "bananium floor";
	sound = 'sound/effects/clownstep1.ogg';
	wet = 16
	})
"cc" = (
/turf/closed/wall/r_wall)
"ch" = (
/obj/structure/disposalpipe/segment{
	invisibility = 101
	},
/turf/closed/wall/r_wall)
"cu" = (
/turf/open/floor/plating)
"dB" = (
/obj/structure/disposalpipe/segment{
	invisibility = 101
	},
/obj/machinery/light/small/directional/north,
/obj/effect/turf_decal/corner/opaque/yellow,
/obj/effect/turf_decal/corner/opaque/yellow{
	dir = 1
	},
/obj/effect/turf_decal/corner/opaque/yellow{
	dir = 8
	},
/obj/effect/turf_decal/corner/opaque/yellow{
	dir = 4
	},
/turf/open/indestructible{
	icon_state = "darkfull";
	wet = 8
	})
"dC" = (
/obj/structure/disposalpipe/segment{
	dir = 4;
	invisibility = 101
	},
/obj/machinery/light/small/directional/north,
/obj/effect/turf_decal/corner/opaque/yellow,
/obj/effect/turf_decal/corner/opaque/yellow{
	dir = 1
	},
/obj/effect/turf_decal/corner/opaque/yellow{
	dir = 8
	},
/obj/effect/turf_decal/corner/opaque/yellow{
	dir = 4
	},
/turf/open/indestructible{
	icon_state = "darkfull";
	wet = 8
	})
"dD" = (
/obj/structure/disposalpipe/segment{
	dir = 10
	},
/obj/machinery/light/small/directional/east,
/obj/effect/turf_decal/corner/opaque/yellow,
/obj/effect/turf_decal/corner/opaque/yellow{
	dir = 1
	},
/obj/effect/turf_decal/corner/opaque/yellow{
	dir = 8
	},
/obj/effect/turf_decal/corner/opaque/yellow{
	dir = 4
	},
/turf/open/indestructible{
	icon_state = "darkfull";
	wet = 8
	})
"dE" = (
/obj/structure/disposalpipe/segment{
	dir = 10
	},
/obj/effect/decal/cleanable/dirt,
/obj/machinery/light/small/directional/west,
/obj/effect/turf_decal/corner/opaque/yellow,
/obj/effect/turf_decal/corner/opaque/yellow{
	dir = 1
	},
/obj/effect/turf_decal/corner/opaque/yellow{
	dir = 8
	},
/obj/effect/turf_decal/corner/opaque/yellow{
	dir = 4
	},
/turf/open/indestructible{
	icon_state = "darkfull";
	wet = 8
	})
"dF" = (
/obj/structure/disposalpipe/segment{
	dir = 4;
	invisibility = 101
	},
/obj/machinery/light/small/directional/west{
	brightness = 3
	},
/turf/open/indestructible{
	icon_state = "white"
	})
"dG" = (
/obj/structure/disposalpipe/segment{
	dir = 4;
	invisibility = 101
	},
/obj/machinery/light/small/directional/east,
/turf/open/indestructible{
	icon_state = "white"
	})
"dH" = (
/obj/structure/disposalpipe/segment{
	dir = 9
	},
/obj/machinery/light/small/directional/east,
/turf/open/indestructible{
	icon_state = "white"
	})
"dI" = (
/obj/machinery/light/directional/north,
/obj/effect/turf_decal/corner/opaque/red,
/obj/effect/turf_decal/corner/opaque/red{
	dir = 8
	},
/obj/effect/turf_decal/corner/opaque/red{
	dir = 4
	},
/obj/effect/turf_decal/corner/opaque/red{
	dir = 1
	},
/turf/open/indestructible{
	icon_state = "darkfull";
	wet = 8
	})
"dK" = (
/obj/machinery/light/small/directional/north,
/turf/open/floor/carpet)
"dL" = (
/obj/item/coin/bananium,
/obj/item/coin/bananium,
/obj/item/coin/bananium,
/obj/item/coin/bananium,
/obj/machinery/light/small/directional/east,
/turf/open/floor/carpet)
"dM" = (
/obj/machinery/light/directional/north,
/turf/open/indestructible/sound{
	icon_state = "bananium";
	name = "bananium floor";
	sound = 'sound/effects/clownstep1.ogg';
	wet = 16
	})
"dO" = (
/obj/machinery/light/directional/south,
/turf/open/indestructible/sound{
	icon_state = "bananium";
	name = "bananium floor";
	sound = 'sound/effects/clownstep1.ogg';
	wet = 16
	})
"eE" = (
/obj/effect/mapping_helpers/no_lava,
/turf/closed/wall/r_wall)
"eX" = (
/obj/effect/mapping_helpers/no_lava,
/turf/open/floor/noslip{
	initial_gas_mix = "LAVALAND_ATMOS"
	})
"gX" = (
/obj/effect/mapping_helpers/no_lava,
/turf/open/chasm/lavaland,
/area/lavaland/surface/outdoors/explored)
"hY" = (
/obj/machinery/light/directional/south,
/obj/effect/mapping_helpers/no_lava,
/turf/open/floor/plating/asteroid/basalt/lava_land_surface)
"nD" = (
/obj/structure/disposalpipe/segment{
	dir = 4;
	invisibility = 101
	},
/turf/open/indestructible{
	icon_state = "light_on-1"
	})
"pv" = (
/obj/machinery/light/directional/east,
/turf/open/floor/plating/asteroid/basalt/lava_land_surface)
"ye" = (
/turf/open/lava/smooth)
"CB" = (
/obj/item/paper/crumpled/bloody/ruins/lavaland/clown_planet/hope,
/obj/effect/decal/cleanable/blood/old,
/obj/effect/mapping_helpers/no_lava,
/turf/open/floor/noslip{
	initial_gas_mix = "LAVALAND_ATMOS"
	})
"Hj" = (
/obj/effect/decal/cleanable/food/pie_smudge,
/obj/effect/turf_decal/corner/opaque/yellow{
	dir = 4
	},
/obj/effect/turf_decal/corner/opaque/yellow{
	dir = 8
	},
/obj/effect/turf_decal/corner/opaque/yellow{
	dir = 1
	},
/obj/effect/turf_decal/corner/opaque/yellow,
/turf/open/indestructible{
	icon_state = "darkfull";
	wet = 8
	})
"Iz" = (
/turf/open/indestructible{
	icon_state = "light_on-1"
	})
"KX" = (
/obj/item/grown/bananapeel{
	color = "#2F3000";
	name = "stealth banana peel"
	},
/obj/effect/mapping_helpers/no_lava,
/turf/open/floor/plating/asteroid/basalt/lava_land_surface,
/area/lavaland/surface/outdoors/explored)
"LH" = (
/obj/machinery/disposal/deliveryChute{
	desc = "The following is engraved upon the chute: A FATE WORSE THAN DEATH LIES WITHIN";
	dir = 1;
	name = "THE TRIAL OF HONKITUDE"
	},
/obj/structure/disposalpipe/trunk,
/obj/effect/mapping_helpers/no_lava,
/turf/open/floor/noslip{
	initial_gas_mix = "LAVALAND_ATMOS"
	})
"Mv" = (
/obj/effect/mapping_helpers/no_lava,
/mob/living/simple_animal/hostile/retaliate/clown,
/turf/open/floor/plating/asteroid/basalt/lava_land_surface,
/area/lavaland/surface/outdoors/explored)
"MR" = (
/obj/machinery/light/directional/west,
/obj/effect/mapping_helpers/no_lava,
/turf/open/floor/plating/asteroid/basalt/lava_land_surface)
"RW" = (
/obj/effect/mapping_helpers/no_lava,
/mob/living/simple_animal/hostile/retaliate/clown,
/turf/open/floor/noslip{
	initial_gas_mix = "LAVALAND_ATMOS"
	})
"TD" = (
/obj/structure/disposalpipe/trunk,
/obj/structure/disposaloutlet{
	dir = 1
	},
/obj/effect/mapping_helpers/no_lava,
/turf/open/floor/noslip{
	initial_gas_mix = "LAVALAND_ATMOS"
	})
"Xm" = (
/obj/item/clothing/head/cone,
/obj/effect/mapping_helpers/no_lava,
/turf/open/floor/noslip{
	initial_gas_mix = "LAVALAND_ATMOS"
	})
"XO" = (
/obj/effect/mapping_helpers/no_lava,
/turf/open/floor/plating/asteroid/basalt/lava_land_surface,
/area/lavaland/surface/outdoors/explored)
"Yf" = (
/obj/machinery/light/directional/north,
/obj/effect/mapping_helpers/no_lava,
/turf/open/floor/plating/asteroid/basalt/lava_land_surface)
"YI" = (
/obj/machinery/light/small/directional/south,
/obj/effect/mapping_helpers/no_lava,
/mob/living/simple_animal/hostile/retaliate/clown,
/turf/open/floor/noslip{
	initial_gas_mix = "LAVALAND_ATMOS"
	})

(1,1,1) = {"
aa
aa
aa
aa
aa
aa
aa
aa
aa
aa
aa
aa
aa
aa
aa
XO
XO
XO
XO
XO
aa
aa
aa
aa
aa
aa
aa
aa
aa
aa
aa
aa
"}
(2,1,1) = {"
aa
aa
aa
aa
aa
aa
aa
cc
cc
cc
cc
cc
cc
cc
pv
XO
gX
XO
XO
gX
pv
cc
cc
cc
cc
cc
aa
aa
aa
aa
aa
aa
"}
(3,1,1) = {"
aa
aa
aa
aa
aa
cc
cc
cc
ye
ye
ye
ye
ye
cc
cc
gX
gX
KX
gX
gX
cc
cc
ye
ye
ye
cc
cc
cc
aa
aa
aa
aa
"}
(4,1,1) = {"
aa
aa
aa
aa
cc
cc
ye
ye
ye
ao
aJ
ao
aJ
ye
cc
cc
gX
gX
gX
cc
cc
ye
ye
aU
cu
ye
ye
cc
cc
aa
aa
aa
"}
(5,1,1) = {"
aa
aa
aa
cc
cc
ye
ye
am
au
aS
dE
aH
bf
aJ
ye
cc
cc
cc
cc
cc
bO
bB
aU
ye
ye
ye
ye
ye
cc
cc
aa
aa
"}
(6,1,1) = {"
aa
aa
aa
cc
ye
ye
cc
aF
at
ar
aW
ar
aG
aL
ye
cc
bB
bH
bB
cc
bB
bH
bY
bB
aU
ye
aU
ye
ye
cc
Yf
aa
"}
(7,1,1) = {"
aa
aa
cc
cc
ye
am
ax
aB
az
at
ar
aJ
aL
aL
cc
bx
bA
bB
bH
bH
bB
bH
bB
bB
bB
cc
ye
cu
ye
cc
cc
aa
"}
(8,1,1) = {"
aa
aa
cc
ye
ye
ap
ar
aG
az
aL
aX
aL
bb
dF
bp
cc
dI
bA
bB
cc
cc
bH
cc
bB
bB
bB
aU
ye
ye
ye
cc
aa
"}
(9,1,1) = {"
aa
aa
cc
ye
am
ar
ar
aH
aA
aA
aL
bb
bb
bb
bq
bp
cc
cc
bA
bB
bB
bH
bB
bB
ca
bH
dO
cc
ye
ye
cc
aa
"}
(10,1,1) = {"
aa
Mv
cc
ye
an
as
ar
aG
aL
az
aL
bb
bb
nD
Iz
br
bA
bA
bA
bB
cc
bB
bB
bH
bH
bB
bB
ye
aU
ye
cc
cc
"}
(11,1,1) = {"
aa
hY
cc
ye
ao
ch
dB
aH
az
az
aL
bb
bg
nD
Iz
bp
cc
bA
bA
bB
bB
cc
bB
bB
bB
bB
bH
ye
aU
ye
ye
cc
"}
(12,1,1) = {"
aa
XO
cc
ye
ap
ar
ar
aI
az
an
aB
aL
bb
dG
br
cc
cc
bA
bB
bB
cc
cc
bB
bB
cc
bB
bH
ye
cu
aU
ye
cc
"}
(13,1,1) = {"
eE
eE
cc
ye
cc
at
ar
aB
aM
ax
ar
aB
aL
aL
bs
ch
aJ
cc
cc
cc
bP
bS
cc
dM
bB
bH
ca
bB
ye
aU
ye
cc
"}
(14,1,1) = {"
eE
Xm
cc
cc
ye
an
ar
ar
ar
ar
aY
ar
aH
aA
aV
ay
az
cc
cc
bL
bM
bM
bM
cc
bB
bH
bH
bB
ye
aU
ye
cc
"}
(15,1,1) = {"
eX
RW
LH
ch
ch
au
ar
ch
ar
aT
ch
ax
ar
aH
aD
aA
aM
aG
cc
dK
bQ
bT
bM
cc
cc
bH
bB
bB
ye
aU
ye
cc
"}
(16,1,1) = {"
RW
CB
YI
cc
ye
ao
ar
aJ
at
aG
at
ar
ar
au
bt
aM
aG
aV
ch
bN
bM
bU
bM
bZ
bB
bH
bB
cc
ye
aU
ye
cc
"}
(17,1,1) = {"
eX
RW
TD
ch
ch
av
ay
aA
aA
aL
aA
bc
ar
aG
bu
by
bC
aD
cc
bM
bR
bV
bM
cc
bB
bB
bB
bB
ye
aU
ye
cc
"}
(18,1,1) = {"
eE
RW
cc
cc
ye
cc
az
az
az
aA
aA
aA
aC
aM
aG
Hj
aL
bI
cc
bL
bM
bM
bM
cc
bB
bB
bB
bB
ye
aU
ye
cc
"}
(19,1,1) = {"
eE
eE
cc
ye
ye
cc
az
az
aO
aA
aA
aL
cc
cc
aZ
cc
bD
cc
bB
cc
bP
dL
cc
dM
bB
bH
bH
bB
ye
aU
ye
cc
"}
(20,1,1) = {"
aa
Mv
cc
ye
cc
cc
aA
aA
aA
az
aA
aL
bh
bk
bn
cc
bE
aJ
bB
bB
cc
cc
bY
bB
bB
bH
bB
ye
aU
cu
ye
cc
"}
(21,1,1) = {"
aa
hY
cc
ye
cc
cc
dC
aK
aL
az
aL
bd
bb
Iz
Iz
bp
cc
aZ
bA
bB
bB
cc
bB
bH
bB
bB
bB
ye
aU
ye
ye
cc
"}
(22,1,1) = {"
aa
XO
cc
ye
aq
aw
aB
aL
aP
az
aL
be
bb
Iz
Iz
bz
ch
bK
cc
bB
bB
bH
bH
bH
bB
bW
dO
cc
aU
ye
cc
cc
"}
(23,1,1) = {"
aa
aa
cc
ye
cc
cc
aC
aA
aA
aO
aZ
bb
bi
bm
br
bp
cc
bA
bA
bB
bB
bH
bH
bB
bB
cc
cc
ye
cu
ye
cc
aa
"}
(24,1,1) = {"
aa
aa
cc
ye
cc
cc
aD
aA
aL
aA
aL
aL
bh
dH
bp
cc
dI
bA
bB
bB
bB
bB
bB
cc
bB
bB
ye
cu
ye
ye
cc
aa
"}
(25,1,1) = {"
aa
aa
cc
ye
ye
cc
aE
aA
aA
aA
aM
aB
aL
cc
cc
bA
bA
bB
bB
bB
bH
bW
bB
bB
bB
cc
ye
aU
ye
cc
cc
aa
"}
(26,1,1) = {"
aa
aa
cc
cc
ye
cc
cc
aM
aB
dD
ar
ar
aS
cc
ye
cc
bF
bB
bB
cc
bB
bB
cc
bB
bB
ye
cu
ye
ye
cc
Yf
aa
"}
(27,1,1) = {"
aa
aa
aa
cc
cc
ye
ye
cc
cu
cc
ba
aC
cu
cc
ye
cc
cc
cc
cc
cc
bB
bB
bB
ye
ye
ye
ye
ye
cc
cc
aa
aa
"}
(28,1,1) = {"
aa
aa
aa
aa
cc
cc
ye
ye
ye
aU
aU
aU
cc
ye
cc
cc
gX
gX
gX
cc
cc
ye
ye
cu
aU
ye
ye
cc
cc
aa
aa
aa
"}
(29,1,1) = {"
aa
aa
aa
aa
aa
cc
cc
cc
ye
ye
ye
ye
ye
cc
cc
gX
gX
KX
gX
gX
cc
cc
ye
ye
ye
cc
cc
cc
aa
aa
aa
aa
"}
(30,1,1) = {"
aa
aa
aa
aa
aa
aa
aa
cc
cc
cc
cc
cc
cc
cc
MR
XO
XO
XO
XO
gX
MR
cc
cc
cc
cc
cc
aa
aa
aa
aa
aa
aa
"}
(31,1,1) = {"
aa
aa
aa
aa
aa
aa
aa
aa
aa
aa
aa
aa
aa
aa
aa
XO
gX
XO
XO
XO
aa
aa
aa
aa
aa
aa
aa
aa
aa
aa
aa
aa
"}
