//MAP CONVERTED BY dmm2tgm.py THIS HEADER COMMENT PREVENTS RECONVERSION, DO NOT REMOVE
"a" = (
/turf/closed/wall/mineral/wood,
/area/whitesands/surface/outdoors/unexplored)
"b" = (
/obj/effect/decal/cleanable/dirt,
/turf/open/floor/wood{
	icon_state = "wood-broken5"
	},
/area/whitesands/surface/outdoors/unexplored)
"c" = (
/obj/structure/table/reinforced,
/obj/item/pda/clear{
	pixel_x = 3;
	pixel_y = -3
	},
/obj/effect/decal/cleanable/dirt,
/turf/open/floor/wood,
/area/whitesands/surface/outdoors/unexplored)
"d" = (
/obj/structure/barricade/wooden,
/turf/open/floor/plating,
/area/whitesands/surface/outdoors/unexplored)
"e" = (
/obj/structure/rack,
/obj/effect/spawner/lootdrop/donkpockets,
/obj/effect/spawner/lootdrop/donkpockets,
/obj/effect/spawner/lootdrop/donkpockets,
/obj/effect/spawner/lootdrop/donkpockets,
/obj/effect/decal/cleanable/dirt,
/turf/open/floor/wood,
/area/whitesands/surface/outdoors/unexplored)
"f" = (
/obj/structure/rack,
/obj/effect/spawner/lootdrop/pizzaparty,
/obj/item/reagent_containers/food/snacks/cornchips,
/obj/item/reagent_containers/food/snacks/butterdog,
/obj/item/reagent_containers/food/snacks/candy,
/obj/item/reagent_containers/food/snacks/canned/peaches,
/obj/item/reagent_containers/food/drinks/bottle/sarsaparilla,
/turf/open/floor/wood,
/area/whitesands/surface/outdoors/unexplored)
"g" = (
/obj/effect/decal/cleanable/dirt,
/turf/open/floor/wood{
	icon_state = "wood-broken4"
	},
/area/whitesands/surface/outdoors/unexplored)
"h" = (
/obj/effect/decal/cleanable/dirt,
/obj/structure/barricade/wooden,
/turf/open/floor/plating,
/area/whitesands/surface/outdoors/unexplored)
"k" = (
/obj/structure/rack,
/obj/item/reagent_containers/food/snacks/cheesyfries,
/obj/item/reagent_containers/food/snacks/chips,
/obj/item/reagent_containers/food/snacks/cheesewedge,
/obj/effect/decal/cleanable/dirt,
/turf/open/floor/wood,
/area/whitesands/surface/outdoors/unexplored)
"l" = (
/obj/structure/dresser,
/turf/open/floor/wood,
/area/whitesands/surface/outdoors/unexplored)
"m" = (
/turf/open/floor/wood,
/area/whitesands/surface/outdoors/unexplored)
"n" = (
/turf/open/floor/wood{
	icon_state = "wood-broken7"
	},
/area/whitesands/surface/outdoors/unexplored)
"o" = (
/turf/open/floor/wood{
	icon_state = "wood-broken3"
	},
/area/whitesands/surface/outdoors/unexplored)
"p" = (
/obj/structure/table/reinforced,
/obj/item/paper_bin,
/obj/item/pen,
/obj/effect/decal/cleanable/dirt,
/turf/open/floor/wood{
	icon_state = "wood-broken7"
	},
/area/whitesands/surface/outdoors/unexplored)
"q" = (
/obj/machinery/door/window/northleft{
	dir = 8
	},
/obj/effect/decal/cleanable/dirt,
/turf/open/floor/wood,
/area/whitesands/surface/outdoors/unexplored)
"r" = (
/obj/structure/rack,
/obj/item/gun/energy/kinetic_accelerator{
	pixel_x = 3;
	pixel_y = -3
	},
/obj/item/gun/energy/kinetic_accelerator{
	pixel_x = -3;
	pixel_y = 3
	},
/turf/open/floor/wood,
/area/whitesands/surface/outdoors/unexplored)
"s" = (
/obj/structure/sign/poster/official/pda_ad,
/turf/closed/wall/mineral/wood,
/area/whitesands/surface/outdoors/unexplored)
"t" = (
/obj/structure/rack,
/obj/effect/spawner/lootdrop/minor/kittyears_or_rabbitears,
/obj/effect/spawner/lootdrop/minor/kittyears_or_rabbitears,
/turf/open/floor/wood,
/area/whitesands/surface/outdoors/unexplored)
"u" = (
/obj/structure/table/reinforced,
/obj/effect/decal/cleanable/dirt,
/turf/open/floor/wood,
/area/whitesands/surface/outdoors/unexplored)
"w" = (
/obj/structure/window,
/obj/structure/rack,
/obj/effect/decal/cleanable/dirt,
/turf/open/floor/wood,
/area/whitesands/surface/outdoors/unexplored)
"x" = (
/obj/structure/mineral_door/wood,
/turf/open/floor/wood,
/area/whitesands/surface/outdoors/unexplored)
"y" = (
/obj/structure/rack,
/obj/item/grenade/clusterbuster/smoke,
/turf/open/floor/wood,
/area/whitesands/surface/outdoors/unexplored)
"z" = (
/turf/open/floor/wood{
	icon_state = "wood-broken5"
	},
/area/whitesands/surface/outdoors/unexplored)
"A" = (
/obj/machinery/vending/cola/random,
/obj/machinery/light{
	dir = 8
	},
/turf/open/floor/wood,
/area/whitesands/surface/outdoors/unexplored)
"B" = (
/turf/open/floor/wood{
	icon_state = "wood-broken4"
	},
/area/whitesands/surface/outdoors/unexplored)
"C" = (
/obj/structure/mineral_door/wood,
/obj/effect/decal/cleanable/dirt,
/turf/open/floor/wood,
/area/whitesands/surface/outdoors/unexplored)
"D" = (
/turf/open/floor/wood{
	icon_state = "wood-broken"
	},
/area/whitesands/surface/outdoors/unexplored)
"E" = (
/obj/effect/spawner/lootdrop/costume,
/obj/effect/spawner/lootdrop/gloves,
/obj/structure/window,
/obj/structure/rack,
/turf/open/floor/wood,
/area/whitesands/surface/outdoors/unexplored)
"F" = (
/obj/structure/rack,
/obj/item/borg/upgrade/modkit/cooldown{
	pixel_x = 7;
	pixel_y = 5
	},
/obj/item/borg/upgrade/modkit/damage,
/obj/item/borg/upgrade/modkit/range{
	pixel_x = -7
	},
/turf/open/floor/wood,
/area/whitesands/surface/outdoors/unexplored)
"G" = (
/obj/effect/spawner/lootdrop/costume,
/obj/structure/window,
/obj/structure/rack,
/turf/open/floor/wood,
/area/whitesands/surface/outdoors/unexplored)
"H" = (
/obj/effect/decal/cleanable/dirt,
/turf/open/floor/wood{
	icon_state = "wood-broken7"
	},
/area/whitesands/surface/outdoors/unexplored)
"I" = (
/obj/effect/decal/cleanable/dirt,
/turf/open/floor/wood{
	icon_state = "wood-broken2"
	},
/area/whitesands/surface/outdoors/unexplored)
"J" = (
/obj/structure/rack,
/obj/item/reagent_containers/food/snacks/chewable/bubblegum/nicotine,
/obj/item/reagent_containers/food/snacks/burger/fivealarm,
/obj/item/reagent_containers/food/snacks/cherrycupcake,
/turf/open/floor/wood,
/area/whitesands/surface/outdoors/unexplored)
"K" = (
/obj/structure/rack,
/obj/item/reagent_containers/food/snacks/chococornet,
/obj/item/reagent_containers/food/snacks/candy,
/obj/item/reagent_containers/food/snacks/canned/peaches,
/turf/open/floor/wood,
/area/whitesands/surface/outdoors/unexplored)
"M" = (
/obj/effect/spawner/lootdrop/costume,
/obj/effect/spawner/lootdrop/gloves,
/obj/item/shard{
	icon_state = "tiny"
	},
/obj/item/shard{
	icon_state = "medium"
	},
/turf/open/floor/wood,
/area/whitesands/surface/outdoors/unexplored)
"N" = (
/obj/structure/bed,
/obj/item/bedsheet/dorms,
/turf/open/floor/wood,
/area/whitesands/surface/outdoors/unexplored)
"O" = (
/obj/structure/rack,
/obj/item/reagent_containers/food/snacks/chewable/bubblegum/happiness,
/obj/item/reagent_containers/food/snacks/candy_corn,
/obj/item/reagent_containers/food/snacks/chocolatebar,
/obj/effect/decal/cleanable/dirt,
/turf/open/floor/wood,
/area/whitesands/surface/outdoors/unexplored)
"Q" = (
/obj/structure/rack,
/obj/item/reagent_containers/food/snacks/chocolatebunny,
/obj/item/reagent_containers/food/snacks/candy,
/obj/item/reagent_containers/food/snacks/canned/beans,
/obj/effect/decal/cleanable/dirt,
/obj/machinery/light{
	dir = 1
	},
/turf/open/floor/wood,
/area/whitesands/surface/outdoors/unexplored)
"R" = (
/obj/structure/rack,
/obj/item/reagent_containers/food/snacks/cheesynachos,
/obj/item/reagent_containers/food/snacks/branrequests,
/obj/item/reagent_containers/food/snacks/canned/beans,
/obj/item/reagent_containers/food/drinks/bottle/sarsaparilla,
/turf/open/floor/wood,
/area/whitesands/surface/outdoors/unexplored)
"S" = (
/turf/template_noop,
/area/template_noop)
"U" = (
/obj/effect/decal/cleanable/dirt,
/turf/open/floor/wood,
/area/whitesands/surface/outdoors/unexplored)
"V" = (
/obj/structure/table/reinforced,
/obj/item/pen/red,
/obj/effect/decal/cleanable/dirt,
/turf/open/floor/wood,
/area/whitesands/surface/outdoors/unexplored)
"W" = (
/obj/structure/rack,
/obj/item/construction/rcd{
	pixel_x = -3;
	pixel_y = 3
	},
/obj/item/rcd_ammo,
/turf/open/floor/wood,
/area/whitesands/surface/outdoors/unexplored)
"X" = (
/obj/structure/closet/cabinet,
/obj/item/stack/spacecash/c100,
/obj/item/stack/spacecash/c10,
/obj/item/stack/spacecash/c1,
/obj/item/stack/spacecash/c1,
/obj/item/stack/spacecash/c1,
/obj/item/stack/spacecash/c1,
/obj/item/stack/spacecash/c1,
/obj/item/stack/spacecash/c20,
/obj/item/stack/spacecash/c200,
/obj/item/stack/spacecash/c50,
/turf/open/floor/wood,
/area/whitesands/surface/outdoors/unexplored)
"Y" = (
/obj/machinery/light{
	dir = 1
	},
/turf/open/floor/wood,
/area/whitesands/surface/outdoors/unexplored)
"Z" = (
/turf/open/floor/plating,
/area/whitesands/surface/outdoors/unexplored)

(1,1,1) = {"
a
d
Z
Z
d
a
a
"}
(2,1,1) = {"
Z
R
H
k
K
A
h
"}
(3,1,1) = {"
a
O
n
H
b
o
E
"}
(4,1,1) = {"
a
Q
D
f
J
H
w
"}
(5,1,1) = {"
d
c
q
u
U
z
M
"}
(6,1,1) = {"
d
r
o
p
B
U
G
"}
(7,1,1) = {"
s
F
H
V
b
e
a
"}
(8,1,1) = {"
a
W
g
u
I
m
C
"}
(9,1,1) = {"
d
y
U
u
U
t
d
"}
(10,1,1) = {"
a
a
x
a
a
d
a
"}
(11,1,1) = {"
a
m
m
m
a
S
S
"}
(12,1,1) = {"
a
Y
m
m
a
S
S
"}
(13,1,1) = {"
a
N
X
l
a
S
S
"}
(14,1,1) = {"
a
a
a
a
a
S
S
"}
