//MAP CONVERTED BY dmm2tgm.py THIS HEADER COMMENT PREVENTS RECONVERSION, DO NOT REMOVE
"a" = (
/turf/template_noop,
/area/template_noop)
"b" = (
/turf/open/floor/wood,
/area/ruin/unpowered)
"c" = (
/obj/structure/closet/crate/coffin,
/obj/item/clothing/head/hooded/cloakhood/bone,
/turf/open/floor/plating/grass/jungle/lit,
/area/overmap_encounter/planetoid/jungle/explored)
"d" = (
/obj/structure/closet/crate/coffin,
/obj/item/reagent_containers/food/snacks/meat/slab/human/mutant/skeleton,
/turf/open/floor/plating/grass/jungle/lit,
/area/overmap_encounter/planetoid/jungle/explored)
"e" = (
/obj/structure/table/wood,
/obj/item/stack/sheet/mineral/wood,
/turf/open/floor/wood,
/area/ruin/unpowered)
"f" = (
/obj/structure/chair/wood/wings{
	dir = 1
	},
/turf/open/floor/wood,
/area/ruin/unpowered)
"g" = (
/obj/item/grown/bananapeel,
/obj/effect/decal/cleanable/dirt,
/obj/machinery/door/airlock/wood,
/turf/open/floor/plating/dirt/jungle/dark/lit,
/area/ruin/unpowered)
"h" = (
/turf/open/floor/plating/grass/jungle/lit,
/area/overmap_encounter/planetoid/jungle/explored)
"i" = (
/obj/structure/closet/crate/coffin,
/turf/open/floor/plating/grass/jungle/lit,
/area/overmap_encounter/planetoid/jungle/explored)
"j" = (
/obj/structure/table/wood,
/obj/item/storage/toolbox/mechanical{
	pixel_x = -1;
	pixel_y = 2
	},
/turf/open/floor/wood,
/area/ruin/unpowered)
"k" = (
/obj/item/reagent_containers/food/snacks/grown/banana,
/turf/open/floor/wood,
/area/ruin/unpowered)
"l" = (
/turf/closed/wall/mineral/wood,
/area/ruin/unpowered)
"m" = (
/obj/structure/closet/crate/coffin,
/obj/effect/mob_spawn/human/corpse/charredskeleton,
/turf/open/floor/plating/grass/jungle/lit,
/area/overmap_encounter/planetoid/jungle/explored)
"n" = (
/obj/structure/table/wood,
/obj/item/flashlight/lamp/bananalamp,
/turf/open/floor/wood,
/area/ruin/unpowered)
"q" = (
/obj/structure/closet/crate/coffin,
/obj/item/reagent_containers/food/snacks/meat/slab/human/mutant/skeleton,
/turf/open/floor/plating/dirt/jungle/dark/lit,
/area/overmap_encounter/planetoid/jungle/explored)
"r" = (
/obj/structure/flora/junglebush/c,
/turf/open/floor/plating/grass/jungle/lit,
/area/overmap_encounter/planetoid/jungle/explored)
"s" = (
/obj/structure/sink/puddle,
/turf/open/floor/plating/grass/jungle/lit,
/area/overmap_encounter/planetoid/jungle/explored)
"u" = (
/obj/structure/closet/crate/coffin,
/obj/effect/decal/cleanable/dirt,
/turf/open/floor/wood,
/area/ruin/unpowered)
"v" = (
/turf/open/floor/plating/dirt/jungle/dark/lit,
/area/overmap_encounter/planetoid/jungle/explored)
"w" = (
/obj/structure/closet/crate/coffin,
/obj/effect/decal/cleanable/dirt,
/obj/item/cultivator/rake,
/obj/item/shovel,
/turf/open/floor/wood,
/area/ruin/unpowered)
"x" = (
/obj/item/grown/bananapeel,
/turf/open/floor/wood,
/area/ruin/unpowered)
"y" = (
/obj/structure/flora/junglebush/b,
/turf/open/floor/plating/grass/jungle/lit,
/area/overmap_encounter/planetoid/jungle/explored)
"z" = (
/obj/structure/closet/cabinet,
/obj/item/clothing/head/pirate{
	pixel_y = -4
	},
/obj/item/clothing/suit/pirate{
	pixel_y = -4
	},
/obj/item/clothing/glasses/eyepatch{
	pixel_y = 2
	},
/turf/open/floor/wood,
/area/ruin/unpowered)
"A" = (
/obj/effect/decal/cleanable/dirt,
/turf/open/floor/wood,
/area/ruin/unpowered)
"B" = (
/obj/structure/closet/crate/coffin,
/obj/item/stack/sheet/bone,
/obj/item/stack/sheet/bone,
/obj/item/stack/sheet/bone,
/turf/open/floor/plating/grass/jungle/lit,
/area/overmap_encounter/planetoid/jungle/explored)
"C" = (
/obj/structure/closet/crate/coffin,
/obj/item/stack/sheet/bone,
/turf/open/floor/plating/grass/jungle/lit,
/area/overmap_encounter/planetoid/jungle/explored)
"E" = (
/obj/structure/closet/crate/coffin,
/obj/effect/decal/cleanable/dirt,
/obj/item/reagent_containers/food/snacks/sugarcookie/spookycoffin,
/obj/item/reagent_containers/food/snacks/sugarcookie/spookycoffin,
/obj/item/reagent_containers/food/snacks/sugarcookie/spookycoffin,
/turf/open/floor/wood,
/area/ruin/unpowered)
"F" = (
/obj/item/reagent_containers/food/snacks/grown/banana,
/turf/open/floor/plating/dirt/jungle/dark/lit,
/area/overmap_encounter/planetoid/jungle/explored)
"G" = (
/obj/machinery/hydroponics/soil,
/turf/open/floor/plating/dirt/jungle/dark/lit,
/area/overmap_encounter/planetoid/jungle/explored)
"H" = (
/obj/structure/closet/crate/coffin,
/obj/effect/decal/cleanable/dirt,
/obj/item/reagent_containers/food/drinks/beer{
	pixel_x = 8
	},
/obj/item/reagent_containers/food/drinks/beer{
	pixel_x = -6
	},
/obj/item/reagent_containers/food/snacks/sugarcookie/spookycoffin,
/turf/open/floor/wood,
/area/ruin/unpowered)
"I" = (
/obj/structure/table/wood,
/obj/item/melee/transforming/energy/sword/saber/pirate{
	pixel_x = 2;
	pixel_y = 3
	},
/obj/item/flashlight/lamp/bananalamp{
	pixel_x = 3;
	pixel_y = 9
	},
/turf/open/floor/wood,
/area/ruin/unpowered)
"J" = (
/obj/structure/closet/crate/coffin{
	desc = "It's a burial receptacle for some fruit.";
	name = "fridge"
	},
/obj/item/reagent_containers/food/snacks/grown/banana,
/obj/item/reagent_containers/food/snacks/grown/banana,
/obj/item/reagent_containers/food/snacks/grown/banana,
/obj/item/reagent_containers/food/snacks/grown/banana,
/obj/item/reagent_containers/food/snacks/grown/bungofruit,
/obj/effect/decal/cleanable/dirt,
/turf/open/floor/wood,
/area/ruin/unpowered)
"K" = (
/obj/structure/closet/crate/coffin,
/obj/item/reagent_containers/food/snacks/monkeycube,
/turf/open/floor/plating/dirt/jungle/dark/lit,
/area/overmap_encounter/planetoid/jungle/explored)
"L" = (
/obj/machinery/door/airlock/wood{
	dir = 8
	},
/turf/open/floor/wood,
/area/ruin/unpowered)
"M" = (
/obj/structure/closet/crate/coffin,
/obj/item/stack/sheet/bone,
/obj/item/stack/sheet/bone,
/turf/open/floor/plating/grass/jungle/lit,
/area/overmap_encounter/planetoid/jungle/explored)
"N" = (
/obj/structure/closet/crate/coffin,
/obj/item/melee/baseball_bat/bone,
/turf/open/floor/plating/grass/jungle/lit,
/area/overmap_encounter/planetoid/jungle/explored)
"P" = (
/obj/structure/closet/crate/coffin,
/obj/effect/decal/cleanable/dirt,
/obj/item/clothing/suit/hooded/cloak/bone,
/turf/open/floor/wood,
/area/ruin/unpowered)
"Q" = (
/obj/structure/closet/crate/coffin,
/obj/effect/decal/remains/human,
/turf/open/floor/plating/grass/jungle/lit,
/area/overmap_encounter/planetoid/jungle/explored)
"R" = (
/obj/structure/bed/dogbed{
	name = "Palmo's bed"
	},
/turf/open/floor/wood,
/area/ruin/unpowered)
"S" = (
/obj/structure/table/wood,
/obj/item/paper{
	default_raw_text = "Forgot I had this paper on me, so I might as well use it as a diary. Today is the 23rd of July, or atleast that's what I made up in my head, and I am currently fulfilling my dream career of carving coffins. Yep, I'm living my best life here. I tamed a monkey a while back, named him Palmo, little guy's been a dear friend since. Until activity picks up on this planet I'm just gonna live a nice and quiet life, and then sell my masterfully crafted coffins to all those in need of them. Also, I found some peculiar fruit earlier, tastes pretty good but I think I probably ingested a few of the seeds. Shouldn't be TOO bad for me. Either way, I'm going to go to bed. Hopefully I find some more paper to use so I can keep writing.";
	pixel_x = 3;
	pixel_y = 3
	},
/obj/item/pen{
	pixel_x = -5;
	pixel_y = 2
	},
/turf/open/floor/wood,
/area/ruin/unpowered)
"T" = (
/obj/structure/flora/grass/jungle,
/turf/open/floor/plating/grass/jungle/lit,
/area/overmap_encounter/planetoid/jungle/explored)
"U" = (
/obj/structure/bed,
/obj/effect/decal/cleanable/dirt,
/obj/effect/mob_spawn/human/corpse/pirate{
	desc = "It looks like they died of a heart attack in their sleep."
	},
/turf/open/floor/wood,
/area/ruin/unpowered)
"V" = (
/mob/living/carbon/monkey{
	dir = 8;
	name = "Palmo"
	},
/turf/open/floor/wood,
/area/ruin/unpowered)
"W" = (
/obj/structure/closet/crate/coffin,
/obj/item/reagent_containers/food/snacks/sugarcookie/spookyskull,
/turf/open/floor/plating/grass/jungle/lit,
/area/overmap_encounter/planetoid/jungle/explored)
"Y" = (
/obj/structure/closet/crate/coffin,
/obj/item/reagent_containers/glass/bucket/wooden,
/obj/item/seeds/banana,
/obj/item/seeds/banana,
/obj/effect/decal/cleanable/dirt,
/turf/open/floor/wood,
/area/ruin/unpowered)
"Z" = (
/obj/structure/flora/junglebush,
/turf/open/floor/plating/grass/jungle/lit,
/area/overmap_encounter/planetoid/jungle/explored)

(1,1,1) = {"
a
a
v
v
v
v
v
y
a
a
d
h
h
i
a
"}
(2,1,1) = {"
a
v
v
l
l
l
l
T
y
h
h
h
Z
Q
a
"}
(3,1,1) = {"
a
v
l
l
U
I
l
l
M
h
i
h
h
h
a
"}
(4,1,1) = {"
a
v
l
z
b
b
R
l
C
h
N
h
h
i
h
"}
(5,1,1) = {"
a
K
l
H
b
A
P
l
c
h
h
a
a
h
i
"}
(6,1,1) = {"
a
l
l
l
L
l
l
l
l
h
a
a
a
a
a
"}
(7,1,1) = {"
a
l
E
x
b
A
b
w
l
W
a
a
a
a
a
"}
(8,1,1) = {"
a
l
e
b
b
b
x
A
l
Z
h
h
a
a
a
"}
(9,1,1) = {"
a
l
S
f
V
A
b
A
g
h
h
s
h
h
a
"}
(10,1,1) = {"
a
l
j
x
A
b
b
Y
l
m
T
h
v
G
h
"}
(11,1,1) = {"
a
l
l
b
b
k
n
l
l
h
G
v
G
v
T
"}
(12,1,1) = {"
a
a
l
l
J
u
l
l
a
B
G
F
G
q
h
"}
(13,1,1) = {"
a
a
a
l
l
l
l
a
a
i
C
G
v
h
r
"}
(14,1,1) = {"
a
a
a
a
a
a
a
a
a
a
h
h
h
h
a
"}
