//MAP CONVERTED BY dmm2tgm.py THIS HEADER COMMENT PREVENTS RECONVERSION, DO NOT REMOVE
"aC" = (
/turf/closed/wall,
/area/ruin/powered)
"bk" = (
/obj/effect/mine/stun,
/turf/open/floor/plating/dirt,
/area/ruin/powered)
"bQ" = (
/obj/effect/decal/cleanable/dirt/dust,
/obj/effect/turf_decal/syndicateemblem/bottom/middle,
/turf/open/floor/mineral/plastitanium/red,
/area/ruin/powered)
"dW" = (
/obj/effect/decal/cleanable/dirt/dust,
/obj/structure/cable{
	icon_state = "4-8"
	},
/turf/open/floor/plating,
/area/ruin/powered)
"eq" = (
/obj/structure/cable{
	icon_state = "5-8"
	},
/obj/effect/turf_decal/syndicateemblem/top/left,
/obj/effect/decal/cleanable/dirt/dust,
/turf/open/floor/mineral/plastitanium/red,
/area/ruin/powered)
"eH" = (
/obj/effect/decal/cleanable/dirt/dust,
/obj/machinery/porta_turret/syndicate/pod,
/obj/structure/cable{
	icon_state = "0-8"
	},
/turf/open/floor/plating,
/area/ruin/powered)
"eU" = (
/obj/machinery/suit_storage_unit/open,
/turf/open/floor/plating{
	icon_state = "panelscorched";
	initial_gas_mix = "ws_atmos"
	},
/area/ruin/powered)
"fy" = (
/obj/effect/decal/cleanable/dirt/dust,
/obj/machinery/porta_turret/syndicate/pod,
/obj/structure/cable{
	icon_state = "0-4"
	},
/turf/open/floor/plating,
/area/ruin/powered)
"fK" = (
/obj/structure/punji_sticks,
/obj/structure/flora/ausbushes/fullgrass,
/turf/open/floor/plating/dirt,
/area/ruin/unpowered)
"gD" = (
/obj/effect/decal/cleanable/dirt/dust,
/obj/structure/cable{
	icon_state = "1-2"
	},
/obj/structure/cable{
	icon_state = "1-10"
	},
/turf/open/floor/plating,
/area/ruin/powered)
"hI" = (
/obj/structure/sign/donk,
/turf/closed/wall/rust,
/area/ruin/powered)
"is" = (
/obj/structure/table,
/obj/item/grenade/smokebomb,
/obj/item/grenade/smokebomb,
/obj/item/grenade/smokebomb,
/obj/effect/decal/cleanable/dirt/dust,
/turf/open/floor/plating,
/area/ruin/powered)
"jt" = (
/obj/structure/sign/poster/contraband/syndicate_recruitment,
/turf/closed/wall/rust,
/area/ruin/powered)
"ka" = (
/obj/structure/sign/poster/contraband/syndicate_recruitment,
/turf/closed/wall,
/area/ruin/powered)
"kj" = (
/obj/machinery/door/airlock/hatch,
/obj/structure/cable{
	icon_state = "1-2"
	},
/turf/open/floor/plating,
/area/ruin/powered)
"kC" = (
/obj/machinery/suit_storage_unit/open,
/turf/open/floor/plating,
/area/ruin/powered)
"nN" = (
/obj/structure/sign/poster/contraband/revolver,
/turf/closed/wall,
/area/ruin/powered)
"nZ" = (
/obj/machinery/suit_storage_unit/open,
/obj/item/toy/nuke,
/turf/open/floor/plating{
	icon_state = "panelscorched";
	initial_gas_mix = "ws_atmos"
	},
/area/ruin/powered)
"ob" = (
/obj/effect/turf_decal/syndicateemblem/bottom/left,
/turf/open/floor/mineral/plastitanium/red,
/area/ruin/powered)
"of" = (
/obj/structure/cable,
/mob/living/simple_animal/hostile/syndicate,
/turf/open/floor/plating,
/area/ruin/powered)
"oE" = (
/obj/structure/punji_sticks,
/obj/structure/flora/ausbushes/fullgrass,
/obj/effect/decal/remains/human,
/turf/open/floor/plating/dirt,
/area/ruin/unpowered)
"oK" = (
/obj/structure/cable{
	icon_state = "4-8"
	},
/obj/effect/turf_decal/syndicateemblem/middle/right,
/turf/open/floor/mineral/plastitanium/red,
/area/ruin/powered)
"ro" = (
/obj/machinery/nuclearbomb/beer{
	desc = "A beer keg designed to look like a nuclear fission explosive. Its old and incredibly dusty. There seems to be a tap on the back.";
	name = "Syndicate Beer Keg"
	},
/obj/effect/decal/cleanable/dirt/dust,
/turf/open/floor/plating,
/area/ruin/powered)
"ry" = (
/obj/effect/decal/cleanable/dirt/dust,
/obj/effect/turf_decal/syndicateemblem/top/right,
/turf/open/floor/mineral/plastitanium/red,
/area/ruin/powered)
"rM" = (
/obj/structure/cable{
	icon_state = "4-8"
	},
/turf/open/floor/mineral/plastitanium/red,
/area/ruin/powered)
"rV" = (
/obj/effect/decal/remains/human,
/obj/effect/decal/cleanable/dirt/dust,
/turf/open/floor/mineral/plastitanium/red,
/area/ruin/powered)
"rW" = (
/obj/structure/punji_sticks,
/obj/structure/flora/ausbushes/lavendergrass,
/obj/effect/decal/cleanable/blood/gibs/up,
/turf/open/floor/plating/dirt,
/area/ruin/unpowered)
"so" = (
/obj/structure/chair/plastic,
/mob/living/simple_animal/hostile/syndicate/ranged,
/turf/open/floor/plating,
/area/ruin/powered)
"sq" = (
/turf/open/floor/plating,
/area/ruin/powered)
"sD" = (
/obj/structure/cable{
	icon_state = "4-8"
	},
/turf/open/floor/plating{
	icon_state = "panelscorched";
	initial_gas_mix = "ws_atmos"
	},
/area/ruin/powered)
"tg" = (
/obj/machinery/suit_storage_unit/syndicate{
	storage_type = /obj/item/toy/balloon/syndicate
	},
/turf/open/floor/plating,
/area/ruin/powered)
"tU" = (
/obj/structure/closet/crate/secure/science,
/obj/item/research_notes/loot/medium,
/obj/item/stack/sheet/plastic/twenty,
/turf/open/floor/plating,
/area/ruin/powered)
"ug" = (
/obj/structure/table,
/obj/item/grenade/frag,
/obj/item/grenade/frag,
/obj/item/grenade/frag,
/turf/open/floor/plating,
/area/ruin/powered)
"ul" = (
/obj/structure/flora/tree/jungle,
/turf/open/floor/plating/dirt,
/area/ruin/unpowered)
"vp" = (
/obj/structure/punji_sticks,
/obj/structure/flora/ausbushes/lavendergrass,
/obj/effect/decal/cleanable/blood/gibs/torso,
/turf/open/floor/plating/dirt,
/area/ruin/unpowered)
"wd" = (
/obj/structure/barricade/sandbags,
/obj/effect/decal/cleanable/dirt/dust,
/turf/open/floor/plating,
/area/ruin/powered)
"wt" = (
/obj/structure/cable{
	icon_state = "1-4"
	},
/obj/effect/turf_decal/syndicateemblem/middle/middle,
/obj/effect/decal/cleanable/dirt/dust,
/turf/open/floor/mineral/plastitanium/red,
/area/ruin/powered)
"AB" = (
/obj/structure/flora/ausbushes/fernybush,
/obj/effect/decal/cleanable/blood/gibs/limb,
/turf/open/floor/plating/dirt,
/area/ruin/unpowered)
"AI" = (
/obj/effect/spawner/structure/window/reinforced,
/turf/open/space/basic,
/area/ruin/powered)
"Bf" = (
/turf/open/floor/plating{
	icon_state = "panelscorched";
	initial_gas_mix = "ws_atmos"
	},
/area/ruin/powered)
"Br" = (
/obj/item/storage/cans/sixbeer,
/turf/open/floor/plating,
/area/ruin/powered)
"Bv" = (
/obj/item/toy/snappop,
/obj/machinery/door/airlock/hatch,
/turf/open/floor/plating,
/area/ruin/powered)
"BJ" = (
/obj/effect/decal/cleanable/dirt/dust,
/turf/open/floor/plating{
	icon_state = "panelscorched";
	initial_gas_mix = "ws_atmos"
	},
/area/ruin/powered)
"CA" = (
/obj/structure/sign/poster/contraband/syndicate,
/turf/closed/wall,
/area/ruin/powered)
"Dd" = (
/obj/structure/closet/crate/secure/weapon,
/obj/item/gun/ballistic/automatic/c20r,
/obj/item/ammo_box/magazine/smgm45,
/obj/item/ammo_box/magazine/smgm45,
/turf/open/floor/plating,
/area/ruin/powered)
"DW" = (
/obj/structure/sign/poster/contraband/free_key,
/turf/closed/wall,
/area/ruin/powered)
"Ec" = (
/obj/structure/flora/grass/jungle,
/obj/effect/decal/cleanable/blood/gibs/down,
/turf/open/floor/plating/dirt,
/area/ruin/unpowered)
"El" = (
/obj/effect/decal/cleanable/dirt/dust,
/turf/open/floor/mineral/plastitanium/red,
/area/ruin/powered)
"EM" = (
/turf/closed/wall/rust,
/area/ruin/powered)
"EY" = (
/obj/structure/rack,
/obj/effect/decal/cleanable/dirt/dust,
/obj/effect/spawner/lootdrop/random_ammo_protolathe_lootdrop,
/obj/effect/spawner/lootdrop/random_ammo_protolathe_lootdrop,
/obj/effect/spawner/lootdrop/random_ammo_protolathe_lootdrop,
/turf/open/floor/plating,
/area/ruin/powered)
"GH" = (
/turf/open/floor/mineral/plastitanium/red,
/area/ruin/powered)
"HN" = (
/turf/template_noop,
/area/template_noop)
"Ip" = (
/obj/structure/rack,
/obj/item/storage/toolbox/syndicate,
/obj/item/gun/ballistic/automatic/pistol,
/turf/open/floor/plating,
/area/ruin/powered)
"Kh" = (
/obj/structure/cable{
	icon_state = "1-2"
	},
/obj/effect/turf_decal/syndicateemblem/top/middle,
/turf/open/floor/mineral/plastitanium/red,
/area/ruin/powered)
"Nb" = (
/turf/open/floor/plating/dirt,
/area/ruin/powered)
"Nh" = (
/obj/effect/turf_decal/syndicateemblem/bottom/right,
/obj/effect/decal/cleanable/dirt/dust,
/turf/open/floor/mineral/plastitanium/red,
/area/ruin/powered)
"NC" = (
/obj/structure/closet/crate/freezer,
/obj/item/reagent_containers/food/snacks/pizzaslice/donkpocket,
/obj/item/reagent_containers/food/snacks/pizzaslice/donkpocket,
/obj/item/storage/box/donkpockets/donkpocketteriyaki,
/obj/item/storage/box/donkpockets,
/obj/item/storage/box/donkpockets/donkpocketberry,
/obj/effect/spawner/lootdrop/donkpockets,
/turf/open/floor/plating,
/area/ruin/powered)
"Ou" = (
/obj/structure/punji_sticks,
/obj/structure/flora/rock/jungle,
/obj/effect/decal/remains/human,
/turf/open/floor/plating/dirt,
/area/ruin/unpowered)
"Oz" = (
/obj/effect/decal/cleanable/dirt/dust,
/obj/structure/barricade/sandbags,
/turf/open/floor/plating,
/area/ruin/powered)
"OG" = (
/obj/structure/barricade/sandbags,
/turf/open/floor/plating,
/area/ruin/powered)
"PO" = (
/obj/effect/decal/cleanable/dirt/dust,
/turf/open/floor/plating,
/area/ruin/powered)
"Qs" = (
/obj/structure/punji_sticks,
/obj/structure/flora/ausbushes/sparsegrass,
/obj/effect/decal/remains/human,
/turf/open/floor/plating/dirt,
/area/ruin/unpowered)
"RS" = (
/obj/structure/table,
/obj/item/clothing/gloves/combat,
/obj/item/clothing/shoes/combat,
/obj/item/clothing/mask/gas/syndicate,
/turf/open/floor/mineral/plastitanium/red,
/area/ruin/powered)
"SF" = (
/obj/structure/table,
/obj/item/kitchen/knife/combat,
/turf/open/floor/plating,
/area/ruin/powered)
"UD" = (
/obj/structure/closet/crate/secure/plasma,
/obj/item/stack/sheet/mineral/plasma/five,
/obj/item/stack/sheet/mineral/plasma/five,
/turf/open/floor/mineral/plastitanium/red,
/area/ruin/powered)
"Vx" = (
/mob/living/simple_animal/hostile/syndicate{
	desc = "God dammit Jerry! Why the fuck are you barracading yourself in with all of our weapon supplies?";
	name = "Jerry"
	},
/turf/open/floor/plating,
/area/ruin/powered)
"Wj" = (
/obj/structure/flora/junglebush/c,
/turf/open/floor/plating/dirt,
/area/ruin/unpowered)
"WJ" = (
/obj/structure/closet/crate/secure/gear,
/obj/item/folder/syndicate,
/obj/item/storage/fancy/cigarettes/cigpack_syndicate,
/turf/open/floor/plating,
/area/ruin/powered)
"Xy" = (
/obj/structure/closet/crate/secure/gear,
/obj/item/storage/box/syndimaid,
/obj/item/storage/box/syndimaid,
/obj/item/blackmarket_uplink,
/turf/open/floor/plating,
/area/ruin/powered)
"XA" = (
/obj/effect/decal/remains/human,
/obj/structure/flora/ausbushes/fullgrass,
/turf/open/floor/plating/dirt,
/area/ruin/unpowered)
"XR" = (
/mob/living/simple_animal/hostile/syndicate/space,
/obj/structure/cable{
	icon_state = "1-2"
	},
/turf/open/floor/plating{
	icon_state = "panelscorched";
	initial_gas_mix = "ws_atmos"
	},
/area/ruin/unpowered)
"YT" = (
/obj/structure/cable{
	icon_state = "4-8"
	},
/turf/open/floor/plating,
/area/ruin/powered)
"Zy" = (
/obj/machinery/power/port_gen/pacman,
/obj/effect/decal/cleanable/cobweb,
/obj/structure/cable{
	icon_state = "0-6"
	},
/turf/open/floor/plating,
/area/ruin/powered)
"ZO" = (
/mob/living/simple_animal/hostile/syndicate,
/obj/effect/decal/cleanable/dirt/dust,
/turf/open/floor/plating,
/area/ruin/powered)

(1,1,1) = {"
HN
HN
HN
HN
HN
HN
Nb
HN
HN
HN
HN
HN
HN
HN
HN
"}
(2,1,1) = {"
HN
HN
EM
EM
HN
Nb
bk
HN
oE
Ec
fK
XA
HN
HN
HN
"}
(3,1,1) = {"
HN
aC
WJ
Xy
EM
HN
HN
EM
EM
fy
OG
aC
aC
HN
HN
"}
(4,1,1) = {"
HN
aC
PO
sq
AI
HN
HN
EM
Zy
dW
El
SF
jt
EM
HN
"}
(5,1,1) = {"
HN
ka
Vx
sq
aC
HN
ul
aC
Ip
rM
sq
rV
RS
EM
vp
"}
(6,1,1) = {"
Nb
EM
Dd
PO
aC
EM
EM
aC
UD
rM
GH
Bf
GH
aC
HN
"}
(7,1,1) = {"
Nb
aC
OG
OG
aC
nZ
eU
CA
GH
eq
Bf
ob
sq
OG
HN
"}
(8,1,1) = {"
Nb
Bv
sq
Bf
Bv
PO
XR
kj
gD
Kh
wt
bQ
so
Oz
Ou
"}
(9,1,1) = {"
Nb
aC
ZO
Bf
aC
kC
tg
CA
Bf
ry
oK
Nh
GH
OG
HN
"}
(10,1,1) = {"
Nb
hI
Bf
Bf
EM
EM
aC
aC
GH
BJ
rM
GH
GH
aC
HN
"}
(11,1,1) = {"
Nb
EM
NC
PO
EM
HN
Wj
DW
of
GH
sD
GH
EY
aC
HN
"}
(12,1,1) = {"
HN
EM
ro
PO
AI
HN
HN
aC
is
ug
YT
nN
EM
EM
HN
"}
(13,1,1) = {"
HN
aC
Br
tU
aC
HN
HN
aC
OG
wd
eH
aC
HN
HN
HN
"}
(14,1,1) = {"
HN
HN
aC
aC
HN
HN
bk
HN
rW
AB
Qs
HN
HN
HN
HN
"}
(15,1,1) = {"
HN
HN
HN
HN
HN
HN
HN
HN
HN
HN
HN
HN
HN
HN
HN
"}
