//MAP CONVERTED BY dmm2tgm.py THIS HEADER COMMENT PREVENTS RECONVERSION, DO NOT REMOVE
"al" = (
/obj/structure/window/plasma/reinforced{
	dir = 8
	},
/obj/machinery/atmospherics/components/unary/portables_connector/visible,
/obj/machinery/portable_atmospherics/canister/toxins,
/turf/open/floor/engine/airless,
/area/overmap_encounter/planetoid/jungle/explored)
"am" = (
/obj/effect/turf_decal/rechargefloor,
/obj/structure/extinguisher_cabinet/directional/north,
/obj/mecha/combat/durand,
/turf/open/floor/engine/airless,
/area/overmap_encounter/planetoid/jungle/explored)
"at" = (
/obj/effect/decal/cleanable/blood{
	icon_state = "splatter1";
	pixel_x = 18;
	pixel_y = 4
	},
/turf/open/floor/plating/dirt/jungle/wasteland{
	icon_state = "wasteland0"
	},
/area/overmap_encounter/planetoid/jungle/explored)
"bb" = (
/obj/machinery/power/shuttle/engine/fueled/plasma{
	dir = 8
	},
/obj/structure/window/plasma/reinforced{
	dir = 1
	},
/turf/open/floor/engine/airless,
/area/overmap_encounter/planetoid/jungle/explored)
"bd" = (
/obj/machinery/door/poddoor/shutters{
	id = "pirateshutters";
	name = "Blast Shutters"
	},
/turf/open/floor/engine/airless,
/area/overmap_encounter/planetoid/jungle/explored)
"bj" = (
/obj/item/trash/cheesie,
/turf/open/floor/engine/airless,
/area/overmap_encounter/planetoid/jungle/explored)
"bv" = (
/obj/structure/cable{
	icon_state = "4-9"
	},
/obj/effect/decal/cleanable/blood,
/obj/item/paper/crumpled/fluff{
	default_raw_text = ''Wecantholdthemanymore,theperimeterhasbeenbreachedandevenwiththemechs,theykeepcoming.Ifearthisistheend...''
	},
/turf/open/floor/plating/dirt/jungle/wasteland{
	icon_state = "wasteland9"
	},
/area/overmap_encounter/planetoid/jungle/explored)
"cU" = (
/obj/effect/decal/cleanable/blood/drip,
/turf/open/floor/plating/dirt/jungle/wasteland{
	icon_state = "wasteland5"
	},
/area/overmap_encounter/planetoid/jungle/explored)
"dn" = (
/obj/effect/decal/cleanable/blood,
/obj/effect/decal/cleanable/blood/drip,
/turf/open/floor/plating/dirt/jungle/wasteland{
	icon_state = "wasteland9"
	},
/area/overmap_encounter/planetoid/jungle/explored)
"dr" = (
/obj/structure/barricade/wooden,
/turf/open/floor/plating/dirt/jungle/wasteland{
	icon_state = "wasteland9"
	},
/area/overmap_encounter/planetoid/jungle/explored)
"dx" = (
/obj/machinery/power/port_gen/pacman,
/obj/structure/cable{
	icon_state = "0-4"
	},
/obj/effect/decal/cleanable/blood{
	icon_state = "bubblegumfoot"
	},
/obj/effect/decal/cleanable/blood/drip,
/turf/open/floor/plating/dirt/jungle/wasteland{
	icon_state = "wasteland9"
	},
/area/overmap_encounter/planetoid/jungle/explored)
"ef" = (
/obj/structure/rack,
/obj/effect/spawner/lootdrop/random_gun_protolathe_lootdrop,
/obj/machinery/atmospherics/pipe/simple/purple/hidden{
	dir = 3
	},
/obj/structure/window/plasma/reinforced{
	dir = 4
	},
/obj/machinery/light/directional/west,
/turf/open/floor/engine/airless,
/area/overmap_encounter/planetoid/jungle/explored)
"fd" = (
/obj/structure/flora/tree/jungle/small{
	icon_state = "tree3"
	},
/turf/open/floor/plating/dirt/jungle,
/area/overmap_encounter/planetoid/jungle/explored)
"fe" = (
/obj/effect/decal/cleanable/blood/drip,
/obj/structure/barricade/sandbags,
/turf/open/floor/plating/dirt/jungle/wasteland{
	icon_state = "wasteland9"
	},
/area/overmap_encounter/planetoid/jungle/explored)
"fr" = (
/obj/structure/cable{
	icon_state = "1-2"
	},
/obj/effect/decal/cleanable/blood{
	icon_state = "bubblegumfoot"
	},
/turf/open/floor/plating/dirt/jungle/wasteland{
	icon_state = "wasteland4"
	},
/area/overmap_encounter/planetoid/jungle/explored)
"fz" = (
/obj/structure/barricade/sandbags,
/obj/effect/decal/fakelattice,
/turf/open/floor/plating/dirt/jungle/wasteland{
	icon_state = "wasteland9"
	},
/area/overmap_encounter/planetoid/jungle/explored)
"fH" = (
/obj/structure/flora/tree/jungle{
	icon_state = "tree6"
	},
/turf/open/floor/plating/dirt/jungle,
/area/overmap_encounter/planetoid/jungle/explored)
"fI" = (
/obj/machinery/atmospherics/pipe/manifold/purple/hidden{
	dir = 8
	},
/obj/structure/closet/firecloset/wall/directional/west,
/obj/item/clothing/mask/breath{
	pixel_y = 0;
	pixel_x = -6
	},
/obj/item/tank/internals/emergency_oxygen{
	pixel_x = 6
	},
/turf/open/floor/engine/airless,
/area/overmap_encounter/planetoid/jungle/explored)
"gU" = (
/obj/structure/cable{
	icon_state = "6-9"
	},
/turf/open/floor/plating/dirt/jungle/wasteland{
	icon_state = "wasteland9"
	},
/area/overmap_encounter/planetoid/jungle/explored)
"gZ" = (
/obj/structure/flora/rock,
/turf/open/floor/plating/dirt/jungle/wasteland{
	icon_state = "wasteland9"
	},
/area/overmap_encounter/planetoid/jungle/explored)
"hk" = (
/obj/machinery/atmospherics/components/unary/shuttle/heater{
	dir = 1
	},
/obj/structure/window/plasma/reinforced{
	dir = 4
	},
/obj/structure/window/plasma/reinforced{
	dir = 1
	},
/turf/open/floor/engine/airless,
/area/overmap_encounter/planetoid/jungle/explored)
"hq" = (
/mob/living/simple_animal/hostile/jungle/mega_arachnid{
	faction = s
	},
/turf/open/floor/plating/dirt/jungle/wasteland{
	icon_state = "wasteland9"
	},
/area/overmap_encounter/planetoid/jungle/explored)
"hQ" = (
/obj/effect/decal/remains/human,
/obj/effect/decal/cleanable/blood{
	icon_state = "bubblegumfoot"
	},
/obj/effect/decal/cleanable/blood/drip,
/obj/effect/decal/cleanable/blood/drip,
/obj/effect/decal/cleanable/blood/drip,
/turf/open/floor/plating/dirt/jungle/wasteland{
	icon_state = "wasteland9"
	},
/area/overmap_encounter/planetoid/jungle/explored)
"hT" = (
/obj/machinery/atmospherics/components/unary/shuttle/heater{
	dir = 1
	},
/obj/structure/window/plasma/reinforced{
	dir = 8
	},
/obj/structure/window/plasma/reinforced{
	dir = 1
	},
/turf/open/floor/engine/airless,
/area/overmap_encounter/planetoid/jungle/explored)
"is" = (
/obj/machinery/computer/mech_bay_power_console{
	dir = 8
	},
/obj/machinery/atmospherics/pipe/simple/purple/hidden{
	dir = 3
	},
/obj/machinery/light/directional/east,
/turf/open/floor/engine/airless,
/area/overmap_encounter/planetoid/jungle/explored)
"iv" = (
/obj/machinery/power/shuttle/engine/fueled/plasma{
	dir = 1
	},
/obj/structure/window/plasma/reinforced{
	dir = 4
	},
/turf/open/floor/engine/airless,
/area/overmap_encounter/planetoid/jungle/explored)
"iC" = (
/obj/structure/mecha_wreckage/durand,
/turf/open/floor/plating/dirt/jungle/wasteland{
	icon_state = "wasteland9"
	},
/area/overmap_encounter/planetoid/jungle/explored)
"iK" = (
/obj/structure/table,
/turf/open/floor/plating/dirt/jungle/wasteland{
	icon_state = "wasteland9"
	},
/area/overmap_encounter/planetoid/jungle/explored)
"jM" = (
/obj/structure/rack,
/obj/item/stack/sheet/mineral/plasma/ten,
/turf/open/floor/plating/dirt/jungle/wasteland{
	icon_state = "wasteland9"
	},
/area/overmap_encounter/planetoid/jungle/explored)
"kj" = (
/obj/structure/flora/rock/jungle,
/turf/open/floor/plating/dirt/jungle,
/area/overmap_encounter/planetoid/jungle/explored)
"kH" = (
/obj/structure/cable{
	icon_state = "1-2"
	},
/turf/open/floor/plating/dirt/jungle/wasteland{
	icon_state = "wasteland9"
	},
/area/overmap_encounter/planetoid/jungle/explored)
"kJ" = (
/obj/structure/cable{
	icon_state = "6-9"
	},
/obj/effect/decal/cleanable/blood/drip,
/turf/open/floor/plating/dirt/jungle/wasteland{
	icon_state = "wasteland9"
	},
/area/overmap_encounter/planetoid/jungle/explored)
"kY" = (
/obj/structure/barricade/sandbags,
/turf/open/floor/plating/dirt/jungle/wasteland{
	icon_state = "wasteland_dug"
	},
/area/overmap_encounter/planetoid/jungle/explored)
"le" = (
/mob/living/simple_animal/hostile/venus_human_trap{
	faction = list("jungle")
	},
/turf/closed/wall/r_wall,
/area/overmap_encounter/planetoid/jungle/explored)
"lB" = (
/obj/machinery/light/directional/east,
/turf/open/floor/plating,
/area/overmap_encounter/planetoid/jungle/explored)
"lE" = (
/obj/structure/cable{
	icon_state = "6-9"
	},
/obj/effect/decal/cleanable/blood/splatter,
/turf/open/floor/plating/dirt/jungle/wasteland{
	icon_state = "wasteland9"
	},
/area/overmap_encounter/planetoid/jungle/explored)
"lZ" = (
/obj/structure/table,
/obj/machinery/button/door{
	dir = 1
	},
/turf/open/floor/engine/airless,
/area/overmap_encounter/planetoid/jungle/explored)
"mu" = (
/obj/effect/decal/cleanable/blood{
	icon_state = "bubblegumfoot"
	},
/turf/open/floor/plating/dirt/jungle/wasteland{
	icon_state = "wasteland5"
	},
/area/overmap_encounter/planetoid/jungle/explored)
"no" = (
/obj/structure/flora/tree/jungle/small{
	icon_state = "tree3"
	},
/obj/structure/flora/tree/jungle,
/turf/open/floor/plating/dirt/jungle,
/area/overmap_encounter/planetoid/jungle/explored)
"nA" = (
/obj/machinery/mech_bay_recharge_port{
	dir = 8
	},
/obj/machinery/atmospherics/pipe/simple/purple/hidden{
	dir = 5
	},
/turf/open/floor/engine/airless,
/area/overmap_encounter/planetoid/jungle/explored)
"oC" = (
/obj/structure/table,
/obj/machinery/light/directional/south,
/turf/open/floor/engine/airless,
/area/overmap_encounter/planetoid/jungle/explored)
"oG" = (
/turf/open/floor/plating/dirt/jungle/wasteland{
	icon_state = "wasteland4"
	},
/area/overmap_encounter/planetoid/jungle/explored)
"oK" = (
/obj/effect/turf_decal/rechargefloor,
/turf/open/floor/engine/airless,
/area/overmap_encounter/planetoid/jungle/explored)
"oP" = (
/turf/open/floor/plating/dirt/jungle/wasteland{
	icon_state = "wasteland1"
	},
/area/overmap_encounter/planetoid/jungle/explored)
"pX" = (
/obj/machinery/mech_bay_recharge_port{
	dir = 1
	},
/obj/machinery/atmospherics/pipe/simple/purple/hidden{
	dir = 6
	},
/turf/open/floor/engine/airless,
/area/overmap_encounter/planetoid/jungle/explored)
"qd" = (
/obj/structure/cable{
	icon_state = "6-9"
	},
/obj/effect/decal/cleanable/blood,
/obj/effect/decal/cleanable/blood,
/turf/open/floor/plating/dirt/jungle/wasteland{
	icon_state = "wasteland4"
	},
/area/overmap_encounter/planetoid/jungle/explored)
"qo" = (
/obj/machinery/atmospherics/pipe/simple/purple/hidden{
	dir = 4
	},
/obj/item/trash/energybar,
/turf/open/floor/engine/airless,
/area/overmap_encounter/planetoid/jungle/explored)
"qU" = (
/obj/machinery/power/floodlight{
	anchored = 1
	},
/obj/structure/cable{
	icon_state = "0-8"
	},
/turf/open/floor/plating/dirt/jungle/wasteland{
	icon_state = "wasteland9"
	},
/area/overmap_encounter/planetoid/jungle/explored)
"rc" = (
/obj/structure/barricade/sandbags,
/obj/effect/decal/cleanable/blood{
	icon_state = "splatter1";
	pixel_x = 18;
	pixel_y = 4
	},
/turf/open/floor/plating/dirt/jungle/wasteland{
	icon_state = "wasteland9"
	},
/area/overmap_encounter/planetoid/jungle/explored)
"rk" = (
/obj/effect/decal/cleanable/blood{
	icon_state = "coatblood"
	},
/turf/closed/wall/r_wall,
/area/overmap_encounter/planetoid/jungle/explored)
"rl" = (
/obj/structure/table,
/obj/item/paper{
	default_raw_text = ''Wewerenotsupposedtobehere.I'vegotnoideawhopunchedinthecoordsforthatdrop,butimsureasshittheywantedusgone.AlphaandGammalandedclose,theremainingsensorsofmypodscanseethem.PersonallyIgotencasedinrock,theshutterswontopen,rocksblockingthem.Ithinkimgonnarunoutoffoodiftheydontfindawaytogetmeout.''
	},
/turf/open/floor/engine/airless,
/area/overmap_encounter/planetoid/jungle/explored)
"rD" = (
/obj/machinery/atmospherics/pipe/simple/purple/hidden{
	dir = 4
	},
/turf/open/floor/engine/airless,
/area/overmap_encounter/planetoid/jungle/explored)
"rI" = (
/obj/effect/decal/cleanable/blood/drip,
/turf/open/floor/engine/airless,
/area/overmap_encounter/planetoid/jungle/explored)
"rM" = (
/obj/machinery/power/floodlight{
	anchored = 1
	},
/obj/structure/cable{
	icon_state = "0-6"
	},
/turf/open/floor/plating/dirt/jungle/wasteland{
	icon_state = "wasteland9"
	},
/area/overmap_encounter/planetoid/jungle/explored)
"rN" = (
/obj/structure/flora/tree/jungle/small,
/turf/open/floor/plating/dirt/jungle,
/area/overmap_encounter/planetoid/jungle/explored)
"rV" = (
/obj/machinery/computer/mech_bay_power_console{
	dir = 4
	},
/obj/machinery/atmospherics/pipe/simple/purple/hidden{
	dir = 3
	},
/obj/machinery/light/directional/west,
/turf/open/floor/engine/airless,
/area/overmap_encounter/planetoid/jungle/explored)
"sD" = (
/obj/effect/decal/cleanable/garbage,
/obj/effect/decal/cleanable/blood,
/obj/effect/decal/cleanable/blood/drip,
/turf/open/floor/plating/dirt/jungle/wasteland{
	icon_state = "wasteland9"
	},
/area/overmap_encounter/planetoid/jungle/explored)
"sN" = (
/obj/structure/window/plasma/reinforced/fulltile,
/obj/structure/grille,
/turf/open/floor/plating,
/area/overmap_encounter/planetoid/jungle/explored)
"tm" = (
/obj/item/trash/pistachios,
/turf/open/floor/engine/airless,
/area/overmap_encounter/planetoid/jungle/explored)
"tB" = (
/mob/living/simple_animal/hostile/venus_human_trap{
	faction = list("jungle")
	},
/turf/open/floor/plating/dirt/jungle/wasteland{
	icon_state = "wasteland9"
	},
/area/overmap_encounter/planetoid/jungle/explored)
"tI" = (
/turf/open/floor/plating/dirt/jungle/wasteland{
	icon_state = "wasteland_dug";
	light_color = "#a0ad20";
	light_range = 3
	},
/area/overmap_encounter/planetoid/jungle/explored)
"ug" = (
/turf/open/floor/plating/dirt/jungle/wasteland{
	icon_state = "wasteland9"
	},
/area/overmap_encounter/planetoid/jungle/explored)
"uV" = (
/obj/structure/table,
/obj/machinery/light/directional/east,
/turf/open/floor/engine/airless,
/area/overmap_encounter/planetoid/jungle/explored)
"vb" = (
/obj/structure/table,
/obj/item/paper{
	default_raw_text = ''BothAlphaandGammalandedsomewhatsafely.Gammahitrock,butmostwherefine,Betaontheotherhand,iscompletelyentombed.Withwhatlittleequipementwehave,notmuchwecandoreally.Atleastwecanuseit'shullascover.We'vemadeasmallFOBaroundthecrashsite,andrescueshouldnotbetoolong...hopefully.''
	},
/turf/open/floor/plating/dirt/jungle/wasteland{
	icon_state = "wasteland9"
	},
/area/overmap_encounter/planetoid/jungle/explored)
"vc" = (
/obj/effect/decal/remains/human,
/turf/open/floor/plating/dirt/jungle/wasteland{
	icon_state = "wasteland9"
	},
/area/overmap_encounter/planetoid/jungle/explored)
"vs" = (
/obj/item/trash/can/food/beans,
/turf/open/floor/engine/airless,
/area/overmap_encounter/planetoid/jungle/explored)
"vU" = (
/obj/effect/decal/remains/human,
/obj/effect/decal/cleanable/blood,
/turf/open/floor/plating/dirt/jungle/wasteland{
	icon_state = "wasteland0"
	},
/area/overmap_encounter/planetoid/jungle/explored)
"wb" = (
/obj/structure/cable{
	icon_state = "4-8"
	},
/turf/open/floor/plating/dirt/jungle/wasteland{
	icon_state = "wasteland9"
	},
/area/overmap_encounter/planetoid/jungle/explored)
"wg" = (
/obj/machinery/mech_bay_recharge_port{
	dir = 1
	},
/obj/machinery/atmospherics/pipe/simple/purple/hidden{
	dir = 10
	},
/turf/open/floor/engine/airless,
/area/overmap_encounter/planetoid/jungle/explored)
"wN" = (
/obj/machinery/atmospherics/pipe/manifold/purple/hidden{
	dir = 1
	},
/obj/structure/closet/firecloset/wall/directional/north,
/obj/item/tank/internals/emergency_oxygen{
	pixel_x = 6
	},
/obj/item/clothing/mask/breath{
	pixel_y = 0;
	pixel_x = -6
	},
/turf/open/floor/engine/airless,
/area/overmap_encounter/planetoid/jungle/explored)
"xq" = (
/obj/effect/decal/cleanable/blood,
/turf/open/floor/plating/dirt/jungle/wasteland{
	icon_state = "wasteland9"
	},
/area/overmap_encounter/planetoid/jungle/explored)
"yd" = (
/obj/effect/decal/cleanable/blood/splatter,
/obj/machinery/door/poddoor/shutters/preopen,
/turf/open/floor/engine/airless,
/area/overmap_encounter/planetoid/jungle/explored)
"yy" = (
/obj/effect/decal/cleanable/garbage,
/turf/open/floor/plating/dirt/jungle/wasteland{
	icon_state = "wasteland9"
	},
/area/overmap_encounter/planetoid/jungle/explored)
"yP" = (
/obj/structure/cable{
	icon_state = "1-2"
	},
/turf/open/floor/plating/dirt/jungle/wasteland{
	icon_state = "wasteland4"
	},
/area/overmap_encounter/planetoid/jungle/explored)
"zC" = (
/obj/structure/barricade/sandbags,
/turf/open/floor/plating/dirt/jungle/wasteland{
	icon_state = "wasteland0"
	},
/area/overmap_encounter/planetoid/jungle/explored)
"zT" = (
/obj/structure/flora/ausbushes,
/turf/open/floor/plating/dirt/jungle,
/area/overmap_encounter/planetoid/jungle/explored)
"AB" = (
/obj/structure/flora/tree/jungle,
/turf/open/floor/plating/dirt/jungle,
/area/overmap_encounter/planetoid/jungle/explored)
"AJ" = (
/obj/structure/chair/comfy/shuttle,
/turf/open/floor/engine/airless,
/area/overmap_encounter/planetoid/jungle/explored)
"Bx" = (
/obj/machinery/door/poddoor/shutters/preopen,
/turf/open/floor/engine/airless,
/area/overmap_encounter/planetoid/jungle/explored)
"CH" = (
/obj/structure/flora/ausbushes/fernybush,
/turf/open/floor/plating/dirt/jungle,
/area/overmap_encounter/planetoid/jungle/explored)
"CL" = (
/turf/closed/wall/r_wall,
/area/overmap_encounter/planetoid/jungle/explored)
"Da" = (
/turf/closed/indestructible/rock,
/area/overmap_encounter/planetoid/jungle/explored)
"Db" = (
/obj/structure/barricade/sandbags,
/turf/open/floor/plating/dirt/jungle/wasteland{
	icon_state = "wasteland9"
	},
/area/overmap_encounter/planetoid/jungle/explored)
"Dq" = (
/obj/effect/decal/cleanable/blood{
	icon_state = "bubblegumfoot"
	},
/obj/effect/decal/cleanable/blood,
/turf/open/floor/plating/dirt/jungle/wasteland{
	icon_state = "wasteland9"
	},
/area/overmap_encounter/planetoid/jungle/explored)
"Fh" = (
/obj/structure/barricade/sandbags,
/obj/structure/barricade/wooden,
/turf/open/floor/plating/dirt/jungle/wasteland{
	icon_state = "wasteland9"
	},
/area/overmap_encounter/planetoid/jungle/explored)
"FQ" = (
/obj/machinery/atmospherics/components/unary/shuttle/heater{
	dir = 8
	},
/obj/structure/window/plasma/reinforced{
	dir = 1
	},
/obj/structure/window/plasma/reinforced{
	dir = 8
	},
/turf/open/floor/engine/airless,
/area/overmap_encounter/planetoid/jungle/explored)
"FY" = (
/mob/living/simple_animal/hostile/jungle/mega_arachnid,
/turf/open/floor/plating/dirt/jungle/wasteland{
	icon_state = "wasteland9"
	},
/area/overmap_encounter/planetoid/jungle/explored)
"Ge" = (
/obj/structure/frame/computer{
	dir = 1
	},
/turf/open/floor/engine/airless,
/area/overmap_encounter/planetoid/jungle/explored)
"Gf" = (
/obj/structure/flora/tree/jungle{
	icon_state = "tree9"
	},
/turf/open/floor/plating/dirt/jungle,
/area/overmap_encounter/planetoid/jungle/explored)
"HR" = (
/obj/machinery/door/poddoor/shutters/preopen{
	dir = 4
	},
/obj/effect/decal/cleanable/blood,
/turf/open/floor/engine/airless,
/area/overmap_encounter/planetoid/jungle/explored)
"IE" = (
/obj/effect/decal/remains/human,
/obj/effect/decal/cleanable/blood/gibs/body,
/turf/open/floor/plating/dirt/jungle/wasteland{
	icon_state = "wasteland9"
	},
/area/overmap_encounter/planetoid/jungle/explored)
"IT" = (
/obj/structure/rack,
/obj/item/poster/random_minutemen,
/turf/open/floor/plating/dirt/jungle/wasteland{
	icon_state = "wasteland9"
	},
/area/overmap_encounter/planetoid/jungle/explored)
"JD" = (
/obj/structure/cable{
	icon_state = "1-8"
	},
/obj/structure/cable{
	icon_state = "1-4"
	},
/turf/open/floor/plating/dirt/jungle/wasteland{
	icon_state = "wasteland9"
	},
/area/overmap_encounter/planetoid/jungle/explored)
"JT" = (
/turf/open/floor/engine/airless,
/area/overmap_encounter/planetoid/jungle/explored)
"Ky" = (
/turf/open/floor/plating/dirt/jungle/wasteland{
	icon_state = "wasteland0"
	},
/area/overmap_encounter/planetoid/jungle/explored)
"Lj" = (
/obj/structure/frame/computer{
	dir = 8
	},
/turf/open/floor/engine/airless,
/area/overmap_encounter/planetoid/jungle/explored)
"Lm" = (
/obj/structure/table,
/obj/item/trash/raisins,
/obj/item/trash/tray,
/turf/open/floor/engine/airless,
/area/overmap_encounter/planetoid/jungle/explored)
"LK" = (
/obj/effect/decal/fakelattice,
/turf/open/floor/plating/dirt/jungle/wasteland{
	icon_state = "wasteland9"
	},
/area/overmap_encounter/planetoid/jungle/explored)
"LW" = (
/obj/effect/decal/cleanable/blood{
	icon_state = "coatblood"
	},
/obj/effect/decal/cleanable/blood/splatter,
/turf/open/floor/plating/dirt/jungle/wasteland{
	icon_state = "wasteland9"
	},
/area/overmap_encounter/planetoid/jungle/explored)
"Mo" = (
/turf/closed/mineral/strong,
/area/overmap_encounter/planetoid/jungle/explored)
"MD" = (
/obj/structure/barricade/sandbags,
/turf/open/floor/plating/dirt/jungle/wasteland{
	icon_state = "wasteland4"
	},
/area/overmap_encounter/planetoid/jungle/explored)
"Nt" = (
/turf/open/floor/plating/dirt/jungle/wasteland{
	icon_state = "wasteland_dug"
	},
/area/overmap_encounter/planetoid/jungle/explored)
"ND" = (
/obj/structure/barricade/sandbags,
/turf/open/floor/plating/dirt/jungle,
/area/overmap_encounter/planetoid/jungle/explored)
"NK" = (
/obj/effect/decal/remains/human,
/obj/effect/decal/cleanable/blood,
/turf/open/floor/plating/dirt/jungle/wasteland{
	icon_state = "wasteland4"
	},
/area/overmap_encounter/planetoid/jungle/explored)
"NT" = (
/obj/machinery/atmospherics/pipe/simple/purple/hidden{
	dir = 3
	},
/turf/open/floor/engine/airless,
/area/overmap_encounter/planetoid/jungle/explored)
"Oa" = (
/obj/effect/decal/cleanable/blood{
	icon_state = "bubblegumfoot"
	},
/turf/open/floor/plating/dirt/jungle/wasteland{
	icon_state = "wasteland9"
	},
/area/overmap_encounter/planetoid/jungle/explored)
"Oz" = (
/obj/effect/decal/cleanable/blood/drip,
/turf/open/floor/plating/dirt/jungle/wasteland{
	icon_state = "wasteland9"
	},
/area/overmap_encounter/planetoid/jungle/explored)
"OE" = (
/turf/open/floor/plating/dirt/jungle,
/area/overmap_encounter/planetoid/jungle/explored)
"PW" = (
/obj/structure/window/plasma/reinforced,
/obj/machinery/atmospherics/components/unary/portables_connector/visible{
	dir = 4
	},
/obj/machinery/portable_atmospherics/canister/toxins,
/turf/open/floor/engine/airless,
/area/overmap_encounter/planetoid/jungle/explored)
"PZ" = (
/obj/effect/decal/cleanable/blood{
	icon_state = "bubblegumfoot"
	},
/obj/structure/bonfire,
/turf/open/floor/plating/dirt/jungle/wasteland{
	icon_state = "wasteland4"
	},
/area/overmap_encounter/planetoid/jungle/explored)
"Qn" = (
/obj/structure/table,
/turf/open/floor/engine/airless,
/area/overmap_encounter/planetoid/jungle/explored)
"Qs" = (
/obj/effect/decal/cleanable/blood/drip,
/obj/structure/mecha_wreckage/durand,
/turf/open/floor/plating/dirt/jungle/wasteland{
	icon_state = "wasteland9"
	},
/area/overmap_encounter/planetoid/jungle/explored)
"Re" = (
/obj/machinery/computer/mech_bay_power_console{
	dir = 1
	},
/obj/machinery/atmospherics/pipe/simple/purple/hidden{
	dir = 4
	},
/obj/machinery/light/directional/south,
/turf/open/floor/engine/airless,
/area/overmap_encounter/planetoid/jungle/explored)
"Ri" = (
/obj/effect/decal/cleanable/blood/footprints,
/turf/open/floor/plating/dirt/jungle/wasteland{
	icon_state = "wasteland4"
	},
/area/overmap_encounter/planetoid/jungle/explored)
"SG" = (
/obj/structure/girder/reinforced,
/turf/open/floor/plating/dirt/jungle/wasteland{
	icon_state = "wasteland9"
	},
/area/overmap_encounter/planetoid/jungle/explored)
"SV" = (
/turf/open/floor/plating/dirt/jungle/wasteland{
	icon_state = "wasteland7"
	},
/area/overmap_encounter/planetoid/jungle/explored)
"SZ" = (
/obj/machinery/atmospherics/pipe/simple/purple/hidden{
	dir = 4
	},
/obj/item/trash/can/food/peaches,
/turf/open/floor/engine/airless,
/area/overmap_encounter/planetoid/jungle/explored)
"Tt" = (
/turf/open/floor/plating,
/area/overmap_encounter/planetoid/jungle/explored)
"TX" = (
/obj/machinery/power/shuttle/engine/fueled/plasma{
	dir = 1
	},
/obj/structure/window/plasma/reinforced{
	dir = 8
	},
/turf/open/floor/engine/airless,
/area/overmap_encounter/planetoid/jungle/explored)
"UZ" = (
/obj/machinery/atmospherics/pipe/manifold/purple/hidden{
	dir = 4
	},
/obj/structure/closet/firecloset/wall/directional/east,
/obj/item/clothing/mask/breath{
	pixel_y = 0;
	pixel_x = -6
	},
/obj/item/tank/internals/emergency_oxygen{
	pixel_x = 6
	},
/turf/open/floor/engine/airless,
/area/overmap_encounter/planetoid/jungle/explored)
"Vg" = (
/obj/machinery/atmospherics/pipe/simple/purple/hidden{
	dir = 3
	},
/obj/effect/decal/cleanable/blood/drip,
/turf/open/floor/engine/airless,
/area/overmap_encounter/planetoid/jungle/explored)
"Vi" = (
/obj/machinery/door/poddoor/shutters/preopen{
	dir = 4
	},
/turf/open/floor/engine/airless,
/area/overmap_encounter/planetoid/jungle/explored)
"Vr" = (
/obj/machinery/atmospherics/components/unary/portables_connector/visible,
/obj/machinery/portable_atmospherics/canister/toxins,
/obj/structure/window/plasma/reinforced{
	dir = 4
	},
/turf/open/floor/engine/airless,
/area/overmap_encounter/planetoid/jungle/explored)
"Vx" = (
/obj/effect/decal/cleanable/blood{
	icon_state = "bubblegumfoot"
	},
/turf/open/floor/plating/dirt/jungle/wasteland{
	icon_state = "wasteland0"
	},
/area/overmap_encounter/planetoid/jungle/explored)
"VT" = (
/obj/effect/decal/remains/human,
/turf/open/floor/engine/airless,
/area/overmap_encounter/planetoid/jungle/explored)
"Wl" = (
/obj/structure/cable{
	icon_state = "2-4"
	},
/obj/structure/cable{
	icon_state = "2-8"
	},
/turf/open/floor/plating/dirt/jungle/wasteland{
	icon_state = "wasteland9"
	},
/area/overmap_encounter/planetoid/jungle/explored)
"XA" = (
/obj/effect/decal/cleanable/blood{
	icon_state = "coatblood"
	},
/obj/effect/decal/cleanable/blood/drip,
/turf/open/floor/plating/dirt/jungle/wasteland{
	icon_state = "wasteland9"
	},
/area/overmap_encounter/planetoid/jungle/explored)
"Zp" = (
/obj/effect/decal/cleanable/blood/footprints,
/turf/open/floor/plating/dirt/jungle/wasteland{
	icon_state = "wasteland9"
	},
/area/overmap_encounter/planetoid/jungle/explored)

(1,1,1) = {"
fd
OE
ug
zT
Gf
OE
OE
rN
Da
Da
Da
Da
Da
Da
Da
Da
Da
Da
Da
Da
"}
(2,1,1) = {"
AB
OE
OE
OE
fH
OE
OE
fH
Mo
Da
Da
Da
CL
CL
CL
CL
CL
Da
Da
Da
"}
(3,1,1) = {"
Gf
ug
Db
Db
Db
Db
ND
Db
dr
Da
Da
CL
CL
Vr
fI
ef
hk
iv
Da
Da
"}
(4,1,1) = {"
zT
ug
Db
rM
Oz
ug
mu
at
SV
ug
Da
Da
bd
tm
SZ
VT
Lm
rl
Da
Da
"}
(5,1,1) = {"
fH
Nt
Db
tB
gU
yy
ug
ug
ug
hq
ug
Da
bd
JT
rD
VT
AJ
Ge
sN
Da
"}
(6,1,1) = {"
fd
ug
oG
fe
xq
qd
ug
Ky
tB
cU
vU
Da
bd
bj
qo
vs
lZ
oC
CL
Da
"}
(7,1,1) = {"
OE
ug
ug
Nt
Nt
hQ
kJ
ug
Zp
Zp
Ri
CL
CL
am
wg
is
hT
TX
Da
Da
"}
(8,1,1) = {"
fH
ug
Nt
zC
ug
iC
ug
lE
PZ
Dq
xq
Nt
CL
CL
CL
CL
CL
CL
CL
Da
"}
(9,1,1) = {"
OE
ug
Db
kY
Db
rc
zC
FY
bv
Oa
Ky
XA
Db
dx
tI
vb
iK
Vx
jM
Da
"}
(10,1,1) = {"
OE
fd
MD
ug
FY
dn
ug
tB
Wl
yP
kH
kH
fr
JD
Oz
Oa
tB
ug
jM
Da
"}
(11,1,1) = {"
OE
Gf
Db
IE
xq
ug
LW
ug
wb
xq
oP
Qs
Db
qU
sD
vc
ug
ug
IT
Da
"}
(12,1,1) = {"
CH
ug
Fh
CL
tB
Oz
ug
rk
qU
ug
Oz
ug
le
CL
CL
CL
CL
CL
CL
Da
"}
(13,1,1) = {"
fH
ug
CL
CL
Vi
Vi
HR
CL
CL
ug
ug
CL
CL
oK
pX
rV
hk
iv
Da
Da
"}
(14,1,1) = {"
Gf
Ky
CL
PW
JT
JT
Tt
oK
CL
Oz
NK
ug
yd
JT
rD
JT
Qn
oC
CL
Da
"}
(15,1,1) = {"
OE
oG
CL
wN
NT
Vg
NT
nA
CL
ug
Nt
ug
Bx
JT
rD
JT
AJ
Ge
Da
Da
"}
(16,1,1) = {"
no
ug
SG
Tt
Tt
JT
JT
Re
CL
tB
Oa
ug
Bx
JT
rD
JT
lZ
Da
Da
Da
"}
(17,1,1) = {"
CH
Nt
fz
Tt
rI
JT
Qn
FQ
CL
Db
Db
CL
CL
al
UZ
Da
Da
Da
Da
Da
"}
(18,1,1) = {"
AB
ug
Db
Tt
lB
Lj
uV
bb
CL
ug
ug
oG
CL
CL
CL
Da
Da
Da
Da
Da
"}
(19,1,1) = {"
OE
ug
Db
fz
CL
sN
CL
LK
CL
Ky
yy
ug
ug
SG
Da
Da
Da
Da
Da
Da
"}
(20,1,1) = {"
fd
ug
ug
ug
ug
ug
ug
ug
ug
ug
rN
kj
gZ
Da
Da
Da
Da
Da
Da
Da
"}
