//MAP CONVERTED BY dmm2tgm.py THIS HEADER COMMENT PREVENTS RECONVERSION, DO NOT REMOVE
"a" = (
/turf/closed/mineral/random/jungle,
/area/overmap_encounter/planetoid/cave/explored)
"b" = (
/obj/machinery/jukebox,
/obj/effect/decal/cleanable/dirt/dust,
/turf/open/floor/plasteel/vaporwave,
/area/overmap_encounter/planetoid/cave/explored)
"c" = (
/obj/structure/table/wood,
/turf/open/floor/grass,
/area/overmap_encounter/planetoid/cave/explored)
"d" = (
/obj/structure/rack,
/obj/effect/spawner/lootdrop/memeorgans,
/turf/open/floor/grass,
/area/overmap_encounter/planetoid/cave/explored)
"e" = (
/obj/structure/flora/ausbushes/fullgrass,
/turf/open/floor/grass,
/area/overmap_encounter/planetoid/cave/explored)
"f" = (
/mob/living/simple_animal/hostile/lizard/space,
/obj/effect/decal/cleanable/dirt/dust,
/turf/open/floor/plasteel/vaporwave,
/area/overmap_encounter/planetoid/cave/explored)
"g" = (
/obj/structure/table/wood/fancy/purple,
/turf/open/floor/plasteel/vaporwave,
/area/overmap_encounter/planetoid/cave/explored)
"h" = (
/obj/effect/decal/cleanable/dirt/dust,
/turf/open/floor/plasteel/vaporwave,
/area/overmap_encounter/planetoid/cave/explored)
"i" = (
/turf/open/floor/grass,
/area/overmap_encounter/planetoid/cave/explored)
"j" = (
/obj/structure/flora/ausbushes/brflowers,
/turf/open/floor/grass,
/area/overmap_encounter/planetoid/cave/explored)
"k" = (
/mob/living/simple_animal/butterfly,
/turf/open/floor/grass,
/area/overmap_encounter/planetoid/cave/explored)
"l" = (
/obj/structure/flora/ausbushes/reedbush,
/turf/open/floor/grass,
/area/overmap_encounter/planetoid/cave/explored)
"m" = (
/obj/structure/table/wood,
/obj/item/reagent_containers/food/drinks/colocup/lean,
/turf/open/floor/grass,
/area/overmap_encounter/planetoid/cave/explored)
"n" = (
/obj/structure/table/wood/fancy/purple,
/obj/item/flashlight/glowstick/pink,
/obj/item/flashlight/glowstick,
/obj/item/flashlight/glowstick/blue,
/obj/item/flashlight/glowstick/cyan,
/obj/item/flashlight/glowstick/orange,
/obj/item/flashlight/glowstick/red,
/obj/item/flashlight/glowstick/yellow,
/turf/open/floor/plasteel/vaporwave,
/area/overmap_encounter/planetoid/cave/explored)
"p" = (
/obj/structure/statue/sandstone/venus{
	dir = 8
	},
/obj/effect/decal/cleanable/cobweb/cobweb2,
/obj/effect/decal/cleanable/dirt/dust,
/turf/open/floor/plasteel/vaporwave,
/area/overmap_encounter/planetoid/cave/explored)
"s" = (
/obj/structure/flora/tree/jungle,
/turf/open/floor/grass,
/area/overmap_encounter/planetoid/cave/explored)
"t" = (
/obj/structure/musician/piano,
/obj/effect/decal/cleanable/dirt/dust,
/turf/open/floor/plasteel/vaporwave,
/area/overmap_encounter/planetoid/cave/explored)
"u" = (
/obj/structure/table/wood/fancy/purple,
/obj/item/storage/pill_bottle/zoom,
/obj/effect/decal/cleanable/dirt/dust,
/obj/item/spacecash/bundle/c1000,
/turf/open/floor/plasteel/vaporwave,
/area/overmap_encounter/planetoid/cave/explored)
"v" = (
/obj/structure/flora/ausbushes/lavendergrass,
/obj/structure/flora/ausbushes/brflowers,
/turf/open/floor/grass,
/area/overmap_encounter/planetoid/cave/explored)
"w" = (
/obj/structure/window/reinforced/tinted/fulltile,
/obj/structure/grille,
/turf/open/floor/plasteel/vaporwave,
/area/overmap_encounter/planetoid/cave/explored)
"x" = (
/obj/structure/sink/puddle,
/turf/open/floor/grass,
/area/overmap_encounter/planetoid/cave/explored)
"z" = (
/turf/template_noop,
/area/template_noop)
"A" = (
/obj/structure/flora/ausbushes/sunnybush,
/turf/open/floor/grass,
/area/overmap_encounter/planetoid/cave/explored)
"B" = (
/obj/structure/table/wood,
/obj/item/pizzabox/meat,
/turf/open/floor/grass,
/area/overmap_encounter/planetoid/cave/explored)
"D" = (
/mob/living/simple_animal/pet/gondola,
/turf/open/floor/grass,
/area/overmap_encounter/planetoid/cave/explored)
"E" = (
/obj/structure/flora/tree/jungle/small,
/turf/open/floor/grass,
/area/overmap_encounter/planetoid/cave/explored)
"F" = (
/obj/machinery/door/airlock/grunge,
/turf/open/floor/plasteel/vaporwave,
/area/overmap_encounter/planetoid/cave/explored)
"G" = (
/obj/structure/table/wood,
/obj/item/storage/pill_bottle/dice,
/obj/item/spacecash/bundle/c1000,
/turf/open/floor/grass,
/area/overmap_encounter/planetoid/cave/explored)
"H" = (
/obj/structure/flora/ausbushes/lavendergrass,
/turf/open/floor/grass,
/area/overmap_encounter/planetoid/cave/explored)
"I" = (
/obj/structure/table/wood/fancy/royalblue,
/obj/item/clothing/glasses/sunglasses/big,
/obj/effect/decal/cleanable/dirt/dust,
/turf/open/floor/plasteel/vaporwave,
/area/overmap_encounter/planetoid/cave/explored)
"K" = (
/obj/machinery/door/airlock/grunge,
/obj/effect/decal/cleanable/dirt/dust,
/turf/open/floor/plasteel/vaporwave,
/area/overmap_encounter/planetoid/cave/explored)
"L" = (
/obj/structure/bed/pod,
/turf/open/floor/grass,
/area/overmap_encounter/planetoid/cave/explored)
"M" = (
/obj/structure/statue/sandstone/venus,
/obj/effect/decal/cleanable/cobweb,
/obj/effect/decal/cleanable/dirt/dust,
/obj/effect/decal/cleanable/dirt/dust,
/turf/open/floor/plasteel/vaporwave,
/area/overmap_encounter/planetoid/cave/explored)
"N" = (
/obj/structure/rack,
/obj/effect/spawner/lootdrop/minor/kittyears_or_rabbitears,
/turf/open/floor/grass,
/area/overmap_encounter/planetoid/cave/explored)
"O" = (
/turf/open/floor/plasteel/vaporwave,
/area/overmap_encounter/planetoid/cave/explored)
"P" = (
/obj/effect/decal/cleanable/greenglow,
/turf/closed/wall,
/area/overmap_encounter/planetoid/cave/explored)
"Q" = (
/obj/structure/table/wood/fancy/royalblue,
/obj/item/statuebust,
/turf/open/floor/plasteel/vaporwave,
/area/overmap_encounter/planetoid/cave/explored)
"R" = (
/obj/effect/decal/cleanable/greenglow,
/obj/effect/decal/cleanable/dirt/dust,
/turf/closed/wall,
/area/overmap_encounter/planetoid/cave/explored)
"S" = (
/mob/living/simple_animal/hostile/lightgeist,
/turf/open/floor/plasteel/vaporwave,
/area/overmap_encounter/planetoid/cave/explored)
"T" = (
/obj/structure/reagent_dispensers/watertank,
/turf/open/floor/grass,
/area/overmap_encounter/planetoid/cave/explored)
"U" = (
/obj/structure/table/wood/fancy/purple,
/obj/item/clothing/suit/det_suit,
/obj/effect/decal/cleanable/dirt/dust,
/turf/open/floor/plasteel/vaporwave,
/area/overmap_encounter/planetoid/cave/explored)

(1,1,1) = {"
z
z
z
a
a
a
a
a
a
a
a
a
a
z
z
"}
(2,1,1) = {"
z
z
a
a
a
a
a
i
i
i
l
a
a
a
z
"}
(3,1,1) = {"
z
a
a
a
a
i
H
i
i
s
i
H
a
a
z
"}
(4,1,1) = {"
a
a
a
a
e
i
k
i
D
i
x
i
B
a
a
"}
(5,1,1) = {"
a
a
H
i
i
i
N
d
i
v
i
k
c
a
a
"}
(6,1,1) = {"
a
a
i
P
P
R
P
P
P
P
P
i
e
T
a
"}
(7,1,1) = {"
a
i
l
P
M
h
U
u
O
t
P
i
i
G
a
"}
(8,1,1) = {"
a
i
i
w
I
h
O
S
O
h
K
H
k
m
a
"}
(9,1,1) = {"
a
k
e
w
Q
O
f
h
O
O
F
i
i
a
a
"}
(10,1,1) = {"
a
j
i
P
p
O
g
n
O
b
P
j
L
a
a
"}
(11,1,1) = {"
a
i
i
P
P
P
P
P
P
P
P
i
a
a
z
"}
(12,1,1) = {"
a
a
i
i
k
i
i
i
i
i
H
A
a
a
z
"}
(13,1,1) = {"
z
a
a
a
j
l
e
i
k
E
i
a
a
a
z
"}
(14,1,1) = {"
z
a
a
a
a
a
a
H
i
i
a
a
a
z
z
"}
(15,1,1) = {"
z
z
z
a
a
a
a
a
a
a
a
z
z
z
z
"}
