//MAP CONVERTED BY dmm2tgm.py THIS HEADER COMMENT PREVENTS RECONVERSION, DO NOT REMOVE
"aq" = (
/obj/effect/mob_spawn/human/corpse/syndicatesoldier,
/turf/open/floor/plating/grass/jungle/lit,
/area/template_noop)
"aS" = (
/obj/structure/rack,
/obj/item/clothing/under/costume/singer/blue,
/obj/item/clothing/under/costume/singer/yellow,
/turf/open/floor/plating,
/area/ruin/jungle/onceler/main)
"bh" = (
/turf/open/floor/plating/dirt/jungle/dark/lit,
/area/template_noop)
"bA" = (
/obj/effect/decal/cleanable/blood/gibs,
/obj/effect/decal/cleanable/blood/gibs/body,
/turf/open/floor/plating,
/area/ruin/jungle/onceler/main)
"bV" = (
/obj/structure/rack,
/obj/item/grown/log/tree,
/obj/item/grown/log/tree,
/obj/item/grown/log/tree,
/obj/item/grown/log/tree,
/obj/item/grown/log/tree,
/turf/open/floor/plating,
/area/ruin/jungle/onceler/main)
"cO" = (
/obj/effect/turf_decal/box/corners{
	dir = 8
	},
/obj/effect/decal/cleanable/blood/gibs,
/obj/machinery/light/floor,
/turf/open/floor/plating,
/area/ruin/jungle/onceler/main)
"ds" = (
/obj/structure/railing/corner{
	dir = 8
	},
/obj/structure/railing/corner,
/turf/open/floor/mineral/titanium/yellow,
/area/ruin/jungle/onceler/main)
"dO" = (
/obj/structure/flora/rock/pile/largejungle,
/turf/open/floor/plating/grass/jungle/lit,
/area/template_noop)
"ej" = (
/obj/structure/flora/stump,
/turf/open/floor/plating/grass/jungle,
/area/template_noop)
"ev" = (
/obj/effect/decal/cleanable/blood/footprints,
/turf/open/floor/plating/dirt/jungle/dark/lit,
/area/template_noop)
"gd" = (
/obj/structure/flora/stump,
/turf/open/floor/plating/dirt/jungle/dark/lit,
/area/template_noop)
"hy" = (
/obj/structure/rack,
/obj/item/clothing/under/utility{
	desc = "An oddly comfortable suit, seems to have wood fibers in it.";
	name = "Thneed"
	},
/obj/item/clothing/under/utility{
	desc = "An oddly comfortable suit, seems to have wood fibers in it.";
	name = "Thneed"
	},
/obj/item/clothing/under/utility{
	desc = "An oddly comfortable suit, seems to have wood fibers in it.";
	name = "Thneed"
	},
/obj/item/clothing/under/utility{
	desc = "An oddly comfortable suit, seems to have wood fibers in it.";
	name = "Thneed"
	},
/obj/item/clothing/under/utility{
	desc = "An oddly comfortable suit, seems to have wood fibers in it.";
	name = "Thneed"
	},
/turf/open/floor/plating,
/area/ruin/jungle/onceler/main)
"ir" = (
/obj/effect/turf_decal/industrial/stand_clear,
/turf/open/floor/plating,
/area/ruin/jungle/onceler/main)
"iO" = (
/obj/effect/turf_decal/industrial/warning/corner{
	dir = 4
	},
/turf/open/floor/plating,
/area/ruin/jungle/onceler/main)
"jz" = (
/obj/structure/flora/rock/jungle,
/turf/open/floor/plating/grass/jungle/lit,
/area/template_noop)
"jC" = (
/obj/machinery/light/floor,
/turf/open/floor/plating,
/area/ruin/jungle/onceler/main)
"kt" = (
/obj/structure/flora/grass/jungle,
/turf/open/floor/plating/grass/jungle/lit,
/area/template_noop)
"kA" = (
/obj/effect/decal/cleanable/blood/tracks,
/turf/open/floor/plating,
/area/ruin/jungle/onceler/main)
"lb" = (
/obj/machinery/light{
	dir = 1
	},
/turf/open/floor/mineral/titanium/yellow,
/area/ruin/jungle/onceler/main)
"lz" = (
/obj/structure/stairs/north,
/obj/structure/railing{
	dir = 4
	},
/turf/open/floor/plating,
/area/ruin/jungle/onceler/main)
"mA" = (
/obj/structure/flora/stump,
/obj/structure/flora/junglebush/b,
/turf/open/floor/plating/grass/jungle/lit,
/area/template_noop)
"mE" = (
/obj/effect/decal/cleanable/blood/old,
/turf/open/floor/plating/grass/jungle/lit,
/area/template_noop)
"mM" = (
/obj/structure/sign/poster/official/work_for_a_future{
	pixel_x = -32
	},
/turf/open/floor/plating,
/area/ruin/jungle/onceler/main)
"nX" = (
/obj/structure/stairs/north,
/obj/structure/railing{
	dir = 8
	},
/turf/open/floor/plating,
/area/ruin/jungle/onceler/main)
"ps" = (
/obj/effect/decal/cleanable/blood/gibs,
/turf/open/floor/plating,
/area/ruin/jungle/onceler/main)
"rH" = (
/turf/open/floor/plating/grass/jungle/lit,
/area/template_noop)
"sm" = (
/obj/structure/flora/junglebush/c,
/turf/open/floor/plating/dirt/jungle/dark/lit,
/area/template_noop)
"tn" = (
/obj/structure/rack,
/obj/item/clothing/suit/striped_sweater,
/obj/item/clothing/suit/striped_sweater,
/turf/open/floor/plating,
/area/ruin/jungle/onceler/main)
"un" = (
/obj/item/rack_parts,
/turf/open/floor/plating,
/area/ruin/jungle/onceler/main)
"uy" = (
/obj/effect/decal/cleanable/blood/old,
/turf/open/floor/plating/dirt/jungle/dark/lit,
/area/template_noop)
"vs" = (
/obj/effect/turf_decal/dept/mining,
/obj/item/rack_parts,
/turf/open/floor/plating,
/area/ruin/jungle/onceler/main)
"vy" = (
/obj/effect/turf_decal/box/corners,
/obj/machinery/light/floor,
/turf/open/floor/plating,
/area/ruin/jungle/onceler/main)
"vD" = (
/obj/effect/decal/cleanable/blood/tracks{
	dir = 10
	},
/turf/open/floor/plating,
/area/ruin/jungle/onceler/main)
"vF" = (
/obj/structure/railing,
/obj/item/clothing/glasses/sunglasses,
/turf/open/floor/mineral/titanium/yellow,
/area/ruin/jungle/onceler/main)
"wD" = (
/turf/open/floor/mineral/titanium/yellow,
/area/ruin/jungle/onceler/main)
"wP" = (
/obj/effect/turf_decal/box/corners{
	dir = 4
	},
/obj/machinery/light/floor,
/turf/open/floor/plating,
/area/ruin/jungle/onceler/main)
"wZ" = (
/obj/effect/turf_decal/dept/mining,
/obj/machinery/light{
	dir = 4
	},
/turf/open/floor/plating,
/area/ruin/jungle/onceler/main)
"xT" = (
/obj/effect/turf_decal/dept/mining,
/obj/effect/turf_decal/industrial/warning,
/turf/open/floor/plating,
/area/ruin/jungle/onceler/main)
"yj" = (
/obj/effect/turf_decal/industrial/warning{
	dir = 1
	},
/turf/open/floor/plating/dirt/jungle/dark/lit,
/area/ruin/jungle/onceler/main)
"yF" = (
/obj/structure/railing,
/obj/effect/mob_spawn/human/corpse/solgov/officer,
/obj/item/clothing/under/suit/green,
/turf/open/floor/mineral/titanium/yellow,
/area/ruin/jungle/onceler/main)
"zu" = (
/obj/structure/railing,
/turf/open/floor/mineral/titanium/yellow,
/area/ruin/jungle/onceler/main)
"AC" = (
/obj/structure/flora/junglebush/c,
/turf/open/floor/plating/grass/jungle/lit,
/area/template_noop)
"AR" = (
/turf/open/floor/plating,
/area/ruin/jungle/onceler/main)
"Bg" = (
/obj/structure/flora/junglebush/large,
/turf/open/floor/plating/dirt/jungle/dark/lit,
/area/template_noop)
"Cc" = (
/turf/open/floor/plating/grass/jungle,
/area/template_noop)
"CS" = (
/obj/effect/decal/cleanable/blood/tracks{
	dir = 8
	},
/turf/open/floor/plating,
/area/ruin/jungle/onceler/main)
"De" = (
/obj/effect/turf_decal/dept/mining,
/obj/machinery/button/door{
	id = "onceler";
	name = "Deliveries Shuttle Shutters";
	pixel_y = -25
	},
/obj/effect/turf_decal/industrial/warning/corner,
/turf/open/floor/plating,
/area/ruin/jungle/onceler/main)
"Df" = (
/obj/structure/flora/rock/jungle,
/turf/open/floor/plating/dirt/jungle/dark/lit,
/area/template_noop)
"DG" = (
/obj/effect/mob_spawn/human/corpse/assistant,
/turf/open/floor/plating,
/area/ruin/jungle/onceler/main)
"EW" = (
/obj/structure/railing/corner,
/turf/open/floor/mineral/titanium/yellow,
/area/ruin/jungle/onceler/main)
"Fd" = (
/obj/effect/turf_decal/industrial/stand_clear,
/obj/effect/turf_decal/industrial/warning,
/turf/open/floor/plating,
/area/ruin/jungle/onceler/main)
"GE" = (
/obj/structure/rack,
/obj/item/hatchet/wooden,
/turf/open/floor/plating,
/area/ruin/jungle/onceler/main)
"HO" = (
/turf/open/floor/plating,
/area/template_noop)
"HZ" = (
/obj/effect/turf_decal/box/corners{
	dir = 1
	},
/obj/machinery/light/floor,
/turf/open/floor/plating,
/area/ruin/jungle/onceler/main)
"Ie" = (
/obj/structure/flora/grass/jungle,
/turf/open/floor/plating/dirt/jungle/dark/lit,
/area/template_noop)
"Ij" = (
/obj/effect/turf_decal/industrial/warning/corner{
	dir = 1
	},
/turf/open/floor/plating,
/area/ruin/jungle/onceler/main)
"IE" = (
/obj/structure/rack,
/obj/item/clothing/under/rank/engineering/engineer/maintenance_tech/skirt,
/turf/open/floor/plating,
/area/ruin/jungle/onceler/main)
"LW" = (
/obj/structure/rack,
/obj/item/clothing/under/costume/yakuza,
/turf/open/floor/plating,
/area/ruin/jungle/onceler/main)
"MA" = (
/obj/effect/decal/cleanable/blood/footprints,
/turf/open/floor/plating/grass/jungle/lit,
/area/template_noop)
"MD" = (
/obj/structure/railing/corner{
	dir = 8
	},
/turf/open/floor/mineral/titanium/yellow,
/area/ruin/jungle/onceler/main)
"MT" = (
/obj/structure/flora/junglebush/b,
/turf/open/floor/plating/grass/jungle/lit,
/area/template_noop)
"MX" = (
/obj/effect/turf_decal/industrial/caution,
/obj/effect/turf_decal/industrial/warning,
/turf/open/floor/plating,
/area/ruin/jungle/onceler/main)
"NO" = (
/obj/effect/turf_decal/industrial/caution,
/turf/open/floor/plating,
/area/ruin/jungle/onceler/main)
"Oh" = (
/obj/machinery/light{
	dir = 1
	},
/obj/structure/sign/poster/retro/build{
	pixel_y = 32
	},
/turf/open/floor/mineral/titanium/yellow,
/area/ruin/jungle/onceler/main)
"Pb" = (
/turf/closed/wall,
/area/ruin/jungle/onceler/main)
"Po" = (
/obj/structure/flora/junglebush/large,
/turf/open/floor/plating/grass/jungle/lit,
/area/template_noop)
"PR" = (
/obj/structure/stairs/north,
/obj/structure/railing{
	dir = 4
	},
/obj/structure/railing{
	dir = 8
	},
/turf/open/floor/plating,
/area/ruin/jungle/onceler/main)
"Qp" = (
/obj/effect/decal/cleanable/blood/footprints,
/turf/open/floor/plating,
/area/ruin/jungle/onceler/main)
"Qv" = (
/obj/structure/flora/rock/pile/largejungle,
/turf/open/floor/plating/dirt/jungle/dark/lit,
/area/template_noop)
"RE" = (
/obj/structure/sign/poster/retro/build{
	pixel_y = 32
	},
/turf/open/floor/mineral/titanium/yellow,
/area/ruin/jungle/onceler/main)
"RJ" = (
/obj/effect/decal/cleanable/blood/tracks{
	dir = 6
	},
/turf/open/floor/plating,
/area/ruin/jungle/onceler/main)
"RK" = (
/obj/effect/decal/cleanable/blood/old,
/turf/open/floor/plating,
/area/ruin/jungle/onceler/main)
"RM" = (
/obj/effect/mob_spawn/human/corpse/syndicatesoldier,
/turf/open/floor/plating/dirt/jungle/dark/lit,
/area/template_noop)
"RV" = (
/obj/machinery/light,
/obj/effect/turf_decal/industrial/warning/corner{
	dir = 8
	},
/turf/open/floor/plating,
/area/ruin/jungle/onceler/main)
"SD" = (
/obj/effect/turf_decal/industrial/warning{
	dir = 1
	},
/turf/open/floor/plating,
/area/ruin/jungle/onceler/main)
"SJ" = (
/obj/structure/stairs/north,
/obj/structure/railing{
	dir = 4
	},
/obj/structure/railing{
	dir = 8
	},
/obj/effect/mob_spawn/human/corpse/assistant,
/turf/open/floor/plating,
/area/ruin/jungle/onceler/main)
"Ta" = (
/obj/machinery/door/poddoor/multi_tile/three_tile_hor{
	id = "onceler"
	},
/turf/open/floor/plating,
/area/ruin/jungle/onceler/main)
"TC" = (
/obj/structure/flora/stump,
/turf/open/floor/plating/grass/jungle/lit,
/area/template_noop)
"UD" = (
/obj/effect/turf_decal/dept/mining,
/obj/machinery/light{
	dir = 8
	},
/turf/open/floor/plating,
/area/ruin/jungle/onceler/main)
"UJ" = (
/turf/open/floor/plating/dirt/jungle/dark/lit,
/area/ruin/jungle/onceler/main)
"VH" = (
/obj/effect/turf_decal/industrial/warning,
/turf/open/floor/plating,
/area/ruin/jungle/onceler/main)
"VR" = (
/obj/effect/turf_decal/dept/mining,
/obj/effect/decal/cleanable/blood/tracks{
	dir = 8
	},
/turf/open/floor/plating,
/area/ruin/jungle/onceler/main)
"VT" = (
/obj/effect/turf_decal/dept/mining,
/turf/open/floor/plating,
/area/ruin/jungle/onceler/main)
"Ws" = (
/obj/structure/sign/poster/official/work_for_a_future{
	pixel_y = 32
	},
/turf/open/floor/mineral/titanium/yellow,
/area/ruin/jungle/onceler/main)
"Xe" = (
/obj/structure/rack,
/obj/item/clothing/head/beanie/black,
/obj/item/clothing/head/beanie/christmas,
/turf/open/floor/plating,
/area/ruin/jungle/onceler/main)
"Yo" = (
/obj/structure/rack,
/obj/item/stack/sheet/mineral/wood/fifty,
/turf/open/floor/plating,
/area/ruin/jungle/onceler/main)
"YM" = (
/obj/machinery/light,
/turf/open/floor/plating,
/area/ruin/jungle/onceler/main)
"ZU" = (
/obj/structure/rack,
/obj/item/clothing/under/utility/skirt{
	desc = "A familiar suit that is oddly comfortable to wear, seems to have wood fibers in it. This one has a cute skirt on it.";
	name = "Thneed Skirt"
	},
/obj/item/clothing/under/utility/skirt{
	desc = "A familiar suit that is oddly comfortable to wear, seems to have wood fibers in it. This one has a cute skirt on it.";
	name = "Thneed Skirt"
	},
/obj/item/clothing/under/utility/skirt{
	desc = "A familiar suit that is oddly comfortable to wear, seems to have wood fibers in it. This one has a cute skirt on it.";
	name = "Thneed Skirt"
	},
/obj/item/clothing/under/utility/skirt{
	desc = "A familiar suit that is oddly comfortable to wear, seems to have wood fibers in it. This one has a cute skirt on it.";
	name = "Thneed Skirt"
	},
/obj/item/clothing/under/utility/skirt{
	desc = "A familiar suit that is oddly comfortable to wear, seems to have wood fibers in it. This one has a cute skirt on it.";
	name = "Thneed Skirt"
	},
/turf/open/floor/plating,
/area/ruin/jungle/onceler/main)

(1,1,1) = {"
rH
rH
rH
rH
rH
TC
rH
rH
rH
rH
rH
rH
rH
Cc
rH
rH
rH
rH
rH
rH
"}
(2,1,1) = {"
rH
rH
rH
rH
rH
rH
Po
rH
rH
jz
TC
kt
rH
gd
rH
rH
aq
jz
rH
rH
"}
(3,1,1) = {"
rH
rH
jz
rH
gd
bh
rH
ej
bh
TC
gd
bh
bh
bh
rH
TC
rH
rH
rH
rH
"}
(4,1,1) = {"
rH
rH
rH
rH
bh
Df
bh
Qv
bh
bh
bh
gd
bh
Df
bh
bh
mE
rH
TC
rH
"}
(5,1,1) = {"
rH
rH
rH
gd
rH
bh
bh
rH
bh
bh
Bg
bh
rH
bh
Ie
bh
bh
rH
rH
rH
"}
(6,1,1) = {"
rH
TC
bh
bh
rH
Pb
Pb
Pb
Pb
Pb
Pb
Pb
Pb
Pb
Pb
Pb
bh
Po
rH
rH
"}
(7,1,1) = {"
rH
rH
bh
Bg
bh
Pb
wD
EW
lz
lz
AR
UD
mM
AR
VT
Pb
bh
rH
Df
rH
"}
(8,1,1) = {"
rH
jz
Cc
bh
bh
Pb
Oh
zu
un
AR
AR
DG
kA
vD
AR
AR
bh
gd
bh
rH
"}
(9,1,1) = {"
Cc
bh
bh
Df
gd
Pb
wD
zu
ZU
VT
AR
AR
AR
VR
DG
AR
Ie
bh
bh
rH
"}
(10,1,1) = {"
rH
rH
gd
gd
bh
Pb
wD
zu
hy
AR
AR
jC
AR
RK
AR
Qp
ev
MA
Bg
rH
"}
(11,1,1) = {"
rH
rH
bh
bh
bh
Pb
Ws
yF
GE
AR
AR
VT
AR
AR
VT
Pb
bh
RM
rH
bh
"}
(12,1,1) = {"
rH
TC
jz
gd
bh
Pb
wD
vF
bV
AR
AR
RK
AR
AR
AR
Pb
bh
uy
gd
bh
"}
(13,1,1) = {"
rH
rH
rH
bh
bh
Pb
RE
zu
Yo
AR
AR
CS
AR
VT
YM
Pb
Bg
bh
bh
bh
"}
(14,1,1) = {"
rH
rH
gd
bh
bh
Pb
lb
ds
PR
SJ
kA
RJ
AR
AR
AR
Pb
bh
bh
rH
Ie
"}
(15,1,1) = {"
rH
jz
bh
rH
gd
Pb
wD
zu
tn
AR
NO
ir
ir
NO
De
Pb
iO
Ie
AR
bh
"}
(16,1,1) = {"
rH
TC
bh
Qv
bh
Pb
wD
zu
Xe
NO
HZ
AR
AR
cO
MX
Ta
SD
bh
bh
bh
"}
(17,1,1) = {"
rH
rH
rH
bh
bh
Pb
Ws
zu
un
AR
ps
AR
AR
AR
xT
AR
SD
AR
AR
HO
"}
(18,1,1) = {"
rH
rH
rH
bh
bh
Pb
wD
zu
aS
ir
AR
VT
AR
AR
Fd
AR
yj
AR
bh
AR
"}
(19,1,1) = {"
rH
rH
jz
sm
gd
Pb
RE
zu
un
ir
AR
AR
ps
AR
Fd
Ta
SD
UJ
AR
bh
"}
(20,1,1) = {"
rH
AC
bh
bh
bh
Pb
wD
zu
LW
AR
bA
AR
AR
VT
VH
AR
SD
AR
AR
AR
"}
(21,1,1) = {"
rH
rH
bh
Df
bh
Pb
lb
zu
vs
NO
wP
AR
AR
vy
MX
AR
yj
AR
AR
bh
"}
(22,1,1) = {"
Cc
bh
bh
bh
bh
Pb
Ws
zu
IE
AR
NO
ir
ir
NO
RV
Pb
Ij
AR
bh
AR
"}
(23,1,1) = {"
rH
TC
rH
bh
bh
Pb
wD
MD
nX
nX
AR
wZ
AR
VT
AR
Pb
bh
bh
bh
rH
"}
(24,1,1) = {"
rH
rH
bh
bh
bh
Pb
Pb
Pb
Pb
Pb
Pb
Pb
Pb
Pb
Pb
Pb
bh
bh
dO
rH
"}
(25,1,1) = {"
rH
jz
bh
Df
gd
bh
bh
bh
rH
gd
bh
bh
bh
bh
bh
bh
bh
bh
rH
rH
"}
(26,1,1) = {"
rH
rH
rH
rH
bh
bh
gd
bh
Df
bh
gd
bh
bh
Df
bh
gd
bh
rH
jz
rH
"}
(27,1,1) = {"
rH
rH
rH
rH
TC
rH
bh
bh
bh
rH
rH
rH
rH
gd
rH
rH
MT
rH
rH
rH
"}
(28,1,1) = {"
rH
rH
TC
rH
rH
rH
TC
jz
rH
rH
rH
jz
rH
rH
rH
rH
rH
rH
rH
rH
"}
(29,1,1) = {"
rH
rH
rH
jz
rH
rH
rH
rH
AC
TC
rH
rH
rH
mA
rH
jz
rH
TC
rH
rH
"}
(30,1,1) = {"
rH
rH
rH
rH
rH
rH
rH
rH
rH
MT
rH
rH
rH
Cc
rH
rH
jz
rH
rH
rH
"}
