//MAP CONVERTED BY dmm2tgm.py THIS HEADER COMMENT PREVENTS RECONVERSION, DO NOT REMOVE
"aE" = (
/obj/machinery/light/broken/directional/west,
/turf/open/floor/wood,
/area/ruin/powered)
"bF" = (
/obj/structure/closet/crate/bin,
/obj/item/trash/popcorn,
/obj/item/trash/candy,
/obj/item/grenade/frag{
	name = "garbage"
	},
/turf/open/floor/wood,
/area/ruin/powered)
"bM" = (
/turf/open/floor/carpet/red,
/area/ruin/powered)
"dQ" = (
/mob/living/simple_animal/hostile/rat,
/obj/machinery/light/small/broken/directional/north,
/turf/open/floor/wood,
/area/ruin/powered)
"eE" = (
/turf/open/floor/wood{
	icon_state = "wood-broken7"
	},
/area/ruin/powered)
"eG" = (
/obj/structure/flora/tree/jungle,
/turf/open/floor/plating/grass/jungle/lit,
/area/overmap_encounter/planetoid/jungle/explored)
"eX" = (
/mob/living/simple_animal/hostile/rat{
	dir = 4
	},
/turf/open/floor/carpet/red,
/area/ruin/powered)
"eZ" = (
/turf/open/floor/wood{
	icon_state = "wood-broken5"
	},
/area/ruin/powered)
"fu" = (
/obj/structure/table/wood,
/obj/item/multitool{
	pixel_x = -5;
	pixel_y = 6
	},
/obj/item/wirecutters/old{
	pixel_y = -1
	},
/obj/item/stack/cable_coil/random/five{
	pixel_x = 9;
	pixel_y = 6
	},
/turf/open/floor/wood,
/area/ruin/powered)
"gI" = (
/obj/structure/table/wood/reinforced,
/obj/item/ammo_casing/shotgun/improvised{
	pixel_x = 6;
	pixel_y = -5
	},
/obj/item/ammo_casing/shotgun/improvised{
	pixel_x = -6;
	pixel_y = 6
	},
/obj/item/ammo_casing/shotgun/improvised{
	pixel_x = 6;
	pixel_y = 8
	},
/turf/open/floor/wood{
	icon_state = "wood-broken7"
	},
/area/ruin/powered)
"gO" = (
/obj/structure/barricade/wooden,
/turf/open/floor/plating/grass/jungle/lit,
/area/overmap_encounter/planetoid/jungle/explored)
"hD" = (
/obj/machinery/light/small/directional/south,
/turf/open/floor/wood,
/area/ruin/powered)
"iH" = (
/turf/open/floor/wood{
	icon_state = "wood-broken2"
	},
/area/ruin/powered)
"iS" = (
/obj/structure/chair/plastic{
	dir = 8
	},
/turf/open/floor/wood,
/area/ruin/powered)
"kn" = (
/obj/machinery/hydroponics/soil,
/obj/item/seeds/corn,
/turf/open/floor/plating/grass/jungle/lit,
/area/overmap_encounter/planetoid/jungle/explored)
"ky" = (
/obj/structure/fence{
	dir = 4
	},
/turf/open/floor/plating/grass/jungle/lit,
/area/overmap_encounter/planetoid/jungle/explored)
"kL" = (
/obj/structure/fence/cut/medium,
/turf/open/floor/plating/grass/jungle/lit,
/area/overmap_encounter/planetoid/jungle/explored)
"lN" = (
/obj/structure/table/wood,
/obj/item/grenade/chem_grenade/ez_clean{
	pixel_x = -4;
	pixel_y = 3
	},
/obj/item/grenade/chem_grenade/cleaner{
	pixel_x = 6;
	pixel_y = 7
	},
/obj/item/research_notes/loot/small{
	origin_type = "explosives";
	pixel_y = 4;
	value = 1200
	},
/turf/open/floor/wood,
/area/ruin/powered)
"lW" = (
/obj/structure/barricade/wooden/crude,
/obj/machinery/door/airlock/wood,
/turf/open/floor/wood,
/area/ruin/powered)
"oD" = (
/turf/open/floor/wood{
	icon_state = "wood-broken"
	},
/area/ruin/powered)
"oH" = (
/obj/structure/fence/corner{
	dir = 5
	},
/turf/open/floor/plating/grass/jungle/lit,
/area/overmap_encounter/planetoid/jungle/explored)
"qp" = (
/obj/structure/noticeboard{
	desc = "A board with many old marks and paper scraps on it.";
	dir = 4;
	name = "Teacher's Board"
	},
/turf/closed/wall/mineral/wood,
/area/ruin/powered)
"ri" = (
/obj/structure/chair/plastic{
	dir = 8
	},
/turf/open/floor/wood{
	icon_state = "wood-broken"
	},
/area/ruin/powered)
"rF" = (
/mob/living/simple_animal/hostile/asteroid/hivelord/legion/dwarf{
	desc = "You can still see what was once a rather small human under the shifting mass of corruption. Its trying to keep you away from the main office for some reason.";
	name = "Student"
	},
/turf/open/floor/wood,
/area/ruin/powered)
"rN" = (
/obj/structure/dresser,
/obj/item/research_notes/loot/medium{
	origin_type = "explosives";
	pixel_y = 6
	},
/turf/open/floor/wood{
	icon_state = "wood-broken5"
	},
/area/ruin/powered)
"so" = (
/obj/structure/flora/junglebush/c,
/turf/open/floor/plating/grass/jungle/lit,
/area/overmap_encounter/planetoid/jungle/explored)
"sV" = (
/obj/structure/chair/comfy/black,
/turf/open/floor/carpet/red,
/area/ruin/powered)
"sX" = (
/obj/structure/bed,
/obj/item/bedsheet/rd,
/turf/open/floor/wood,
/area/ruin/powered)
"tc" = (
/obj/structure/fence,
/turf/open/floor/plating/grass/jungle/lit,
/area/overmap_encounter/planetoid/jungle/explored)
"uH" = (
/obj/structure/flora/tree/jungle/small,
/turf/open/floor/plating/grass/jungle/lit,
/area/overmap_encounter/planetoid/jungle/explored)
"vs" = (
/obj/structure/flora/rock,
/turf/open/floor/plating/grass/jungle/lit,
/area/overmap_encounter/planetoid/jungle/explored)
"wq" = (
/obj/structure/table/wood,
/obj/item/grenade/firecracker{
	pixel_x = -8;
	pixel_y = -5
	},
/obj/item/grenade/firecracker{
	pixel_x = -8;
	pixel_y = 8
	},
/obj/item/grenade/firecracker{
	pixel_x = 4
	},
/turf/open/floor/wood,
/area/ruin/powered)
"wz" = (
/obj/structure/floodlight_frame,
/turf/open/floor/plating/grass/jungle/lit,
/area/overmap_encounter/planetoid/jungle/explored)
"wK" = (
/obj/structure/table/wood,
/obj/item/book/manual/wiki/grenades{
	desc = "Some kind of manual about making hellish grenades and explosives. Completely unreadable, but you feel as though you've gained a level in explosives.";
	name = "Pete's Lesson";
	pixel_y = 3
	},
/turf/open/floor/wood{
	icon_state = "wood-broken5"
	},
/area/ruin/powered)
"xs" = (
/obj/structure/table/wood/reinforced,
/obj/item/storage/belt/utility/chief/full,
/turf/open/floor/wood{
	icon_state = "wood-broken2"
	},
/area/ruin/powered)
"xQ" = (
/obj/structure/flora/junglebush/b,
/turf/open/floor/plating/grass/jungle/lit,
/area/overmap_encounter/planetoid/jungle/explored)
"yu" = (
/turf/closed/wall/mineral/wood,
/area/ruin/powered)
"yJ" = (
/obj/structure/table/wood/reinforced,
/obj/item/grenade/clusterbuster/soap{
	name = "Reality Devastator"
	},
/turf/open/floor/wood,
/area/ruin/powered)
"zg" = (
/obj/item/transfer_valve{
	pixel_x = 7;
	pixel_y = 2
	},
/obj/item/transfer_valve{
	pixel_x = -8;
	pixel_y = 2
	},
/obj/structure/table/wood/fancy/orange,
/turf/open/floor/wood,
/area/ruin/powered)
"Bo" = (
/obj/machinery/light/broken/directional/south,
/turf/open/floor/wood,
/area/ruin/powered)
"Bz" = (
/obj/structure/closet/toolcloset,
/turf/open/floor/wood,
/area/ruin/powered)
"Cr" = (
/obj/structure/table/wood,
/obj/item/grenade/chem_grenade/large{
	pixel_x = -7;
	pixel_y = -1
	},
/obj/item/grenade/chem_grenade/large{
	pixel_x = 4;
	pixel_y = 9
	},
/obj/item/screwdriver/old{
	pixel_y = 10
	},
/turf/open/floor/wood,
/area/ruin/powered)
"CR" = (
/obj/structure/barricade/wooden/crude,
/obj/machinery/door/airlock/wood{
	dir = 8
	},
/turf/open/floor/wood,
/area/ruin/powered)
"DU" = (
/mob/living/simple_animal/hostile/asteroid/hivelord/legion{
	name = "Student"
	},
/turf/open/floor/wood{
	icon_state = "wood-broken7"
	},
/area/ruin/powered)
"FT" = (
/obj/machinery/light/small/directional/south,
/turf/open/floor/wood{
	icon_state = "wood-broken2"
	},
/area/ruin/powered)
"Gz" = (
/obj/machinery/door/airlock/wood,
/turf/open/floor/wood,
/area/ruin/powered)
"GE" = (
/obj/structure/chair/stool/bar{
	dir = 4;
	name = "teacher's stool"
	},
/turf/open/floor/wood,
/area/ruin/powered)
"Ho" = (
/obj/structure/table/wood/reinforced,
/obj/item/flashlight/lamp/green,
/turf/open/floor/wood,
/area/ruin/powered)
"Hr" = (
/obj/structure/fence/cut/large{
	dir = 4
	},
/turf/open/floor/plating/grass/jungle/lit,
/area/overmap_encounter/planetoid/jungle/explored)
"It" = (
/obj/structure/flora/junglebush,
/turf/open/floor/plating/grass/jungle/lit,
/area/overmap_encounter/planetoid/jungle/explored)
"Jd" = (
/obj/effect/mob_spawn/human/corpse/charredskeleton{
	desc = "Many die in the pursuit of science. Even more die making homebrew explosives in a random shack on some frontier planet.";
	name = "charred remains of the Teacher"
	},
/turf/open/floor/carpet/red,
/area/ruin/powered)
"Je" = (
/obj/machinery/hydroponics/soil,
/turf/open/floor/plating/grass/jungle/lit,
/area/overmap_encounter/planetoid/jungle/explored)
"Na" = (
/obj/item/reagent_containers/food/snacks/grown/corn,
/turf/open/floor/plating/grass/jungle/lit,
/area/overmap_encounter/planetoid/jungle/explored)
"Oe" = (
/turf/open/floor/plating/grass/jungle/lit,
/area/overmap_encounter/planetoid/jungle/explored)
"Qj" = (
/obj/item/grown/corncob,
/turf/open/floor/plating/grass/jungle/lit,
/area/overmap_encounter/planetoid/jungle/explored)
"Rc" = (
/obj/structure/chair/plastic{
	dir = 8
	},
/turf/open/floor/wood{
	icon_state = "wood-broken7"
	},
/area/ruin/powered)
"RR" = (
/mob/living/simple_animal/hostile/rat{
	dir = 1
	},
/obj/machinery/light/small/directional/south,
/turf/open/floor/wood,
/area/ruin/powered)
"SI" = (
/obj/structure/table/wood,
/obj/item/grenade/stingbang{
	pixel_x = -5;
	pixel_y = 9
	},
/obj/item/lighter/greyscale{
	pixel_x = 6
	},
/turf/open/floor/wood{
	icon_state = "wood-broken2"
	},
/area/ruin/powered)
"Tb" = (
/obj/structure/flora/junglebush/large,
/turf/open/floor/plating/grass/jungle/lit,
/area/overmap_encounter/planetoid/jungle/explored)
"TB" = (
/turf/open/floor/wood,
/area/ruin/powered)
"TQ" = (
/obj/structure/bookcase/random,
/turf/open/floor/wood{
	icon_state = "wood-broken2"
	},
/area/ruin/powered)
"Ux" = (
/obj/structure/barricade/wooden,
/obj/machinery/door/airlock/wood{
	dir = 8
	},
/turf/open/floor/wood,
/area/ruin/powered)
"Vq" = (
/obj/structure/table/wood/reinforced,
/obj/item/grenade/chem_grenade/adv_release{
	pixel_x = 6;
	pixel_y = 5
	},
/obj/item/grenade/chem_grenade/adv_release{
	pixel_x = -5;
	pixel_y = 5
	},
/obj/item/grenade/chem_grenade/adv_release{
	pixel_y = 5
	},
/turf/open/floor/wood{
	icon_state = "wood-broken"
	},
/area/ruin/powered)
"WO" = (
/obj/item/seeds/corn/snapcorn,
/turf/open/floor/plating/grass/jungle/lit,
/area/overmap_encounter/planetoid/jungle/explored)
"WW" = (
/obj/structure/table/wood,
/obj/item/clothing/mask/gas/welding,
/obj/item/research_notes/loot/small{
	origin_type = "explosives";
	pixel_y = 3;
	value = 1200
	},
/turf/open/floor/wood{
	icon_state = "wood-broken4"
	},
/area/ruin/powered)
"XH" = (
/obj/machinery/light/small/directional/north,
/turf/open/floor/wood,
/area/ruin/powered)
"Ym" = (
/obj/item/tank/internals/plasma/full{
	pixel_x = -8;
	pixel_y = -1
	},
/obj/item/tank/internals/plasma/full{
	pixel_x = 5
	},
/obj/item/tank/internals/oxygen{
	pixel_x = -7;
	pixel_y = 8
	},
/obj/item/tank/internals/oxygen{
	pixel_x = 4;
	pixel_y = -6
	},
/obj/structure/table/wood/fancy/orange,
/turf/open/floor/wood{
	icon_state = "wood-broken5"
	},
/area/ruin/powered)
"Zo" = (
/turf/open/floor/wood{
	icon_state = "wood-broken4"
	},
/area/ruin/powered)
"ZH" = (
/mob/living/simple_animal/hostile/cockroach/glockroach,
/turf/open/floor/plating/grass/jungle/lit,
/area/overmap_encounter/planetoid/jungle/explored)
"ZL" = (
/obj/machinery/hydroponics/soil,
/obj/item/reagent_containers/food/snacks/grown/corn,
/turf/open/floor/plating/grass/jungle/lit,
/area/overmap_encounter/planetoid/jungle/explored)
"ZX" = (
/obj/machinery/hydroponics/soil,
/obj/item/grown/corncob,
/turf/open/floor/plating/grass/jungle/lit,
/area/overmap_encounter/planetoid/jungle/explored)

(1,1,1) = {"
Oe
It
Oe
Oe
Oe
It
Tb
Oe
Oe
xQ
Oe
Oe
Oe
Oe
It
"}
(2,1,1) = {"
Oe
yu
yu
yu
yu
yu
yu
yu
yu
vs
Oe
Oe
uH
xQ
Oe
"}
(3,1,1) = {"
eG
yu
sX
oD
bF
yu
zg
Ym
yu
yu
vs
Oe
Oe
It
Tb
"}
(4,1,1) = {"
Oe
yu
rN
eX
bM
Gz
eE
TB
Bz
yu
qp
qp
yu
yu
Oe
"}
(5,1,1) = {"
Oe
yu
dQ
Jd
RR
yu
oD
iH
Zo
aE
oD
GE
TQ
yu
Oe
"}
(6,1,1) = {"
Oe
yu
xs
sV
gI
yu
XH
Zo
rF
TB
TB
eE
TB
lW
xQ
"}
(7,1,1) = {"
Oe
yu
Ho
Vq
yJ
yu
TB
TB
Zo
TB
eZ
Zo
oD
yu
Oe
"}
(8,1,1) = {"
eG
yu
yu
yu
yu
yu
Ux
CR
yu
lN
fu
wK
hD
yu
It
"}
(9,1,1) = {"
Oe
ky
so
Oe
Qj
Oe
Oe
gO
yu
yu
Rc
TB
oD
yu
Oe
"}
(10,1,1) = {"
Tb
ky
Oe
kn
Oe
ZX
xQ
kn
Oe
yu
wq
SI
Bo
yu
Oe
"}
(11,1,1) = {"
Oe
Hr
Oe
Je
WO
Je
wz
ZL
Oe
yu
iS
TB
DU
yu
xQ
"}
(12,1,1) = {"
Oe
ky
Oe
ZL
Na
Je
Oe
ZX
so
yu
WW
Cr
FT
yu
Oe
"}
(13,1,1) = {"
Oe
ky
Qj
Je
ZH
kn
Qj
ZL
Oe
yu
TB
ri
TB
yu
Oe
"}
(14,1,1) = {"
Oe
oH
tc
tc
tc
tc
kL
tc
tc
yu
yu
yu
yu
yu
Oe
"}
(15,1,1) = {"
Oe
Oe
Oe
eG
xQ
Oe
Oe
It
Tb
Oe
Oe
Oe
Oe
Oe
It
"}
