//MAP CONVERTED BY dmm2tgm.py THIS HEADER COMMENT PREVENTS RECONVERSION, DO NOT REMOVE
"aM" = (
/obj/structure/table,
/obj/item/disk/data,
/obj/item/disk/data,
/obj/item/disk/data,
/obj/item/disk/data,
/obj/item/disk/data,
/turf/open/floor/plasteel,
/area/ruin/powered)
"aP" = (
/obj/item/kirbyplants/fullysynthetic,
/turf/open/floor/plasteel,
/area/ruin/powered)
"cI" = (
/obj/effect/mob_spawn/human/corpse/assistant,
/obj/effect/decal/cleanable/blood/old,
/turf/open/floor/plasteel,
/area/ruin/powered)
"dJ" = (
/obj/structure/closet/crate/radiation,
/obj/item/stack/sheet/mineral/uranium/twenty,
/turf/open/floor/plasteel,
/area/ruin/powered)
"ez" = (
/obj/structure/bed,
/obj/item/bedsheet/medical,
/turf/open/floor/plasteel,
/area/ruin/powered)
"eQ" = (
/obj/machinery/washing_machine,
/turf/open/floor/plasteel,
/area/ruin/powered)
"fM" = (
/obj/structure/chair/greyscale{
	dir = 8
	},
/turf/open/floor/plasteel,
/area/ruin/powered)
"fR" = (
/obj/effect/decal/cleanable/xenoblood/xgibs/larva,
/turf/open/floor/plasteel,
/area/ruin/powered)
"gb" = (
/obj/structure/table,
/obj/item/plant_analyzer,
/obj/structure/cable{
	icon_state = "0-2"
	},
/turf/open/floor/plasteel,
/area/ruin/powered)
"ge" = (
/obj/structure/spacevine/dense,
/obj/machinery/smartfridge/drying_rack,
/turf/open/floor/plasteel,
/area/ruin/powered)
"hl" = (
/obj/structure/cable{
	icon_state = "1-2"
	},
/obj/machinery/door/airlock/command,
/obj/effect/turf_decal/industrial/warning,
/obj/effect/turf_decal/industrial/warning{
	dir = 1
	},
/turf/open/floor/plasteel,
/area/ruin/powered)
"hL" = (
/obj/item/reagent_containers/food/drinks/bottle/hooch,
/turf/open/floor/plasteel,
/area/ruin/powered)
"ii" = (
/obj/structure/closet/secure_closet/hydroponics,
/obj/effect/turf_decal/box,
/turf/open/floor/plasteel,
/area/ruin/powered)
"ik" = (
/obj/effect/decal/cleanable/blood/gibs/up,
/turf/open/floor/plasteel,
/area/ruin/powered)
"iG" = (
/obj/machinery/vending/cigarette,
/obj/effect/turf_decal/box,
/turf/open/floor/plasteel,
/area/ruin/powered)
"jc" = (
/obj/machinery/seed_extractor,
/turf/open/floor/plasteel,
/area/ruin/powered)
"jf" = (
/obj/structure/closet/crate/large,
/obj/item/circuitboard/machine/biogenerator,
/obj/item/reagent_containers/spray/pestspray,
/obj/item/reagent_containers/spray/pestspray,
/obj/item/reagent_containers/spray/weedspray,
/obj/item/reagent_containers/spray/weedspray,
/turf/open/floor/plasteel,
/area/ruin/powered)
"ji" = (
/obj/item/seeds/tomato/killer,
/obj/item/seeds/kudzu,
/obj/item/seeds/cannabis,
/obj/item/seeds/random,
/obj/structure/closet/crate/secure/hydroponics,
/turf/open/floor/plasteel,
/area/ruin/powered)
"js" = (
/obj/structure/cable{
	icon_state = "1-2"
	},
/obj/effect/decal/cleanable/blood/tracks,
/obj/structure/spacevine,
/turf/open/floor/plasteel,
/area/ruin/powered)
"jK" = (
/obj/machinery/door/airlock/external{
	dir = 4
	},
/turf/open/floor/plasteel,
/area/ruin/powered)
"ke" = (
/obj/structure/cable{
	icon_state = "1-4"
	},
/obj/structure/cable{
	icon_state = "1-8"
	},
/turf/open/floor/plasteel,
/area/ruin/powered)
"kj" = (
/obj/machinery/vending/sovietsoda,
/obj/effect/turf_decal/box,
/turf/open/floor/plasteel,
/area/ruin/powered)
"lb" = (
/obj/machinery/power/smes,
/turf/open/floor/plasteel,
/area/ruin/powered)
"lK" = (
/obj/machinery/hydroponics/constructable,
/obj/structure/spacevine,
/obj/item/reagent_containers/food/snacks/grown/cherries,
/obj/item/reagent_containers/food/snacks/grown/cherries,
/turf/open/floor/plasteel,
/area/ruin/powered)
"mg" = (
/obj/structure/cable{
	icon_state = "1-2"
	},
/obj/machinery/door/airlock/glass,
/obj/effect/turf_decal/industrial/warning,
/obj/effect/turf_decal/industrial/warning{
	dir = 1
	},
/turf/open/floor/plasteel,
/area/ruin/powered)
"mB" = (
/obj/machinery/door/airlock/external{
	dir = 8
	},
/turf/open/floor/plasteel,
/area/ruin/powered)
"mN" = (
/obj/structure/spacevine/dense,
/obj/item/reagent_containers/food/snacks/grown/carrot,
/turf/open/floor/plasteel,
/area/ruin/powered)
"nl" = (
/obj/structure/cable{
	icon_state = "4-8"
	},
/obj/effect/decal/cleanable/xenoblood/xgibs,
/turf/open/floor/plasteel,
/area/ruin/powered)
"nJ" = (
/obj/structure/flora/ausbushes/sparsegrass,
/obj/structure/spacevine,
/turf/open/floor/plating/grass/jungle/lit,
/area/overmap_encounter/planetoid/jungle/explored)
"nS" = (
/obj/structure/cable{
	icon_state = "1-4"
	},
/obj/effect/decal/cleanable/blood/tracks,
/turf/open/floor/plasteel,
/area/ruin/powered)
"oc" = (
/obj/machinery/door/airlock/glass{
	dir = 4
	},
/obj/effect/turf_decal/industrial/warning{
	dir = 4
	},
/obj/effect/turf_decal/industrial/warning{
	dir = 8
	},
/turf/open/floor/plasteel,
/area/ruin/powered)
"om" = (
/obj/effect/decal/cleanable/blood,
/obj/effect/decal/cleanable/blood/tracks{
	dir = 10
	},
/obj/effect/mob_spawn/human/corpse/cargo_tech,
/obj/item/clothing/mask/cigarette/rollie/trippy{
	pixel_x = 7;
	pixel_y = 15
	},
/turf/open/floor/plasteel,
/area/ruin/powered)
"oR" = (
/obj/structure/table,
/obj/item/storage/fancy/cigarettes/cigpack_robust,
/turf/open/floor/plasteel,
/area/ruin/powered)
"pt" = (
/obj/structure/cable{
	icon_state = "0-2"
	},
/obj/structure/glowshroom/single,
/turf/open/floor/plasteel,
/area/ruin/powered)
"pO" = (
/obj/machinery/hydroponics/constructable,
/obj/item/reagent_containers/food/snacks/grown/ambrosia,
/turf/open/floor/plasteel,
/area/ruin/powered)
"qM" = (
/obj/structure/sign/poster/contraband/ambrosia_vulgaris,
/turf/closed/wall,
/area/ruin/powered)
"ru" = (
/obj/structure/cable{
	icon_state = "2-4"
	},
/obj/structure/cable{
	icon_state = "4-8"
	},
/obj/structure/spacevine,
/turf/open/floor/plasteel,
/area/ruin/powered)
"sv" = (
/obj/machinery/hydroponics/constructable,
/obj/item/reagent_containers/food/snacks/grown/garlic{
	pixel_y = -3
	},
/turf/open/floor/plasteel,
/area/ruin/powered)
"uC" = (
/obj/structure/cable{
	icon_state = "4-8"
	},
/obj/effect/decal/cleanable/blood/footprints{
	dir = 4;
	pixel_y = 11
	},
/turf/open/floor/plasteel,
/area/ruin/powered)
"uK" = (
/obj/structure/flora/ausbushes/sparsegrass,
/obj/structure/flora/grass/jungle,
/turf/open/floor/plating/grass/jungle/lit,
/area/overmap_encounter/planetoid/jungle/explored)
"uM" = (
/obj/structure/cable{
	icon_state = "1-2"
	},
/obj/structure/cable{
	icon_state = "1-8"
	},
/turf/open/floor/plasteel,
/area/ruin/powered)
"wl" = (
/obj/structure/table,
/obj/item/screwdriver/power{
	pixel_y = 6
	},
/obj/item/storage/belt/utility,
/turf/open/floor/plasteel,
/area/ruin/powered)
"wD" = (
/obj/structure/sign/poster/contraband/kudzu{
	pixel_x = 3
	},
/turf/closed/wall,
/area/ruin/powered)
"wP" = (
/obj/structure/closet/crate/medical,
/obj/item/stack/medical/ointment/herb,
/obj/item/stack/medical/suture/medicated,
/obj/item/stack/medical/suture/medicated,
/obj/item/stack/medical/ointment/herb,
/obj/item/gun/syringe,
/obj/item/reagent_containers/syringe/piercing,
/obj/item/reagent_containers/syringe/piercing,
/obj/item/reagent_containers/syringe/piercing,
/turf/open/floor/plasteel,
/area/ruin/powered)
"wU" = (
/obj/structure/flora/ausbushes/grassybush,
/turf/open/floor/plating/grass/jungle/lit,
/area/overmap_encounter/planetoid/jungle/explored)
"yr" = (
/obj/structure/cable{
	icon_state = "4-8"
	},
/obj/structure/spacevine,
/turf/open/floor/plasteel,
/area/ruin/powered)
"yt" = (
/obj/structure/cable{
	icon_state = "4-8"
	},
/obj/machinery/door/airlock{
	dir = 4
	},
/obj/effect/turf_decal/industrial/warning{
	dir = 8
	},
/obj/effect/turf_decal/industrial/warning{
	dir = 4
	},
/turf/open/floor/plasteel,
/area/ruin/powered)
"yR" = (
/obj/machinery/hydroponics/constructable,
/obj/effect/decal/cleanable/xenoblood,
/obj/item/reagent_containers/food/snacks/grown/berries,
/turf/open/floor/plasteel,
/area/ruin/powered)
"yS" = (
/obj/structure/table,
/obj/item/storage/toolbox/mechanical{
	pixel_y = 6
	},
/obj/item/storage/toolbox/electrical,
/obj/item/storage/fancy/rollingpapers,
/turf/open/floor/plasteel,
/area/ruin/powered)
"zm" = (
/obj/structure/flora/grass/jungle,
/obj/structure/spacevine,
/turf/open/floor/plating/grass/jungle/lit,
/area/overmap_encounter/planetoid/jungle/explored)
"Aq" = (
/obj/structure/table,
/obj/item/paper_bin,
/obj/item/pen,
/obj/item/folder,
/obj/item/stamp,
/turf/open/floor/plasteel,
/area/ruin/powered)
"AD" = (
/obj/structure/bed,
/obj/item/bedsheet/black,
/turf/open/floor/plasteel,
/area/ruin/powered)
"Cj" = (
/obj/structure/cable{
	icon_state = "1-8"
	},
/turf/open/floor/plasteel,
/area/ruin/powered)
"DL" = (
/obj/machinery/power/port_gen/pacman,
/obj/structure/cable{
	icon_state = "0-2"
	},
/turf/open/floor/plasteel,
/area/ruin/powered)
"DS" = (
/obj/structure/closet/crate/bin,
/turf/open/floor/plasteel,
/area/ruin/powered)
"EJ" = (
/obj/structure/cable{
	icon_state = "0-8"
	},
/obj/effect/decal/cleanable/blood/footprints{
	dir = 4;
	pixel_y = 7
	},
/mob/living/simple_animal/hostile/killertomato,
/turf/open/floor/plasteel,
/area/ruin/powered)
"FF" = (
/obj/effect/decal/cleanable/xenoblood,
/turf/open/floor/plasteel,
/area/ruin/powered)
"FG" = (
/obj/machinery/door/airlock{
	dir = 4
	},
/obj/effect/turf_decal/industrial/warning{
	dir = 4
	},
/obj/effect/turf_decal/industrial/warning{
	dir = 8
	},
/turf/open/floor/plasteel,
/area/ruin/powered)
"FR" = (
/obj/structure/glowshroom/single,
/turf/open/floor/plasteel,
/area/ruin/powered)
"FZ" = (
/obj/structure/cable{
	icon_state = "4-8"
	},
/obj/structure/spacevine/dense,
/turf/open/floor/plasteel,
/area/ruin/powered)
"Gq" = (
/obj/structure/table,
/obj/item/book/manual/hydroponics_pod_people,
/turf/open/floor/plasteel,
/area/ruin/powered)
"Gx" = (
/obj/structure/cable{
	icon_state = "1-4"
	},
/obj/effect/decal/cleanable/blood/tracks{
	dir = 8
	},
/mob/living/simple_animal/hostile/killertomato,
/turf/open/floor/plasteel,
/area/ruin/powered)
"GW" = (
/obj/effect/decal/cleanable/blood/footprints{
	dir = 4;
	pixel_y = 11
	},
/turf/open/floor/plasteel,
/area/ruin/powered)
"Hm" = (
/obj/structure/chair/greyscale{
	dir = 8
	},
/obj/effect/decal/cleanable/blood/gibs/old,
/turf/open/floor/plasteel,
/area/ruin/powered)
"HQ" = (
/obj/structure/flora/ausbushes/sparsegrass,
/turf/open/floor/plating/grass/jungle/lit,
/area/overmap_encounter/planetoid/jungle/explored)
"Ia" = (
/obj/machinery/hydroponics/constructable,
/obj/structure/spacevine,
/obj/item/reagent_containers/food/snacks/grown/ambrosia,
/turf/open/floor/plasteel,
/area/ruin/powered)
"Ie" = (
/obj/structure/table,
/obj/machinery/plantgenes,
/turf/open/floor/plasteel,
/area/ruin/powered)
"Ig" = (
/obj/structure/table,
/obj/item/clothing/glasses/meson,
/turf/open/floor/plasteel,
/area/ruin/powered)
"IG" = (
/obj/structure/closet/crate/large,
/obj/item/inducer,
/obj/item/circuitboard/machine/smes,
/obj/item/stock_parts/cell/potato,
/obj/item/stock_parts/cell/potato,
/obj/item/stock_parts/cell/potato,
/turf/open/floor/plasteel,
/area/ruin/powered)
"JU" = (
/obj/structure/cable{
	icon_state = "2-4"
	},
/turf/open/floor/plasteel,
/area/ruin/powered)
"Ke" = (
/obj/structure/sign/departments/botany,
/turf/closed/wall,
/area/ruin/powered)
"Kn" = (
/obj/structure/sign/departments/botany,
/turf/closed/wall/r_wall,
/area/ruin/powered)
"Kt" = (
/obj/structure/chair/greyscale{
	dir = 4
	},
/turf/open/floor/plasteel,
/area/ruin/powered)
"LW" = (
/obj/structure/cable{
	icon_state = "4-8"
	},
/obj/item/reagent_containers/food/snacks/grown/berries,
/obj/structure/glowshroom/single,
/turf/open/floor/plasteel,
/area/ruin/powered)
"Mq" = (
/obj/machinery/suit_storage_unit/standard_unit,
/obj/effect/turf_decal/industrial/warning/corner,
/obj/effect/turf_decal/industrial/warning/corner{
	dir = 8
	},
/turf/open/floor/plasteel/tech/techmaint,
/area/ruin/powered)
"Nk" = (
/obj/structure/table,
/obj/item/reagent_containers/food/snacks/salad/jungle{
	pixel_y = 7
	},
/turf/open/floor/plasteel,
/area/ruin/powered)
"Nn" = (
/obj/item/spear,
/turf/open/floor/plasteel,
/area/ruin/powered)
"Np" = (
/obj/structure/girder/reinforced,
/turf/open/floor/plating,
/area/ruin/powered)
"NE" = (
/obj/structure/grille/broken,
/obj/structure/spacevine,
/turf/open/floor/plating,
/area/overmap_encounter/planetoid/jungle/explored)
"OT" = (
/obj/machinery/door/airlock,
/obj/effect/decal/cleanable/blood/footprints,
/obj/effect/turf_decal/industrial/warning,
/obj/effect/turf_decal/industrial/warning{
	dir = 1
	},
/turf/open/floor/plasteel,
/area/ruin/powered)
"OX" = (
/turf/open/floor/plasteel,
/area/ruin/powered)
"Pm" = (
/obj/structure/sign/departments/engineering,
/turf/closed/wall/r_wall,
/area/ruin/powered)
"Pp" = (
/obj/structure/grille/broken,
/obj/structure/spacevine,
/turf/open/floor/plating,
/area/ruin/powered)
"Pq" = (
/obj/effect/decal/cleanable/xenoblood,
/obj/structure/spacevine/dense,
/turf/open/floor/plasteel,
/area/ruin/powered)
"Pz" = (
/obj/effect/turf_decal/industrial/warning{
	dir = 8
	},
/obj/effect/turf_decal/industrial/warning{
	dir = 4
	},
/turf/open/floor/plasteel,
/area/ruin/powered)
"Qa" = (
/obj/structure/spacevine/dense,
/turf/open/floor/plasteel,
/area/ruin/powered)
"Qc" = (
/obj/effect/spawner/structure/window/hollow/reinforced,
/turf/open/floor/plasteel,
/area/ruin/powered)
"Qg" = (
/obj/structure/cable{
	icon_state = "1-4"
	},
/obj/structure/spacevine,
/obj/item/reagent_containers/food/snacks/grown/banana,
/turf/open/floor/plasteel,
/area/ruin/powered)
"Qu" = (
/obj/structure/door_assembly/door_assembly_com{
	dir = 4
	},
/obj/effect/turf_decal/industrial/warning{
	dir = 8
	},
/obj/effect/turf_decal/industrial/warning{
	dir = 4
	},
/turf/open/floor/plasteel,
/area/ruin/powered)
"QJ" = (
/obj/structure/cable{
	icon_state = "4-8"
	},
/obj/machinery/door/airlock/engineering{
	locked = 1;
	dir = 4
	},
/turf/open/floor/plasteel,
/area/ruin/powered)
"Rj" = (
/obj/structure/closet/crate{
	icon_state = "crateopen"
	},
/obj/item/stack/sheet/mineral/plasma/twenty,
/turf/open/floor/plasteel,
/area/ruin/powered)
"Se" = (
/obj/structure/closet/secure_closet/personal,
/turf/open/floor/plasteel,
/area/ruin/powered)
"Sh" = (
/obj/structure/flora/grass/jungle,
/turf/open/floor/plating/grass/jungle/lit,
/area/overmap_encounter/planetoid/jungle/explored)
"Ss" = (
/obj/machinery/power/terminal{
	dir = 1
	},
/obj/structure/cable{
	icon_state = "0-4"
	},
/obj/structure/cable{
	icon_state = "0-8"
	},
/turf/open/floor/plasteel,
/area/ruin/powered)
"SB" = (
/obj/machinery/vending/hydronutrients,
/obj/structure/cable{
	icon_state = "0-2"
	},
/turf/open/floor/plasteel,
/area/ruin/powered)
"SQ" = (
/obj/structure/cable{
	icon_state = "4-8"
	},
/obj/structure/sign/poster/contraband/kudzu{
	pixel_x = 2
	},
/turf/closed/wall,
/area/ruin/powered)
"Ti" = (
/obj/machinery/door/airlock,
/obj/effect/turf_decal/industrial/warning,
/obj/effect/turf_decal/industrial/warning{
	dir = 1
	},
/turf/open/floor/plasteel,
/area/ruin/powered)
"TO" = (
/obj/structure/salvageable/seed,
/obj/effect/turf_decal/box,
/turf/open/floor/plasteel,
/area/ruin/powered)
"TV" = (
/obj/structure/spacevine,
/turf/open/floor/plasteel,
/area/ruin/powered)
"Uo" = (
/obj/structure/table,
/obj/structure/cable{
	icon_state = "0-2"
	},
/obj/item/reagent_containers/food/snacks/salad/fruit{
	pixel_y = 8
	},
/turf/open/floor/plasteel,
/area/ruin/powered)
"Vn" = (
/obj/structure/table,
/obj/item/clipboard,
/turf/open/floor/plasteel,
/area/ruin/powered)
"VH" = (
/obj/structure/cable{
	icon_state = "1-2"
	},
/turf/open/floor/plasteel,
/area/ruin/powered)
"Wo" = (
/obj/structure/sign/poster/contraband/donut_corp,
/turf/closed/wall,
/area/ruin/powered)
"WE" = (
/obj/structure/cable{
	icon_state = "4-8"
	},
/turf/open/floor/plasteel,
/area/ruin/powered)
"Xg" = (
/obj/structure/cable{
	icon_state = "1-2"
	},
/obj/structure/spacevine,
/obj/item/reagent_containers/food/snacks/grown/banana,
/mob/living/simple_animal/hostile/venus_human_trap,
/turf/open/floor/plasteel,
/area/ruin/powered)
"Yc" = (
/obj/effect/decal/cleanable/blood,
/turf/open/floor/plasteel,
/area/ruin/powered)
"YN" = (
/obj/structure/table,
/obj/item/toy/cards/deck/tarot{
	pixel_x = -8
	},
/obj/item/reagent_containers/food/snacks/salad/herbsalad{
	pixel_x = 8;
	pixel_y = 12
	},
/turf/open/floor/plasteel,
/area/ruin/powered)
"Zq" = (
/obj/machinery/suit_storage_unit/standard_unit,
/obj/effect/turf_decal/industrial/warning/corner{
	dir = 1
	},
/obj/effect/turf_decal/industrial/warning/corner{
	dir = 4
	},
/turf/open/floor/plasteel/tech/techmaint,
/area/ruin/powered)
"ZO" = (
/obj/structure/bed,
/obj/item/bedsheet/green,
/turf/open/floor/plasteel,
/area/ruin/powered)
"ZU" = (
/turf/closed/wall,
/area/ruin/powered)

(1,1,1) = {"
ZU
Ke
jK
jK
Ke
ZU
Qc
ZU
Qc
Qc
wU
Sh
"}
(2,1,1) = {"
Np
Mq
Pz
Pz
Zq
ZU
aM
Vn
Aq
Qc
NE
nJ
"}
(3,1,1) = {"
ZU
ZU
mB
mB
wD
ZU
OX
fM
TV
Pq
NE
NE
"}
(4,1,1) = {"
ZU
yS
JU
VH
VH
hl
js
nS
om
TV
TV
Qc
"}
(5,1,1) = {"
ZU
gb
Cj
Yc
TO
ZU
pt
uM
Gx
Qa
jf
ZU
"}
(6,1,1) = {"
ZU
Gq
FR
OX
ii
Np
DS
ik
WE
Yc
wP
Qc
"}
(7,1,1) = {"
ZU
ZU
Kn
oc
ZU
Np
ZU
ZU
SQ
Qu
ZU
ZU
"}
(8,1,1) = {"
ZU
qM
ji
OX
FR
pO
ZU
iG
WE
fR
Kt
ZU
"}
(9,1,1) = {"
Sh
ZU
SB
Qg
Yc
yR
Np
kj
nl
OX
YN
ZU
"}
(10,1,1) = {"
nJ
Qc
lK
ru
Xg
VH
mg
VH
ke
OX
Hm
ZU
"}
(11,1,1) = {"
nJ
Pp
Ia
FZ
TV
sv
ZU
Uo
ke
FF
aP
ZU
"}
(12,1,1) = {"
zm
Qc
ge
LW
mN
Ia
ZU
Nk
WE
DS
ZU
ZU
"}
(13,1,1) = {"
Sh
ZU
jc
yr
Ie
ZU
ZU
ZU
yt
ZU
ZU
HQ
"}
(14,1,1) = {"
wU
ZU
Pm
QJ
ZU
ZU
AD
Ti
uC
Se
Qc
Sh
"}
(15,1,1) = {"
HQ
ZU
wl
WE
IG
ZU
ZU
ZU
EJ
Se
ZU
uK
"}
(16,1,1) = {"
Sh
Np
Ig
WE
dJ
ZU
ZO
OT
GW
eQ
Qc
Sh
"}
(17,1,1) = {"
Sh
Np
Rj
WE
OX
ZU
ZU
ZU
FG
ZU
ZU
wU
"}
(18,1,1) = {"
Sh
ZU
lb
Ss
OX
Wo
ez
Nn
cI
Qc
Sh
HQ
"}
(19,1,1) = {"
HQ
ZU
DL
Cj
OX
ZU
oR
OX
hL
Qc
HQ
Sh
"}
(20,1,1) = {"
Sh
ZU
ZU
ZU
ZU
ZU
ZU
Qc
Qc
ZU
Sh
Sh
"}
