//MAP CONVERTED BY dmm2tgm.py THIS HEADER COMMENT PREVENTS RECONVERSION, DO NOT REMOVE
"aH" = (
/obj/structure/alien/weeds,
/obj/structure/table/wood/fancy,
/obj/machinery/chem_dispenser/drinks/beer{
	dir = 8
	},
/turf/open/floor/plating/dirt,
/area/overmap_encounter/planetoid/cave/explored)
"aW" = (
/obj/structure/alien/weeds,
/obj/structure/bed/nest,
/obj/item/storage/bag/books,
/turf/open/floor/plating/dirt,
/area/overmap_encounter/planetoid/cave/explored)
"bB" = (
/obj/structure/alien/weeds,
/obj/structure/mecha_wreckage/seraph,
/turf/open/floor/plating/dirt,
/area/overmap_encounter/planetoid/cave/explored)
"ce" = (
/obj/structure/alien/weeds,
/obj/effect/mob_spawn/human/corpse/cargo_tech,
/obj/effect/decal/cleanable/blood/old,
/turf/open/floor/plating/dirt,
/area/overmap_encounter/planetoid/cave/explored)
"cj" = (
/obj/structure/alien/weeds,
/obj/item/clothing/head/crown,
/turf/open/floor/plating/dirt,
/area/overmap_encounter/planetoid/cave/explored)
"cO" = (
/obj/structure/alien/weeds,
/obj/structure/barricade/wooden,
/turf/open/floor/plating/dirt,
/area/overmap_encounter/planetoid/cave/explored)
"dj" = (
/obj/structure/alien/weeds,
/obj/structure/alien/weeds/node,
/obj/effect/decal/cleanable/blood/old,
/turf/open/floor/plating/dirt,
/area/overmap_encounter/planetoid/cave/explored)
"eA" = (
/obj/structure/flora/ausbushes/pointybush,
/turf/open/floor/plating/dirt/jungle,
/area/overmap_encounter/planetoid/jungle/explored)
"eB" = (
/obj/structure/flora/ausbushes/reedbush,
/turf/open/floor/plating/dirt/jungle,
/area/overmap_encounter/planetoid/jungle/explored)
"eG" = (
/obj/structure/alien/weeds,
/obj/structure/bed/nest,
/turf/open/floor/plating/dirt,
/area/overmap_encounter/planetoid/cave/explored)
"fj" = (
/obj/structure/alien/weeds,
/obj/structure/mecha_wreckage/ripley,
/turf/open/floor/plating/dirt,
/area/overmap_encounter/planetoid/cave/explored)
"fZ" = (
/obj/structure/flora/ausbushes/grassybush,
/turf/open/floor/plating/dirt/jungle,
/area/overmap_encounter/planetoid/jungle/explored)
"gU" = (
/obj/structure/alien/weeds,
/obj/effect/decal/remains/xeno,
/turf/open/floor/plating/dirt,
/area/overmap_encounter/planetoid/cave/explored)
"hu" = (
/obj/structure/alien/weeds,
/obj/structure/alien/weeds/node,
/obj/machinery/vending/boozeomat,
/turf/open/floor/plating/dirt,
/area/overmap_encounter/planetoid/cave/explored)
"ia" = (
/obj/structure/alien/weeds,
/turf/open/floor/plating/dirt,
/area/overmap_encounter/planetoid/cave/explored)
"iF" = (
/turf/closed/mineral/random/jungle,
/area/overmap_encounter/planetoid/cave/explored)
"jI" = (
/obj/structure/alien/resin/wall,
/turf/closed/mineral/random/jungle,
/area/overmap_encounter/planetoid/cave/explored)
"kd" = (
/obj/structure/alien/resin/membrane,
/obj/structure/alien/weeds,
/turf/open/floor/plating/dirt,
/area/overmap_encounter/planetoid/cave/explored)
"lh" = (
/obj/structure/alien/weeds,
/obj/structure/sink/oil_well,
/turf/open/floor/plating/dirt,
/area/overmap_encounter/planetoid/cave/explored)
"lS" = (
/obj/structure/alien/weeds,
/obj/structure/bed/nest,
/obj/item/clothing/glasses/night,
/turf/open/floor/plating/dirt,
/area/overmap_encounter/planetoid/cave/explored)
"mW" = (
/obj/structure/alien/weeds,
/obj/effect/decal/cleanable/xenoblood/xgibs/larva/body,
/turf/open/floor/plating/dirt,
/area/overmap_encounter/planetoid/cave/explored)
"nn" = (
/obj/structure/barricade/wooden,
/turf/open/floor/plating/dirt,
/area/overmap_encounter/planetoid/cave/explored)
"oB" = (
/obj/effect/decal/cleanable/xenoblood/xgibs/larva/body,
/turf/open/floor/plating/dirt/jungle,
/area/overmap_encounter/planetoid/jungle/explored)
"oX" = (
/obj/structure/alien/weeds,
/obj/structure/alien/egg,
/obj/item/toy/toy_xeno,
/turf/open/floor/plating/dirt,
/area/overmap_encounter/planetoid/cave/explored)
"qK" = (
/obj/structure/flora/junglebush,
/turf/open/floor/plating/dirt/jungle,
/area/overmap_encounter/planetoid/jungle/explored)
"rY" = (
/obj/structure/alien/weeds,
/obj/structure/table/wood/fancy,
/obj/item/reagent_containers/food/drinks/bottle/fernet,
/obj/item/reagent_containers/food/drinks/bottle/champagne,
/turf/open/floor/plating/dirt,
/area/overmap_encounter/planetoid/cave/explored)
"sw" = (
/obj/structure/alien/resin/wall,
/turf/open/floor/plating/dirt/jungle,
/area/overmap_encounter/planetoid/cave/explored)
"tZ" = (
/obj/effect/decal/cleanable/xenoblood,
/turf/open/floor/plating/dirt/jungle,
/area/overmap_encounter/planetoid/jungle/explored)
"ul" = (
/obj/structure/alien/weeds,
/obj/structure/bed/nest,
/obj/item/storage/box/alienhandcuffs,
/turf/open/floor/plating/dirt,
/area/overmap_encounter/planetoid/cave/explored)
"uo" = (
/obj/structure/alien/weeds,
/obj/effect/mob_spawn/human/corpse/assistant,
/obj/structure/bed/nest,
/obj/effect/decal/cleanable/blood/old,
/turf/open/floor/plating/dirt,
/area/overmap_encounter/planetoid/cave/explored)
"uR" = (
/obj/effect/decal/cleanable/xenoblood/xgibs/up,
/turf/open/floor/plating/dirt/jungle,
/area/overmap_encounter/planetoid/jungle/explored)
"vg" = (
/obj/structure/alien/weeds,
/obj/structure/bed/nest,
/obj/item/clothing/under/costume/mech_suit/blue,
/turf/open/floor/plating/dirt,
/area/overmap_encounter/planetoid/cave/explored)
"vt" = (
/obj/structure/alien/resin/wall,
/turf/open/floor/plating/grass,
/area/overmap_encounter/planetoid/cave/explored)
"vW" = (
/obj/structure/alien/weeds,
/obj/structure/bed/nest,
/obj/item/mecha_parts/mecha_equipment/weapon/energy/plasma,
/turf/open/floor/plating/dirt,
/area/overmap_encounter/planetoid/cave/explored)
"wc" = (
/obj/structure/alien/weeds,
/obj/structure/alien/egg,
/turf/open/floor/plating/dirt,
/area/overmap_encounter/planetoid/cave/explored)
"wg" = (
/obj/structure/alien/weeds,
/obj/effect/decal/cleanable/blood/old,
/turf/open/floor/plating/dirt,
/area/overmap_encounter/planetoid/cave/explored)
"wl" = (
/obj/structure/alien/weeds,
/obj/effect/decal/cleanable/xenoblood/xgibs/torso,
/turf/open/floor/plating/dirt,
/area/overmap_encounter/planetoid/jungle/explored)
"wt" = (
/obj/structure/alien/weeds,
/obj/structure/alien/resin/wall,
/obj/structure/sign/poster/contraband/lusty_xenomorph,
/turf/open/floor/plating/grass,
/area/overmap_encounter/planetoid/cave/explored)
"xY" = (
/obj/structure/alien/weeds,
/obj/effect/mob_spawn/human/corpse/assistant,
/obj/structure/bed/nest,
/turf/open/floor/plating/dirt,
/area/overmap_encounter/planetoid/cave/explored)
"ya" = (
/obj/effect/decal/cleanable/xenoblood/xgibs/larva,
/turf/open/floor/plating/dirt/jungle,
/area/overmap_encounter/planetoid/jungle/explored)
"yF" = (
/obj/structure/alien/weeds,
/obj/structure/alien/resin/wall,
/turf/open/floor/plating/grass,
/area/overmap_encounter/planetoid/cave/explored)
"yG" = (
/obj/structure/alien/weeds,
/mob/living/simple_animal/hostile/alien/maid,
/turf/open/floor/plating/dirt,
/area/overmap_encounter/planetoid/cave/explored)
"yV" = (
/obj/structure/alien/resin/wall,
/obj/structure/alien/weeds,
/turf/closed/mineral/random/jungle,
/area/overmap_encounter/planetoid/cave/explored)
"zi" = (
/obj/structure/alien/resin/wall,
/obj/structure/alien/weeds,
/turf/open/floor/plating/dirt/jungle,
/area/overmap_encounter/planetoid/cave/explored)
"zv" = (
/obj/structure/alien/weeds,
/turf/open/floor/plating/dirt/jungle,
/area/overmap_encounter/planetoid/jungle/explored)
"zy" = (
/obj/structure/alien/resin/wall,
/obj/structure/alien/weeds,
/turf/open/floor/plating/grass,
/area/overmap_encounter/planetoid/cave/explored)
"zz" = (
/obj/structure/alien/weeds,
/obj/effect/decal/remains/xeno/larva,
/turf/open/floor/plating/dirt,
/area/overmap_encounter/planetoid/cave/explored)
"AC" = (
/obj/structure/alien/weeds,
/obj/structure/barricade/wooden/crude,
/turf/open/floor/plating/dirt,
/area/overmap_encounter/planetoid/cave/explored)
"AE" = (
/obj/structure/alien/weeds,
/obj/structure/bed/nest,
/obj/item/clothing/head/helmet/riot,
/obj/item/shield/riot,
/turf/open/floor/plating/dirt,
/area/overmap_encounter/planetoid/cave/explored)
"AI" = (
/obj/structure/alien/weeds,
/obj/structure/alien/weeds/node,
/turf/open/floor/plating/dirt,
/area/overmap_encounter/planetoid/cave/explored)
"Du" = (
/obj/structure/alien/weeds,
/obj/effect/mob_spawn/human/corpse/nanotrasensoldier,
/obj/structure/bed/nest,
/turf/open/floor/plating/dirt,
/area/overmap_encounter/planetoid/cave/explored)
"DP" = (
/obj/structure/alien/resin/wall,
/obj/structure/sign/poster/contraband/backdoor_xeno_babes_6,
/turf/open/floor/plating/grass,
/area/overmap_encounter/planetoid/cave/explored)
"Ee" = (
/obj/structure/alien/weeds,
/obj/structure/bed/nest,
/obj/item/kitchen/knife/combat/survival,
/turf/open/floor/plating/dirt,
/area/overmap_encounter/planetoid/cave/explored)
"EC" = (
/obj/structure/alien/weeds,
/obj/structure/bed/nest,
/obj/effect/spawner/lootdrop/maintenance/two,
/turf/open/floor/plating/dirt,
/area/overmap_encounter/planetoid/cave/explored)
"Fe" = (
/obj/structure/alien/weeds,
/obj/structure/bed/nest,
/obj/item/cartridge,
/obj/item/clothing/under/rank/civilian/curator,
/turf/open/floor/plating/dirt,
/area/overmap_encounter/planetoid/cave/explored)
"FA" = (
/obj/structure/alien/weeds,
/obj/structure/bed/nest,
/obj/item/clothing/head/helmet/space/eva,
/turf/open/floor/plating/dirt,
/area/overmap_encounter/planetoid/cave/explored)
"Gk" = (
/obj/structure/alien/weeds,
/mob/living/simple_animal/hostile/alien/sentinel,
/obj/effect/decal/cleanable/blood/old,
/turf/open/floor/plating/dirt,
/area/overmap_encounter/planetoid/cave/explored)
"Gt" = (
/obj/structure/alien/weeds,
/obj/structure/alien/resin/membrane,
/turf/open/floor/plating/dirt,
/area/overmap_encounter/planetoid/cave/explored)
"Hh" = (
/obj/structure/alien/weeds,
/mob/living/simple_animal/hostile/alien/drone,
/turf/open/floor/plating/dirt,
/area/overmap_encounter/planetoid/cave/explored)
"Hz" = (
/obj/structure/alien/weeds,
/obj/structure/alien/egg/burst,
/turf/open/floor/plating/dirt,
/area/overmap_encounter/planetoid/cave/explored)
"II" = (
/turf/open/floor/plating/dirt/jungle,
/area/overmap_encounter/planetoid/jungle/explored)
"KR" = (
/obj/structure/alien/weeds,
/obj/structure/table/wood/fancy,
/obj/machinery/dish_drive,
/turf/open/floor/plating/dirt,
/area/overmap_encounter/planetoid/cave/explored)
"Lg" = (
/obj/structure/alien/weeds,
/obj/structure/alien/resin/membrane,
/turf/open/floor/plating/grass,
/area/overmap_encounter/planetoid/cave/explored)
"Lh" = (
/obj/structure/alien/weeds,
/mob/living/simple_animal/hostile/alien/queen/large,
/turf/open/floor/plating/dirt,
/area/overmap_encounter/planetoid/cave/explored)
"MJ" = (
/obj/structure/alien/weeds,
/obj/effect/decal/remains/human,
/turf/open/floor/plating/dirt,
/area/overmap_encounter/planetoid/cave/explored)
"Ne" = (
/obj/structure/alien/weeds,
/obj/structure/alien/weeds/node,
/mob/living/simple_animal/hostile/alien,
/turf/open/floor/plating/dirt,
/area/overmap_encounter/planetoid/cave/explored)
"NK" = (
/obj/structure/alien/weeds,
/obj/item/bodypart/chest/larva,
/turf/open/floor/plating/dirt,
/area/overmap_encounter/planetoid/cave/explored)
"RG" = (
/obj/structure/alien/weeds,
/turf/closed/mineral/random/jungle,
/area/overmap_encounter/planetoid/cave/explored)
"TS" = (
/obj/structure/alien/weeds,
/obj/structure/bed/nest,
/obj/item/mecha_parts/mecha_equipment/drill/diamonddrill,
/turf/open/floor/plating/dirt,
/area/overmap_encounter/planetoid/cave/explored)
"TY" = (
/obj/structure/flora/junglebush/large,
/turf/open/floor/plating/dirt/jungle,
/area/overmap_encounter/planetoid/jungle/explored)
"UV" = (
/obj/structure/alien/weeds,
/turf/open/floor/plating/dirt,
/area/overmap_encounter/planetoid/jungle/explored)
"VK" = (
/obj/structure/flora/tree/jungle/small,
/turf/open/floor/plating/dirt/jungle,
/area/overmap_encounter/planetoid/jungle/explored)
"VT" = (
/obj/structure/alien/weeds,
/obj/structure/table/wood/fancy,
/obj/machinery/chem_dispenser/drinks{
	dir = 8
	},
/turf/open/floor/plating/dirt,
/area/overmap_encounter/planetoid/cave/explored)
"Wb" = (
/turf/template_noop,
/area/template_noop)
"Wj" = (
/obj/structure/flora/tree/jungle,
/turf/open/floor/plating/dirt/jungle,
/area/overmap_encounter/planetoid/jungle/explored)
"Yq" = (
/obj/structure/flora/ausbushes/stalkybush,
/turf/open/floor/plating/dirt/jungle,
/area/overmap_encounter/planetoid/jungle/explored)

(1,1,1) = {"
Wb
Wb
Wb
Wb
iF
iF
II
II
tZ
eB
Wb
Wb
Wb
Wb
Wb
"}
(2,1,1) = {"
Wb
Wb
iF
iF
iF
iF
RG
Yq
II
Wj
II
Wb
Wb
Wb
Wb
"}
(3,1,1) = {"
Wb
iF
jI
zi
zi
zi
vt
zv
zv
II
II
II
Wb
Wb
Wb
"}
(4,1,1) = {"
iF
jI
zy
Hz
zz
NK
zy
zy
zy
ya
TY
II
Wb
Wb
Wb
"}
(5,1,1) = {"
iF
vt
wc
ia
ia
ia
ia
vg
zy
zv
II
II
fZ
Wb
Wb
"}
(6,1,1) = {"
iF
vt
wc
AI
fj
ce
ia
ia
zy
zy
zy
zy
II
II
Wb
"}
(7,1,1) = {"
iF
sw
vt
ia
Lh
ia
yF
Gt
yF
lh
lS
zy
II
qK
Wb
"}
(8,1,1) = {"
iF
iF
vt
mW
ia
ia
yF
ia
yF
dj
Du
zy
eB
oB
Yq
"}
(9,1,1) = {"
iF
iF
vt
vt
cj
mW
yF
Hh
yF
Gk
AE
zy
UV
II
II
"}
(10,1,1) = {"
Wb
iF
iF
vt
oX
yF
yF
ia
yF
ia
zy
vt
UV
VK
II
"}
(11,1,1) = {"
Wb
iF
iF
vt
yF
yF
EC
ia
yF
Gt
zy
cO
UV
UV
TY
"}
(12,1,1) = {"
Wb
iF
iF
vt
ia
gU
AI
ia
ia
ia
kd
AC
wl
UV
II
"}
(13,1,1) = {"
Wb
iF
sw
zy
Gt
yF
yF
yF
yF
yF
zy
nn
UV
UV
eA
"}
(14,1,1) = {"
Wb
iF
vt
uo
ia
ia
ia
ia
bB
vW
zy
zy
zy
zy
uR
"}
(15,1,1) = {"
Wb
iF
DP
FA
ia
Hh
ia
wg
xY
yF
yF
Fe
aW
zy
Yq
"}
(16,1,1) = {"
Wb
iF
sw
Ee
ia
AI
ia
ia
TS
yF
ia
Ne
eG
zy
iF
"}
(17,1,1) = {"
Wb
iF
jI
vt
yF
Lg
yF
yF
yF
yF
ia
MJ
ul
yV
iF
"}
(18,1,1) = {"
Wb
Wb
iF
jI
vt
ia
ia
ia
ia
ia
ia
zy
vt
jI
iF
"}
(19,1,1) = {"
Wb
Wb
Wb
iF
jI
vt
vt
Gt
yF
wt
yF
zy
iF
iF
Wb
"}
(20,1,1) = {"
Wb
Wb
Wb
Wb
iF
iF
vt
ia
ia
ia
KR
zy
iF
Wb
Wb
"}
(21,1,1) = {"
Wb
Wb
Wb
Wb
Wb
Wb
jI
vt
hu
yG
rY
yV
iF
Wb
Wb
"}
(22,1,1) = {"
Wb
Wb
Wb
Wb
Wb
Wb
Wb
jI
vt
VT
aH
yV
Wb
Wb
Wb
"}
(23,1,1) = {"
Wb
Wb
Wb
Wb
Wb
Wb
Wb
iF
sw
vt
jI
jI
Wb
Wb
Wb
"}
(24,1,1) = {"
Wb
Wb
Wb
Wb
Wb
Wb
Wb
Wb
iF
iF
iF
Wb
Wb
Wb
Wb
"}
(25,1,1) = {"
Wb
Wb
Wb
Wb
Wb
Wb
Wb
Wb
Wb
Wb
Wb
Wb
Wb
Wb
Wb
"}
