//MAP CONVERTED BY dmm2tgm.py THIS HEADER COMMENT PREVENTS RECONVERSION, DO NOT REMOVE
"a" = (
/turf/template_noop,
/area/template_noop)
"c" = (
/obj/structure/flora/tree/jungle,
/turf/open/floor/plating/dirt/jungle/lit,
/area/overmap_encounter/planetoid/jungle/explored)
"e" = (
/obj/structure/spider/stickyweb,
/obj/item/reagent_containers/food/snacks/spidereggs,
/turf/open/floor/plating/dirt/jungle/lit,
/area/overmap_encounter/planetoid/jungle/explored)
"f" = (
/obj/structure/spider/stickyweb,
/turf/open/floor/plating/dirt/jungle/lit,
/area/overmap_encounter/planetoid/jungle/explored)
"g" = (
/obj/structure/spider/stickyweb,
/obj/machinery/door/airlock/research,
/turf/open/floor/plating/dirt/jungle/dark/lit,
/area/overmap_encounter/planetoid/jungle/explored)
"i" = (
/obj/effect/decal/cleanable/dirt/dust,
/turf/open/floor/plating/dirt/jungle/lit,
/area/overmap_encounter/planetoid/jungle/explored)
"j" = (
/obj/effect/decal/cleanable/glass,
/obj/structure/barricade/wooden,
/obj/structure/grille/broken,
/obj/effect/decal/cleanable/dirt/dust,
/turf/open/floor/plating,
/area/overmap_encounter/planetoid/jungle/explored)
"k" = (
/obj/effect/decal/remains/human,
/obj/item/clothing/head/helmet/swat/nanotrasen,
/obj/effect/decal/cleanable/blood,
/turf/open/floor/plating,
/area/overmap_encounter/planetoid/jungle/explored)
"l" = (
/obj/structure/spider/spiderling,
/turf/open/floor/plating/dirt/jungle/dark/lit,
/area/overmap_encounter/planetoid/jungle/explored)
"m" = (
/mob/living/simple_animal/hostile/poison/giant_spider/nurse,
/turf/open/floor/plating/dirt/jungle/lit,
/area/overmap_encounter/planetoid/jungle/explored)
"o" = (
/obj/structure/spider/stickyweb,
/turf/open/floor/plating/dirt/jungle/dark/lit,
/area/overmap_encounter/planetoid/jungle/explored)
"q" = (
/obj/effect/decal/cleanable/glass,
/obj/structure/barricade/wooden,
/obj/structure/grille/broken,
/turf/open/floor/plating/dirt/jungle/lit,
/area/overmap_encounter/planetoid/jungle/explored)
"r" = (
/turf/open/floor/plating/dirt/jungle/lit,
/area/overmap_encounter/planetoid/jungle/explored)
"s" = (
/obj/item/paper/guides/jobs/medical/cloning,
/turf/open/floor/plating,
/area/overmap_encounter/planetoid/jungle/explored)
"t" = (
/obj/structure/spider/spiderling,
/turf/open/floor/plating/dirt/jungle/lit,
/area/overmap_encounter/planetoid/jungle/explored)
"u" = (
/obj/structure/spider/stickyweb,
/obj/effect/decal/cleanable/dirt/dust,
/turf/open/floor/plating/dirt/jungle/lit,
/area/overmap_encounter/planetoid/jungle/explored)
"v" = (
/obj/structure/spider/spiderling,
/obj/structure/spider/cocoon,
/obj/item/pda/geneticist,
/obj/effect/decal/cleanable/blood,
/obj/effect/decal/cleanable/dirt/dust,
/obj/item/circuitboard/machine/dnascanner,
/obj/item/circuitboard/computer/cloning,
/turf/open/floor/plating/dirt/jungle/lit,
/area/overmap_encounter/planetoid/jungle/explored)
"w" = (
/obj/machinery/clonepod,
/turf/open/floor/plating,
/area/overmap_encounter/planetoid/jungle/explored)
"x" = (
/obj/effect/decal/cleanable/insectguts,
/obj/machinery/door/airlock/research,
/turf/open/floor/plating,
/area/overmap_encounter/planetoid/jungle/explored)
"y" = (
/turf/open/floor/plating/dirt/jungle/dark/lit,
/area/overmap_encounter/planetoid/jungle/explored)
"A" = (
/obj/structure/closet/wardrobe/genetics_white,
/obj/item/storage/firstaid/toxin,
/turf/open/floor/plating,
/area/overmap_encounter/planetoid/jungle/explored)
"C" = (
/obj/item/storage/belt/security/webbing,
/turf/open/floor/plating/dirt/jungle/dark/lit,
/area/overmap_encounter/planetoid/jungle/explored)
"D" = (
/obj/effect/decal/cleanable/ash/large,
/turf/open/floor/plating,
/area/overmap_encounter/planetoid/jungle/explored)
"G" = (
/obj/structure/spider/spiderling,
/obj/structure/spider/cocoon,
/obj/item/research_notes/loot/medium,
/turf/open/floor/plating,
/area/overmap_encounter/planetoid/jungle/explored)
"I" = (
/obj/structure/spider/stickyweb,
/obj/item/organ/heart/gland/spiderman,
/obj/structure/closet/crate/freezer,
/obj/item/reagent_containers/food/snacks/spiderlollipop,
/obj/item/reagent_containers/food/snacks/spiderlollipop,
/obj/item/reagent_containers/food/snacks/spiderlollipop,
/turf/open/floor/plating,
/area/overmap_encounter/planetoid/jungle/explored)
"K" = (
/turf/closed/wall/rust,
/area/overmap_encounter/planetoid/jungle/explored)
"L" = (
/obj/effect/decal/cleanable/glass,
/obj/structure/barricade/wooden,
/obj/structure/grille/broken,
/obj/effect/decal/cleanable/dirt/dust,
/turf/open/floor/plating/dirt/jungle/lit,
/area/overmap_encounter/planetoid/jungle/explored)
"M" = (
/obj/structure/spider/spiderling,
/obj/effect/decal/cleanable/insectguts,
/turf/open/floor/plating/dirt/jungle/lit,
/area/overmap_encounter/planetoid/jungle/explored)
"N" = (
/obj/effect/decal/cleanable/cobweb/cobweb2,
/mob/living/simple_animal/hostile/poison/giant_spider/nurse,
/turf/open/floor/plating/dirt/jungle/dark/lit,
/area/overmap_encounter/planetoid/jungle/explored)
"O" = (
/obj/item/melee/flyswatter,
/obj/item/reagent_containers/spray/pestspray,
/turf/open/floor/plating/dirt/jungle/lit,
/area/overmap_encounter/planetoid/jungle/explored)
"P" = (
/obj/effect/decal/cleanable/glass,
/obj/structure/barricade/wooden,
/obj/structure/grille/broken,
/obj/structure/spider/stickyweb,
/turf/open/floor/plating,
/area/overmap_encounter/planetoid/jungle/explored)
"Q" = (
/obj/effect/decal/cleanable/glass,
/obj/structure/barricade/wooden,
/obj/structure/grille/broken,
/turf/open/floor/plating,
/area/overmap_encounter/planetoid/jungle/explored)
"T" = (
/obj/effect/decal/cleanable/dirt/dust,
/turf/open/floor/plating,
/area/overmap_encounter/planetoid/jungle/explored)
"U" = (
/obj/structure/spider/stickyweb,
/obj/effect/decal/cleanable/insectguts,
/turf/open/floor/plating/dirt/jungle/dark/lit,
/area/overmap_encounter/planetoid/jungle/explored)
"V" = (
/obj/effect/decal/cleanable/insectguts,
/turf/open/floor/plating/dirt/jungle/lit,
/area/overmap_encounter/planetoid/jungle/explored)
"W" = (
/obj/item/flamethrower,
/obj/item/tank/internals/plasma/full,
/obj/effect/decal/cleanable/dirt/dust,
/turf/open/floor/plating/dirt/jungle/dark/lit,
/area/overmap_encounter/planetoid/jungle/explored)
"X" = (
/obj/effect/decal/cleanable/cobweb,
/obj/structure/spider/stickyweb,
/mob/living/simple_animal/hostile/poison/giant_spider,
/obj/item/reagent_containers/food/snacks/spidereggs,
/obj/effect/decal/cleanable/dirt/dust,
/turf/open/floor/plating,
/area/overmap_encounter/planetoid/jungle/explored)

(1,1,1) = {"
K
K
K
P
K
K
M
r
a
"}
(2,1,1) = {"
K
X
e
f
v
L
o
i
c
"}
(3,1,1) = {"
K
I
u
m
A
K
f
o
f
"}
(4,1,1) = {"
K
U
l
W
w
g
o
f
t
"}
(5,1,1) = {"
P
f
C
k
s
x
O
y
V
"}
(6,1,1) = {"
q
N
T
D
G
j
i
r
a
"}
(7,1,1) = {"
K
K
Q
K
K
K
f
a
a
"}
