//MAP CONVERTED BY dmm2tgm.py THIS HEADER COMMENT PREVENTS RECONVERSION, DO NOT REMOVE
"ab" = (
/turf/open/space/basic,
/area/space)
"be" = (
/obj/machinery/power/smes/shuttle/precharged{
	dir = 1
	},
/obj/effect/turf_decal/techfloor,
/turf/open/floor/plasteel/telecomms_floor,
/area/space)
"cq" = (
/obj/effect/turf_decal/corner_steel_grid{
	dir = 6
	},
/turf/open/floor/plasteel/mono/dark,
/area/space)
"cv" = (
/turf/open/floor/engine/hull/interior,
/area/space)
"cN" = (
/obj/effect/turf_decal/corner_steel_grid{
	dir = 6
	},
/obj/effect/turf_decal/spline/fancy/opaque/blue{
	dir = 4
	},
/turf/open/floor/plasteel/mono/dark,
/area/space)
"dm" = (
/obj/machinery/chem_master,
/turf/open/floor/mineral/titanium,
/area/space)
"dn" = (
/obj/machinery/airalarm/directional/south,
/turf/open/space/basic,
/area/space)
"dQ" = (
/obj/machinery/atmospherics/components/unary/shuttle/fire_heater,
/obj/effect/turf_decal/techfloor{
	dir = 10
	},
/turf/open/floor/plasteel/telecomms_floor,
/area/space)
"ed" = (
/obj/structure/railing/thin,
/obj/structure/table/reinforced,
/obj/effect/turf_decal/techfloor{
	dir = 8
	},
/turf/open/floor/plasteel/telecomms_floor,
/area/space)
"fb" = (
/obj/effect/turf_decal/techfloor/corner{
	dir = 8
	},
/turf/open/floor/plasteel/tech,
/area/space)
"ff" = (
/obj/effect/turf_decal/borderfloor{
	dir = 5
	},
/turf/open/floor/plasteel,
/area/space)
"fJ" = (
/obj/effect/turf_decal/corner_steel_grid/full{
	dir = 1
	},
/obj/effect/turf_decal/spline/fancy/opaque/blue{
	dir = 5
	},
/turf/open/floor/plasteel/mono/dark,
/area/space)
"fT" = (
/obj/structure/grille,
/obj/structure/window/plasma/reinforced/plastitanium,
/turf/open/floor/engine/hull/interior,
/area/space)
"hd" = (
/obj/machinery/atmospherics/components/unary/vent_pump/high_volume/siphon/on{
	dir = 8
	},
/obj/effect/turf_decal/atmos/air,
/turf/open/floor/engine/air,
/area/space)
"hy" = (
/obj/machinery/smartfridge/chemistry{
	dir = 1
	},
/turf/open/floor/mineral/titanium,
/area/space)
"hV" = (
/obj/effect/turf_decal/spline/fancy/opaque/black,
/turf/open/floor/plasteel/patterned/cargo_one,
/area/space)
"ia" = (
/obj/machinery/power/terminal{
	dir = 1
	},
/obj/effect/turf_decal/techfloor{
	dir = 1
	},
/turf/open/floor/plasteel/tech,
/area/space)
"iM" = (
/obj/structure/chair/sofa/blue/left/directional/south,
/turf/open/space/basic,
/area/space)
"iS" = (
/obj/effect/turf_decal/corner_steel_grid/full{
	dir = 4
	},
/obj/effect/turf_decal/spline/fancy/opaque/blue{
	dir = 6
	},
/turf/open/floor/plasteel/mono/dark,
/area/space)
"jf" = (
/obj/machinery/computer/cryopod/directional/south,
/turf/open/floor/plasteel/stairs{
	icon = 'icons/obj/stairs.dmi';
	dir = 1
	},
/area/space)
"js" = (
/turf/open/floor/plasteel/showroomfloor,
/area/space)
"kr" = (
/obj/machinery/cryopod{
	dir = 8
	},
/obj/machinery/light/small/directional/south,
/turf/open/floor/pod/dark,
/area/space)
"ml" = (
/obj/effect/turf_decal/spline/fancy/opaque/black{
	dir = 10
	},
/turf/open/floor/plasteel/patterned/cargo_one,
/area/space)
"ne" = (
/obj/machinery/power/smes/shuttle/precharged{
	dir = 2
	},
/obj/effect/turf_decal/techfloor{
	dir = 1
	},
/turf/open/floor/plasteel/telecomms_floor,
/area/space)
"nl" = (
/obj/effect/turf_decal/techfloor/orange,
/obj/effect/turf_decal/techfloor/orange{
	dir = 1
	},
/turf/open/floor/plasteel/tech/grid,
/area/space)
"nq" = (
/obj/structure/railing/thin,
/obj/structure/noticeboard{
	pixel_y = 25
	},
/obj/effect/turf_decal/techfloor{
	dir = 4
	},
/turf/open/floor/plasteel/telecomms_floor,
/area/space)
"ov" = (
/obj/item/radio/intercom/wideband/directional/north,
/obj/effect/turf_decal/techfloor{
	dir = 1
	},
/obj/machinery/computer/cargo,
/turf/open/floor/plasteel/telecomms_floor,
/area/space)
"pv" = (
/obj/effect/turf_decal/techfloor,
/obj/machinery/modular_computer/console/preset/command{
	dir = 1;
	icon_state = "computer-middle"
	},
/turf/open/floor/plasteel/telecomms_floor,
/area/space)
"pG" = (
/obj/structure/guncloset,
/obj/item/gun/energy/kalix/pistol,
/obj/item/gun/energy/kalix/pistol,
/turf/open/space/basic,
/area/space)
"rx" = (
/obj/machinery/power/generator,
/turf/open/space/basic,
/area/space)
"rY" = (
/obj/structure/table/reinforced,
/obj/machinery/recharger{
	pixel_x = 6;
	pixel_y = 1
	},
/obj/item/stock_parts/cell/gun/kalix{
	pixel_x = -8;
	pixel_y = -2
	},
/obj/item/stock_parts/cell/gun/kalix{
	pixel_x = -8;
	pixel_y = 6
	},
/obj/item/stock_parts/cell/gun/kalix{
	pixel_x = -8;
	pixel_y = 14
	},
/obj/item/stock_parts/cell/gun/kalix{
	pixel_x = 7;
	pixel_y = 14
	},
/turf/open/space/basic,
/area/space)
"sf" = (
/turf/open/floor/plating,
/area/space)
"ss" = (
/turf/open/floor/plasteel/tech,
/area/space)
"tl" = (
/obj/effect/turf_decal/techfloor,
/obj/machinery/modular_computer/console/preset/command{
	dir = 1;
	icon_state = "computer-right"
	},
/turf/open/floor/plasteel/telecomms_floor,
/area/space)
"tq" = (
/obj/structure/table/chem,
/turf/open/floor/mineral/titanium,
/area/space)
"tZ" = (
/obj/machinery/power/terminal,
/obj/effect/turf_decal/techfloor,
/turf/open/floor/plasteel/tech,
/area/space)
"uk" = (
/obj/effect/turf_decal/borderfloor{
	dir = 6
	},
/turf/open/floor/plasteel,
/area/space)
"uM" = (
/turf/open/floor/plasteel/mono/dark,
/area/space)
"wo" = (
/obj/effect/turf_decal/techfloor{
	dir = 4
	},
/obj/machinery/computer/helm{
	dir = 8
	},
/turf/open/floor/plasteel/telecomms_floor,
/area/space)
"xL" = (
/obj/machinery/door/airlock/hatch{
	dir = 4
	},
/turf/open/floor/plasteel/tech/grid,
/area/space)
"yg" = (
/obj/structure/table/reinforced,
/turf/open/space/basic,
/area/space)
"zh" = (
/obj/effect/turf_decal/corner_steel_grid/full,
/obj/effect/turf_decal/spline/fancy/opaque/blue{
	dir = 10
	},
/turf/open/floor/plasteel/mono/dark,
/area/space)
"AV" = (
/obj/machinery/atmospherics/components/binary/circulator/cold{
	dir = 1
	},
/turf/open/space/basic,
/area/space)
"CO" = (
/obj/machinery/chem_heater,
/turf/open/floor/mineral/titanium,
/area/space)
"DG" = (
/obj/effect/turf_decal/techfloor{
	dir = 8
	},
/turf/open/space/basic,
/area/space)
"Eq" = (
/obj/machinery/atmospherics/components/unary/shuttle/fire_heater,
/obj/effect/turf_decal/techfloor{
	dir = 9
	},
/turf/open/floor/plasteel/telecomms_floor,
/area/space)
"EE" = (
/obj/effect/turf_decal/spline/fancy/opaque/black{
	dir = 4
	},
/turf/open/floor/plasteel/patterned/cargo_one,
/area/space)
"FZ" = (
/turf/open/floor/plasteel/dark,
/area/space)
"Gh" = (
/obj/machinery/power/shuttle/engine/electric,
/turf/open/floor/engine/hull,
/area/space)
"Gk" = (
/obj/effect/turf_decal/spline/fancy/opaque/black{
	dir = 8
	},
/turf/open/floor/plasteel/patterned/cargo_one,
/area/space)
"GY" = (
/turf/open/floor/plasteel/tech/grid,
/area/space)
"HD" = (
/turf/closed/wall/mineral/titanium,
/area/space)
"HW" = (
/obj/effect/turf_decal/techfloor/corner{
	dir = 8
	},
/obj/effect/turf_decal/techfloor/corner{
	dir = 1
	},
/turf/open/space/basic,
/area/space)
"Ic" = (
/obj/machinery/atmospherics/components/binary/circulator,
/turf/open/space/basic,
/area/space)
"Ig" = (
/turf/open/floor/plasteel,
/area/space)
"JC" = (
/obj/structure/crate_shelf,
/obj/effect/turf_decal/industrial/outline/yellow,
/turf/open/floor/plasteel/patterned/ridged,
/area/space)
"KG" = (
/obj/effect/turf_decal/spline/fancy/opaque/black{
	dir = 6
	},
/turf/open/floor/plasteel/patterned/cargo_one,
/area/space)
"Md" = (
/obj/machinery/atmospherics/pipe/layer_manifold{
	dir = 4
	},
/turf/open/floor/plating,
/area/space)
"Mp" = (
/obj/structure/chair/sofa/blue/right/directional/east,
/turf/open/space/basic,
/area/space)
"MI" = (
/obj/structure/chair/sofa/blue/directional/south,
/turf/open/space/basic,
/area/space)
"MK" = (
/obj/effect/turf_decal/borderfloor{
	dir = 10
	},
/turf/open/floor/plasteel,
/area/space)
"MY" = (
/turf/open/floor/plasteel/patterned/cargo_one,
/area/space)
"Nb" = (
/obj/effect/turf_decal/corner_steel_grid{
	dir = 10
	},
/obj/effect/turf_decal/spline/fancy/opaque/blue,
/turf/open/floor/plasteel/mono/dark,
/area/space)
"Nk" = (
/obj/effect/turf_decal/atmos/mix,
/obj/machinery/atmospherics/components/unary/vent_pump/high_volume/siphon/on{
	dir = 8
	},
/turf/open/floor/engine/hydrogen_fuel,
/area/space)
"OQ" = (
/obj/effect/turf_decal/industrial/warning{
	dir = 4
	},
/turf/open/floor/plasteel/patterned/cargo_one,
/area/space)
"Qc" = (
/obj/machinery/cryopod{
	dir = 4
	},
/obj/machinery/light/small/directional/south,
/turf/open/floor/pod/dark,
/area/space)
"Qt" = (
/obj/structure/table/chem,
/obj/structure/sink/chem{
	pixel_y = 4;
	pixel_x = -8
	},
/obj/item/reagent_containers/glass/beaker{
	pixel_x = -11;
	pixel_y = 10
	},
/obj/item/reagent_containers/glass/beaker{
	pixel_x = -11;
	pixel_y = 5
	},
/obj/item/reagent_containers/glass/beaker{
	pixel_x = -11
	},
/obj/machinery/reagentgrinder{
	pixel_y = 9;
	pixel_x = 7
	},
/turf/open/floor/mineral/titanium,
/area/space)
"RN" = (
/obj/effect/turf_decal/techfloor/corner{
	dir = 1
	},
/turf/open/floor/plasteel/tech,
/area/space)
"Sa" = (
/obj/effect/turf_decal/borderfloor{
	dir = 9
	},
/turf/open/floor/plasteel,
/area/space)
"Sj" = (
/obj/machinery/power/shuttle/engine/fire,
/turf/open/floor/engine/hull/interior,
/area/space)
"SE" = (
/obj/machinery/door/airlock/hatch{
	dir = 4
	},
/turf/open/space/basic,
/area/space)
"Vx" = (
/obj/effect/turf_decal/corner_steel_grid{
	dir = 9
	},
/obj/effect/turf_decal/spline/fancy/opaque/blue{
	dir = 8
	},
/turf/open/floor/plasteel/mono/dark,
/area/space)
"Wt" = (
/obj/structure/grille,
/obj/structure/window/reinforced/fulltile/shuttle,
/turf/open/floor/plating,
/area/space)
"WE" = (
/obj/effect/turf_decal/corner_steel_grid/full{
	dir = 8
	},
/obj/effect/turf_decal/spline/fancy/opaque/blue{
	dir = 9
	},
/turf/open/floor/plasteel/mono/dark,
/area/space)
"WO" = (
/obj/effect/turf_decal/corner_steel_grid{
	dir = 5
	},
/obj/effect/turf_decal/spline/fancy/opaque/blue{
	dir = 1
	},
/turf/open/floor/plasteel/mono/dark,
/area/space)
"Xh" = (
/turf/closed/wall/mineral/plastitanium,
/area/space)
"XY" = (
/obj/machinery/door/airlock/hatch,
/turf/open/floor/plasteel/tech/grid,
/area/space)
"Yi" = (
/obj/structure/chair/sofa/blue/corner/directional/east,
/turf/open/space/basic,
/area/space)
"Zz" = (
/turf/open/floor/mineral/titanium/tiled,
/area/space)
"ZX" = (
/obj/structure/table/chem,
/obj/item/reagent_containers/glass/beaker{
	pixel_x = 11;
	pixel_y = 10
	},
/obj/item/reagent_containers/glass/beaker{
	pixel_x = 11;
	pixel_y = 5
	},
/obj/item/reagent_containers/glass/beaker{
	pixel_x = 11
	},
/obj/item/reagent_scanner{
	pixel_x = 2;
	pixel_y = -3
	},
/turf/open/floor/mineral/titanium,
/area/space)

(1,1,1) = {"
ab
ab
ab
ab
ab
ab
ab
ab
Xh
ab
ab
ab
ab
ab
ab
ab
ab
"}
(2,1,1) = {"
ab
ab
ab
ab
ab
Xh
Sj
Sj
Xh
Sj
Sj
Xh
ab
ab
ab
ab
ab
"}
(3,1,1) = {"
ab
ab
ab
Xh
cv
Xh
Eq
dQ
Xh
Eq
dQ
Xh
SE
Xh
ab
ab
ab
"}
(4,1,1) = {"
ab
ab
ab
Xh
cv
fT
DG
DG
HW
DG
DG
fT
ab
Xh
ab
ab
ab
"}
(5,1,1) = {"
HD
Gh
Xh
Xh
cv
fT
ab
ab
ab
ab
ab
fT
ab
Xh
Xh
Gh
HD
"}
(6,1,1) = {"
HD
ne
ia
Xh
Xh
Xh
ab
Ic
rx
AV
ab
Xh
xL
Xh
tZ
be
HD
"}
(7,1,1) = {"
HD
HD
RN
XY
ab
ab
ab
ab
ab
ab
ab
ab
ab
XY
fb
HD
HD
"}
(8,1,1) = {"
ab
HD
HD
Xh
ab
ab
ab
ab
ab
ab
ab
ab
ab
Xh
HD
HD
ab
"}
(9,1,1) = {"
ab
ab
HD
Xh
Xh
Xh
Xh
ab
ab
ab
ab
ab
ab
ab
HD
ab
ab
"}
(10,1,1) = {"
HD
sf
HD
JC
OQ
JC
Xh
Xh
Xh
GY
Xh
Md
Xh
Md
HD
sf
HD
"}
(11,1,1) = {"
HD
ab
HD
MY
MY
MY
Xh
ab
ab
ab
Xh
hd
Xh
Nk
HD
ab
HD
"}
(12,1,1) = {"
HD
ab
HD
ab
ab
ab
GY
ab
ab
ab
HD
HD
HD
HD
HD
ab
HD
"}
(13,1,1) = {"
HD
sf
HD
ab
ab
ab
HD
ab
ab
ab
HD
Zz
Zz
HD
HD
sf
HD
"}
(14,1,1) = {"
ab
ab
HD
HD
GY
HD
HD
HD
ab
ab
HD
Zz
Zz
HD
ab
ab
ab
"}
(15,1,1) = {"
ab
ab
ab
HD
Vx
Vx
zh
HD
GY
HD
HD
HD
GY
HD
ab
ab
ab
"}
(16,1,1) = {"
ab
ab
ab
nl
Gk
ml
Nb
HD
WE
zh
ab
ab
ab
HD
HD
ab
ab
"}
(17,1,1) = {"
ab
ab
ab
nl
MY
hV
Nb
GY
WO
Nb
ab
ab
ab
ab
HD
ab
ab
"}
(18,1,1) = {"
ab
ab
ab
nl
EE
KG
Nb
HD
WO
Nb
ab
ab
ab
ab
HD
ab
ab
"}
(19,1,1) = {"
ab
ab
ab
HD
cN
cN
iS
HD
WO
Nb
tq
tq
tq
tq
HD
ab
ab
"}
(20,1,1) = {"
ab
ab
ab
HD
HD
GY
HD
HD
WO
Nb
Ig
Sa
MK
hy
HD
ab
ab
"}
(21,1,1) = {"
ab
ab
ab
HD
pG
ab
ab
HD
WO
Nb
ZX
ff
uk
JC
HD
ab
ab
"}
(22,1,1) = {"
ab
ab
ab
HD
HD
yg
rY
HD
fJ
iS
Qt
CO
dm
HD
HD
ab
ab
"}
(23,1,1) = {"
ab
ab
ab
ab
HD
HD
HD
HD
ab
HD
HD
HD
HD
HD
ab
ab
ab
"}
(24,1,1) = {"
ab
ab
HD
sf
HD
js
HD
ab
ab
dn
HD
ed
Qc
HD
sf
HD
ab
"}
(25,1,1) = {"
ab
ab
HD
ab
HD
js
GY
ab
ab
ab
GY
FZ
jf
HD
ab
HD
ab
"}
(26,1,1) = {"
ab
ab
HD
sf
HD
js
HD
ab
ab
ab
HD
nq
kr
HD
sf
HD
ab
"}
(27,1,1) = {"
ab
ab
ab
ab
HD
HD
HD
HD
ab
ab
HD
HD
HD
HD
ab
ab
ab
"}
(28,1,1) = {"
ab
ab
ab
HD
HD
ab
ab
HD
ab
ab
HD
ss
ss
HD
HD
ab
ab
"}
(29,1,1) = {"
ab
ab
ab
HD
ab
ab
ab
HD
ab
ab
GY
uM
uM
ss
HD
ab
ab
"}
(30,1,1) = {"
ab
ab
ab
HD
ab
ab
ab
GY
ab
ab
HD
uM
uM
tl
Wt
ab
ab
"}
(31,1,1) = {"
ab
ab
ab
HD
ab
ab
HD
HD
ab
ab
HD
ov
cq
pv
Wt
ab
ab
"}
(32,1,1) = {"
ab
ab
ab
HD
HD
HD
HD
ab
ab
ab
HD
HD
wo
Wt
Wt
ab
ab
"}
(33,1,1) = {"
ab
ab
ab
HD
HD
Yi
Mp
ab
ab
ab
ab
HD
HD
Wt
ab
ab
ab
"}
(34,1,1) = {"
ab
ab
ab
ab
HD
MI
ab
ab
ab
ab
ab
Wt
ab
ab
ab
ab
ab
"}
(35,1,1) = {"
ab
ab
ab
ab
HD
iM
ab
ab
ab
ab
Wt
Wt
ab
ab
ab
ab
ab
"}
(36,1,1) = {"
ab
ab
ab
ab
HD
Wt
Wt
Wt
Wt
Wt
Wt
ab
ab
ab
ab
ab
ab
"}
(37,1,1) = {"
ab
ab
ab
ab
ab
ab
ab
ab
ab
ab
ab
ab
ab
ab
ab
ab
ab
"}
