//MAP CONVERTED BY dmm2tgm.py THIS HEADER COMMENT PREVENTS RECONVERSION, DO NOT REMOVE
"bs" = (
/obj/structure/catwalk/over/plated_catwalk,
/turf/open/floor/plating,
/area/space)
"ck" = (
/obj/item/toy/plush/landmine,
/obj/item/toy/plush/spider{
	pixel_x = -1;
	pixel_y = 9
	},
/turf/open/floor/grass/fakebasalt,
/area/space)
"cR" = (
/obj/structure/table/reinforced,
/obj/structure/closet/secure_closet/wall/directional/west{
	icon_state = "sec_wall"
	},
/obj/item/clothing/suit/armor/vest/alt,
/obj/item/storage/box/ammo/a12g_buckshot,
/obj/item/storage/box/ammo/a12g_buckshot,
/obj/item/stock_parts/cell/gun,
/obj/item/stock_parts/cell/gun,
/obj/item/stock_parts/cell/gun/kalix,
/obj/item/stock_parts/cell/potato,
/turf/open/floor/plasteel/tech,
/area/space)
"en" = (
/obj/machinery/suit_storage_unit/independent/security,
/obj/structure/window/reinforced{
	dir = 4
	},
/turf/open/floor/plasteel/tech,
/area/space)
"fc" = (
/obj/structure/table/reinforced,
/obj/item/binoculars{
	pixel_x = 8;
	pixel_y = -1
	},
/obj/machinery/power/apc/auto_name/directional/west,
/turf/open/floor/plasteel/dark,
/area/space)
"gc" = (
/turf/open/floor/plasteel/tech,
/area/space)
"gf" = (
/obj/effect/shield,
/turf/open/floor/plating,
/area/space)
"hg" = (
/obj/machinery/computer{
	dir = 4
	},
/turf/open/floor/plating,
/area/space)
"hB" = (
/turf/open/floor/plating,
/area/space)
"hU" = (
/obj/machinery/power/port_gen/pacman/super,
/obj/structure/catwalk/over/plated_catwalk/dark,
/turf/open/floor/plating,
/area/space)
"je" = (
/obj/machinery/power/shuttle/engine/electric,
/turf/open/floor/plating,
/area/space)
"ka" = (
/obj/structure/table/reinforced,
/obj/item/radio/intercom/wideband/table{
	dir = 4;
	pixel_x = 6;
	pixel_y = 0
	},
/obj/machinery/firealarm/directional/east,
/obj/machinery/airalarm/directional/north,
/turf/open/floor/plasteel/dark,
/area/space)
"kc" = (
/obj/structure/dresser,
/turf/open/floor/plasteel/grimy,
/area/space)
"kC" = (
/obj/structure/closet/cabinet,
/turf/open/floor/plasteel/grimy,
/area/space)
"kJ" = (
/obj/structure/mirror{
	pixel_x = 0;
	pixel_y = 31
	},
/obj/structure/sink{
	pixel_x = 0;
	pixel_y = 19
	},
/turf/open/floor/plasteel/patterned,
/area/space)
"lz" = (
/turf/closed/wall/r_wall,
/area/space)
"lF" = (
/obj/machinery/portable_atmospherics/canister/oxygen,
/obj/structure/catwalk/over/plated_catwalk/dark,
/turf/open/floor/plating,
/area/space)
"mb" = (
/obj/machinery/power/port_gen/pacman,
/obj/structure/catwalk/over/plated_catwalk/dark,
/turf/open/floor/plating,
/area/space)
"mT" = (
/obj/machinery/computer/cargo{
	dir = 8
	},
/turf/open/floor/plasteel/dark,
/area/space)
"nn" = (
/turf/open/space/basic,
/area/space)
"oM" = (
/obj/structure/bed/bunk,
/obj/structure/bed/bunk/top,
/turf/open/floor/plasteel/grimy,
/area/space)
"pk" = (
/obj/machinery/portable_atmospherics/canister/hydrogen,
/obj/structure/catwalk/over/plated_catwalk/dark,
/turf/open/floor/plating,
/area/space)
"qh" = (
/obj/machinery/power/smes,
/obj/structure/catwalk/over/plated_catwalk/dark,
/turf/open/floor/plating,
/area/space)
"qI" = (
/obj/structure/sign/warning/nosmoking/burnt,
/turf/closed/wall,
/area/space)
"qL" = (
/obj/structure/catwalk/over/plated_catwalk/dark,
/turf/open/floor/plating,
/area/space)
"rp" = (
/obj/structure/bed/bunk,
/obj/structure/bed/bunk/top,
/obj/structure/bed/bunk/top,
/turf/open/floor/plasteel/grimy,
/area/space)
"rH" = (
/obj/mecha/working/ripley/cargo,
/turf/open/floor/plating,
/area/space)
"uy" = (
/obj/machinery/computer/crew{
	dir = 4
	},
/turf/open/floor/plasteel/dark,
/area/space)
"uE" = (
/obj/machinery/computer/helm{
	dir = 8
	},
/turf/open/floor/plasteel/dark,
/area/space)
"vi" = (
/obj/structure/grille,
/obj/structure/window/reinforced/fulltile,
/turf/open/floor/plating,
/area/space)
"wA" = (
/obj/structure/toilet{
	pixel_y = 1;
	dir = 4;
	pixel_x = -6
	},
/obj/machinery/shower{
	dir = 8
	},
/obj/structure/catwalk/over/plated_catwalk,
/turf/open/floor/plating,
/area/space)
"wK" = (
/turf/closed/wall,
/area/space)
"xd" = (
/obj/machinery/atmospherics/components/unary/shuttle/fire_heater,
/turf/open/floor/plating,
/area/space)
"xe" = (
/obj/machinery/power/shuttle/engine/electric,
/turf/open/floor/engine/hull,
/area/space)
"xx" = (
/obj/structure/closet/crate/large,
/obj/machinery/power/planet_beacon,
/turf/open/space/basic,
/area/space)
"yi" = (
/obj/structure/table/reinforced,
/obj/machinery/fax/indie,
/turf/open/floor/plasteel/dark,
/area/space)
"yj" = (
/turf/open/floor/plasteel/tech/techmaint,
/area/space)
"yC" = (
/obj/machinery/atmospherics/components/binary/dp_vent_pump/high_volume/layer4,
/turf/open/floor/plasteel/tech/techmaint,
/area/space)
"yY" = (
/obj/structure/lattice,
/obj/structure/lattice/catwalk,
/turf/open/space/basic,
/area/space)
"zK" = (
/obj/structure/closet/crate/large,
/obj/machinery/power/emitter,
/turf/open/space/basic,
/area/space)
"Ac" = (
/obj/machinery/power/shuttle/engine/fire,
/turf/open/floor/engine/hull,
/area/space)
"Ds" = (
/obj/machinery/power/smes,
/turf/open/floor/plating,
/area/space)
"Fz" = (
/turf/open/floor/plasteel/patterned/grid,
/area/space)
"GM" = (
/turf/open/floor/plasteel/grimy,
/area/space)
"GS" = (
/obj/item/toy/plush/moth/punished{
	pixel_x = 6;
	pixel_y = 9
	},
/obj/item/assembly/signaler{
	pixel_x = -7;
	pixel_y = 0;
	code = 31
	},
/obj/structure/flora/ausbushes/ywflowers/hell,
/turf/open/floor/grass/fakebasalt,
/area/space)
"Iz" = (
/turf/open/floor/plasteel/patterned,
/area/space)
"Ml" = (
/obj/machinery/mech_bay_recharge_port{
	dir = 2
	},
/turf/open/floor/plating,
/area/space)
"Mx" = (
/obj/machinery/door/window/brigdoor/eastright,
/turf/open/floor/plasteel/tech,
/area/space)
"NC" = (
/obj/item/gun/energy/e_gun/e11,
/obj/item/gun/energy/e_gun/e11,
/obj/structure/guncloset,
/obj/item/gun/ballistic/shotgun/flamingarrow/conflagration,
/obj/item/gun/energy/kalix/pistol,
/obj/item/gun/energy/laser/e10,
/turf/open/floor/plasteel/tech,
/area/space)
"Rl" = (
/turf/open/floor/plasteel,
/area/space)
"SG" = (
/obj/machinery/power/smes/shuttle,
/turf/open/floor/plating,
/area/space)
"TI" = (
/obj/effect/turf_decal/corner/transparent/beige/full,
/obj/effect/turf_decal/corner/transparent/brown/diagonal,
/turf/open/floor/plasteel,
/area/space)
"UM" = (
/obj/effect/shield,
/turf/open/floor/engine/hull,
/area/space)
"UX" = (
/obj/item/mecha_parts/mecha_equipment/thrusters,
/turf/open/floor/plating,
/area/space)
"Wg" = (
/obj/machinery/power/ship_gravity,
/obj/structure/catwalk/over/plated_catwalk/dark,
/turf/open/floor/plating,
/area/space)
"XC" = (
/turf/open/floor/engine/hull,
/area/space)

(1,1,1) = {"
nn
nn
nn
nn
nn
nn
nn
nn
nn
nn
nn
nn
nn
nn
nn
nn
nn
nn
nn
nn
nn
nn
nn
nn
nn
nn
UX
wK
UX
nn
"}
(2,1,1) = {"
nn
nn
nn
nn
nn
nn
nn
nn
nn
nn
nn
nn
nn
nn
nn
nn
nn
nn
nn
nn
nn
nn
nn
nn
nn
wK
hB
Ds
hB
wK
"}
(3,1,1) = {"
nn
nn
nn
nn
nn
nn
nn
nn
Ac
Ac
nn
nn
je
je
nn
xe
xe
nn
nn
Ac
Ac
nn
nn
nn
nn
gf
hB
Ml
rH
hB
"}
(4,1,1) = {"
nn
nn
nn
nn
nn
nn
nn
lz
xd
xd
lz
lz
SG
SG
lz
SG
SG
lz
lz
xd
xd
lz
nn
nn
nn
gf
hB
hg
hB
hB
"}
(5,1,1) = {"
nn
nn
nn
nn
nn
nn
nn
lz
hB
hB
hB
hB
hB
hB
hB
hB
hB
hB
hB
hB
hB
lz
nn
nn
nn
wK
hB
hB
hB
wK
"}
(6,1,1) = {"
nn
nn
nn
nn
nn
nn
nn
lz
hB
hB
hB
wK
mb
qL
lF
lF
lF
wK
hB
hB
hB
lz
nn
nn
nn
wK
wK
hB
wK
wK
"}
(7,1,1) = {"
nn
nn
nn
nn
nn
nn
nn
lz
lz
lz
lz
lz
hU
qL
pk
pk
qh
lz
lz
lz
lz
lz
nn
nn
nn
nn
wK
hB
wK
nn
"}
(8,1,1) = {"
nn
nn
nn
nn
nn
nn
nn
nn
nn
nn
nn
lz
Wg
qL
qL
pk
qh
lz
nn
nn
nn
nn
nn
nn
nn
nn
nn
nn
nn
nn
"}
(9,1,1) = {"
nn
nn
nn
nn
nn
nn
nn
nn
lz
lz
lz
lz
lz
lz
hB
lz
lz
lz
lz
lz
lz
lz
nn
nn
nn
nn
nn
nn
nn
nn
"}
(10,1,1) = {"
nn
nn
nn
nn
nn
nn
xx
nn
lz
yi
fc
uy
wK
TI
bs
TI
TI
TI
qI
GS
ck
lz
nn
nn
nn
nn
nn
nn
nn
nn
"}
(11,1,1) = {"
nn
nn
nn
nn
nn
nn
zK
nn
vi
qL
qL
qL
vi
TI
bs
TI
TI
TI
wK
wK
wK
lz
nn
nn
nn
nn
nn
nn
nn
nn
"}
(12,1,1) = {"
nn
nn
nn
nn
nn
nn
nn
nn
vi
qL
qL
qL
gc
bs
bs
bs
bs
bs
hB
yj
yC
hB
nn
nn
nn
nn
nn
nn
nn
nn
"}
(13,1,1) = {"
nn
nn
nn
nn
nn
nn
nn
nn
vi
qL
qL
qL
vi
TI
bs
TI
TI
TI
wK
yj
yC
hB
nn
nn
nn
nn
nn
nn
nn
nn
"}
(14,1,1) = {"
nn
nn
nn
nn
nn
nn
nn
nn
lz
ka
uE
mT
lz
TI
bs
TI
TI
TI
lz
lz
lz
lz
nn
nn
nn
nn
nn
nn
nn
nn
"}
(15,1,1) = {"
nn
nn
nn
nn
nn
nn
nn
nn
lz
lz
lz
lz
lz
TI
bs
TI
TI
TI
lz
nn
nn
nn
nn
nn
nn
nn
nn
nn
nn
nn
"}
(16,1,1) = {"
nn
nn
nn
nn
nn
nn
nn
nn
nn
nn
nn
nn
lz
Iz
bs
wK
wK
wK
lz
nn
nn
nn
nn
nn
nn
nn
nn
nn
nn
nn
"}
(17,1,1) = {"
nn
nn
nn
nn
nn
nn
nn
nn
nn
nn
nn
nn
lz
Iz
bs
wK
NC
cR
lz
lz
lz
lz
lz
lz
lz
nn
nn
nn
nn
nn
"}
(18,1,1) = {"
nn
nn
nn
nn
nn
nn
nn
nn
nn
nn
nn
nn
lz
Iz
bs
wK
bs
bs
wK
kJ
wA
wK
oM
GM
vi
nn
nn
nn
nn
nn
"}
(19,1,1) = {"
nn
nn
nn
nn
nn
nn
nn
nn
nn
nn
nn
nn
lz
Iz
bs
wK
en
Mx
wK
Rl
wK
wK
kC
GM
vi
nn
nn
nn
nn
nn
"}
(20,1,1) = {"
nn
nn
nn
nn
nn
nn
nn
nn
lz
lz
lz
lz
lz
Iz
bs
Rl
Rl
Rl
bs
Rl
Rl
Rl
GM
GM
vi
nn
nn
nn
nn
nn
"}
(21,1,1) = {"
nn
nn
nn
nn
nn
nn
nn
nn
lz
Fz
Fz
Fz
Fz
Iz
bs
bs
bs
bs
bs
bs
bs
bs
GM
GM
lz
nn
nn
nn
nn
nn
"}
(22,1,1) = {"
nn
nn
nn
nn
nn
nn
nn
nn
lz
Iz
Iz
Iz
Iz
Iz
bs
lz
hB
hB
lz
lz
lz
lz
kc
GM
vi
nn
nn
nn
nn
nn
"}
(23,1,1) = {"
nn
nn
nn
nn
nn
nn
nn
nn
lz
bs
bs
bs
bs
bs
bs
lz
hB
hB
hB
hB
hB
lz
oM
GM
vi
nn
nn
nn
nn
nn
"}
(24,1,1) = {"
nn
nn
nn
nn
nn
nn
nn
nn
lz
gf
gf
gf
lz
lz
lz
lz
hB
hB
hB
hB
hB
lz
rp
GM
vi
nn
nn
nn
nn
nn
"}
(25,1,1) = {"
nn
nn
nn
nn
nn
nn
nn
nn
yY
yY
yY
yY
yY
lz
hB
hB
hB
hB
hB
hB
hB
lz
lz
lz
lz
nn
nn
nn
nn
nn
"}
(26,1,1) = {"
nn
nn
nn
nn
nn
nn
nn
nn
nn
yY
yY
yY
nn
lz
hB
hB
hB
hB
hB
hB
hB
hB
hB
lz
nn
nn
nn
nn
nn
nn
"}
(27,1,1) = {"
nn
nn
nn
nn
nn
nn
nn
nn
nn
nn
nn
nn
nn
gf
hB
hB
hB
hB
hB
hB
hB
hB
hB
lz
nn
nn
nn
nn
nn
nn
"}
(28,1,1) = {"
nn
nn
nn
nn
nn
nn
nn
nn
nn
nn
nn
nn
nn
gf
hB
hB
wK
wK
UM
UM
wK
hB
hB
lz
nn
nn
nn
nn
nn
nn
"}
(29,1,1) = {"
nn
nn
nn
nn
nn
nn
nn
nn
nn
nn
nn
nn
nn
gf
hB
wK
wK
XC
XC
XC
XC
XC
hB
lz
nn
nn
nn
nn
nn
nn
"}
(30,1,1) = {"
nn
nn
nn
nn
nn
nn
nn
nn
nn
nn
nn
nn
nn
gf
hB
XC
XC
XC
XC
XC
XC
wK
hB
lz
nn
nn
nn
nn
nn
nn
"}
(31,1,1) = {"
nn
nn
nn
nn
nn
nn
nn
nn
nn
nn
nn
nn
nn
gf
hB
wK
wK
XC
XC
XC
XC
XC
hB
lz
nn
nn
nn
nn
nn
nn
"}
(32,1,1) = {"
nn
nn
nn
nn
nn
nn
nn
nn
nn
nn
nn
nn
nn
gf
hB
hB
wK
wK
XC
XC
wK
hB
hB
lz
nn
nn
nn
nn
nn
nn
"}
(33,1,1) = {"
nn
nn
nn
nn
nn
nn
nn
nn
nn
nn
nn
nn
nn
gf
hB
hB
hB
hB
hB
hB
hB
hB
hB
lz
nn
nn
nn
nn
nn
nn
"}
(34,1,1) = {"
nn
nn
nn
nn
nn
nn
nn
nn
nn
nn
nn
nn
nn
lz
lz
lz
lz
lz
lz
lz
lz
lz
lz
lz
nn
nn
nn
nn
nn
nn
"}
(35,1,1) = {"
nn
nn
nn
nn
nn
nn
nn
nn
nn
nn
nn
nn
nn
nn
nn
nn
nn
nn
nn
nn
nn
nn
nn
nn
nn
nn
nn
nn
nn
nn
"}
(36,1,1) = {"
nn
nn
nn
nn
nn
nn
nn
nn
nn
nn
nn
nn
nn
nn
nn
nn
nn
nn
nn
nn
nn
nn
nn
nn
nn
nn
nn
nn
nn
nn
"}
(37,1,1) = {"
nn
nn
nn
nn
nn
nn
nn
nn
nn
nn
nn
nn
nn
nn
nn
nn
nn
nn
nn
nn
nn
nn
nn
nn
nn
nn
nn
nn
nn
nn
"}
(38,1,1) = {"
nn
nn
nn
nn
nn
nn
nn
nn
nn
nn
nn
nn
nn
nn
nn
nn
nn
nn
nn
nn
nn
nn
nn
nn
nn
nn
nn
nn
nn
nn
"}
(39,1,1) = {"
nn
nn
nn
nn
nn
nn
nn
nn
nn
nn
nn
nn
nn
nn
nn
nn
nn
nn
nn
nn
nn
nn
nn
nn
nn
nn
nn
nn
nn
nn
"}
(40,1,1) = {"
nn
nn
nn
nn
nn
nn
nn
nn
nn
nn
nn
nn
nn
nn
nn
nn
nn
nn
nn
nn
nn
nn
nn
nn
nn
nn
nn
nn
nn
nn
"}
