//MAP CONVERTED BY dmm2tgm.py THIS HEADER COMMENT PREVENTS RECONVERSION, DO NOT REMOVE
"ad" = (
/obj/effect/turf_decal/industrial/warning{
	dir = 4
	},
/obj/effect/decal/cleanable/dirt/dust,
/turf/open/floor/plasteel/patterned,
/area/ship/cargo)
"aD" = (
/obj/structure/railing/thin/corner{
	dir = 4
	},
/obj/structure/railing/thin/corner{
	dir = 1
	},
/obj/structure/closet/emcloset/wall/directional/west,
/obj/item/radio/intercom/directional/south,
/obj/effect/decal/cleanable/dirt,
/turf/open/floor/plasteel/patterned,
/area/ship/cargo)
"aE" = (
/obj/structure/railing{
	dir = 8
	},
/obj/machinery/light/dim/directional/south,
/obj/structure/tank_dispenser,
/turf/open/floor/plasteel,
/area/ship/cargo)
"bO" = (
/obj/machinery/power/smes/shuttle/precharged{
	dir = 1
	},
/obj/structure/cable{
	icon_state = "0-2"
	},
/obj/structure/window/reinforced,
/obj/machinery/door/poddoor/shutters{
	id = "rhodes_engines"
	},
/turf/open/floor/plating,
/area/ship/engineering)
"cJ" = (
/obj/machinery/power/shuttle/engine/electric,
/obj/structure/window/reinforced,
/obj/structure/window/reinforced{
	dir = 1
	},
/obj/structure/cable{
	icon_state = "0-4"
	},
/turf/open/floor/engine/hull/reinforced,
/area/ship/external/dark)
"cY" = (
/obj/structure/platform/ship_three{
	dir = 4
	},
/obj/effect/turf_decal/industrial/outline/yellow,
/obj/structure/reagent_dispensers/watertank,
/turf/open/floor/plasteel/patterned/cargo_one,
/area/ship/cargo)
"dd" = (
/obj/structure/table/reinforced,
/obj/item/radio/intercom/wideband/table{
	pixel_x = -2;
	pixel_y = 1
	},
/turf/open/floor/plasteel/tech/grid,
/area/ship/bridge)
"du" = (
/obj/structure/chair/office{
	dir = 4
	},
/obj/effect/decal/cleanable/dirt/dust,
/obj/effect/turf_decal/corner_techfloor_grid/full{
	dir = 1
	},
/obj/effect/turf_decal/box/corners{
	dir = 8
	},
/turf/open/floor/plasteel,
/area/ship/bridge)
"dC" = (
/obj/structure/railing/corner{
	dir = 8
	},
/obj/structure/cable{
	icon_state = "2-6"
	},
/obj/effect/turf_decal/corner_techfloor_grid{
	dir = 5
	},
/turf/open/floor/plasteel,
/area/ship/bridge)
"ed" = (
/obj/structure/cable{
	icon_state = "6-10"
	},
/obj/structure/cable{
	icon_state = "1-10"
	},
/obj/effect/decal/cleanable/dirt,
/turf/open/floor/plasteel/patterned/grid,
/area/ship/cargo)
"eH" = (
/obj/structure/platform/ship_three{
	dir = 4
	},
/obj/effect/turf_decal/industrial/outline/yellow,
/obj/structure/reagent_dispensers/fueltank,
/turf/open/floor/plasteel/patterned/cargo_one,
/area/ship/cargo)
"fD" = (
/turf/template_noop,
/area/template_noop)
"fG" = (
/obj/structure/cable{
	icon_state = "5-6"
	},
/obj/structure/cable{
	icon_state = "5-10"
	},
/obj/machinery/holopad,
/obj/effect/turf_decal/box,
/turf/open/floor/plasteel/patterned/grid,
/area/ship/cargo)
"fM" = (
/obj/structure/platform/ship_three/corner{
	dir = 8
	},
/obj/structure/platform/ship_three/corner,
/obj/structure/railing/corner{
	dir = 4
	},
/obj/structure/cable{
	icon_state = "4-8"
	},
/obj/effect/decal/cleanable/dirt/dust,
/obj/effect/decal/cleanable/dirt/dust,
/obj/effect/decal/cleanable/dirt/dust,
/turf/open/floor/plasteel/patterned/cargo_one,
/area/ship/cargo)
"gi" = (
/obj/structure/platform/ship_three{
	dir = 4
	},
/obj/effect/turf_decal/industrial/outline/yellow,
/obj/structure/closet/crate/large{
	name = "large generator crate"
	},
/obj/machinery/power/port_gen/pacman/super,
/obj/item/stack/sheet/mineral/uranium/five,
/turf/open/floor/plasteel/patterned/cargo_one,
/area/ship/cargo)
"gN" = (
/obj/machinery/power/shieldwallgen/atmos/roundstart{
	dir = 4;
	id = "rhodes_starboard_field"
	},
/obj/structure/cable,
/obj/effect/turf_decal/spline/fancy/opaque/black{
	dir = 8
	},
/obj/effect/decal/cleanable/dirt,
/obj/machinery/door/poddoor{
	id = "rhodes_starboard"
	},
/turf/open/floor/plasteel/patterned/ridged,
/area/ship/cargo)
"gU" = (
/obj/structure/platform/ship_three,
/obj/structure/platform/ship_three{
	dir = 1
	},
/obj/structure/railing{
	dir = 1
	},
/obj/structure/cable{
	icon_state = "4-8"
	},
/obj/effect/decal/cleanable/dirt/dust,
/turf/open/floor/plasteel/stairs/old{
	dir = 8
	},
/area/ship/engineering)
"hJ" = (
/obj/structure/railing{
	dir = 1
	},
/obj/structure/cable{
	icon_state = "4-8"
	},
/obj/structure/sign/poster/retro/build{
	pixel_y = 32
	},
/turf/open/floor/plasteel/stairs/old{
	dir = 4
	},
/area/ship/bridge)
"hT" = (
/obj/structure/rack,
/obj/machinery/computer/helm/viewscreen/directional/north,
/obj/item/wrench{
	pixel_x = -6;
	pixel_y = 3
	},
/turf/open/floor/plasteel/tech,
/area/ship/engineering)
"ie" = (
/obj/structure/cable{
	icon_state = "4-8"
	},
/obj/structure/cable{
	icon_state = "8-10"
	},
/turf/open/floor/plasteel,
/area/ship/cargo)
"iX" = (
/obj/machinery/door/airlock/command{
	name = "Bridge";
	dir = 4
	},
/obj/structure/cable{
	icon_state = "4-8"
	},
/turf/open/floor/plasteel,
/area/ship/bridge)
"jC" = (
/obj/effect/decal/cleanable/dirt,
/turf/open/floor/plasteel,
/area/ship/cargo)
"km" = (
/obj/structure/cable{
	icon_state = "5-8"
	},
/obj/effect/turf_decal/miskilamo_small/left,
/obj/effect/turf_decal/spline/fancy/opaque/black{
	dir = 8
	},
/turf/open/floor/plasteel/patterned/grid,
/area/ship/cargo)
"lE" = (
/obj/structure/railing{
	dir = 10
	},
/obj/structure/table,
/obj/machinery/jukebox/boombox{
	pixel_y = 4;
	pixel_x = -3
	},
/obj/item/radio/weather_monitor{
	pixel_x = 5;
	pixel_y = 2
	},
/turf/open/floor/plasteel,
/area/ship/cargo)
"mb" = (
/obj/effect/turf_decal/spline/fancy/opaque/black{
	dir = 4
	},
/obj/effect/decal/cleanable/dirt,
/obj/effect/decal/cleanable/dirt,
/turf/open/floor/plasteel/patterned/grid,
/area/ship/cargo)
"mn" = (
/obj/structure/railing{
	dir = 4
	},
/obj/machinery/atmospherics/pipe/simple/scrubbers/hidden/layer4{
	dir = 10
	},
/obj/effect/decal/cleanable/dirt/dust,
/turf/open/floor/plasteel/patterned,
/area/ship/engineering)
"nb" = (
/obj/machinery/power/shuttle/engine/electric,
/obj/structure/window/reinforced{
	dir = 1
	},
/obj/structure/window/reinforced,
/obj/structure/cable{
	icon_state = "0-4"
	},
/turf/open/floor/engine/hull/reinforced,
/area/ship/external/dark)
"nv" = (
/obj/structure/railing/corner{
	dir = 1
	},
/obj/structure/cable{
	icon_state = "4-8"
	},
/obj/effect/decal/cleanable/dirt/dust,
/turf/open/floor/plasteel,
/area/ship/cargo)
"nG" = (
/obj/effect/decal/cleanable/dirt,
/obj/effect/decal/cleanable/dirt,
/obj/machinery/door/poddoor{
	id = "rhodes_starboard"
	},
/turf/open/floor/plasteel/patterned/ridged,
/area/ship/cargo)
"nN" = (
/obj/machinery/power/shieldwallgen/atmos/roundstart{
	dir = 8;
	id = "rhodes_port_field"
	},
/obj/structure/cable{
	icon_state = "0-10"
	},
/obj/effect/turf_decal/spline/fancy/opaque/black{
	dir = 4
	},
/obj/effect/decal/cleanable/dirt,
/obj/machinery/door/poddoor{
	id = "rhodes_port"
	},
/turf/open/floor/plasteel/patterned/ridged,
/area/ship/cargo)
"nR" = (
/obj/effect/turf_decal/industrial/loading/stripes,
/obj/effect/decal/cleanable/dirt,
/turf/open/floor/plasteel,
/area/ship/cargo)
"ob" = (
/obj/structure/table/reinforced,
/obj/machinery/fax/indie,
/turf/open/floor/plasteel/tech/grid,
/area/ship/bridge)
"ou" = (
/obj/machinery/atmospherics/pipe/layer_manifold,
/obj/machinery/advanced_airlock_controller/directional/east,
/obj/structure/closet/emcloset/wall/directional/west,
/turf/open/floor/plasteel/tech,
/area/ship/engineering)
"oD" = (
/obj/structure/cable{
	icon_state = "4-8"
	},
/obj/structure/closet/firecloset/wall/directional/south{
	pixel_x = -3
	},
/obj/effect/turf_decal/industrial/shutoff{
	dir = 4
	},
/obj/effect/decal/cleanable/dirt/dust,
/obj/machinery/atmospherics/components/binary/valve/layer4{
	dir = 4;
	name = "external to airlock valve"
	},
/turf/open/floor/plasteel/tech,
/area/ship/engineering)
"pv" = (
/obj/structure/window/reinforced,
/obj/structure/window/reinforced{
	dir = 4
	},
/obj/structure/cable{
	icon_state = "1-8"
	},
/obj/structure/grille,
/turf/open/floor/engine/hull/reinforced,
/area/ship/external/dark)
"py" = (
/turf/closed/wall/r_wall/rust/yesdiag,
/area/ship/bridge)
"pJ" = (
/obj/structure/platform/ship_three{
	dir = 4
	},
/obj/structure/railing/thin{
	dir = 4
	},
/obj/structure/railing/thin{
	dir = 8
	},
/turf/open/floor/plasteel/stairs/old{
	dir = 1
	},
/area/ship/cargo)
"qg" = (
/obj/structure/window/reinforced{
	dir = 1
	},
/obj/structure/window/reinforced{
	dir = 4
	},
/obj/structure/cable{
	icon_state = "2-8"
	},
/obj/structure/grille,
/turf/open/floor/engine/hull/reinforced,
/area/ship/external/dark)
"qL" = (
/obj/structure/platform/ship_three{
	dir = 8
	},
/obj/structure/crate_shelf,
/obj/machinery/light/small/directional/south,
/obj/structure/closet/crate,
/obj/item/stack/sheet/metal/twenty,
/obj/item/stack/sheet/glass/twenty,
/obj/effect/turf_decal/borderfloor{
	dir = 4
	},
/obj/effect/turf_decal/box/corners{
	dir = 1
	},
/obj/effect/turf_decal/box/corners{
	dir = 8
	},
/obj/item/stack/sheet/plastic/five,
/turf/open/floor/plasteel/tech/grid,
/area/ship/cargo)
"qT" = (
/obj/structure/guncloset,
/obj/item/gun/ballistic/automatic/pistol/candor/no_mag,
/obj/item/gun/ballistic/automatic/pistol/candor/no_mag,
/turf/open/floor/plasteel,
/area/ship/cargo)
"rl" = (
/turf/closed/wall/r_wall/rust,
/area/ship/cargo)
"rs" = (
/obj/structure/railing{
	dir = 6
	},
/obj/machinery/power/terminal{
	dir = 1
	},
/obj/structure/cable/yellow{
	icon_state = "0-10"
	},
/turf/open/floor/plasteel/patterned,
/area/ship/engineering)
"rK" = (
/obj/structure/cable{
	icon_state = "1-2"
	},
/obj/effect/turf_decal/spline/fancy/opaque/black{
	dir = 8
	},
/obj/structure/railing/corner{
	dir = 4
	},
/obj/machinery/atmospherics/pipe/simple/scrubbers/hidden/layer4,
/turf/open/floor/plasteel/patterned,
/area/ship/engineering)
"rR" = (
/turf/closed/wall/r_wall,
/area/ship/bridge)
"sq" = (
/turf/closed/wall/yesdiag,
/area/ship/engineering)
"tb" = (
/obj/structure/table/reinforced,
/obj/item/binoculars{
	pixel_y = 2
	},
/obj/machinery/light/small/directional/east,
/turf/open/floor/plasteel/tech/grid,
/area/ship/bridge)
"tc" = (
/turf/open/floor/engine/hull,
/area/ship/external/dark)
"tt" = (
/obj/machinery/power/terminal{
	dir = 1
	},
/obj/structure/cable{
	icon_state = "0-2"
	},
/obj/effect/turf_decal/spline/fancy/opaque/black{
	dir = 8
	},
/obj/effect/decal/cleanable/dirt/dust,
/turf/open/floor/plasteel/patterned,
/area/ship/engineering)
"tP" = (
/obj/structure/railing{
	dir = 5
	},
/obj/structure/cable/yellow{
	icon_state = "0-9"
	},
/obj/effect/decal/cleanable/dirt/dust,
/obj/effect/decal/cleanable/dirt/dust,
/obj/machinery/power/port_gen/pacman,
/obj/item/stack/sheet/mineral/plasma/five,
/turf/open/floor/plasteel/patterned,
/area/ship/engineering)
"uO" = (
/obj/structure/window/reinforced{
	dir = 4
	},
/obj/machinery/atmospherics/pipe/simple/scrubbers/hidden/layer4,
/obj/structure/grille,
/obj/structure/window/reinforced,
/obj/machinery/door/poddoor/shutters{
	id = "rhodes_engines"
	},
/turf/open/floor/plating,
/area/ship/engineering)
"vr" = (
/turf/closed/wall/rust/yesdiag,
/area/ship/engineering)
"vz" = (
/turf/open/floor/plasteel/patterned/grid,
/area/ship/cargo)
"vY" = (
/obj/structure/cable{
	icon_state = "2-5"
	},
/obj/structure/cable{
	icon_state = "1-5"
	},
/obj/effect/turf_decal/spline/fancy/opaque/black{
	dir = 8
	},
/obj/structure/railing/corner,
/obj/structure/cable{
	icon_state = "2-8"
	},
/obj/machinery/atmospherics/pipe/simple/scrubbers/hidden/layer4{
	dir = 10
	},
/turf/open/floor/plasteel/patterned,
/area/ship/engineering)
"wr" = (
/turf/closed/wall/yesdiag,
/area/ship/cargo)
"xi" = (
/turf/closed/wall/r_wall/rust,
/area/ship/bridge)
"xo" = (
/turf/closed/wall/rust,
/area/ship/engineering)
"yk" = (
/obj/structure/cable{
	icon_state = "2-8"
	},
/obj/structure/cable{
	icon_state = "5-6"
	},
/obj/effect/decal/cleanable/dirt,
/turf/open/floor/plasteel/patterned/grid,
/area/ship/cargo)
"yA" = (
/obj/effect/turf_decal/spline/fancy/opaque/black{
	dir = 8
	},
/obj/structure/closet/crate/medical,
/obj/effect/mapping_helpers/crate_shelve,
/obj/item/storage/firstaid/ancient{
	pixel_x = 3
	},
/obj/item/reagent_containers/hypospray/medipen{
	pixel_x = -8
	},
/obj/item/reagent_containers/hypospray/medipen{
	pixel_x = -5;
	pixel_y = -3
	},
/turf/open/floor/plasteel/patterned/grid,
/area/ship/cargo)
"zn" = (
/turf/closed/wall/r_wall,
/area/ship/cargo)
"zF" = (
/turf/closed/wall,
/area/ship/engineering)
"zL" = (
/obj/structure/platform/ship_three{
	dir = 4
	},
/obj/item/radio/intercom/directional/north,
/obj/effect/turf_decal/industrial/outline/yellow,
/obj/structure/closet/crate/large{
	name = "large air canister crate"
	},
/obj/machinery/portable_atmospherics/canister/air,
/turf/open/floor/plasteel/patterned/cargo_one,
/area/ship/cargo)
"Bj" = (
/obj/structure/cable/yellow{
	icon_state = "5-6"
	},
/obj/structure/cable{
	icon_state = "1-2"
	},
/obj/structure/cable{
	icon_state = "1-4"
	},
/obj/effect/turf_decal/spline/fancy/opaque/black{
	dir = 8
	},
/obj/structure/railing/corner{
	dir = 4
	},
/obj/machinery/atmospherics/pipe/simple/scrubbers/hidden/layer4,
/obj/machinery/light/dim/directional/west,
/obj/effect/decal/cleanable/dirt/dust,
/turf/open/floor/plasteel/patterned,
/area/ship/engineering)
"Bo" = (
/obj/machinery/computer/helm/retro{
	dir = 8
	},
/turf/open/floor/plasteel/tech/grid,
/area/ship/bridge)
"Dw" = (
/obj/structure/grille,
/obj/structure/window/reinforced/fulltile,
/obj/machinery/door/poddoor/shutters/preopen{
	id = "rhodes_airlock";
	dir = 4
	},
/turf/open/floor/plating,
/area/ship/engineering)
"EQ" = (
/obj/structure/platform/ship_three/corner{
	dir = 4
	},
/obj/structure/platform/ship_three/corner{
	dir = 1
	},
/obj/structure/railing/corner{
	dir = 1
	},
/obj/structure/cable{
	icon_state = "4-8"
	},
/turf/open/floor/plasteel/patterned/cargo_one,
/area/ship/cargo)
"Fg" = (
/obj/effect/turf_decal/miskilamo_small,
/turf/open/floor/plasteel/patterned/grid,
/area/ship/cargo)
"Fh" = (
/obj/machinery/portable_atmospherics/canister/air,
/obj/machinery/atmospherics/components/unary/portables_connector/layer2,
/turf/open/floor/plasteel/tech,
/area/ship/engineering)
"GA" = (
/obj/machinery/door/airlock/external,
/turf/open/floor/plasteel/tech,
/area/ship/engineering)
"GN" = (
/obj/machinery/suit_storage_unit/inherit/industrial,
/obj/item/clothing/suit/space/eva,
/obj/item/clothing/mask/breath,
/obj/item/clothing/head/helmet/space/eva,
/turf/open/floor/plasteel,
/area/ship/cargo)
"Ht" = (
/turf/closed/wall/r_wall/yesdiag,
/area/ship/bridge)
"HK" = (
/obj/structure/platform/ship_three/corner,
/obj/structure/railing/thin/corner,
/obj/structure/railing/thin/corner{
	dir = 8
	},
/obj/structure/cable{
	icon_state = "4-5"
	},
/turf/open/floor/plasteel,
/area/ship/cargo)
"Io" = (
/obj/effect/decal/cleanable/dirt,
/obj/effect/decal/cleanable/dirt,
/obj/machinery/door/airlock/external,
/obj/machinery/atmospherics/pipe/layer_manifold,
/turf/open/floor/plasteel/tech,
/area/ship/engineering)
"IW" = (
/obj/effect/turf_decal/spline/fancy/opaque/black{
	dir = 4
	},
/obj/effect/decal/cleanable/dirt/dust,
/turf/open/floor/plasteel/patterned/grid,
/area/ship/cargo)
"JP" = (
/obj/structure/cable{
	icon_state = "2-9"
	},
/obj/effect/turf_decal/spline/fancy/opaque/black{
	dir = 4
	},
/turf/open/floor/plasteel/patterned/grid,
/area/ship/cargo)
"JQ" = (
/obj/machinery/power/apc/auto_name/directional/west,
/obj/structure/cable{
	icon_state = "0-4"
	},
/obj/machinery/light_switch{
	dir = 4;
	pixel_x = -20;
	pixel_y = 12
	},
/obj/machinery/atmospherics/pipe/simple/scrubbers/hidden/layer4{
	dir = 6
	},
/obj/machinery/atmospherics/pipe/simple/supply/hidden/layer2,
/turf/open/floor/plasteel/tech,
/area/ship/engineering)
"KK" = (
/obj/structure/platform/ship_three{
	dir = 8
	},
/obj/structure/crate_shelf,
/obj/structure/closet/crate/solarpanel_small,
/obj/machinery/light/small/directional/north,
/obj/effect/turf_decal/borderfloor{
	dir = 4
	},
/obj/effect/turf_decal/box/corners{
	dir = 1
	},
/obj/effect/turf_decal/box/corners{
	dir = 8
	},
/turf/open/floor/plasteel/tech/grid,
/area/ship/cargo)
"Lh" = (
/obj/machinery/atmospherics/components/binary/dp_vent_pump/layer2,
/obj/machinery/atmospherics/pipe/simple/scrubbers/hidden/layer4,
/obj/effect/decal/cleanable/dirt,
/obj/item/radio/intercom/directional/west,
/obj/structure/chair/handrail{
	dir = 4
	},
/turf/open/floor/plasteel/tech,
/area/ship/engineering)
"Ly" = (
/obj/effect/turf_decal/industrial/warning{
	dir = 4
	},
/obj/machinery/computer/cryopod/retro/directional/south,
/obj/effect/decal/cleanable/dirt,
/turf/open/floor/plasteel/patterned,
/area/ship/cargo)
"Lz" = (
/obj/structure/railing/corner{
	dir = 1
	},
/obj/structure/cable{
	icon_state = "1-8"
	},
/obj/effect/decal/cleanable/dirt/dust,
/turf/open/floor/plasteel,
/area/ship/bridge)
"LA" = (
/obj/machinery/power/shieldwallgen/atmos/roundstart{
	dir = 4;
	id = "rhodes_port_field"
	},
/obj/structure/cable{
	icon_state = "0-2"
	},
/obj/effect/turf_decal/spline/fancy/opaque/black{
	dir = 8
	},
/obj/machinery/door/poddoor{
	id = "rhodes_port"
	},
/turf/open/floor/plasteel/patterned/ridged,
/area/ship/cargo)
"LJ" = (
/obj/structure/table/reinforced,
/obj/machinery/button/shieldwallgen{
	dir = 8;
	pixel_x = 6;
	id = "rhodes_port_field";
	pixel_y = -3
	},
/obj/machinery/button/shieldwallgen{
	dir = 8;
	pixel_x = -5;
	id = "rhodes_starboard_field";
	pixel_y = 8
	},
/obj/machinery/button/door{
	dir = 8;
	pixel_x = 8;
	pixel_y = 6;
	id = "rhodes_port"
	},
/obj/machinery/button/door{
	dir = 8;
	pixel_x = -3;
	pixel_y = -1;
	id = "rhodes_starboard"
	},
/turf/open/floor/plasteel/tech/grid,
/area/ship/bridge)
"Mg" = (
/obj/effect/turf_decal/industrial/loading/stripes,
/obj/structure/closet/wall/directional/east,
/obj/item/storage/box/ammo/c45,
/obj/item/storage/box/ammo/c45{
	pixel_y = 8
	},
/obj/item/ammo_box/magazine/m45/empty,
/obj/item/ammo_box/magazine/m45/empty,
/obj/item/ammo_box/magazine/m45/empty{
	pixel_x = 5;
	pixel_y = -1
	},
/obj/item/ammo_box/magazine/m45/empty{
	pixel_x = 5;
	pixel_y = -1
	},
/turf/open/floor/plasteel,
/area/ship/cargo)
"Mi" = (
/obj/machinery/light/small/directional/east,
/obj/machinery/computer/crew/retro,
/turf/open/floor/plasteel/tech/grid,
/area/ship/bridge)
"Nv" = (
/obj/effect/decal/cleanable/dirt,
/obj/machinery/door/poddoor{
	id = "rhodes_port"
	},
/obj/docking_port/mobile{
	dir = 2;
	launch_status = 0;
	name = "Colony Shuttle";
	port_direction = 8;
	preferred_direction = 4
	},
/turf/open/floor/plasteel/patterned/ridged,
/area/ship/cargo)
"NG" = (
/obj/machinery/cryopod/poor{
	dir = 8
	},
/obj/effect/turf_decal/box,
/turf/open/floor/plasteel/tech/grid,
/area/ship/cargo)
"Of" = (
/obj/machinery/power/terminal,
/obj/structure/cable,
/obj/effect/turf_decal/spline/fancy/opaque/black{
	dir = 8
	},
/obj/machinery/atmospherics/pipe/simple/scrubbers/hidden/layer4{
	dir = 5
	},
/obj/effect/decal/cleanable/dirt/dust,
/obj/machinery/button/door{
	dir = 4;
	id = "rhodes_engines";
	name = "engine shutters";
	pixel_x = -20;
	pixel_y = -7
	},
/obj/machinery/button/door{
	dir = 4;
	id = "rhodes_airlock";
	name = "airlock window shutters";
	pixel_x = -20;
	pixel_y = 7
	},
/turf/open/floor/plasteel/patterned,
/area/ship/engineering)
"Om" = (
/obj/structure/table/reinforced,
/obj/item/radio/intercom/table{
	dir = 4;
	pixel_y = 4;
	pixel_x = 4
	},
/obj/machinery/button/door{
	pixel_y = 23;
	pixel_x = -3
	},
/turf/open/floor/plasteel/tech/grid,
/area/ship/bridge)
"PJ" = (
/obj/structure/railing{
	dir = 4
	},
/obj/machinery/power/smes/engineering,
/obj/structure/cable{
	icon_state = "0-10"
	},
/obj/item/radio/intercom/directional/north,
/turf/open/floor/plasteel/patterned,
/area/ship/engineering)
"Ql" = (
/obj/structure/cable{
	icon_state = "9-10"
	},
/obj/structure/cable{
	icon_state = "1-9"
	},
/obj/structure/cable{
	icon_state = "4-9"
	},
/obj/effect/turf_decal/miskilamo_small/right,
/obj/effect/turf_decal/spline/fancy/opaque/black{
	dir = 4
	},
/obj/effect/decal/cleanable/dirt/dust,
/turf/open/floor/plasteel/patterned/grid,
/area/ship/cargo)
"Qv" = (
/obj/effect/turf_decal/spline/fancy/opaque/black{
	dir = 8
	},
/turf/open/floor/plasteel/patterned/grid,
/area/ship/cargo)
"QY" = (
/turf/closed/wall/rust/yesdiag,
/area/ship/cargo)
"Rb" = (
/obj/structure/railing/corner{
	dir = 8
	},
/obj/effect/decal/cleanable/dirt,
/turf/open/floor/plasteel,
/area/ship/cargo)
"Rm" = (
/obj/structure/platform/ship_three{
	dir = 8
	},
/obj/structure/crate_shelf,
/obj/effect/turf_decal/borderfloor{
	dir = 6
	},
/obj/effect/turf_decal/box/corners{
	dir = 1
	},
/obj/structure/closet/crate/rations,
/turf/open/floor/plasteel/tech/grid,
/area/ship/cargo)
"RN" = (
/obj/structure/grille,
/obj/structure/window/reinforced/fulltile,
/obj/machinery/door/poddoor/shutters{
	id = "rhodes_bridge"
	},
/turf/open/floor/plating,
/area/ship/bridge)
"Sb" = (
/obj/machinery/atmospherics/components/unary/passive_vent/layer4{
	dir = 1
	},
/turf/open/floor/engine/hull,
/area/ship/external/dark)
"Sj" = (
/obj/effect/decal/cleanable/dirt/dust,
/obj/effect/turf_decal/corner_techfloor_grid/full{
	dir = 4
	},
/obj/effect/turf_decal/box/corners{
	dir = 1
	},
/obj/machinery/holopad/secure,
/turf/open/floor/plasteel,
/area/ship/bridge)
"Sz" = (
/turf/closed/wall/rust,
/area/ship/cargo)
"SW" = (
/obj/structure/cable{
	icon_state = "9-10"
	},
/obj/effect/turf_decal/corner_techfloor_grid{
	dir = 6
	},
/turf/open/floor/plasteel,
/area/ship/bridge)
"Tw" = (
/obj/machinery/power/shieldwallgen/atmos/roundstart{
	dir = 8;
	id = "rhodes_starboard_field"
	},
/obj/structure/cable,
/obj/effect/turf_decal/spline/fancy/opaque/black{
	dir = 4
	},
/obj/machinery/door/poddoor{
	id = "rhodes_starboard"
	},
/turf/open/floor/plasteel/patterned/ridged,
/area/ship/cargo)
"Tx" = (
/obj/machinery/power/smes/shuttle/precharged{
	dir = 2
	},
/obj/structure/cable,
/obj/structure/window/reinforced{
	dir = 1
	},
/obj/machinery/door/poddoor/shutters{
	id = "rhodes_engines"
	},
/turf/open/floor/plating,
/area/ship/engineering)
"UW" = (
/obj/structure/railing{
	dir = 9
	},
/turf/open/floor/plasteel,
/area/ship/cargo)
"WM" = (
/obj/machinery/computer/helm/viewscreen/directional/east,
/turf/open/floor/plasteel,
/area/ship/cargo)
"WT" = (
/obj/structure/grille,
/obj/structure/window/reinforced/fulltile,
/obj/machinery/door/poddoor/shutters{
	id = "rhodes_bridge";
	dir = 4
	},
/turf/open/floor/plating,
/area/ship/bridge)
"Xj" = (
/obj/structure/cable{
	icon_state = "2-5"
	},
/obj/effect/turf_decal/spline/fancy/opaque/black{
	dir = 8
	},
/obj/effect/decal/cleanable/dirt,
/turf/open/floor/plasteel/patterned/grid,
/area/ship/cargo)
"XU" = (
/turf/closed/wall,
/area/ship/cargo)
"XX" = (
/obj/structure/chair/office,
/obj/structure/cable{
	icon_state = "0-5"
	},
/obj/machinery/power/apc/auto_name/directional/west,
/obj/effect/decal/cleanable/dirt/dust,
/obj/machinery/light_switch{
	dir = 4;
	pixel_x = -20;
	pixel_y = 12
	},
/obj/effect/turf_decal/corner_techfloor_grid{
	dir = 10
	},
/obj/effect/turf_decal/box/corners{
	dir = 4
	},
/obj/effect/turf_decal/box/corners{
	dir = 1
	},
/turf/open/floor/plasteel,
/area/ship/bridge)
"Yj" = (
/obj/structure/railing{
	dir = 8
	},
/obj/machinery/autolathe,
/obj/machinery/light/dim/directional/north,
/turf/open/floor/plasteel,
/area/ship/cargo)
"Yt" = (
/obj/structure/platform/ship_three,
/obj/structure/window/reinforced,
/obj/machinery/power/apc/auto_name/directional/east,
/obj/structure/cable{
	icon_state = "0-8"
	},
/obj/effect/decal/cleanable/dirt/dust,
/obj/machinery/light_switch{
	dir = 8;
	pixel_x = 20;
	pixel_y = 12
	},
/turf/open/floor/plasteel,
/area/ship/cargo)
"Yw" = (
/obj/structure/platform/ship_three{
	dir = 1
	},
/obj/structure/platform/ship_three,
/obj/structure/railing{
	dir = 1
	},
/obj/structure/cable{
	icon_state = "4-8"
	},
/turf/open/floor/plasteel/stairs/old{
	dir = 4
	},
/area/ship/cargo)
"YU" = (
/obj/structure/cable{
	icon_state = "1-4"
	},
/obj/effect/turf_decal/spline/fancy/opaque/black{
	dir = 8
	},
/turf/open/floor/plasteel/patterned/grid,
/area/ship/cargo)
"Zg" = (
/obj/structure/platform/ship_three{
	dir = 8
	},
/obj/effect/turf_decal/borderfloor{
	dir = 5
	},
/obj/effect/turf_decal/box/corners{
	dir = 8
	},
/obj/structure/ore_box,
/turf/open/floor/plasteel/tech/grid,
/area/ship/cargo)

(1,1,1) = {"
fD
sq
zF
zF
xo
xo
xo
vr
fD
"}
(2,1,1) = {"
fD
zF
Fh
JQ
Io
Lh
ou
GA
fD
"}
(3,1,1) = {"
nb
zF
hT
oD
zF
Dw
zF
zF
cJ
"}
(4,1,1) = {"
qg
Tx
tt
vY
Bj
rK
Of
bO
pv
"}
(5,1,1) = {"
tc
xo
PJ
rs
gU
tP
mn
uO
Sb
"}
(6,1,1) = {"
fD
Sz
KK
Rm
EQ
Zg
qL
XU
fD
"}
(7,1,1) = {"
fD
LA
YU
yA
km
Qv
Xj
gN
fD
"}
(8,1,1) = {"
fD
Nv
yk
ed
Fg
fG
vz
nG
fD
"}
(9,1,1) = {"
fD
nN
mb
JP
Ql
IW
JP
Tw
fD
"}
(10,1,1) = {"
fD
XU
zL
gi
fM
eH
cY
Sz
fD
"}
(11,1,1) = {"
QY
XU
Yj
lE
Yw
UW
aE
Sz
wr
"}
(12,1,1) = {"
Sz
GN
nR
Rb
nv
HK
pJ
aD
Sz
"}
(13,1,1) = {"
Sz
qT
jC
WM
ie
Yt
ad
Ly
XU
"}
(14,1,1) = {"
XU
GN
Mg
rR
iX
xi
NG
NG
XU
"}
(15,1,1) = {"
wr
zn
zn
rR
hJ
xi
rl
zn
QY
"}
(16,1,1) = {"
fD
RN
ob
dC
Lz
XX
dd
RN
fD
"}
(17,1,1) = {"
fD
RN
Mi
du
SW
Sj
tb
RN
fD
"}
(18,1,1) = {"
fD
Ht
xi
Om
Bo
LJ
rR
py
fD
"}
(19,1,1) = {"
fD
fD
py
WT
WT
WT
Ht
fD
fD
"}
