//MAP CONVERTED BY dmm2tgm.py THIS HEADER COMMENT PREVENTS RECONVERSION, DO NOT REMOVE
"ab" = (
/turf/open/space/basic,
/area/space)
"be" = (
/obj/effect/turf_decal/techfloor/orange{
	dir = 1
	},
/obj/effect/turf_decal/techfloor/orange,
/turf/open/floor/plasteel/tech/grid,
/area/space)
"cq" = (
/obj/effect/turf_decal/corner_steel_grid{
	dir = 6
	},
/turf/open/floor/plasteel/mono/dark,
/area/space)
"cv" = (
/turf/open/floor/engine/hull/interior,
/area/space)
"cN" = (
/obj/machinery/atmospherics/components/unary/vent_pump/high_volume/siphon/on{
	dir = 1
	},
/turf/open/floor/engine/o2,
/area/space)
"dm" = (
/obj/structure/railing/thin/corner{
	dir = 8
	},
/turf/open/floor/plasteel/tech/techmaint,
/area/space)
"ed" = (
/turf/open/floor/plasteel/stairs{
	icon = 'icons/obj/stairs.dmi';
	dir = 4
	},
/area/space)
"ff" = (
/obj/effect/turf_decal/trimline/opaque/blue/filled/warning{
	dir = 1
	},
/obj/effect/turf_decal/trimline/opaque/blue/filled/warning,
/turf/open/floor/mineral/titanium/tiled,
/area/space)
"fT" = (
/obj/machinery/atmospherics/pipe/layer_manifold{
	dir = 4
	},
/turf/open/space/basic,
/area/space)
"hy" = (
/obj/machinery/atmospherics/pipe/simple/purple/hidden,
/turf/open/floor/plating,
/area/space)
"ia" = (
/obj/machinery/atmospherics/components/binary/valve/layer4,
/obj/machinery/atmospherics/components/binary/pump/layer2{
	dir = 1;
	name = "Hydrogen To Fuel Line"
	},
/obj/machinery/atmospherics/components/binary/pump{
	dir = 1;
	name = "Hydrogen To Burn"
	},
/turf/open/floor/plating,
/area/space)
"iM" = (
/obj/structure/chair/sofa/blue/left/directional/south,
/turf/open/space/basic,
/area/space)
"iS" = (
/obj/effect/turf_decal/borderfloor{
	dir = 1
	},
/turf/open/floor/mineral/titanium,
/area/space)
"jf" = (
/turf/closed/wall/mineral/titanium,
/turf/closed/wall/mineral/titanium,
/area/space)
"kr" = (
/obj/machinery/atmospherics/components/unary/portables_connector/visible/layer4,
/obj/machinery/atmospherics/pipe/simple/purple/hidden,
/turf/open/floor/plating,
/area/space)
"ml" = (
/obj/effect/turf_decal/industrial/warning{
	dir = 1
	},
/turf/open/floor/plasteel/patterned/cargo_one,
/area/space)
"nq" = (
/obj/effect/turf_decal/industrial/warning/corner{
	dir = 1
	},
/obj/effect/turf_decal/industrial/warning/corner{
	dir = 4
	},
/turf/open/floor/plasteel/patterned/cargo_one,
/area/space)
"pv" = (
/obj/effect/turf_decal/techfloor,
/obj/machinery/modular_computer/console/preset/command{
	dir = 1;
	icon_state = "computer-middle"
	},
/turf/open/floor/plasteel/telecomms_floor,
/area/space)
"pG" = (
/obj/structure/railing/thin{
	dir = 10
	},
/turf/open/floor/plasteel/tech/techmaint,
/area/space)
"rx" = (
/obj/machinery/power/generator,
/turf/open/space/basic,
/area/space)
"rY" = (
/obj/effect/turf_decal/trimline/opaque/blue/filled,
/turf/open/floor/mineral/titanium/tiled,
/area/space)
"sf" = (
/turf/open/floor/plating,
/area/space)
"ss" = (
/turf/open/floor/plasteel/tech,
/area/space)
"tq" = (
/obj/effect/turf_decal/industrial/outline/yellow,
/obj/structure/crate_shelf{
	capacity = 2
	},
/turf/open/floor/plasteel/patterned/ridged,
/area/space)
"tZ" = (
/obj/item/radio/intercom/wideband/directional/north,
/obj/effect/turf_decal/techfloor{
	dir = 1
	},
/turf/open/floor/plasteel/telecomms_floor,
/area/space)
"uk" = (
/obj/machinery/atmospherics/components/binary/valve/layer4,
/obj/machinery/atmospherics/pipe/simple/purple/hidden,
/turf/open/floor/plating,
/area/space)
"uM" = (
/turf/open/floor/plasteel/mono/dark,
/area/space)
"wo" = (
/obj/effect/turf_decal/techfloor{
	dir = 4
	},
/obj/machinery/computer/helm{
	dir = 8
	},
/turf/open/floor/plasteel/telecomms_floor,
/area/space)
"xL" = (
/obj/effect/turf_decal/borderfloor{
	dir = 6
	},
/turf/open/floor/mineral/titanium,
/area/space)
"AV" = (
/obj/machinery/atmospherics/components/binary/circulator/cold{
	dir = 1
	},
/turf/open/space/basic,
/area/space)
"Di" = (
/obj/effect/turf_decal/borderfloor,
/obj/effect/turf_decal/borderfloor{
	dir = 1
	},
/turf/open/floor/mineral/titanium,
/area/space)
"Dj" = (
/obj/structure/grille,
/obj/structure/window/reinforced/fulltile/shuttle,
/turf/open/floor/engine/hull/interior,
/area/space)
"Eq" = (
/obj/effect/turf_decal/techfloor,
/turf/open/floor/plasteel/telecomms_floor,
/area/space)
"EE" = (
/obj/structure/railing/thin,
/turf/open/floor/plasteel/stairs{
	icon = 'icons/obj/stairs.dmi';
	dir = 4
	},
/area/space)
"FZ" = (
/obj/machinery/atmospherics/components/binary/valve/layer4,
/obj/machinery/atmospherics/components/binary/pump/layer2{
	dir = 1;
	name = "Oxygen To Fuel Line"
	},
/obj/machinery/atmospherics/pipe/simple/purple/hidden{
	dir = 6
	},
/turf/open/floor/plating,
/area/space)
"Gh" = (
/obj/structure/table/optable,
/turf/open/floor/mineral/titanium/tiled,
/area/space)
"Gk" = (
/obj/effect/turf_decal/industrial/outline/yellow,
/obj/structure/crate_shelf,
/turf/open/floor/plasteel/patterned/ridged,
/area/space)
"GY" = (
/turf/open/floor/plasteel/tech/grid,
/area/space)
"HD" = (
/turf/closed/wall/mineral/titanium,
/area/space)
"Ic" = (
/obj/machinery/atmospherics/pipe/simple/purple/hidden{
	dir = 9
	},
/turf/open/floor/plating,
/area/space)
"Ig" = (
/obj/effect/turf_decal/borderfloor{
	dir = 10
	},
/turf/open/floor/mineral/titanium,
/area/space)
"JC" = (
/obj/structure/railing/thin,
/turf/open/floor/plasteel/tech/techmaint,
/area/space)
"KG" = (
/obj/machinery/atmospherics/components/trinary/mixer/airmix/flipped{
	dir = 4
	},
/turf/open/space/basic,
/area/space)
"Lw" = (
/obj/machinery/atmospherics/components/unary/portables_connector/visible,
/turf/open/space/basic,
/area/space)
"LG" = (
/obj/machinery/atmospherics/pipe/simple/purple/hidden{
	dir = 10
	},
/turf/open/space/basic,
/area/space)
"Md" = (
/obj/machinery/atmospherics/pipe/layer_manifold,
/turf/open/floor/plating,
/area/space)
"Mp" = (
/obj/structure/chair/sofa/blue/right/directional/east,
/turf/open/space/basic,
/area/space)
"MI" = (
/obj/structure/chair/sofa/blue/directional/south,
/turf/open/space/basic,
/area/space)
"MK" = (
/obj/effect/turf_decal/borderfloor{
	dir = 5
	},
/turf/open/floor/mineral/titanium,
/area/space)
"MY" = (
/turf/open/floor/plasteel/patterned/cargo_one,
/area/space)
"Nb" = (
/obj/effect/turf_decal/borderfloor/full,
/obj/effect/turf_decal/borderfloor/corner{
	dir = 1
	},
/obj/effect/turf_decal/borderfloor/corner{
	dir = 8
	},
/obj/effect/turf_decal/borderfloor/corner{
	dir = 4
	},
/turf/open/floor/mineral/titanium,
/area/space)
"OQ" = (
/turf/open/floor/plasteel/tech/techmaint,
/area/space)
"Qc" = (
/obj/structure/table/chem,
/turf/open/floor/mineral/titanium/tiled,
/area/space)
"Qt" = (
/obj/effect/turf_decal/borderfloor,
/turf/open/floor/mineral/titanium,
/area/space)
"RN" = (
/obj/machinery/atmospherics/components/unary/portables_connector/visible/layer4,
/turf/open/floor/plating,
/area/space)
"Sa" = (
/obj/effect/turf_decal/borderfloor{
	dir = 8
	},
/obj/effect/turf_decal/borderfloor{
	dir = 4
	},
/turf/open/floor/mineral/titanium,
/area/space)
"Sj" = (
/obj/machinery/power/shuttle/engine/fire,
/turf/open/floor/engine/hull/interior,
/area/space)
"Sq" = (
/obj/machinery/stasis{
	dir = 8
	},
/turf/open/floor/mineral/titanium/tiled,
/area/space)
"SE" = (
/obj/machinery/atmospherics/components/unary/vent_pump/high_volume/siphon/on{
	dir = 1
	},
/turf/open/floor/engine/hydrogen,
/area/space)
"Vx" = (
/obj/effect/turf_decal/industrial/warning{
	dir = 8
	},
/obj/effect/turf_decal/industrial/warning{
	dir = 4
	},
/turf/open/floor/plasteel/patterned/cargo_one,
/area/space)
"Wt" = (
/obj/structure/grille,
/obj/structure/window/reinforced/fulltile/shuttle,
/turf/open/floor/plating,
/area/space)
"WE" = (
/obj/structure/window/reinforced/fulltile/shuttle,
/obj/structure/grille,
/turf/open/floor/engine/hull/interior,
/area/space)
"Xh" = (
/turf/closed/wall/mineral/plastitanium,
/area/space)
"XY" = (
/obj/machinery/atmospherics/components/binary/circulator{
	dir = 2
	},
/turf/open/space/basic,
/area/space)
"Yi" = (
/obj/structure/chair/sofa/blue/corner/directional/east,
/turf/open/space/basic,
/area/space)
"Za" = (
/obj/machinery/atmospherics/components/unary/vent_pump/high_volume/siphon/on{
	dir = 1
	},
/turf/open/floor/engine/n2,
/area/space)
"Zz" = (
/turf/open/floor/mineral/titanium/tiled,
/area/space)

(1,1,1) = {"
ab
ab
ab
ab
ab
ab
ab
Xh
ab
ab
ab
ab
ab
ab
ab
ab
ab
"}
(2,1,1) = {"
ab
ab
ab
ab
ab
ab
ab
Xh
ab
ab
ab
ab
ab
ab
ab
ab
ab
"}
(3,1,1) = {"
ab
ab
ab
ab
Xh
Sj
Sj
Xh
Sj
Sj
Xh
ab
ab
ab
ab
ab
ab
"}
(4,1,1) = {"
ab
ab
Xh
cv
Xh
ab
ab
Xh
ab
ab
Xh
Xh
cv
Xh
ab
ab
ab
"}
(5,1,1) = {"
ab
ab
Xh
cv
Dj
ab
ab
ab
ab
ab
ab
Xh
ab
Xh
ab
ab
ab
"}
(6,1,1) = {"
Xh
cv
Xh
cv
WE
ab
XY
rx
AV
ab
ab
GY
GY
Xh
ab
ab
ab
"}
(7,1,1) = {"
Xh
ab
Xh
Xh
Xh
ab
ab
ab
ab
ab
ab
Xh
Xh
Xh
ab
ab
ab
"}
(8,1,1) = {"
Xh
GY
GY
OQ
OQ
pG
ab
Lw
ab
RN
ia
Md
SE
Xh
HD
ab
ab
"}
(9,1,1) = {"
Xh
Xh
Xh
OQ
OQ
JC
ab
ab
fT
sf
sf
Xh
Xh
Xh
HD
ab
ab
"}
(10,1,1) = {"
Xh
ab
GY
OQ
OQ
JC
ed
EE
ab
RN
FZ
Md
cN
Xh
HD
ab
ab
"}
(11,1,1) = {"
Xh
ab
Xh
OQ
OQ
dm
OQ
JC
KG
hy
Ic
Xh
Xh
Xh
HD
ab
ab
"}
(12,1,1) = {"
Xh
GY
Xh
Xh
Xh
OQ
OQ
JC
LG
kr
uk
Md
Za
Xh
HD
ab
ab
"}
(13,1,1) = {"
ab
ab
HD
HD
HD
HD
GY
HD
HD
HD
HD
HD
Xh
Xh
HD
ab
ab
"}
(14,1,1) = {"
ab
ab
HD
Gk
Gk
ml
MY
MY
HD
ab
ab
HD
HD
HD
HD
ab
ab
"}
(15,1,1) = {"
ab
ab
be
Vx
Vx
nq
MY
MY
GY
ab
ab
HD
ab
ab
HD
ab
ab
"}
(16,1,1) = {"
ab
ab
HD
Gk
Gk
ml
MY
MY
HD
ab
ab
GY
ab
ab
HD
ab
ab
"}
(17,1,1) = {"
ab
ab
HD
HD
HD
GY
HD
HD
HD
GY
HD
HD
HD
HD
HD
HD
ab
"}
(18,1,1) = {"
ab
ab
jf
ab
ab
ab
HD
Zz
Zz
Di
tq
Wt
Zz
Gh
HD
ab
ab
"}
(19,1,1) = {"
ab
ab
be
ab
ab
ab
HD
Zz
Zz
Di
tq
Wt
Zz
Zz
HD
ab
ab
"}
(20,1,1) = {"
ab
ab
be
ab
ab
ab
GY
Sa
Sa
Nb
Ig
HD
sf
HD
HD
ab
ab
"}
(21,1,1) = {"
ab
ab
be
ab
ab
ab
HD
Qc
Zz
iS
Qt
ff
Zz
Qc
HD
ab
ab
"}
(22,1,1) = {"
ab
ab
HD
ab
ab
ab
HD
Qc
Zz
iS
Qt
ff
Zz
Sq
HD
ab
ab
"}
(23,1,1) = {"
ab
ab
HD
HD
HD
HD
HD
Qc
Qc
MK
xL
rY
HD
HD
HD
HD
ab
"}
(24,1,1) = {"
ab
ab
ab
ab
ab
HD
HD
HD
HD
HD
ab
HD
HD
ab
HD
ab
ab
"}
(25,1,1) = {"
ab
ab
ab
ab
ab
HD
ab
ab
ab
ab
ab
ab
HD
ab
HD
ab
ab
"}
(26,1,1) = {"
ab
ab
ab
ab
ab
HD
ab
ab
HD
ab
ab
ab
ab
ab
HD
ab
ab
"}
(27,1,1) = {"
ab
ab
ab
ab
HD
HD
HD
HD
HD
HD
ab
ab
HD
HD
HD
HD
ab
"}
(28,1,1) = {"
ab
ab
ab
ab
ab
HD
ab
ab
HD
ab
ab
ab
HD
ss
ss
HD
HD
"}
(29,1,1) = {"
ab
ab
ab
ab
ab
HD
ab
ab
HD
ab
ab
ab
ab
uM
uM
ss
HD
"}
(30,1,1) = {"
ab
ab
ab
ab
ab
HD
ab
ab
ab
ab
ab
ab
HD
uM
uM
Eq
Wt
"}
(31,1,1) = {"
ab
ab
ab
ab
ab
HD
ab
ab
HD
ab
ab
ab
HD
tZ
cq
pv
Wt
"}
(32,1,1) = {"
ab
ab
ab
ab
HD
HD
HD
HD
HD
ab
ab
ab
HD
HD
wo
Wt
Wt
"}
(33,1,1) = {"
ab
ab
ab
ab
ab
HD
HD
Yi
Mp
ab
ab
ab
ab
HD
HD
Wt
ab
"}
(34,1,1) = {"
ab
ab
ab
ab
ab
ab
HD
MI
ab
ab
ab
ab
ab
Wt
ab
ab
ab
"}
(35,1,1) = {"
ab
ab
ab
ab
ab
ab
HD
iM
ab
ab
ab
ab
Wt
Wt
ab
ab
ab
"}
(36,1,1) = {"
ab
ab
ab
ab
ab
ab
HD
Wt
Wt
Wt
Wt
Wt
Wt
ab
ab
ab
ab
"}
