//MAP CONVERTED BY dmm2tgm.py THIS HEADER COMMENT PREVENTS RECONVERSION, DO NOT REMOVE
"a" = (
/turf/open/space/basic,
/area/space)
"j" = (
/turf/closed/wall/mineral/plastitanium,
/area/ship/hallway/central)
"m" = (
/turf/closed/wall/mineral/plastitanium,
/area/ship/engineering/engines/port)
"p" = (
/turf/open/space/basic,
/area/ship/engineering/engines/port)
"q" = (
/turf/closed/wall/mineral/plastitanium,
/area/ship/cargo)
"r" = (
/turf/closed/wall/mineral/plastitanium,
/area/ship/security)
"s" = (
/turf/closed/wall/mineral/plastitanium,
/area/ship/crew/ccommons)
"u" = (
/turf/open/space/basic,
/area/ship/bridge)
"w" = (
/turf/closed/wall/mineral/plastitanium,
/area/ship/medical)
"y" = (
/turf/open/space/basic,
/area/ship/medical)
"A" = (
/turf/closed/wall/mineral/plastitanium,
/area/ship/crew/dorm)
"F" = (
/turf/open/space/basic,
/area/ship/crew/cryo)
"H" = (
/turf/open/space/basic,
/area/ship/engineering/engines/starboard)
"L" = (
/turf/open/space/basic,
/area/ship/cargo)
"N" = (
/turf/open/space/basic,
/area/ship/crew/ccommons)
"O" = (
/turf/closed/wall/mineral/plastitanium,
/area/ship/bridge)
"P" = (
/turf/open/space/basic,
/area/ship/crew/dorm)
"Q" = (
/turf/open/space/basic,
/area/ship/security)
"R" = (
/turf/closed/wall/mineral/plastitanium,
/area/ship/engineering/engines/starboard)
"V" = (
/turf/open/space/basic,
/area/ship/hallway/central)
"Y" = (
/turf/closed/wall/mineral/plastitanium,
/area/ship/crew/cryo)

(1,1,1) = {"
a
a
a
a
a
a
a
a
a
a
a
a
a
a
a
a
a
a
a
a
a
a
a
a
a
"}
(2,1,1) = {"
a
a
a
a
a
a
a
a
a
a
a
a
a
a
a
a
a
a
a
a
a
a
a
a
a
"}
(3,1,1) = {"
a
a
a
a
a
a
a
O
O
O
O
O
O
O
O
O
O
O
a
a
a
a
a
a
a
"}
(4,1,1) = {"
a
a
a
a
a
a
a
O
u
u
u
u
u
u
u
u
u
O
a
a
a
a
a
a
a
"}
(5,1,1) = {"
a
a
a
a
a
a
O
O
u
u
u
u
u
u
u
u
u
O
O
a
a
a
a
a
a
"}
(6,1,1) = {"
a
a
a
m
m
m
O
O
u
u
u
u
u
u
u
u
u
O
O
R
R
R
a
a
a
"}
(7,1,1) = {"
a
a
m
m
p
p
p
O
O
u
u
u
u
u
u
u
O
O
H
H
H
R
R
a
a
"}
(8,1,1) = {"
a
a
m
p
p
p
p
p
O
u
u
u
u
u
u
u
O
H
H
H
H
H
R
a
a
"}
(9,1,1) = {"
a
a
m
p
p
p
p
p
O
u
u
u
u
u
u
u
O
H
H
H
H
H
R
a
a
"}
(10,1,1) = {"
a
a
m
p
p
p
p
p
O
u
u
u
u
u
u
u
O
H
H
H
H
H
R
a
a
"}
(11,1,1) = {"
a
a
m
p
p
p
p
p
O
O
O
O
O
O
O
O
O
H
H
H
H
H
R
a
a
"}
(12,1,1) = {"
a
a
m
p
p
p
p
p
s
N
N
N
N
N
N
N
s
H
H
H
H
H
R
a
a
"}
(13,1,1) = {"
a
a
A
A
A
p
p
s
s
N
N
N
N
N
N
N
s
s
H
H
Y
Y
Y
a
a
"}
(14,1,1) = {"
a
a
A
P
A
A
A
A
N
N
N
N
N
N
N
N
N
s
Y
Y
Y
F
Y
a
a
"}
(15,1,1) = {"
a
a
A
P
P
P
P
A
N
N
N
N
N
N
N
N
N
s
F
F
F
F
Y
a
a
"}
(16,1,1) = {"
a
a
A
P
P
P
P
A
N
N
N
N
N
N
N
N
N
s
F
F
F
F
Y
a
a
"}
(17,1,1) = {"
a
a
A
A
P
P
P
A
A
N
N
N
N
N
N
N
s
s
w
F
F
Y
Y
a
a
"}
(18,1,1) = {"
a
a
a
A
P
P
P
P
A
N
N
N
N
N
N
s
s
y
w
F
F
Y
a
a
a
"}
(19,1,1) = {"
a
a
a
A
A
P
P
P
A
N
N
N
N
N
N
s
y
y
w
F
Y
Y
a
a
a
"}
(20,1,1) = {"
a
a
a
a
A
A
r
r
r
s
N
N
N
N
N
s
y
y
w
Y
Y
a
a
a
a
"}
(21,1,1) = {"
a
a
a
a
r
r
Q
Q
Q
s
s
j
j
j
s
s
y
y
y
w
w
a
a
a
a
"}
(22,1,1) = {"
a
a
a
a
r
Q
Q
Q
Q
Q
r
V
V
V
w
y
y
y
y
y
w
a
a
a
a
"}
(23,1,1) = {"
a
a
a
a
r
Q
Q
Q
Q
Q
r
V
V
V
w
y
y
y
y
y
w
a
a
a
a
"}
(24,1,1) = {"
a
a
a
a
r
Q
Q
Q
Q
Q
r
V
V
V
w
y
y
y
y
y
w
a
a
a
a
"}
(25,1,1) = {"
a
a
a
a
r
Q
Q
Q
q
q
q
j
j
j
q
q
q
y
y
y
w
a
a
a
a
"}
(26,1,1) = {"
a
a
a
a
r
Q
Q
Q
q
L
L
L
L
L
L
L
q
y
y
y
w
a
a
a
a
"}
(27,1,1) = {"
a
a
a
a
r
Q
Q
q
q
L
L
L
L
L
L
L
q
q
y
y
w
a
a
a
a
"}
(28,1,1) = {"
a
a
a
a
r
r
r
q
L
L
L
L
L
L
L
L
L
q
w
w
w
a
a
a
a
"}
(29,1,1) = {"
a
a
a
a
a
a
r
q
L
L
L
L
L
L
L
L
L
q
w
a
a
a
a
a
a
"}
(30,1,1) = {"
a
a
a
a
a
a
a
q
L
L
L
L
L
L
L
L
L
q
a
a
a
a
a
a
a
"}
(31,1,1) = {"
a
a
a
a
a
a
a
q
q
L
L
L
L
L
L
L
q
q
a
a
a
a
a
a
a
"}
(32,1,1) = {"
a
a
a
a
a
a
a
a
q
q
q
q
q
q
q
q
q
a
a
a
a
a
a
a
a
"}
(33,1,1) = {"
a
a
a
a
a
a
a
a
a
a
a
a
a
a
a
a
a
a
a
a
a
a
a
a
a
"}
(34,1,1) = {"
a
a
a
a
a
a
a
a
a
a
a
a
a
a
a
a
a
a
a
a
a
a
a
a
a
"}
