//MAP CONVERTED BY dmm2tgm.py THIS HEADER COMMENT PREVENTS RECONVERSION, DO NOT REMOVE
"a" = (
/turf/open/floor/plating/asteroid/snow/icemoon,
/area/space)
"b" = (
/obj/structure/chair/wood/wings{
	dir = 1
	},
/turf/open/floor/wood/maple,
/area/space)
"c" = (
/obj/effect/turf_decal/spline/fancy/wood{
	dir = 4
	},
/turf/open/floor/wood/mahogany,
/area/space)
"d" = (
/obj/structure/chair/wood/wings{
	dir = 4
	},
/turf/open/floor/wood/maple,
/area/space)
"e" = (
/obj/structure/rack,
/obj/item/stack/sheet/animalhide/goliath_hide/polar_bear_hide,
/obj/item/stack/sheet/animalhide/goliath_hide/polar_bear_hide,
/obj/item/stack/sheet/animalhide/goliath_hide/polar_bear_hide,
/obj/item/grown/cotton/durathread,
/obj/item/grown/cotton/durathread,
/obj/item/grown/cotton/durathread,
/obj/item/grown/cotton/durathread,
/obj/item/grown/cotton/durathread,
/turf/open/floor/wood/ebony,
/area/space)
"f" = (
/obj/structure/chair/wood/wings,
/turf/open/floor/wood/maple,
/area/space)
"g" = (
/obj/structure/railing/wood{
	dir = 4
	},
/obj/structure/railing/wood{
	dir = 10
	},
/turf/open/floor/wood,
/area/space)
"h" = (
/turf/open/floor/wood,
/area/space)
"i" = (
/turf/open/floor/wood/mahogany,
/area/space)
"j" = (
/obj/structure/railing/wood{
	dir = 8
	},
/turf/open/floor/wood,
/area/space)
"k" = (
/turf/closed/indestructible/wood,
/area/space)
"l" = (
/obj/effect/turf_decal/spline/fancy/wood{
	dir = 5
	},
/turf/open/floor/wood/mahogany,
/area/space)
"m" = (
/obj/structure/rack,
/obj/item/clothing/head/cowboy/sec/roumain{
	pixel_y = -1;
	pixel_x = -7
	},
/obj/item/clothing/head/cowboy/sec/roumain{
	pixel_x = 10
	},
/turf/open/floor/wood/ebony,
/area/space)
"n" = (
/obj/structure/rack,
/obj/item/ammo_box/c38_box{
	pixel_x = -6;
	pixel_y = 7
	},
/obj/item/ammo_box/c38_box{
	pixel_x = -6;
	pixel_y = 1
	},
/turf/open/floor/wood/ebony,
/area/space)
"o" = (
/obj/effect/turf_decal/spline/fancy/wood{
	dir = 8
	},
/obj/effect/turf_decal/spline/fancy/wood{
	dir = 8
	},
/turf/open/floor/wood/mahogany,
/area/space)
"p" = (
/obj/structure/chair/wood/wings{
	dir = 1
	},
/turf/open/floor/wood/mahogany,
/area/space)
"q" = (
/obj/structure/table/wood,
/turf/open/floor/wood/mahogany,
/area/space)
"r" = (
/obj/structure/table/wood,
/turf/open/floor/wood/ebony,
/area/space)
"s" = (
/turf/open/floor/plating/dirt/icemoon,
/area/space)
"t" = (
/obj/effect/turf_decal/spline/fancy/wood,
/turf/open/floor/wood/mahogany,
/area/space)
"u" = (
/obj/structure/table/wood,
/obj/item/storage/toolbox/mechanical{
	pixel_y = 10
	},
/obj/item/chisel{
	pixel_x = 5
	},
/turf/open/floor/wood/maple,
/area/space)
"v" = (
/obj/structure/railing/wood{
	dir = 4
	},
/obj/structure/railing/wood,
/turf/open/floor/wood,
/area/space)
"w" = (
/obj/structure/table/wood,
/obj/item/clothing/under/suit/roumain,
/turf/open/floor/wood/ebony,
/area/space)
"x" = (
/obj/structure/railing/wood,
/turf/open/floor/wood,
/area/space)
"y" = (
/obj/structure/rack,
/obj/item/clothing/suit/armor/roumain,
/obj/item/clothing/suit/armor/roumain,
/turf/open/floor/wood/ebony,
/area/space)
"z" = (
/turf/open/water/jungle,
/area/space)
"A" = (
/turf/open/floor/plasteel/stairs/wood,
/area/space)
"B" = (
/obj/effect/turf_decal/spline/fancy/wood{
	dir = 8
	},
/turf/open/floor/wood/mahogany,
/area/space)
"C" = (
/obj/structure/railing/wood{
	dir = 10
	},
/turf/open/floor/wood,
/area/space)
"D" = (
/obj/structure/table/wood,
/obj/item/stack/sheet/hairlesshide,
/obj/item/stack/sheet/hairlesshide,
/obj/item/stack/sheet/hairlesshide,
/obj/item/stack/sheet/hairlesshide,
/obj/item/stack/sheet/cotton/durathread,
/obj/item/stack/sheet/cotton/durathread,
/obj/item/stack/sheet/cotton/durathread,
/obj/item/stack/sheet/cotton/durathread,
/obj/item/stack/sheet/cotton/durathread,
/turf/open/floor/wood/ebony,
/area/space)
"E" = (
/obj/structure/table/wood,
/obj/item/reagent_containers/glass/filter{
	pixel_x = 5
	},
/obj/item/reagent_containers/food/drinks/sillycup{
	pixel_x = -5;
	pixel_y = -3
	},
/turf/open/floor/wood/ebony,
/area/space)
"F" = (
/turf/open/floor/plasteel/stairs/wood{
	dir = 4
	},
/area/space)
"G" = (
/obj/structure/table/wood,
/obj/item/weaponcrafting/stock,
/turf/open/floor/wood/maple,
/area/space)
"H" = (
/obj/effect/turf_decal/spline/fancy/wood{
	dir = 6
	},
/turf/open/floor/wood/mahogany,
/area/space)
"I" = (
/obj/structure/rack,
/turf/open/floor/wood/ebony,
/area/space)
"J" = (
/obj/structure/loom,
/turf/open/floor/wood/ebony,
/area/space)
"K" = (
/obj/effect/turf_decal/spline/fancy/wood{
	dir = 10
	},
/turf/open/floor/wood/mahogany,
/area/space)
"L" = (
/obj/structure/railing/wood{
	dir = 6
	},
/turf/open/floor/wood,
/area/space)
"M" = (
/obj/machinery/smartfridge/drying_rack{
	name = "tanning rack";
	desc = "A wooden contraption, used to dry skinned hides"
	},
/turf/open/floor/wood/maple,
/area/space)
"N" = (
/obj/effect/turf_decal/spline/fancy/wood{
	dir = 9
	},
/turf/open/floor/wood/mahogany,
/area/space)
"O" = (
/obj/structure/fermenting_barrel/gunpowder,
/turf/open/floor/wood/maple,
/area/space)
"P" = (
/obj/item/stack/sheet/durathread{
	pixel_x = -10;
	pixel_y = 10
	},
/obj/structure/rack,
/obj/item/stack/sheet/durathread,
/obj/item/stack/sheet/durathread{
	pixel_y = 10
	},
/obj/item/stack/sheet/durathread{
	pixel_x = -10
	},
/obj/item/stack/sheet/leather,
/obj/item/stack/sheet/leather,
/obj/item/stack/sheet/leather,
/obj/item/stack/sheet/leather,
/obj/item/stack/sheet/leather,
/turf/open/floor/wood/ebony,
/area/space)
"R" = (
/obj/structure/rack,
/turf/open/floor/wood/maple,
/area/space)
"S" = (
/obj/effect/turf_decal/spline/fancy/wood/corner{
	dir = 1
	},
/turf/open/floor/wood/mahogany,
/area/space)
"T" = (
/obj/structure/grille,
/turf/open/floor/wood,
/area/space)
"U" = (
/obj/effect/turf_decal/spline/fancy/wood/corner{
	dir = 4
	},
/turf/open/floor/wood/mahogany,
/area/space)
"V" = (
/obj/structure/railing/wood{
	dir = 5
	},
/turf/open/floor/wood,
/area/space)
"W" = (
/obj/structure/table/wood,
/obj/item/clothing/head/bearpelt{
	pixel_y = 10
	},
/obj/item/kitchen/knife/hunting,
/turf/open/floor/wood/ebony,
/area/space)
"X" = (
/turf/open/floor/wood/maple,
/area/space)
"Y" = (
/obj/structure/table/wood,
/turf/open/floor/wood/maple,
/area/space)
"Z" = (
/obj/structure/table/wood,
/obj/item/stack/sheet/cotton/cloth/ten,
/obj/item/scalpel{
	name = "leather knife";
	desc = "A sharpened leather knife, used for leatherwork."
	},
/turf/open/floor/wood/ebony,
/area/space)

(1,1,1) = {"
a
a
a
a
a
a
a
a
a
a
a
a
a
a
a
a
a
a
a
a
a
a
a
a
a
a
a
a
a
a
a
a
a
a
a
a
a
a
a
a
a
a
a
a
a
a
a
a
a
a
"}
(2,1,1) = {"
a
a
a
a
a
a
a
a
a
a
a
a
a
a
a
a
a
a
a
a
a
a
a
a
a
a
a
a
a
a
a
a
a
a
a
a
a
a
a
a
a
a
a
a
a
a
a
a
a
a
"}
(3,1,1) = {"
a
a
a
a
a
a
a
a
a
a
a
a
a
a
a
a
a
a
a
a
a
a
a
a
a
a
a
a
a
a
a
a
a
a
a
a
a
a
a
a
a
a
a
a
a
a
a
a
a
a
"}
(4,1,1) = {"
a
a
a
a
a
a
a
a
a
a
a
a
a
a
a
a
a
a
a
a
a
a
a
a
a
a
a
a
a
a
a
a
a
a
a
a
a
a
a
a
a
a
a
a
a
a
a
a
a
a
"}
(5,1,1) = {"
a
a
a
a
a
a
a
a
a
a
a
a
a
a
a
a
a
a
a
a
a
a
a
a
a
a
a
a
a
a
a
a
a
a
a
a
a
a
a
a
a
a
a
a
a
a
a
a
a
a
"}
(6,1,1) = {"
a
a
a
a
a
a
a
a
a
a
a
a
a
a
a
a
a
a
a
a
a
a
a
a
a
a
a
a
a
a
a
a
a
a
a
a
a
a
a
a
a
a
a
a
a
a
a
a
a
a
"}
(7,1,1) = {"
a
a
a
a
a
a
a
a
a
a
a
a
a
a
a
a
a
a
a
a
a
a
a
a
a
a
a
a
a
a
a
a
a
a
a
a
a
a
a
a
a
a
a
a
a
a
a
a
a
a
"}
(8,1,1) = {"
a
a
a
a
a
a
a
a
a
a
a
a
a
a
a
a
a
a
a
a
a
a
a
a
a
a
a
a
a
a
a
a
a
a
a
a
a
a
a
a
a
a
a
a
a
a
a
a
a
a
"}
(9,1,1) = {"
a
a
a
a
a
a
a
a
a
a
a
a
a
a
a
a
a
a
a
a
a
a
a
a
a
a
a
a
a
a
a
a
a
a
a
a
a
a
a
a
a
a
a
a
a
a
a
a
a
a
"}
(10,1,1) = {"
a
a
a
a
a
a
a
a
a
a
a
a
a
a
a
a
a
a
a
a
a
a
a
a
a
a
a
a
a
a
a
a
a
a
a
a
a
a
a
a
a
a
a
a
a
a
a
a
a
a
"}
(11,1,1) = {"
a
a
a
a
a
a
a
a
a
a
a
a
a
a
a
a
a
a
a
a
a
a
a
a
a
a
a
a
a
a
a
a
a
a
a
a
a
a
a
a
a
a
a
a
a
a
a
a
a
a
"}
(12,1,1) = {"
a
a
a
a
a
a
a
a
a
a
a
a
a
a
a
a
a
a
a
a
a
a
a
a
a
a
a
a
a
a
a
a
a
a
a
a
a
a
a
a
a
a
a
a
a
a
a
a
a
a
"}
(13,1,1) = {"
a
a
a
a
a
a
a
a
a
a
a
a
a
a
a
a
a
a
a
a
a
a
a
a
a
a
a
a
a
a
a
a
a
a
a
a
a
a
a
a
a
a
a
a
a
a
a
a
a
a
"}
(14,1,1) = {"
a
a
a
a
a
a
a
a
a
a
a
a
a
a
a
a
a
a
a
a
a
a
a
a
a
a
a
a
a
a
a
a
a
a
a
a
a
a
a
a
a
a
a
a
a
a
a
a
a
a
"}
(15,1,1) = {"
a
a
a
a
a
a
a
a
a
a
a
a
a
a
a
a
a
a
a
a
a
a
a
a
a
a
a
a
a
a
a
a
a
a
a
a
a
a
a
a
a
a
a
a
a
a
a
a
a
a
"}
(16,1,1) = {"
a
a
a
a
a
a
k
k
k
k
k
k
k
k
k
k
k
k
k
a
a
a
a
a
a
a
a
a
a
a
a
a
a
a
a
a
a
a
a
a
a
a
a
a
a
a
a
a
a
a
"}
(17,1,1) = {"
a
a
a
a
a
a
k
X
X
X
X
X
X
X
X
X
X
X
k
a
a
a
a
a
a
a
a
a
a
a
a
a
a
a
a
a
a
a
a
a
a
a
a
a
a
a
a
a
a
a
"}
(18,1,1) = {"
a
a
a
a
a
a
k
X
X
X
X
X
X
X
X
X
X
X
k
a
a
a
a
a
a
a
a
a
a
a
a
a
a
a
a
a
a
a
a
a
a
a
a
a
a
a
a
a
a
a
"}
(19,1,1) = {"
a
a
a
a
a
k
k
X
X
X
X
X
X
X
X
k
k
k
k
a
a
a
s
s
s
s
s
s
s
a
a
a
a
a
a
a
a
a
a
a
a
a
a
a
a
a
a
a
a
a
"}
(20,1,1) = {"
a
a
a
a
a
k
X
X
X
k
X
X
X
X
k
k
j
j
g
a
a
s
s
s
s
z
z
s
s
s
a
a
a
a
a
a
a
a
a
a
a
a
a
a
a
a
a
a
a
a
"}
(21,1,1) = {"
a
a
a
a
a
k
X
X
X
k
k
k
k
k
k
h
h
h
A
a
s
s
z
s
z
z
z
z
s
s
s
a
a
a
a
a
a
a
a
a
a
a
a
a
a
a
a
a
a
a
"}
(22,1,1) = {"
a
a
a
a
a
k
X
X
k
k
N
B
o
K
T
h
h
h
C
a
s
s
z
z
z
z
z
z
z
s
s
a
a
a
a
a
a
a
a
a
a
a
a
a
a
a
a
a
a
a
"}
(23,1,1) = {"
a
a
a
a
a
k
X
X
k
N
S
i
i
t
T
h
h
h
x
a
s
s
z
z
z
z
z
z
z
s
s
a
a
a
a
a
a
a
a
a
a
a
a
a
a
a
a
a
a
a
"}
(24,1,1) = {"
a
a
a
a
a
k
X
X
k
i
i
q
i
t
T
h
h
h
x
a
s
z
z
z
z
z
z
z
z
z
s
a
a
a
a
a
a
a
a
a
a
a
a
a
a
a
a
a
a
a
"}
(25,1,1) = {"
a
a
a
a
a
k
X
X
X
i
i
q
p
t
T
h
h
h
x
a
s
s
z
z
z
z
z
z
z
s
s
a
a
a
a
a
a
a
a
a
a
a
a
a
a
a
a
a
a
a
"}
(26,1,1) = {"
a
a
a
a
a
k
X
X
k
i
i
q
i
t
T
h
h
h
x
a
s
s
z
z
z
z
z
z
s
s
a
a
a
a
a
a
a
a
a
a
a
a
a
a
a
a
a
a
a
a
"}
(27,1,1) = {"
a
a
a
a
a
k
X
X
k
l
U
i
i
t
T
h
h
h
x
a
a
s
s
z
z
z
z
z
z
s
s
a
a
a
a
a
a
a
a
a
a
a
a
a
a
a
a
a
a
a
"}
(28,1,1) = {"
a
a
a
a
a
k
X
X
k
k
l
c
c
H
T
h
h
h
x
a
a
s
s
s
s
z
s
z
s
s
a
a
a
a
a
a
a
a
a
a
a
a
a
a
a
a
a
a
a
a
"}
(29,1,1) = {"
a
a
a
a
a
k
X
X
X
k
k
k
k
k
k
L
F
V
v
a
a
a
s
s
s
s
s
s
s
a
a
a
a
a
a
a
a
a
a
a
a
a
a
a
a
a
a
a
a
a
"}
(30,1,1) = {"
a
a
a
a
a
k
k
X
X
X
X
X
X
X
X
X
X
X
a
a
a
a
s
a
s
a
s
s
a
a
a
a
a
a
a
a
a
a
a
a
a
a
a
a
a
a
a
a
a
a
"}
(31,1,1) = {"
a
a
a
a
a
a
k
X
X
X
X
X
X
X
X
X
X
X
a
a
a
a
a
a
a
a
a
a
a
a
a
a
a
a
a
a
a
a
a
a
a
a
a
a
a
a
a
a
a
a
"}
(32,1,1) = {"
a
a
a
a
a
a
k
k
k
k
k
k
k
k
k
k
k
k
a
a
a
a
a
a
a
a
a
a
a
a
a
a
a
a
a
a
a
a
a
a
a
a
a
a
a
a
a
a
a
a
"}
(33,1,1) = {"
a
a
a
a
a
a
a
a
a
a
a
a
a
a
a
a
a
a
a
a
a
a
a
a
a
a
a
a
a
a
a
a
a
a
a
a
a
a
a
a
a
a
a
a
a
a
a
a
a
a
"}
(34,1,1) = {"
a
a
a
a
a
a
a
a
a
a
a
a
a
a
a
a
a
a
a
a
a
a
a
a
a
a
a
a
a
a
a
a
a
a
a
a
a
a
a
a
a
a
a
a
a
a
a
a
a
a
"}
(35,1,1) = {"
a
a
a
a
a
a
a
a
a
a
a
a
a
a
a
a
a
a
a
a
a
a
k
k
X
X
k
k
k
k
k
a
a
a
a
a
a
a
a
a
a
a
a
a
a
a
a
a
a
a
"}
(36,1,1) = {"
a
a
a
a
a
a
a
a
a
a
a
a
a
a
a
a
a
a
a
a
a
k
k
X
X
X
X
M
e
J
k
a
a
a
a
a
a
a
a
a
a
a
a
a
a
a
a
a
a
a
"}
(37,1,1) = {"
a
a
a
a
a
a
a
a
a
a
a
a
a
a
a
a
a
a
a
a
a
k
Y
X
X
X
X
X
f
D
k
a
a
a
a
a
a
a
a
a
a
a
a
a
a
a
a
a
a
a
"}
(38,1,1) = {"
a
a
a
a
a
a
a
a
a
a
a
a
a
a
a
a
a
a
a
a
a
k
Y
b
X
R
R
X
X
W
k
a
a
a
a
a
a
a
a
a
a
a
a
a
a
a
a
a
a
a
"}
(39,1,1) = {"
a
a
a
a
a
a
a
a
a
a
a
a
a
a
a
a
a
a
a
a
a
k
R
X
X
R
R
X
X
P
k
a
a
a
a
a
a
a
a
a
a
a
a
a
a
a
a
a
a
a
"}
(40,1,1) = {"
a
a
a
a
a
a
a
a
a
a
a
a
a
a
a
a
a
a
a
a
a
k
u
X
X
R
R
X
X
Z
k
a
a
a
a
a
a
a
a
a
a
a
a
a
a
a
a
a
a
a
"}
(41,1,1) = {"
a
a
a
a
a
a
a
a
a
a
a
a
a
a
a
a
a
a
a
a
a
k
G
b
X
X
X
X
f
w
k
a
a
a
a
a
a
a
a
a
a
a
a
a
a
a
a
a
a
a
"}
(42,1,1) = {"
a
a
a
a
a
a
a
a
a
a
a
a
a
a
a
a
a
a
a
a
a
k
R
X
X
X
X
X
m
y
k
a
a
a
a
a
a
a
a
a
a
a
a
a
a
a
a
a
a
a
"}
(43,1,1) = {"
a
a
a
a
a
a
a
a
a
a
a
a
a
a
a
a
a
a
a
a
a
k
k
X
X
d
X
O
k
k
k
a
a
a
a
a
a
a
a
a
a
a
a
a
a
a
a
a
a
a
"}
(44,1,1) = {"
a
a
a
a
a
a
a
a
a
a
a
a
a
a
a
a
a
a
a
a
a
a
k
I
n
r
E
k
k
a
a
a
a
a
a
a
a
a
a
a
a
a
a
a
a
a
a
a
a
a
"}
(45,1,1) = {"
a
a
a
a
a
a
a
a
a
a
a
a
a
a
a
a
a
a
a
a
a
a
k
k
k
k
k
k
a
a
a
a
a
a
a
a
a
a
a
a
a
a
a
a
a
a
a
a
a
a
"}
(46,1,1) = {"
a
a
a
a
a
a
a
a
a
a
a
a
a
a
a
a
a
a
a
a
a
a
a
a
a
a
a
a
a
a
a
a
a
a
a
a
a
a
a
a
a
a
a
a
a
a
a
a
a
a
"}
(47,1,1) = {"
a
a
a
a
a
a
a
a
a
a
a
a
a
a
a
a
a
a
a
a
a
a
a
a
a
a
a
a
a
a
a
a
a
a
a
a
a
a
a
a
a
a
a
a
a
a
a
a
a
a
"}
(48,1,1) = {"
a
a
a
a
a
a
a
a
a
a
a
a
a
a
a
a
a
a
a
a
a
a
a
a
a
a
a
a
a
a
a
a
a
a
a
a
a
a
a
a
a
a
a
a
a
a
a
a
a
a
"}
(49,1,1) = {"
a
a
a
a
a
a
a
a
a
a
a
a
a
a
a
a
a
a
a
a
a
a
a
a
a
a
a
a
a
a
a
a
a
a
a
a
a
a
a
a
a
a
a
a
a
a
a
a
a
a
"}
(50,1,1) = {"
a
a
a
a
a
a
a
a
a
a
a
a
a
a
a
a
a
a
a
a
a
a
a
a
a
a
a
a
a
a
a
a
a
a
a
a
a
a
a
a
a
a
a
a
a
a
a
a
a
a
"}
