//MAP CONVERTED BY dmm2tgm.py THIS HEADER COMMENT PREVENTS RECONVERSION, DO NOT REMOVE
"a" = (
/turf/open/floor/plating/asteroid/snow/icemoon,
/area/space)
"e" = (
/obj/effect/turf_decal/spline/fancy/wood{
	dir = 10
	},
/turf/open/floor/wood/mahogany,
/area/space)
"h" = (
/turf/open/floor/wood,
/area/space)
"i" = (
/obj/structure/table/wood,
/turf/open/floor/wood/mahogany,
/area/space)
"j" = (
/obj/effect/turf_decal/spline/fancy/wood{
	dir = 4
	},
/turf/open/floor/wood/mahogany,
/area/space)
"k" = (
/turf/closed/indestructible/wood,
/area/space)
"l" = (
/obj/effect/turf_decal/spline/fancy/wood{
	dir = 6
	},
/turf/open/floor/wood/mahogany,
/area/space)
"m" = (
/obj/structure/railing/wood{
	dir = 6
	},
/turf/open/floor/wood,
/area/space)
"s" = (
/turf/open/floor/plating/dirt/icemoon,
/area/space)
"u" = (
/obj/structure/grille,
/turf/open/floor/wood,
/area/space)
"w" = (
/obj/effect/turf_decal/spline/fancy/wood,
/turf/open/floor/wood/mahogany,
/area/space)
"y" = (
/obj/structure/railing/wood{
	dir = 8
	},
/turf/open/floor/wood,
/area/space)
"z" = (
/turf/open/water/jungle,
/area/space)
"C" = (
/obj/effect/turf_decal/spline/fancy/wood{
	dir = 8
	},
/obj/effect/turf_decal/spline/fancy/wood{
	dir = 8
	},
/turf/open/floor/wood/mahogany,
/area/space)
"D" = (
/obj/structure/chair/wood/wings{
	dir = 1
	},
/turf/open/floor/wood/mahogany,
/area/space)
"F" = (
/obj/structure/railing/wood{
	dir = 4
	},
/obj/structure/railing/wood{
	dir = 10
	},
/turf/open/floor/wood,
/area/space)
"H" = (
/turf/open/floor/wood/mahogany,
/area/space)
"I" = (
/turf/open/floor/wood/ebony,
/area/space)
"J" = (
/turf/open/floor/plasteel/stairs/wood,
/area/space)
"K" = (
/obj/effect/turf_decal/spline/fancy/wood/corner{
	dir = 1
	},
/turf/open/floor/wood/mahogany,
/area/space)
"L" = (
/turf/open/floor/wood/maple,
/area/space)
"M" = (
/obj/structure/closet/secure_closet/shadow,
/turf/open/floor/wood/ebony,
/area/space)
"N" = (
/obj/structure/railing/wood{
	dir = 10
	},
/turf/open/floor/wood,
/area/space)
"Q" = (
/obj/effect/turf_decal/spline/fancy/wood{
	dir = 5
	},
/turf/open/floor/wood/mahogany,
/area/space)
"S" = (
/obj/structure/railing/wood,
/turf/open/floor/wood,
/area/space)
"T" = (
/obj/effect/turf_decal/spline/fancy/wood{
	dir = 8
	},
/turf/open/floor/wood/mahogany,
/area/space)
"V" = (
/obj/structure/railing/wood{
	dir = 4
	},
/turf/open/floor/wood,
/area/space)
"W" = (
/obj/structure/closet/secure_closet/hunter,
/turf/open/floor/wood/ebony,
/area/space)
"X" = (
/obj/effect/turf_decal/spline/fancy/wood/corner{
	dir = 4
	},
/turf/open/floor/wood/mahogany,
/area/space)
"Z" = (
/obj/effect/turf_decal/spline/fancy/wood{
	dir = 9
	},
/turf/open/floor/wood/mahogany,
/area/space)

(1,1,1) = {"
a
a
a
a
a
a
a
a
a
a
a
a
a
a
a
a
a
a
a
a
a
a
a
a
a
a
a
a
a
a
a
a
a
a
a
a
a
a
a
a
a
a
a
a
a
a
a
a
a
a
"}
(2,1,1) = {"
a
a
a
a
a
a
a
a
a
a
a
a
a
a
a
a
a
a
a
a
a
a
a
a
a
a
a
a
a
a
a
a
a
a
a
a
a
a
a
a
a
a
a
a
a
a
a
a
a
a
"}
(3,1,1) = {"
a
a
a
a
a
a
a
a
a
a
a
a
a
a
a
a
a
a
a
a
a
a
a
a
a
a
a
a
a
a
a
a
a
a
a
a
a
a
a
a
a
a
a
a
a
a
a
a
a
a
"}
(4,1,1) = {"
a
a
a
a
a
a
a
a
a
a
a
a
a
a
a
a
a
a
a
a
a
a
a
a
a
a
a
a
a
a
a
a
a
a
a
a
a
a
a
a
a
a
a
a
a
a
a
a
a
a
"}
(5,1,1) = {"
a
a
a
a
a
a
a
a
a
a
a
a
a
a
a
a
a
a
a
k
k
k
k
k
k
k
k
k
k
k
k
k
k
a
a
a
a
a
a
a
a
a
a
a
a
a
a
a
a
a
"}
(6,1,1) = {"
a
a
a
a
a
a
a
a
a
a
a
a
a
a
a
a
a
a
k
k
a
a
a
a
a
a
a
a
a
a
a
a
k
k
a
a
a
a
a
a
a
a
a
a
a
a
a
a
a
a
"}
(7,1,1) = {"
a
a
a
a
a
a
a
a
a
a
a
a
a
a
a
a
a
a
k
a
a
a
a
a
a
a
a
a
a
a
a
a
a
k
a
a
a
a
a
a
a
a
a
a
a
a
a
a
a
a
"}
(8,1,1) = {"
a
a
a
a
a
a
a
a
a
a
a
a
a
a
a
a
a
a
k
a
a
a
a
a
a
a
a
a
a
a
a
a
a
k
a
a
a
a
a
a
a
a
a
a
a
a
a
a
a
a
"}
(9,1,1) = {"
a
a
a
a
a
a
a
a
a
a
a
a
a
a
a
a
a
a
k
a
a
a
a
a
a
a
a
a
a
a
a
a
a
k
a
a
a
a
a
a
a
a
a
a
a
a
a
a
a
a
"}
(10,1,1) = {"
a
a
a
a
a
a
a
a
a
a
a
a
a
a
a
a
a
a
k
a
a
a
a
a
a
a
a
a
a
a
a
a
a
k
a
a
a
a
a
a
a
a
a
a
a
a
a
a
a
a
"}
(11,1,1) = {"
a
a
a
a
a
a
a
a
a
a
a
a
a
a
a
a
a
a
k
k
a
a
a
a
a
a
a
a
a
a
a
a
k
k
a
a
a
a
a
a
a
a
a
a
a
a
a
a
a
a
"}
(12,1,1) = {"
a
a
a
a
a
a
a
a
a
a
a
a
a
a
a
a
a
a
a
k
k
k
k
k
k
k
k
k
k
k
k
k
k
a
a
a
a
a
a
a
a
a
a
a
a
a
a
a
a
a
"}
(13,1,1) = {"
a
a
a
a
a
a
a
a
a
a
a
a
a
a
a
a
a
a
a
a
a
a
a
a
a
a
a
a
a
a
a
a
a
a
a
a
a
a
a
a
a
a
a
a
a
a
a
a
a
a
"}
(14,1,1) = {"
a
a
a
a
a
a
a
a
a
a
a
a
a
a
a
a
a
a
a
a
a
a
a
a
a
a
a
a
a
a
a
a
a
a
a
a
a
a
a
a
a
a
a
a
a
a
a
a
a
a
"}
(15,1,1) = {"
a
a
a
a
a
a
a
a
a
a
a
a
a
a
a
a
a
a
a
a
a
a
a
a
a
a
a
a
a
a
a
a
a
a
a
a
a
a
a
a
a
a
a
a
a
a
a
a
a
a
"}
(16,1,1) = {"
a
a
a
a
a
a
a
a
a
a
a
a
a
a
a
a
a
a
a
a
a
a
a
a
a
a
a
a
a
a
a
a
a
a
a
a
a
a
a
a
a
a
a
a
a
a
a
a
a
a
"}
(17,1,1) = {"
a
a
a
a
a
k
k
k
k
k
k
k
k
k
k
k
k
k
a
a
a
a
a
a
a
a
a
a
a
a
a
a
a
a
a
a
a
a
a
a
a
a
a
a
a
a
a
a
a
a
"}
(18,1,1) = {"
a
a
a
a
a
k
L
L
L
L
L
L
L
L
L
L
L
L
a
a
a
a
a
a
a
a
a
a
a
a
a
a
a
a
a
a
a
a
a
a
a
a
a
a
a
a
a
a
a
a
"}
(19,1,1) = {"
a
a
a
a
a
k
L
L
L
L
L
L
L
L
L
L
L
L
a
a
a
a
s
s
s
s
s
s
s
a
a
a
a
a
a
a
a
a
a
a
a
a
a
a
a
a
a
a
a
a
"}
(20,1,1) = {"
a
a
a
a
a
k
L
L
L
k
k
k
k
k
k
k
y
F
a
a
a
s
s
s
s
z
z
s
s
s
a
a
a
a
a
a
a
a
a
a
a
a
a
a
a
a
a
a
a
a
"}
(21,1,1) = {"
a
a
a
a
a
k
L
L
k
k
Z
T
C
e
u
h
h
J
a
a
s
s
z
s
z
z
z
z
s
s
s
a
a
a
a
a
a
a
a
a
a
a
a
a
a
a
a
a
a
a
"}
(22,1,1) = {"
a
a
a
a
a
k
L
L
k
Z
K
H
H
w
u
h
h
N
a
a
s
s
z
z
z
z
z
z
z
s
s
a
a
a
a
a
a
a
a
a
a
a
a
a
a
a
a
a
a
a
"}
(23,1,1) = {"
a
a
a
a
a
k
L
L
T
K
H
i
H
w
u
h
h
S
a
a
s
s
z
z
z
z
z
z
z
s
s
a
a
a
a
a
a
a
a
a
a
a
a
a
a
a
a
a
a
a
"}
(24,1,1) = {"
a
a
a
a
a
k
L
L
H
H
H
i
D
w
u
h
h
S
a
a
s
z
z
z
z
z
z
z
z
z
s
a
a
a
a
a
a
a
a
a
a
a
a
a
a
a
a
a
a
a
"}
(25,1,1) = {"
a
a
a
a
a
k
L
L
j
X
H
i
H
w
u
h
h
S
a
a
s
s
z
z
z
z
z
z
z
s
s
a
a
a
a
a
a
a
a
a
a
a
a
a
a
a
a
a
a
a
"}
(26,1,1) = {"
a
a
a
a
a
k
L
L
k
Q
X
H
H
w
u
h
h
m
a
a
s
s
z
z
z
z
z
z
s
s
a
a
a
a
a
a
a
a
a
a
a
a
a
a
a
a
a
a
a
a
"}
(27,1,1) = {"
a
a
a
a
a
k
L
L
k
k
Q
j
j
l
u
h
h
J
a
a
a
s
s
z
z
z
z
z
z
s
s
a
a
a
a
a
a
a
a
a
a
a
a
a
a
a
a
a
a
a
"}
(28,1,1) = {"
a
a
a
a
a
k
L
L
L
k
k
k
k
k
k
k
V
F
a
a
a
s
s
s
s
z
s
z
s
s
a
a
a
a
a
a
a
a
a
a
a
a
a
a
a
a
a
a
a
a
"}
(29,1,1) = {"
a
a
a
a
a
k
L
L
L
L
L
L
L
L
L
L
L
L
a
a
a
a
s
s
s
s
s
s
s
a
a
a
a
a
a
a
a
a
a
a
a
a
a
a
a
a
a
a
a
a
"}
(30,1,1) = {"
a
a
a
a
a
k
k
L
L
L
L
L
L
L
L
L
L
L
a
a
a
a
s
a
s
a
s
s
a
a
a
a
a
a
a
a
a
a
a
a
a
a
a
a
a
a
a
a
a
a
"}
(31,1,1) = {"
a
a
a
a
a
a
k
k
k
k
W
L
L
L
M
k
k
k
a
a
a
a
a
a
a
a
a
a
a
a
a
a
a
a
a
a
a
a
a
a
a
a
a
a
a
a
a
a
a
a
"}
(32,1,1) = {"
a
a
a
a
a
a
a
a
a
k
W
L
L
L
M
k
a
a
a
a
a
a
a
a
a
a
a
a
a
a
a
a
a
a
a
a
a
a
a
a
a
a
a
a
a
a
a
a
a
a
"}
(33,1,1) = {"
a
a
a
a
a
a
a
a
a
k
k
I
L
I
k
k
a
a
a
a
a
a
a
a
a
a
a
a
a
a
a
a
a
a
a
a
a
a
a
a
a
a
a
a
a
a
a
a
a
a
"}
(34,1,1) = {"
a
a
a
a
a
a
a
a
a
a
k
I
L
I
k
a
a
a
a
a
a
a
a
a
a
a
a
a
a
a
a
a
a
a
a
a
a
a
a
a
a
a
a
a
a
a
a
a
a
a
"}
(35,1,1) = {"
a
a
a
a
a
a
a
a
a
a
k
k
I
k
k
a
a
a
a
a
a
a
a
a
a
a
a
a
a
a
a
a
a
a
a
a
a
a
a
a
a
a
a
a
a
a
a
a
a
a
"}
(36,1,1) = {"
a
a
a
a
a
a
a
a
a
a
a
k
k
k
a
a
a
a
a
a
a
a
a
a
a
a
a
a
a
a
a
a
a
a
a
a
a
a
a
a
a
a
a
a
a
a
a
a
a
a
"}
(37,1,1) = {"
a
a
a
a
a
a
a
a
a
a
a
a
a
a
a
a
a
a
a
a
a
a
a
a
a
a
a
a
a
a
a
a
a
a
a
a
a
a
a
a
a
a
a
a
a
a
a
a
a
a
"}
(38,1,1) = {"
a
a
a
a
a
a
a
a
a
a
a
a
a
a
a
a
a
a
a
a
a
a
a
a
a
a
a
a
a
a
a
a
a
a
a
a
a
a
a
a
a
a
a
a
a
a
a
a
a
a
"}
(39,1,1) = {"
a
a
a
a
a
a
a
a
a
a
a
a
a
a
a
a
a
a
a
a
a
a
a
a
a
a
a
a
a
a
a
a
a
a
a
a
a
a
a
a
a
a
a
a
a
a
a
a
a
a
"}
(40,1,1) = {"
a
a
a
a
a
a
a
a
a
a
a
a
a
a
a
a
a
a
a
a
a
a
a
a
a
a
a
a
a
a
a
a
a
a
a
a
a
a
a
a
a
a
a
a
a
a
a
a
a
a
"}
(41,1,1) = {"
a
a
a
a
a
a
a
a
a
a
a
a
a
a
a
a
a
a
a
a
a
a
a
a
a
a
a
a
a
a
a
a
a
a
a
a
a
a
a
a
a
a
a
a
a
a
a
a
a
a
"}
(42,1,1) = {"
a
a
a
a
a
a
a
a
a
a
a
a
a
a
a
a
a
a
a
a
a
a
a
a
a
a
a
a
a
a
a
a
a
a
a
a
a
a
a
a
a
a
a
a
a
a
a
a
a
a
"}
(43,1,1) = {"
a
a
a
a
a
a
a
a
a
a
a
a
a
a
a
a
a
a
a
a
a
a
a
a
a
a
a
a
a
a
a
a
a
a
a
a
a
a
a
a
a
a
a
a
a
a
a
a
a
a
"}
(44,1,1) = {"
a
a
a
a
a
a
a
a
a
a
a
a
a
a
a
a
a
a
a
a
a
a
a
a
a
a
a
a
a
a
a
a
a
a
a
a
a
a
a
a
a
a
a
a
a
a
a
a
a
a
"}
(45,1,1) = {"
a
a
a
a
a
a
a
a
a
a
a
a
a
a
a
a
a
a
a
a
a
a
a
a
a
a
a
a
a
a
a
a
a
a
a
a
a
a
a
a
a
a
a
a
a
a
a
a
a
a
"}
(46,1,1) = {"
a
a
a
a
a
a
a
a
a
a
a
a
a
a
a
a
a
a
a
a
a
a
a
a
a
a
a
a
a
a
a
a
a
a
a
a
a
a
a
a
a
a
a
a
a
a
a
a
a
a
"}
(47,1,1) = {"
a
a
a
a
a
a
a
a
a
a
a
a
a
a
a
a
a
a
a
a
a
a
a
a
a
a
a
a
a
a
a
a
a
a
a
a
a
a
a
a
a
a
a
a
a
a
a
a
a
a
"}
(48,1,1) = {"
a
a
a
a
a
a
a
a
a
a
a
a
a
a
a
a
a
a
a
a
a
a
a
a
a
a
a
a
a
a
a
a
a
a
a
a
a
a
a
a
a
a
a
a
a
a
a
a
a
a
"}
(49,1,1) = {"
a
a
a
a
a
a
a
a
a
a
a
a
a
a
a
a
a
a
a
a
a
a
a
a
a
a
a
a
a
a
a
a
a
a
a
a
a
a
a
a
a
a
a
a
a
a
a
a
a
a
"}
(50,1,1) = {"
a
a
a
a
a
a
a
a
a
a
a
a
a
a
a
a
a
a
a
a
a
a
a
a
a
a
a
a
a
a
a
a
a
a
a
a
a
a
a
a
a
a
a
a
a
a
a
a
a
a
"}
