//MAP CONVERTED BY dmm2tgm.py THIS HEADER COMMENT PREVENTS RECONVERSION, DO NOT REMOVE
"ak" = (
/obj/effect/turf_decal/corner/opaque/blue/diagonal,
/obj/structure/table/wood,
/turf/open/floor/plasteel/white,
/area/space)
"aF" = (
/turf/open/floor/plasteel/stairs/wood{
	dir = 4
	},
/area/space)
"bb" = (
/turf/open/floor/plating/asteroid/icerock/temperate,
/area/space)
"bC" = (
/obj/structure/bed,
/obj/item/bedsheet/random,
/turf/open/floor/wood/maple,
/area/space)
"bL" = (
/obj/effect/turf_decal/spline/fancy/wood,
/obj/structure/table/wood,
/turf/open/floor/wood/mahogany,
/area/space)
"dA" = (
/obj/effect/turf_decal/spline/fancy/wood/corner{
	dir = 1
	},
/turf/open/floor/wood/mahogany,
/area/space)
"dT" = (
/obj/structure/table/wood,
/turf/open/floor/wood/mahogany,
/area/space)
"eq" = (
/obj/machinery/door/airlock/wood,
/obj/effect/turf_decal/siding/brown{
	dir = 9
	},
/turf/open/floor/wood/ebony,
/area/space)
"eC" = (
/obj/item/clothing/head/bearpelt{
	pixel_y = 10
	},
/obj/item/kitchen/knife/hunting,
/obj/structure/table/wood,
/turf/open/floor/wood/ebony,
/area/space)
"eK" = (
/obj/structure/mineral_door/wood,
/turf/open/floor/wood/maple,
/area/space)
"fi" = (
/obj/effect/turf_decal/siding/brown{
	dir = 6
	},
/turf/open/floor/wood/ebony,
/area/space)
"fw" = (
/obj/effect/turf_decal/spline/fancy/wood{
	dir = 1
	},
/turf/open/floor/wood/mahogany,
/area/space)
"fA" = (
/obj/effect/turf_decal/siding/blue{
	dir = 1
	},
/turf/open/floor/plasteel/white,
/area/space)
"ho" = (
/obj/effect/turf_decal/siding/brown{
	dir = 4
	},
/turf/open/floor/wood/ebony,
/area/space)
"jk" = (
/obj/effect/turf_decal/corner/opaque/blue/diagonal,
/obj/effect/turf_decal/corner/opaque/blue/diagonal,
/obj/structure/table/wood,
/turf/open/floor/plasteel/white,
/area/space)
"jD" = (
/obj/effect/turf_decal/spline/fancy/wood{
	dir = 10
	},
/obj/structure/table/wood,
/turf/open/floor/wood/mahogany,
/area/space)
"kl" = (
/obj/effect/turf_decal/spline/fancy/wood{
	dir = 8
	},
/turf/open/floor/wood/mahogany,
/area/space)
"ko" = (
/obj/structure/rack,
/turf/open/floor/wood/maple,
/area/space)
"lz" = (
/obj/structure/table/wood,
/obj/item/reagent_containers/glass/filter{
	pixel_x = 5
	},
/obj/item/reagent_containers/food/drinks/sillycup{
	pixel_x = -5;
	pixel_y = -3
	},
/turf/open/floor/wood/ebony,
/area/space)
"lM" = (
/obj/effect/turf_decal/corner/opaque/blue/diagonal,
/obj/effect/turf_decal/corner/opaque/blue/diagonal,
/obj/structure/table/optable,
/turf/open/floor/plasteel/white,
/area/space)
"mF" = (
/obj/structure/table/wood,
/turf/open/floor/wood/ebony,
/area/space)
"mI" = (
/obj/structure/table/wood,
/obj/item/stack/sheet/hairlesshide,
/obj/item/stack/sheet/hairlesshide,
/obj/item/stack/sheet/hairlesshide,
/obj/item/stack/sheet/hairlesshide,
/obj/item/stack/sheet/cotton/durathread,
/obj/item/stack/sheet/cotton/durathread,
/obj/item/stack/sheet/cotton/durathread,
/obj/item/stack/sheet/cotton/durathread,
/obj/item/stack/sheet/cotton/durathread,
/turf/open/floor/wood/ebony,
/area/space)
"nm" = (
/turf/open/space/basic,
/area/space)
"nM" = (
/obj/machinery/door/airlock/wood,
/obj/effect/turf_decal/siding/brown{
	dir = 8
	},
/turf/open/floor/wood/ebony,
/area/space)
"ow" = (
/turf/open/floor/plasteel/stairs/wood/walnut{
	dir = 1
	},
/area/space)
"oC" = (
/turf/open/floor/carpet,
/area/space)
"qA" = (
/obj/machinery/smartfridge/drying_rack{
	name = "tanning rack";
	desc = "A wooden contraption, used to dry skinned hides"
	},
/turf/open/floor/wood/ebony,
/area/space)
"qW" = (
/obj/effect/turf_decal/spline/fancy/wood{
	dir = 8
	},
/obj/effect/turf_decal/spline/fancy/wood{
	dir = 8
	},
/obj/structure/chair/wood/wings{
	dir = 4
	},
/turf/open/floor/wood/mahogany,
/area/space)
"rx" = (
/obj/item/grown/log/tree{
	pixel_x = -6;
	pixel_y = 12
	},
/obj/item/grown/log/tree{
	pixel_x = 6;
	pixel_y = 12
	},
/obj/item/grown/log/tree{
	pixel_y = 18
	},
/obj/structure/table/wood,
/obj/item/storage/box/matches{
	pixel_y = 2
	},
/turf/open/floor/wood/maple,
/area/space)
"sc" = (
/obj/structure/fireplace,
/obj/item/throwing_star/magspear{
	name = "fire poker";
	desc = "A small metal rod used to stir up fireplaces. This one is adorned with ornate golden filigree"
	},
/turf/open/floor/wood/maple,
/area/space)
"st" = (
/obj/effect/turf_decal/corner/opaque/blue/diagonal,
/turf/open/floor/plasteel/white,
/area/space)
"sD" = (
/obj/structure/railing/wood{
	dir = 6
	},
/turf/open/floor/wood,
/area/space)
"sO" = (
/obj/effect/turf_decal/spline/fancy/wood{
	dir = 6
	},
/turf/open/floor/wood/mahogany,
/area/space)
"tq" = (
/obj/structure/fermenting_barrel/gunpowder,
/turf/open/floor/wood/maple,
/area/space)
"tD" = (
/obj/structure/table/wood,
/obj/item/stack/sheet/cotton/cloth/ten,
/obj/item/scalpel{
	name = "leather knife";
	desc = "A sharpened leather knife, used for leatherwork."
	},
/turf/open/floor/wood/ebony,
/area/space)
"tL" = (
/obj/structure/table/wood,
/obj/item/storage/toolbox/mechanical{
	pixel_y = 10
	},
/obj/item/chisel{
	pixel_x = 5
	},
/turf/open/floor/wood/maple,
/area/space)
"tW" = (
/turf/open/floor/plasteel/stairs/wood/walnut{
	dir = 8
	},
/area/space)
"uA" = (
/obj/item/stack/sheet/durathread{
	pixel_x = -10;
	pixel_y = 10
	},
/obj/structure/rack,
/obj/item/stack/sheet/durathread,
/obj/item/stack/sheet/durathread{
	pixel_y = 10
	},
/obj/item/stack/sheet/durathread{
	pixel_x = -10
	},
/obj/item/stack/sheet/leather,
/obj/item/stack/sheet/leather,
/obj/item/stack/sheet/leather,
/obj/item/stack/sheet/leather,
/obj/item/stack/sheet/leather,
/turf/open/floor/wood/ebony,
/area/space)
"uK" = (
/obj/structure/fermenting_barrel,
/turf/open/floor/wood/maple,
/area/space)
"uR" = (
/turf/open/floor/wood/ebony,
/area/space)
"uX" = (
/turf/open/floor/plasteel/white,
/area/space)
"wi" = (
/obj/effect/turf_decal/spline/fancy/wood/corner{
	dir = 4
	},
/turf/open/floor/wood/mahogany,
/area/space)
"wZ" = (
/obj/effect/turf_decal/siding/blue{
	dir = 5
	},
/turf/open/floor/plasteel/white,
/area/space)
"yQ" = (
/obj/structure/bookcase/random/religion,
/turf/open/floor/wood/maple,
/area/space)
"zl" = (
/obj/structure/chair/wood/wings{
	dir = 4
	},
/turf/open/floor/wood/maple,
/area/space)
"Ar" = (
/obj/effect/turf_decal/siding/brown{
	dir = 10
	},
/turf/open/floor/wood/ebony,
/area/space)
"Ay" = (
/obj/machinery/door/airlock/wood{
	dir = 4
	},
/turf/open/floor/wood/maple,
/area/space)
"Bq" = (
/obj/structure/rack,
/obj/item/ammo_box/c38_box{
	pixel_x = -6;
	pixel_y = 7
	},
/obj/item/ammo_box/c38_box{
	pixel_x = -6;
	pixel_y = 1
	},
/turf/open/floor/wood/ebony,
/area/space)
"Er" = (
/obj/structure/table/wood,
/obj/item/weaponcrafting/stock,
/obj/item/weaponcrafting/receiver,
/turf/open/floor/wood/maple,
/area/space)
"Ez" = (
/turf/open/floor/plasteel/stairs/wood,
/area/space)
"FL" = (
/obj/effect/turf_decal/siding/blue/corner,
/obj/effect/turf_decal/siding/blue/corner{
	dir = 4
	},
/turf/open/floor/plasteel/white,
/area/space)
"Gm" = (
/turf/closed/indestructible/wood,
/area/space)
"Gq" = (
/obj/effect/turf_decal/siding/blue,
/turf/open/floor/plasteel/white,
/area/space)
"Gv" = (
/obj/structure/railing/wood{
	dir = 10
	},
/turf/open/floor/wood,
/area/space)
"Gy" = (
/turf/open/floor/plating/asteroid/snow/icemoon,
/area/space)
"Hl" = (
/turf/closed/mineral/random/snow/underground,
/area/space)
"IF" = (
/obj/structure/rack,
/obj/item/stack/sheet/animalhide/goliath_hide/polar_bear_hide,
/obj/item/stack/sheet/animalhide/goliath_hide/polar_bear_hide,
/obj/item/stack/sheet/animalhide/goliath_hide/polar_bear_hide,
/obj/item/grown/cotton/durathread,
/obj/item/grown/cotton/durathread,
/obj/item/grown/cotton/durathread,
/obj/item/grown/cotton/durathread,
/obj/item/grown/cotton/durathread,
/turf/open/floor/wood/ebony,
/area/space)
"Ja" = (
/turf/open/floor/grass/ship/jungle,
/area/space)
"Kg" = (
/turf/open/floor/wood,
/area/space)
"KR" = (
/obj/effect/turf_decal/spline/fancy/wood,
/turf/open/floor/wood/mahogany,
/area/space)
"Lu" = (
/obj/structure/noticeboard,
/turf/closed/indestructible/wood,
/area/space)
"NO" = (
/obj/effect/turf_decal/spline/fancy/wood{
	dir = 5
	},
/turf/open/floor/wood/mahogany,
/area/space)
"Oa" = (
/obj/effect/turf_decal/siding/blue{
	dir = 10
	},
/turf/open/floor/plasteel/white,
/area/space)
"Ok" = (
/obj/effect/turf_decal/siding/blue{
	dir = 6
	},
/turf/open/floor/plasteel/white,
/area/space)
"ON" = (
/obj/effect/turf_decal/siding/blue{
	dir = 9
	},
/turf/open/floor/plasteel/white,
/area/space)
"Pz" = (
/obj/structure/railing/wood{
	dir = 5
	},
/turf/open/floor/wood,
/area/space)
"PV" = (
/obj/structure/railing/wood{
	dir = 4
	},
/obj/structure/railing/wood,
/turf/open/floor/wood,
/area/space)
"Qz" = (
/turf/open/floor/wood/maple,
/area/space)
"Rd" = (
/obj/effect/turf_decal/spline/fancy/wood{
	dir = 9
	},
/turf/open/floor/wood/mahogany,
/area/space)
"Rw" = (
/obj/structure/rack,
/obj/item/clothing/head/cowboy/sec/roumain{
	pixel_y = -1;
	pixel_x = -7
	},
/obj/item/clothing/head/cowboy/sec/roumain{
	pixel_x = 10
	},
/turf/open/floor/wood/ebony,
/area/space)
"RH" = (
/obj/structure/table/wood,
/obj/item/clothing/under/suit/roumain,
/turf/open/floor/wood/ebony,
/area/space)
"RM" = (
/obj/effect/turf_decal/siding/blue/end{
	dir = 4
	},
/turf/open/floor/plasteel/white,
/area/space)
"Sx" = (
/obj/effect/turf_decal/siding/brown{
	dir = 8
	},
/turf/open/floor/wood/ebony,
/area/space)
"Td" = (
/obj/structure/rack,
/obj/item/clothing/suit/armor/roumain,
/obj/item/clothing/suit/armor/roumain,
/turf/open/floor/wood/ebony,
/area/space)
"Tr" = (
/obj/structure/rack,
/turf/open/floor/wood/ebony,
/area/space)
"TA" = (
/turf/open/water/jungle,
/area/space)
"Uc" = (
/obj/item/toy/plush/moth/punished{
	name = "Flufftunato";
	desc = "For the love of God Mothtressor!"
	},
/turf/open/floor/plating/asteroid/icerock/temperate,
/area/space)
"Vz" = (
/turf/open/floor/wood/mahogany,
/area/space)
"Wd" = (
/obj/effect/turf_decal/siding/blue{
	dir = 8
	},
/turf/open/floor/plasteel/white,
/area/space)
"Wk" = (
/obj/structure/table/wood,
/turf/open/floor/wood/maple,
/area/space)
"Ws" = (
/obj/structure/grille,
/obj/structure/window/reinforced/fulltile,
/obj/structure/curtain/cloth/fancy,
/turf/open/floor/wood,
/area/space)
"WZ" = (
/obj/structure/chair/wood/wings,
/turf/open/floor/wood/maple,
/area/space)
"XK" = (
/obj/effect/turf_decal/spline/fancy/wood{
	dir = 4
	},
/turf/open/floor/wood/mahogany,
/area/space)
"Yd" = (
/obj/structure/chair/wood/wings{
	dir = 1
	},
/turf/open/floor/wood/maple,
/area/space)
"Yw" = (
/obj/structure/loom,
/turf/open/floor/wood/ebony,
/area/space)
"Zn" = (
/turf/open/floor/plating/dirt/icemoon,
/area/space)
"ZZ" = (
/obj/structure/railing/wood,
/turf/open/floor/wood,
/area/space)

(1,1,1) = {"
Gy
Gy
Gy
Gy
Gy
Gy
Gy
Gy
Gy
Gy
Gy
Gy
Gy
Gy
Gy
Gy
Gy
Gy
Gy
Gy
Gy
Gy
Gy
Gy
Gy
Gy
Gy
Gy
Gy
Gy
Gy
Gy
Gy
Gy
Gy
Gy
Gy
Hl
Hl
Gm
Gm
Gm
Gm
Gm
Gm
Gm
Gm
Gy
Gy
Gy
"}
(2,1,1) = {"
Gy
Gy
Gy
Gy
Gy
Gy
Gy
Gy
Gy
Gy
Gy
Gy
Gy
Gy
Gy
Gy
Gy
Gy
Gy
Gy
Gy
Gy
Gy
Gy
Gy
Gy
Gy
Gy
Gy
Gy
Gy
Gy
Gy
Gy
Gy
Gy
Gy
Gm
Gm
Gm
Qz
Qz
Qz
nm
nm
nm
Gm
Gy
Gy
Gy
"}
(3,1,1) = {"
Gy
Gy
Gy
Gy
Gy
Gy
Gy
Gy
Gy
Gy
Gy
Gy
Gy
Gy
Gy
Gy
Gy
Gy
Gy
Gy
Gy
Gy
Gy
Gy
Gy
Gy
Gy
Gy
Gy
Gy
Gy
Gy
Gy
Gy
Gy
Gy
Gy
Gm
Qz
Qz
Qz
Qz
Qz
Qz
WZ
nm
Gm
Gy
Gy
Gy
"}
(4,1,1) = {"
Gy
Gy
Gy
Gy
Gy
Gy
Gy
Gy
Gy
Gy
Gy
Gy
Gy
Gy
Gy
Gy
Gy
Gy
Gy
Gy
Gy
Gy
Gy
Gy
Gy
Gy
Gy
Gy
Gy
Gy
Gy
Gy
Gy
Gy
Gy
Gy
Gy
Gm
Qz
Qz
Qz
ko
ko
Qz
Qz
nm
Gm
Gy
Gy
Gy
"}
(5,1,1) = {"
Gy
Gy
Gy
Gy
Gy
Gy
Gy
Gy
Hl
Hl
Hl
Hl
Hl
Hl
Hl
Hl
Hl
Hl
Hl
Hl
Hl
Hl
Hl
Hl
Hl
Hl
Hl
Hl
Gy
Gy
Gy
Gy
Gy
Gy
Gy
Gy
Gy
Gm
Qz
Qz
Qz
ko
ko
Qz
Qz
nm
Gm
Gy
Gy
Gy
"}
(6,1,1) = {"
Gy
Gy
Gy
Gy
Gy
Gy
Gy
Hl
Hl
Hl
Hl
Hl
Hl
Hl
Hl
Hl
Hl
Hl
Hl
Hl
Hl
Hl
Hl
Hl
Hl
Hl
Hl
Hl
Hl
Gy
Gy
Gy
Gy
Gy
Gy
Gy
Gy
Gm
nm
Qz
Qz
ko
ko
Qz
Qz
nm
Gm
Gy
Gy
Gy
"}
(7,1,1) = {"
Gy
Gy
Gy
Gy
Gy
Gy
Gy
Hl
Hl
Gm
Gm
Gm
Gm
Gm
Gm
Gm
Gm
Gm
Gm
Gm
Gm
Gm
Gm
Gm
Gm
Gm
Gm
Gm
Gm
Gm
Hl
Gy
Gy
Gy
Gy
Gy
Gy
Gm
nm
Yd
Qz
Qz
Qz
Qz
WZ
nm
Gm
Gy
Gy
Gy
"}
(8,1,1) = {"
Gy
Gy
Gy
Gy
Gy
Gy
Gy
Hl
Gm
Gm
IF
qA
ko
Er
tL
Gm
rx
Qz
Qz
bC
Gm
ak
lM
jk
Gm
uX
Qz
Qz
Qz
Gm
Gm
Hl
Gy
Gy
Gy
Gy
Gy
Gm
nm
Qz
Qz
Qz
Qz
Qz
nm
nm
Gm
Gy
Gy
Gy
"}
(9,1,1) = {"
Gy
Gy
Gy
Gy
Gy
Hl
Hl
Hl
Gm
Yw
Qz
Qz
Qz
Qz
Qz
Gm
sc
oC
oC
bC
Gm
ON
Wd
Oa
Gm
uX
Qz
Qz
Qz
Qz
Gm
Hl
Gy
Gy
Gy
Gy
Gy
Gm
Gm
Qz
Qz
zl
Qz
tq
Gm
Gm
Gm
Gy
Gy
Gy
"}
(10,1,1) = {"
Gy
Gy
Gy
Gy
Gy
Hl
Hl
Hl
Gm
mI
Qz
Qz
Qz
Qz
Qz
Lu
Qz
oC
oC
bC
Gm
fA
uX
Gq
Gm
Gm
Gm
Qz
Qz
Qz
Gm
Hl
Hl
Gy
Gy
Gy
Gy
Hl
Gm
Tr
Bq
mF
lz
Gm
Gm
Hl
Hl
Gy
Gy
Gy
"}
(11,1,1) = {"
Gy
Gy
Gy
Gy
Gy
Hl
Hl
Hl
Gm
eC
Qz
Qz
Qz
Qz
Qz
Gm
yQ
Qz
Qz
bC
Gm
fA
uX
Gq
st
Gm
Qz
Qz
Qz
Qz
Gm
Hl
Hl
Gy
Gy
Gy
Gy
Gy
Gm
Gm
Gm
Gm
Gm
Gm
Hl
Hl
Hl
Gy
Gy
Gy
"}
(12,1,1) = {"
Gy
Gy
Gy
Gy
Gy
Hl
Hl
Hl
Gm
uA
Qz
Qz
Qz
Gm
Gm
Gm
Gm
Qz
Gm
Gm
Gm
wZ
FL
Ok
st
Gm
Qz
Qz
Qz
Qz
Gm
Hl
Hl
Gy
Gy
Gy
Gy
Gy
Gy
Gy
Gy
Gy
Gy
Gy
Gy
Gy
Gy
Gy
Gy
Gy
"}
(13,1,1) = {"
Gy
Gy
Gy
Gy
Gy
Hl
Hl
Hl
Gm
tD
Qz
Qz
Qz
Gm
uR
uR
uR
uR
uR
Gm
Gm
Gm
RM
Gm
Gm
Gm
Qz
Qz
Qz
Qz
Gm
Hl
Hl
Gy
Gy
Gy
Gy
Gy
Gy
Gy
Gy
Gy
Gy
Gy
Gy
Gy
Gy
Gy
Gy
Gy
"}
(14,1,1) = {"
Gy
Gy
Gy
Gy
Gy
Hl
Hl
Hl
Gm
RH
Qz
Qz
Qz
uR
uR
uR
uR
uR
uR
uR
uR
uR
uR
uR
Gm
Qz
Qz
Qz
Qz
Qz
Gm
Hl
Hl
Gy
Gy
Gy
Gy
Gy
Gy
Gy
Gy
Zn
Zn
Zn
Zn
Zn
Zn
Gy
Gy
Gy
"}
(15,1,1) = {"
Gy
Gy
Gy
Gy
Gy
Hl
Hl
Hl
Gm
Td
Rw
Qz
Qz
Gm
uR
uR
uR
uR
uR
uR
uR
uR
uR
uR
Qz
Qz
Qz
Qz
Qz
Qz
Gm
Hl
Hl
Hl
Hl
Gy
Gy
Gy
Gy
Gy
Gy
Zn
TA
Zn
TA
TA
Zn
Gy
Gy
Gy
"}
(16,1,1) = {"
Gy
Gy
Gy
Gy
Gy
Gy
Hl
Hl
Gm
Gm
Gm
Gm
Gm
Gm
Gm
Gm
Gm
Gm
Gm
uR
uR
uR
uR
uR
Gm
Qz
Qz
Qz
Qz
Gm
Gm
Hl
Hl
Hl
Hl
Gy
Gy
Gy
Gy
Gy
Gy
Zn
TA
TA
TA
Zn
Zn
Gy
Gy
Gy
"}
(17,1,1) = {"
Gy
Gy
Gy
Gy
Gy
Gy
Hl
Hl
Hl
Hl
Hl
Hl
Hl
Hl
Hl
Hl
Hl
Hl
Gm
Gm
Gm
Ay
Gm
Gm
Gm
Gm
Gm
Gm
Gm
Gm
Hl
Hl
Hl
Hl
Hl
Gy
Gy
Gy
Gy
Gy
Gy
Zn
TA
TA
TA
TA
Zn
Gy
Gy
Gy
"}
(18,1,1) = {"
Gy
Gy
Gy
Gy
Gy
Gy
Hl
Hl
Hl
Hl
Hl
Hl
Hl
Hl
Hl
Hl
Hl
Hl
Hl
bb
bb
bb
bb
bb
bb
bb
bb
bb
bb
bb
Hl
Hl
Hl
Hl
Hl
Gy
Gy
Gy
Gy
Gy
Gy
Zn
Zn
TA
TA
Zn
Zn
Gy
Gy
Gy
"}
(19,1,1) = {"
Gy
Gy
Gy
Gy
Gy
Hl
Hl
Hl
Hl
Hl
Hl
Hl
Uc
Hl
Hl
Hl
Hl
Hl
Hl
bb
bb
bb
bb
bb
bb
bb
bb
bb
bb
bb
bb
Hl
Hl
Hl
Hl
Gy
Gy
Gy
Gy
Gy
Gy
Zn
Zn
Zn
Zn
Zn
Zn
Gy
Gy
Gy
"}
(20,1,1) = {"
Gy
Gy
Gy
Hl
Hl
Hl
Hl
Hl
Hl
Gm
Gm
Gm
Gm
Gm
Gm
Gm
Hl
Hl
Hl
bb
bb
bb
bb
Gy
Gy
Gy
Gy
Gy
Gy
Gy
bb
bb
bb
Hl
Hl
Gy
Gy
Gy
Gy
Gy
Gy
Gy
Gy
Gy
Gy
Gy
Gy
Gy
Gy
Gy
"}
(21,1,1) = {"
Gy
Gy
Gy
Hl
Hl
Hl
Gm
Gm
Gm
Gm
Qz
Qz
Qz
Qz
Qz
Gm
Gm
Hl
Hl
Hl
bb
bb
Gy
Gy
Gy
Gy
Gy
Gy
Gy
Gy
Gy
bb
bb
Hl
Hl
Gy
Gy
Gy
Gy
Gy
Gy
Gy
Gy
Gy
Gy
Gy
Gy
Gy
Gy
Gy
"}
(22,1,1) = {"
Gy
Gy
Gy
Hl
Hl
Hl
Gm
Qz
Qz
ow
Qz
Qz
Qz
Qz
Qz
Wk
Gm
Hl
Hl
bb
bb
bb
Gy
Gy
Gy
Gy
Gy
Gy
Gy
Gy
Gy
bb
bb
Hl
Hl
Hl
Gy
Gy
Gy
Gy
Gy
Gy
Gy
Gy
Gy
Gy
Gy
Gy
Gy
Gy
"}
(23,1,1) = {"
Gy
Gy
Gy
Hl
Hl
Hl
Gm
Qz
Qz
ow
Qz
Qz
Qz
Qz
Qz
Wk
Gm
Hl
Hl
bb
bb
bb
Gy
Gy
Gy
Gy
Gy
Gy
Gy
Gy
Gy
bb
bb
Hl
Hl
Hl
Gy
Gy
Gy
Gy
Gy
Gy
Gy
Gy
Gy
Gy
Gy
Gy
Gy
Gy
"}
(24,1,1) = {"
Gy
Gy
Gy
Hl
Hl
Hl
Gm
tW
tW
Gm
Qz
Qz
Qz
Qz
uK
Gm
Gm
Hl
Hl
bb
bb
bb
Gy
Gy
Gy
Gy
Gy
Gy
Gy
Gy
Gy
bb
bb
Hl
Hl
Hl
Gy
Gy
Gy
Gy
Gy
Gy
Gy
Gy
Gy
Gy
Gy
Gy
Gy
Gy
"}
(25,1,1) = {"
Gy
Gy
Gy
Hl
Hl
Gm
Gm
eK
eK
Gm
Qz
Qz
Qz
Qz
Gm
Gm
Kg
Kg
sD
bb
bb
bb
Gy
Gy
Gy
Gy
Gy
Gy
Gy
Gy
Gy
bb
bb
Hl
Hl
Hl
Gy
Gy
Gy
Gy
Gy
Gy
Gy
Gy
Gy
Gy
Gy
Gy
Gy
Gy
"}
(26,1,1) = {"
Gy
Gy
Hl
Hl
Hl
Gm
Qz
Qz
Qz
Gm
Gm
Gm
Gm
Gm
Gm
Kg
Kg
Kg
Ez
bb
bb
bb
Gy
Gy
Gy
Gy
Gy
Gy
Gy
Gy
Gy
bb
bb
Hl
Hl
Hl
Gy
Gy
Gy
Gy
Gy
Gy
Gy
Gy
Gy
Gy
Gy
Gy
Gy
Gy
"}
(27,1,1) = {"
Gy
Gy
Hl
Hl
Hl
Gm
Qz
Qz
Gm
Gm
Rd
kl
qW
jD
Ws
Kg
Kg
Kg
Gv
bb
bb
bb
Gy
Gy
Gy
Gy
Gy
Gy
Gy
Gy
Gy
bb
bb
Hl
Hl
Gy
Gy
Gy
Gy
Gy
Gy
Gy
Gy
Gy
Gy
Gy
Gy
Gy
Gy
Gy
"}
(28,1,1) = {"
Gy
Gy
Hl
Hl
Hl
Gm
Qz
Qz
Gm
Rd
dA
dT
dT
bL
Ws
Kg
Kg
Kg
ZZ
bb
bb
bb
Gy
Gy
Gy
Gy
Gy
Gy
Gy
Gy
Gy
bb
bb
Hl
Hl
Gy
Gy
Gy
Gy
Gy
Gy
Gy
Gy
Gy
Gy
Gy
Gy
Gy
Gy
Gy
"}
(29,1,1) = {"
Gy
Gy
Hl
Hl
Hl
Gm
Qz
Qz
Gm
fw
Vz
Vz
Vz
KR
Ws
Kg
Kg
Kg
ZZ
bb
bb
bb
Gy
Gy
Gy
Gy
Gy
Gy
Gy
Gy
Gy
bb
bb
Hl
Hl
Gy
Gy
Gy
Gy
Gy
Gy
Gy
Gy
Gy
Gy
Gy
Gy
Gy
Gy
Gy
"}
(30,1,1) = {"
Gy
Gy
Hl
Hl
Hl
Gm
Qz
Qz
eK
fw
Vz
Vz
Vz
KR
Ws
Kg
Kg
Kg
ZZ
bb
bb
bb
Gy
Gy
Gy
Gy
Gy
Gy
Gy
Gy
Gy
bb
bb
Hl
Hl
Gy
Gy
Gy
Gy
Gy
Gy
Gy
Gy
Gy
Gy
Gy
Gy
Gy
Gy
Gy
"}
(31,1,1) = {"
Gy
Gy
Hl
Hl
Hl
Gm
Qz
Qz
Gm
fw
Vz
Vz
Vz
KR
Ws
Kg
Kg
Kg
ZZ
bb
bb
bb
Gy
Gy
Gy
Gy
Gy
Gy
Gy
Gy
Gy
bb
bb
Hl
Hl
Hl
Gy
Gy
Gy
Gy
Gy
Gy
Gy
Gy
Gy
Gy
Gy
Gy
Gy
Gy
"}
(32,1,1) = {"
Gy
Gy
Hl
Hl
Hl
Gm
Qz
Qz
Gm
NO
wi
Vz
Vz
KR
Ws
Kg
Kg
Kg
ZZ
bb
bb
bb
Gy
Gy
Gy
Gy
Gy
Gy
Gy
Gy
Gy
bb
bb
Hl
Hl
Hl
Gy
Gy
Gy
Gy
Gy
Gy
Gy
Gy
Gy
Gy
Gy
Gy
Gy
Gy
"}
(33,1,1) = {"
Gy
Gy
Hl
Hl
Hl
Gm
Qz
Qz
Gm
Gm
NO
XK
XK
sO
Ws
Kg
Kg
Kg
ZZ
bb
bb
bb
Gy
Gy
Gy
Gy
Gy
Gy
Gy
Gy
Gy
bb
bb
Hl
Hl
Hl
Gy
Gy
Gy
Gy
Gy
Gy
Gy
Gy
Gy
Gy
Gy
Gy
Gy
Gy
"}
(34,1,1) = {"
Gy
Gy
Hl
Hl
Hl
Gm
Qz
Qz
Qz
Gm
Gm
Gm
Gm
Gm
Gm
sD
aF
Pz
PV
bb
bb
bb
Gy
Gy
Gy
Gy
Gy
Gy
Gy
Gy
Gy
bb
bb
Hl
Hl
Hl
Gy
Gy
Gy
Gy
Gy
Gy
Gy
Gy
Gy
Gy
Gy
Gy
Gy
Gy
"}
(35,1,1) = {"
Gy
Gy
Hl
Hl
Hl
Gm
Gm
Qz
Qz
Qz
Qz
Qz
Qz
Qz
eq
Sx
Sx
Ar
Gm
Hl
bb
bb
bb
Gy
Gy
Gy
Gy
Gy
Gy
Gy
bb
bb
bb
Hl
Hl
Hl
Gy
Gy
Gy
Gy
Gy
Gy
Gy
Gy
Gy
Gy
Gy
Gy
Gy
Gy
"}
(36,1,1) = {"
Gy
Gy
Hl
Hl
Hl
Hl
Gm
Qz
Qz
Qz
Qz
Qz
Qz
Qz
nM
ho
ho
fi
Gm
Hl
Hl
bb
bb
bb
bb
bb
bb
bb
bb
bb
bb
bb
bb
Hl
Hl
Hl
Gy
Gy
Gy
Gy
Gy
Gy
Gy
Gy
Gy
Gy
Gy
Gy
Gy
Gy
"}
(37,1,1) = {"
Gy
Gy
Hl
Hl
Hl
Hl
Gm
Gm
Gm
Gm
Gm
Gm
Gm
Gm
Gm
Gm
Gm
Gm
Gm
Hl
Hl
bb
bb
bb
bb
bb
bb
bb
bb
bb
bb
bb
bb
Hl
Hl
Hl
Gy
Gy
Gy
Gy
Gy
Hl
Gy
Gy
Gy
Gy
Gy
Gy
Gy
Gy
"}
(38,1,1) = {"
Gy
Gy
Hl
Hl
Hl
Hl
Hl
Hl
Hl
Hl
Hl
Hl
Hl
Hl
Hl
Hl
Hl
Hl
Hl
Hl
Hl
bb
bb
bb
bb
bb
bb
bb
bb
bb
bb
bb
bb
Hl
Hl
Hl
Gy
Gy
Gy
Gy
Gy
Hl
Gy
Gy
Gy
Gy
Gy
Gy
Gy
Gy
"}
(39,1,1) = {"
Gy
Gy
Hl
Hl
Hl
Hl
Hl
Hl
Hl
Hl
Hl
Hl
Hl
Hl
Hl
Hl
Hl
Hl
Hl
Hl
Hl
bb
bb
bb
bb
bb
bb
bb
bb
bb
bb
bb
bb
Hl
Hl
Hl
Gy
Gy
Gy
Gy
Gy
Hl
Gy
Gy
Gy
Gy
Gy
Gy
Gy
Gy
"}
(40,1,1) = {"
Gy
Gy
Hl
Hl
Hl
Hl
Hl
Hl
Hl
Hl
Hl
Hl
Hl
Hl
Hl
Hl
Hl
Hl
Hl
Hl
Hl
bb
bb
bb
bb
bb
bb
bb
bb
bb
bb
bb
bb
Hl
Hl
Hl
Gy
Gy
Gy
Gy
Gy
Hl
Gm
uR
uR
Gm
uR
uR
Gm
Hl
"}
(41,1,1) = {"
Gy
Gy
Gy
Gy
Hl
Hl
Hl
Hl
Hl
Hl
Hl
Hl
Hl
Hl
Hl
Hl
Hl
Hl
Hl
Hl
Hl
bb
bb
bb
bb
bb
bb
bb
bb
bb
bb
bb
bb
Hl
Hl
Hl
Gy
Gy
Gy
Gy
Gy
Gm
Gm
uR
uR
uR
uR
uR
Gm
Gm
"}
(42,1,1) = {"
Gy
Gy
Gy
Gy
Gy
Gy
Gy
Gy
Gy
Gy
Hl
Hl
Hl
Hl
Hl
Hl
Hl
Hl
Hl
Hl
Hl
Hl
Hl
Hl
Hl
Hl
Hl
Hl
Hl
Hl
Hl
Hl
Hl
Hl
Hl
Hl
Gy
Gy
Gy
Gy
Gy
Gm
uR
uR
uR
uR
uR
uR
uR
uR
"}
(43,1,1) = {"
Gy
Gy
Gy
Gy
Gy
Gy
Gy
Gy
Gy
Gy
Hl
Hl
Hl
Hl
Hl
Hl
Hl
Hl
Hl
Hl
Hl
Hl
Hl
Hl
Hl
Hl
Hl
Hl
Hl
Hl
Hl
Hl
Hl
Hl
Hl
Hl
Gy
Gy
Gy
Gy
Gy
Gm
uR
uR
uR
uR
uR
uR
uR
uR
"}
(44,1,1) = {"
Gy
Gy
Gy
Gy
Gy
Gy
Gy
Gy
Gy
Gy
Gy
Gy
Gy
Gy
Gy
Hl
Hl
Hl
Hl
Gy
Hl
Hl
Hl
Hl
Hl
Hl
Hl
Hl
Hl
Hl
Hl
Hl
Hl
Hl
Hl
Hl
Gy
Gy
Gy
Gy
Gy
Gm
Qz
Qz
uR
uR
uR
Qz
Qz
Gm
"}
(45,1,1) = {"
Gy
Gy
Gy
Gy
Gy
Gy
Gy
Gy
Gy
Gy
Gy
Gy
Gy
Gy
Gy
Gy
Gy
Gy
Gy
Gy
Gy
Gy
Gy
Gy
Gy
Gy
Gy
Gy
Gy
Gy
Gy
Gy
Gy
Hl
Hl
Hl
Gy
Gy
Gy
Gy
Gy
Gm
Qz
Qz
uR
uR
uR
Qz
Qz
Gm
"}
(46,1,1) = {"
Gy
Gy
Gy
Gy
Gy
Gy
Gy
Gy
Gy
Gy
Gy
Gy
Gy
Gy
Gy
Gy
Gy
Gy
Gy
Gy
Gy
Gy
Gy
Gy
Gy
Gy
Gy
Gy
Gy
Gy
Gy
Gy
Gy
Gy
Gy
Gy
Gy
Gy
Gy
Gy
Gy
Gm
Qz
Qz
uR
uR
uR
Qz
Qz
Gm
"}
(47,1,1) = {"
Gy
Gy
Gy
Gy
Gy
Gy
Gy
Gy
Gy
Gy
Gy
Gy
Gy
Gy
Gy
Gy
Gy
Gy
Gy
Gy
Gy
Gy
Gy
Gy
Gy
Gy
Gy
Gy
Gy
Gy
Gy
Gy
Gy
Gy
Gy
Gy
Gy
Gy
Gy
Gy
Gy
Gm
Qz
Qz
uR
uR
uR
Qz
Qz
Gm
"}
(48,1,1) = {"
Gy
Gy
Gy
Gy
Gy
Gy
Gy
Gy
Gy
Gy
Gy
Gy
Gy
Gy
Gy
Gy
Gy
Gy
Gy
Gy
Gy
Gy
Gy
Gy
Gy
Gy
Gy
Gy
Gy
Gy
Gy
Gy
Gy
Gy
Gy
Gy
Gy
Gy
Gy
Gy
Gy
Gm
Qz
Qz
uR
uR
uR
Qz
Qz
Gm
"}
(49,1,1) = {"
Gy
Gy
Gy
Gy
Gy
Gy
Gy
Gy
Gy
Gy
Gy
Gy
Gy
Gy
Gy
Gy
Gy
Gy
Gy
Gy
Gy
Gy
Gy
Gy
Gy
Gy
Gy
Gy
Gy
Gy
Gy
Gy
Gy
Gy
Gy
Gy
Gy
Gy
Gy
Gy
Gy
Gm
Qz
Qz
uR
uR
uR
Qz
Qz
Gm
"}
(50,1,1) = {"
nm
nm
nm
nm
nm
nm
nm
nm
nm
nm
Gy
Gy
Gy
Gy
Gy
Gy
Gy
Gy
Gy
Gy
Gy
Gy
Gy
Gy
Gy
Gy
Gy
Gy
Gy
Gy
Gy
Gy
Gy
Gy
Gy
Gy
Gy
Gy
Gy
Gy
Gy
Gm
Qz
Qz
uR
uR
uR
Qz
Qz
Gm
"}
(51,1,1) = {"
nm
nm
nm
nm
nm
nm
nm
nm
nm
nm
Gy
Gy
Gy
Gy
Gy
Gy
Gy
Gy
Gy
Gy
Gy
Gy
Gy
Gy
Gy
Gy
Gy
Gy
Gy
Gy
Gy
Gy
Gy
Gy
Gy
Gy
Gy
Gy
Gy
Gy
Gy
Gm
Ja
Ja
Ja
Ja
Ja
Ja
Ja
Gm
"}
(52,1,1) = {"
nm
nm
nm
nm
nm
nm
nm
nm
nm
nm
Gy
Gy
Gy
Gy
Gy
Gy
Gy
Gy
Gy
Gy
Gy
Gy
Gy
Gy
Gy
Gy
Gy
Gy
Gy
Gy
Gy
Gy
Gy
Gy
Gy
Gy
Gy
Gy
Gy
Gy
Gy
Gm
Ja
Ja
Ja
Ja
Ja
Ja
Ja
Gm
"}
(53,1,1) = {"
nm
nm
nm
nm
nm
nm
nm
nm
nm
nm
Gy
Gy
Gy
Gy
Gy
Gy
Gy
Gy
Gy
Gy
Gy
Gy
Gy
Gy
Gy
Gy
Gy
Gy
Gy
Gy
Gy
Gy
Gy
Gy
Gy
Gy
Gy
Gy
Gy
Gy
Gy
Gm
Gm
Ja
Ja
Ja
Ja
Ja
Gm
Gm
"}
(54,1,1) = {"
nm
nm
nm
nm
nm
nm
nm
nm
nm
nm
Gy
Gy
Gy
Gy
Gy
Gy
Gy
Gy
Gy
Gy
Gy
Gy
Gy
Gy
Gy
Gy
Gy
Gy
Gy
Gy
Gy
Gy
Gy
Gy
Gy
Gy
Gy
Gy
Gy
Gy
Gy
Hl
Gm
Gm
Ja
Ja
Ja
Gm
Gm
Hl
"}
(55,1,1) = {"
nm
nm
nm
nm
nm
nm
nm
nm
nm
nm
Gy
Gy
Gy
Gy
Gy
Gy
Gy
Gy
Gy
Gy
Gy
Gy
Gy
Gy
Gy
Gy
Gy
Gy
Gy
Gy
Gy
Gy
Gy
Gy
Gy
Gy
Gy
Gy
Gy
Gy
Gy
Hl
Hl
Gm
Gm
Gm
Gm
Gm
Hl
Hl
"}
(56,1,1) = {"
nm
nm
nm
nm
nm
nm
nm
nm
nm
nm
Gy
Gy
Gy
Gy
Gy
Gy
Gy
Gy
Gy
Gy
Gy
Gy
Gy
Gy
Gy
Gy
Gy
Gy
Gy
Gy
Gy
Gy
Gy
Gy
Gy
Gy
Gy
Gy
Gy
Gy
Gy
Gy
Gy
Gy
Gy
Gy
Gy
Gy
Gy
Gy
"}
(57,1,1) = {"
nm
nm
nm
nm
nm
nm
nm
nm
nm
nm
Gy
Gy
Gy
Gy
Gy
Gy
Gy
Gy
Gy
Gy
Gy
Gy
Gy
Gy
Gy
Gy
Gy
Gy
Gy
Gy
Gy
Gy
Gy
Gy
Gy
Gy
Gy
Gy
Gy
Gy
Gy
Gy
Gy
Gy
Gy
Gy
Gy
Gy
Gy
Gy
"}
(58,1,1) = {"
nm
nm
nm
nm
nm
nm
nm
nm
nm
nm
Gy
Gy
Gy
Gy
Gy
Gy
Gy
Gy
Gy
Gy
Gy
Gy
Gy
Gy
Gy
Gy
Gy
Gy
Gy
Gy
Gy
Gy
Gy
Gy
Gy
Gy
Gy
Gy
Gy
Gy
Gy
Gy
Gy
Gy
Gy
Gy
Gy
Gy
Gy
Gy
"}
(59,1,1) = {"
nm
nm
nm
nm
nm
nm
nm
nm
nm
nm
Gy
Gy
Gy
Gy
Gy
Gy
Gy
Gy
Gy
Gy
Gy
Gy
Gy
Gy
Gy
Gy
Gy
Gy
Gy
Gy
Gy
Gy
Gy
Gy
Gy
Gy
Gy
Gy
Gy
Gy
Gy
Gy
Gy
Gy
Gy
Gy
Gy
Gy
Gy
Gy
"}
(60,1,1) = {"
nm
nm
nm
nm
nm
nm
nm
nm
nm
nm
Gy
Gy
Gy
Gy
Gy
Gy
Gy
Gy
Gy
Gy
Gy
Gy
Gy
Gy
Gy
Gy
Gy
Gy
Gy
Gy
Gy
Gy
Gy
Gy
Gy
Gy
Gy
Gy
Gy
Gy
Gy
Gy
Gy
Gy
Gy
Gy
Gy
Gy
Gy
Gy
"}
