//MAP CONVERTED BY dmm2tgm.py THIS HEADER COMMENT PREVENTS RECONVERSION, DO NOT REMOVE
"a" = (
/turf/open/floor/plating/dirt/jungle/dark/lit,
/area/space)
"b" = (
/obj/item/coin/iron,
/turf/open/water/jungle/lit,
/area/space)
"c" = (
/turf/open/floor/wood,
/area/space)
"e" = (
/turf/open/floor/concrete/slab_1,
/area/space)
"l" = (
/obj/item/radio/intercom/directional/south,
/turf/open/floor/concrete/pavement,
/area/space)
"m" = (
/turf/open/water/jungle/lit,
/area/space)
"o" = (
/obj/effect/turf_decal/industrial/warning{
	dir = 4
	},
/turf/open/floor/concrete/pavement,
/area/space)
"p" = (
/turf/closed/mineral/random/jungle,
/area/space)
"q" = (
/turf/closed/wall/concrete/reinforced,
/area/space)
"s" = (
/turf/open/space/basic,
/area/space)
"t" = (
/obj/structure/railing{
	dir = 4
	},
/turf/open/floor/concrete/slab_1,
/area/space)
"x" = (
/obj/effect/turf_decal/industrial/warning{
	dir = 8
	},
/turf/open/floor/concrete/pavement,
/area/space)
"z" = (
/turf/open/floor/plasteel/stairs/wood,
/area/space)
"A" = (
/obj/structure/healingfountain,
/turf/open/water/jungle/lit,
/area/space)
"E" = (
/obj/structure/displaycase,
/turf/open/floor/wood,
/area/space)
"F" = (
/obj/item/coin/plastic,
/turf/open/water/jungle/lit,
/area/space)
"G" = (
/obj/machinery/light/floor/hangar,
/turf/open/floor/concrete/slab_1,
/area/space)
"I" = (
/obj/structure/chair/bench/beige{
	dir = 4
	},
/turf/open/floor/concrete/slab_1,
/area/space)
"K" = (
/obj/item/coin/gold,
/turf/open/water/jungle/lit,
/area/space)
"M" = (
/obj/effect/turf_decal/industrial/warning{
	dir = 8
	},
/obj/effect/turf_decal/industrial/stand_clear/white{
	dir = 4
	},
/turf/open/floor/concrete/pavement,
/area/space)
"O" = (
/obj/structure/chair/bench/beige,
/turf/open/floor/concrete/slab_1,
/area/space)
"P" = (
/turf/open/floor/concrete/pavement,
/area/space)
"Q" = (
/obj/structure/chair/bench/beige{
	dir = 8
	},
/turf/open/floor/concrete/slab_1,
/area/space)
"R" = (
/obj/structure/chair/bench/beige{
	dir = 1
	},
/turf/open/floor/concrete/slab_1,
/area/space)
"S" = (
/obj/structure/rack,
/turf/open/floor/wood,
/area/space)
"T" = (
/obj/effect/turf_decal/industrial/warning{
	dir = 4
	},
/obj/effect/turf_decal/industrial/stand_clear/white{
	dir = 8
	},
/turf/open/floor/concrete/pavement,
/area/space)
"U" = (
/obj/structure/railing{
	dir = 8
	},
/turf/open/floor/concrete/slab_1,
/area/space)
"W" = (
/obj/structure/table/reinforced,
/turf/open/floor/wood,
/area/space)
"X" = (
/turf/closed/wall/mineral/wood,
/area/space)
"Y" = (
/obj/machinery/door/poddoor/shutters{
	dir = 8
	},
/turf/open/floor/concrete/reinforced/jungleplanet/lit,
/area/space)

(1,1,1) = {"
s
s
s
s
s
s
s
s
s
s
a
a
p
p
p
p
a
a
a
a
a
a
a
a
a
a
a
a
a
a
a
a
a
a
a
a
a
a
a
a
a
a
a
a
a
a
a
a
a
a
"}
(2,1,1) = {"
s
s
s
s
s
s
s
s
s
s
a
a
p
p
p
p
a
a
a
a
a
a
a
a
a
a
a
a
a
a
a
a
a
a
a
a
a
a
a
a
a
a
a
a
a
a
a
a
a
a
"}
(3,1,1) = {"
s
s
s
s
s
s
s
s
s
s
p
a
p
p
p
p
a
a
a
a
a
a
a
a
a
a
a
a
a
a
a
a
a
a
a
a
a
a
a
a
a
a
a
a
a
a
a
a
a
a
"}
(4,1,1) = {"
s
s
s
s
s
s
s
s
s
s
p
p
p
p
p
p
a
a
a
a
a
a
a
a
a
a
a
a
a
a
a
a
a
a
a
a
a
a
a
a
a
a
a
a
a
a
a
a
a
a
"}
(5,1,1) = {"
s
s
s
s
s
s
s
s
s
s
p
p
p
X
X
X
X
X
X
a
a
a
a
a
a
a
a
a
a
a
a
a
a
a
a
a
a
a
a
a
a
a
a
a
a
a
a
a
a
a
"}
(6,1,1) = {"
s
s
s
s
s
s
s
s
s
s
a
p
X
X
S
S
S
S
X
X
a
a
a
a
a
a
a
a
a
a
a
a
a
a
a
a
a
a
a
a
a
a
a
a
a
a
a
a
a
a
"}
(7,1,1) = {"
s
s
s
s
s
s
s
s
s
s
a
p
X
S
c
c
c
c
S
X
a
a
a
a
a
a
a
e
e
e
e
e
e
e
a
a
a
a
a
a
a
a
a
a
a
a
a
a
a
a
"}
(8,1,1) = {"
s
s
s
s
s
s
s
s
s
s
p
p
X
S
c
c
c
c
S
X
a
a
a
a
a
a
e
e
P
P
P
P
P
e
e
a
a
a
a
a
a
a
a
a
a
a
a
a
a
a
"}
(9,1,1) = {"
s
s
s
s
s
s
s
s
s
s
p
p
X
E
c
c
c
c
E
X
a
a
a
a
a
e
e
P
P
P
P
P
P
P
e
e
a
a
a
a
a
a
a
a
a
a
a
a
a
a
"}
(10,1,1) = {"
s
s
s
s
s
s
s
s
s
s
p
X
X
S
c
c
c
c
S
X
a
a
a
a
e
e
P
P
P
P
P
P
P
P
P
e
e
a
a
a
a
a
a
a
a
a
a
a
a
a
"}
(11,1,1) = {"
s
s
s
s
s
s
s
s
X
X
X
X
X
S
c
c
c
c
S
X
a
a
a
e
e
P
P
P
e
I
I
I
e
P
P
P
e
e
a
a
a
a
a
a
a
a
a
a
a
a
"}
(12,1,1) = {"
s
s
s
s
s
s
s
X
X
S
S
S
X
X
c
c
c
c
c
X
X
a
e
e
P
P
P
e
e
m
m
m
e
e
P
P
P
e
e
a
a
a
a
a
a
a
a
a
a
a
"}
(13,1,1) = {"
s
s
s
s
s
s
s
X
S
c
c
c
X
S
c
c
c
c
c
c
X
X
t
P
P
P
e
e
m
m
K
m
m
e
e
P
P
P
e
a
a
a
a
a
a
a
a
a
a
a
"}
(14,1,1) = {"
s
s
s
s
s
s
s
X
S
c
c
c
X
S
c
c
c
c
c
c
c
c
z
P
P
P
O
m
m
b
m
K
m
m
R
P
P
P
e
a
a
a
a
a
a
a
a
a
a
a
"}
(15,1,1) = {"
s
s
s
s
s
s
s
X
S
c
c
c
X
S
c
c
c
c
c
c
c
c
z
P
P
P
O
m
m
m
A
m
m
m
R
P
P
P
e
a
a
a
a
a
a
a
a
a
a
a
"}
(16,1,1) = {"
s
s
s
s
s
s
s
X
X
X
c
X
X
S
c
c
c
c
c
c
c
c
z
P
P
P
O
m
m
m
b
m
F
m
R
P
P
P
e
a
a
a
a
a
a
a
a
a
a
a
"}
(17,1,1) = {"
s
s
s
s
s
s
s
X
c
c
c
c
X
X
c
c
c
c
c
c
X
X
U
P
P
P
e
e
F
m
m
m
m
e
e
P
P
P
e
a
a
a
a
a
a
a
a
a
a
a
"}
(18,1,1) = {"
s
s
s
s
s
s
s
X
c
c
c
c
c
X
c
W
W
W
W
X
X
a
e
e
P
P
P
e
e
m
m
m
e
e
P
P
P
e
e
a
a
a
a
a
a
a
a
a
a
a
"}
(19,1,1) = {"
s
s
s
s
s
s
s
X
c
c
c
c
c
c
c
c
c
c
c
X
X
a
a
e
e
P
P
P
e
Q
Q
Q
e
P
P
P
e
e
a
a
a
a
a
a
a
a
a
a
a
a
"}
(20,1,1) = {"
s
s
s
s
s
s
s
X
X
X
X
X
X
X
c
c
c
c
X
X
a
a
a
a
e
e
P
P
P
P
P
P
P
P
P
e
e
a
a
a
a
a
a
a
a
a
a
a
a
a
"}
(21,1,1) = {"
s
s
s
s
s
s
s
s
s
s
a
a
a
X
X
X
X
X
X
a
a
a
a
a
a
e
e
P
P
P
P
P
P
P
e
e
a
a
a
a
a
a
a
a
a
a
a
a
a
a
"}
(22,1,1) = {"
s
s
s
s
s
s
s
s
s
s
a
a
a
a
a
a
a
a
a
a
a
a
a
a
a
a
e
e
P
P
P
P
P
e
e
a
a
a
a
a
a
a
a
a
a
a
a
a
a
a
"}
(23,1,1) = {"
s
s
s
s
s
s
s
s
s
s
a
a
a
a
a
a
a
a
a
a
a
a
a
a
a
a
a
e
e
P
P
P
e
e
a
a
a
a
a
a
a
a
a
a
a
a
a
a
a
a
"}
(24,1,1) = {"
s
s
s
s
s
s
s
s
s
s
a
a
a
a
a
a
a
a
a
a
a
a
a
a
a
a
a
a
e
P
P
P
e
a
a
a
a
a
a
a
a
a
a
a
a
a
a
a
a
a
"}
(25,1,1) = {"
s
s
s
s
s
s
s
s
s
s
a
a
a
a
a
a
a
a
a
a
a
a
a
a
a
a
a
a
e
P
P
P
e
a
a
a
a
a
a
a
a
a
a
a
a
a
a
a
a
a
"}
(26,1,1) = {"
s
s
s
s
s
s
s
s
s
s
a
a
a
a
a
a
a
a
a
a
a
a
a
a
a
a
a
a
e
P
P
P
e
a
a
a
a
a
a
a
a
a
a
a
a
a
a
a
a
a
"}
(27,1,1) = {"
s
s
s
s
s
s
s
s
s
s
a
a
a
a
a
a
a
a
a
a
a
a
a
a
a
a
a
a
e
P
P
P
e
a
a
a
a
a
a
a
a
a
a
a
a
a
a
a
a
a
"}
(28,1,1) = {"
s
s
s
s
s
s
s
s
s
s
a
a
a
a
a
a
a
a
a
a
a
a
a
a
a
a
a
a
e
P
P
P
e
a
a
a
a
a
a
a
a
a
a
a
a
a
a
a
a
a
"}
(29,1,1) = {"
s
s
s
s
s
s
s
s
s
s
a
a
a
a
a
a
a
a
a
a
a
a
a
a
a
a
a
a
e
P
P
P
e
a
a
a
a
a
a
a
a
a
a
a
a
a
a
a
a
a
"}
(30,1,1) = {"
s
s
s
s
s
s
s
s
s
s
a
a
a
a
a
a
a
a
a
a
a
a
a
a
a
a
a
a
e
P
P
P
e
a
a
a
a
a
a
a
a
a
a
a
a
a
a
a
a
a
"}
(31,1,1) = {"
s
s
s
s
s
s
s
s
s
s
a
a
a
a
a
a
a
a
a
a
a
a
a
a
a
a
a
a
e
P
P
P
e
a
a
a
a
a
a
a
a
a
a
a
a
a
a
a
a
a
"}
(32,1,1) = {"
s
s
s
s
s
s
s
s
s
s
a
a
a
a
a
a
a
a
a
a
a
a
a
a
a
a
a
a
e
P
P
P
e
a
a
a
a
a
a
a
a
a
a
a
a
a
a
a
a
a
"}
(33,1,1) = {"
s
s
s
s
s
s
s
s
s
s
a
a
a
a
a
a
a
a
a
a
a
a
a
a
a
a
a
s
e
P
P
P
e
a
a
a
a
a
a
a
a
a
a
a
a
a
a
a
a
a
"}
(34,1,1) = {"
s
s
s
s
s
s
s
s
s
s
a
a
a
a
a
a
a
a
a
a
a
p
p
p
p
p
p
s
e
P
P
P
e
a
a
a
a
a
a
a
a
a
a
a
a
a
a
a
a
a
"}
(35,1,1) = {"
s
s
s
s
s
s
s
s
s
s
s
s
s
s
s
s
s
s
s
s
s
s
s
s
s
s
s
s
e
P
P
P
e
a
a
a
a
a
a
a
a
a
a
a
a
a
a
a
a
a
"}
(36,1,1) = {"
s
s
s
s
s
s
s
s
s
s
s
s
s
s
s
s
s
s
s
s
s
s
s
s
s
s
s
e
e
P
P
P
e
e
a
a
a
a
a
a
a
a
a
a
a
a
a
a
a
a
"}
(37,1,1) = {"
s
s
s
s
s
s
s
s
s
s
s
s
s
s
s
s
s
s
s
s
s
s
s
s
s
s
s
e
P
P
P
P
P
e
a
a
a
a
a
a
a
a
a
a
a
a
a
a
a
a
"}
(38,1,1) = {"
s
s
s
s
s
s
s
s
s
s
s
s
s
s
s
s
s
s
s
s
s
s
s
s
s
s
s
e
P
P
P
P
P
e
a
a
a
a
a
a
a
a
a
a
a
a
a
a
a
a
"}
(39,1,1) = {"
s
s
s
s
s
s
s
s
s
s
a
a
a
a
a
a
s
s
s
s
s
s
p
p
p
p
p
e
P
P
P
P
P
e
p
p
a
p
a
a
a
a
a
a
a
a
a
a
a
a
"}
(40,1,1) = {"
s
s
s
s
s
s
s
s
s
s
s
s
s
s
a
a
s
a
a
p
p
p
p
p
p
p
p
G
P
P
P
P
P
G
p
p
p
p
a
a
a
a
a
a
a
a
a
a
a
a
"}
(41,1,1) = {"
s
s
s
s
s
s
s
s
s
s
s
s
s
s
a
a
s
a
a
a
a
a
p
p
p
p
p
q
P
P
P
P
l
q
p
p
p
p
a
a
a
a
a
a
a
a
a
a
a
a
"}
(42,1,1) = {"
s
s
s
s
s
s
s
s
s
s
s
s
s
s
a
p
s
a
p
p
p
p
p
p
p
p
p
q
T
o
o
o
T
q
p
p
p
p
p
a
a
a
a
a
a
s
s
a
a
a
"}
(43,1,1) = {"
s
s
s
s
s
s
s
s
s
s
s
s
s
s
p
p
p
p
p
p
p
p
p
p
p
p
p
q
Y
Y
Y
Y
Y
q
p
p
p
p
p
p
p
a
a
a
a
s
s
a
a
a
"}
(44,1,1) = {"
s
s
s
s
s
s
s
s
s
s
s
s
s
s
a
p
p
p
p
p
p
p
p
p
p
p
p
q
M
x
x
x
M
q
p
p
p
p
p
p
p
p
a
a
a
s
s
a
a
a
"}
(45,1,1) = {"
s
s
s
s
s
s
s
s
s
s
s
s
s
s
p
p
p
p
p
p
p
p
p
p
p
p
p
q
P
P
P
P
l
q
p
p
p
p
p
p
p
p
p
a
a
s
s
a
a
a
"}
(46,1,1) = {"
s
s
s
s
s
s
s
s
s
s
s
s
s
s
a
a
p
p
p
p
p
p
p
p
p
p
a
G
P
P
P
P
P
G
p
p
p
p
p
p
p
p
p
p
a
s
s
a
a
a
"}
(47,1,1) = {"
s
s
s
s
s
s
s
s
s
s
s
s
s
s
a
a
p
p
p
p
p
p
a
a
a
a
a
a
P
P
P
P
P
a
a
p
p
p
p
p
p
p
p
p
a
s
s
a
a
a
"}
(48,1,1) = {"
s
s
s
s
s
s
s
s
s
s
s
s
s
s
a
p
p
p
p
p
p
p
a
a
a
a
a
a
a
P
P
P
a
a
a
a
p
p
p
p
p
p
p
a
a
a
a
a
a
a
"}
(49,1,1) = {"
s
s
s
s
s
s
s
s
s
s
s
s
s
s
a
p
p
p
p
p
p
p
a
a
a
a
a
a
a
a
a
a
a
a
a
a
p
p
p
p
p
p
p
a
a
a
a
a
a
a
"}
(50,1,1) = {"
s
s
s
s
s
s
s
s
s
s
s
s
s
s
a
p
p
p
p
a
a
a
a
a
a
a
a
a
a
a
a
a
a
a
a
a
p
p
p
p
p
p
p
a
a
a
a
a
a
a
"}
(51,1,1) = {"
s
s
s
s
s
s
s
s
s
s
s
s
s
s
a
p
p
p
p
a
a
a
a
a
a
a
a
a
a
a
a
a
a
a
a
a
a
a
a
a
p
p
p
p
p
a
a
a
a
a
"}
(52,1,1) = {"
s
s
s
s
s
s
s
s
s
s
s
s
s
s
a
p
p
p
p
a
a
a
a
a
a
a
a
a
a
a
a
a
a
a
a
a
a
a
a
a
p
p
p
p
p
a
a
a
a
a
"}
(53,1,1) = {"
s
s
s
s
s
s
s
s
s
s
s
s
s
s
a
p
p
p
a
a
a
a
a
a
a
a
a
a
a
a
a
a
a
a
a
a
a
a
a
a
p
p
p
p
a
a
a
a
a
a
"}
(54,1,1) = {"
s
s
s
s
s
s
s
s
s
s
s
s
s
s
a
a
p
p
a
a
a
a
a
a
a
a
a
a
a
a
a
a
a
a
a
a
a
a
a
a
p
p
p
p
a
s
a
a
a
a
"}
(55,1,1) = {"
s
s
s
s
s
s
s
s
s
s
s
s
s
s
a
p
p
p
p
a
a
a
a
a
a
a
a
a
a
a
a
a
a
a
a
a
a
a
a
a
p
p
p
p
p
s
a
a
a
a
"}
(56,1,1) = {"
s
s
s
s
s
s
s
s
s
s
s
s
s
s
a
p
p
p
p
a
a
a
a
a
a
a
a
a
a
a
a
a
a
a
a
a
a
a
a
a
p
p
p
p
p
s
a
a
a
a
"}
(57,1,1) = {"
s
s
s
s
s
s
s
s
s
s
s
s
s
s
p
p
p
p
a
a
a
a
a
a
a
a
a
a
a
a
a
a
a
a
a
a
a
a
a
a
p
p
p
p
p
s
a
a
a
a
"}
(58,1,1) = {"
s
s
s
s
s
s
s
s
s
s
s
s
s
s
a
p
p
p
p
a
a
a
a
a
a
a
a
a
a
a
a
a
a
a
a
a
a
a
a
a
p
p
p
p
p
s
a
a
a
a
"}
(59,1,1) = {"
s
s
s
s
s
s
s
s
s
s
s
s
s
s
a
a
p
p
a
a
a
a
a
a
a
a
a
a
a
a
a
a
a
a
a
a
a
a
a
a
p
p
p
p
p
s
a
a
a
a
"}
(60,1,1) = {"
s
s
s
s
s
s
s
s
s
s
s
s
s
s
a
p
p
p
p
a
a
a
a
a
a
a
a
a
a
a
a
a
a
a
a
a
a
a
a
a
p
p
p
p
p
s
a
a
a
a
"}
(61,1,1) = {"
s
s
s
s
s
s
s
s
s
s
s
s
s
s
a
p
p
p
a
a
a
a
a
a
a
a
a
a
a
a
a
a
a
a
a
a
a
a
a
a
a
p
p
p
p
s
a
a
a
a
"}
(62,1,1) = {"
s
s
s
s
s
s
s
s
s
s
s
s
s
s
a
p
p
p
a
a
a
a
a
a
a
a
a
a
a
a
a
a
a
a
a
a
a
a
a
a
a
p
p
p
p
a
a
a
a
a
"}
(63,1,1) = {"
s
s
s
s
s
s
s
s
s
s
s
s
s
s
a
a
p
p
p
p
a
a
a
a
a
a
a
a
a
a
a
a
a
a
a
a
a
a
a
p
p
p
p
p
a
a
a
a
a
a
"}
(64,1,1) = {"
s
s
s
s
s
s
s
s
s
s
s
s
s
s
a
a
p
p
p
p
a
a
a
a
a
a
a
a
a
a
a
a
a
a
a
a
a
a
a
p
p
p
p
p
a
p
a
a
a
a
"}
(65,1,1) = {"
s
s
s
s
s
s
s
s
s
s
s
s
s
s
s
a
p
p
p
p
a
a
a
a
a
a
a
a
a
a
a
a
a
a
a
a
a
p
p
p
p
p
p
a
a
s
s
a
a
a
"}
(66,1,1) = {"
s
s
s
s
s
s
s
s
s
s
s
s
s
s
s
a
p
p
p
p
p
a
a
a
a
a
a
a
a
a
a
a
a
a
a
p
a
p
p
p
p
p
p
a
a
s
s
a
a
a
"}
(67,1,1) = {"
s
s
s
s
s
s
s
s
s
s
s
s
s
s
s
a
a
p
p
p
p
a
a
a
a
a
a
a
a
a
a
a
a
a
a
p
p
p
p
p
p
p
p
a
a
s
s
a
a
a
"}
(68,1,1) = {"
s
s
s
s
s
s
s
s
s
s
s
s
s
s
s
a
a
p
p
p
p
p
p
p
a
a
a
a
a
a
a
a
a
a
a
p
p
p
p
p
p
p
p
a
a
s
s
a
a
a
"}
(69,1,1) = {"
s
s
s
s
s
s
s
s
s
s
s
s
s
s
s
a
a
p
p
p
p
p
p
p
p
p
p
p
p
p
p
p
p
p
p
p
p
p
p
p
p
p
p
p
a
s
s
a
a
a
"}
(70,1,1) = {"
s
s
s
s
s
s
s
s
s
s
s
s
s
s
s
a
a
p
p
p
p
p
p
p
p
p
p
p
p
p
p
p
p
p
p
p
p
p
p
p
p
p
p
a
a
s
s
a
a
a
"}
(71,1,1) = {"
s
s
s
s
s
s
s
s
s
s
s
s
s
s
s
s
s
s
s
s
p
p
p
p
p
p
p
p
p
p
p
p
p
p
p
p
p
s
s
s
s
s
s
s
s
s
s
a
a
a
"}
(72,1,1) = {"
s
s
s
s
s
s
s
s
s
s
s
s
s
s
s
s
s
s
s
s
p
p
p
p
p
p
p
p
p
p
p
p
p
p
p
p
p
s
s
s
s
s
s
s
s
s
s
a
a
a
"}
