//MAP CONVERTED BY dmm2tgm.py THIS HEADER COMMENT PREVENTS RECONVERSION, DO NOT REMOVE
"a" = (
/turf/open/floor/plating/dirt/jungle/dark/lit,
/area/space)
"c" = (
/turf/open/floor/concrete/reinforced,
/area/space)
"d" = (
/obj/structure/fence{
	dir = 4
	},
/turf/open/floor/plating/dirt/jungle/dark/lit,
/area/space)
"o" = (
/obj/effect/turf_decal/industrial/warning{
	dir = 4
	},
/turf/open/floor/concrete/slab_1,
/area/space)
"p" = (
/turf/closed/mineral/random/jungle,
/area/space)
"q" = (
/turf/closed/wall/concrete/reinforced,
/area/space)
"x" = (
/obj/effect/turf_decal/industrial/warning{
	dir = 8
	},
/turf/open/floor/concrete/slab_1,
/area/space)
"G" = (
/obj/machinery/light/floor/hangar,
/turf/open/floor/concrete/slab_1,
/area/space)
"M" = (
/obj/effect/turf_decal/industrial/warning{
	dir = 8
	},
/obj/effect/turf_decal/industrial/stand_clear/white{
	dir = 4
	},
/turf/open/floor/concrete/slab_1,
/area/space)
"T" = (
/obj/effect/turf_decal/industrial/warning{
	dir = 4
	},
/obj/effect/turf_decal/industrial/stand_clear/white{
	dir = 8
	},
/turf/open/floor/concrete/slab_1,
/area/space)
"X" = (
/turf/open/floor/concrete/slab_1,
/area/space)

(1,1,1) = {"
a
a
p
p
p
p
a
a
a
a
a
a
a
a
a
a
a
a
a
a
a
a
a
a
a
a
a
a
a
a
a
a
a
a
a
a
a
a
a
a
"}
(2,1,1) = {"
a
a
p
p
p
p
a
a
a
a
a
a
a
a
a
a
a
a
a
a
a
a
a
a
a
a
a
a
a
a
a
a
a
p
p
p
p
p
p
a
"}
(3,1,1) = {"
p
a
p
p
p
p
a
a
a
a
a
a
a
a
a
a
a
a
a
a
a
a
a
a
a
a
a
a
a
a
a
a
p
p
p
p
p
p
p
p
"}
(4,1,1) = {"
p
p
p
p
p
p
a
a
a
a
a
a
a
a
a
a
a
a
X
X
X
X
X
a
a
a
a
a
a
a
a
a
p
p
p
p
p
p
p
p
"}
(5,1,1) = {"
p
p
p
p
p
p
a
a
a
a
a
a
a
a
a
a
a
a
X
X
X
X
X
a
a
a
a
a
a
a
a
a
a
p
p
p
p
p
p
p
"}
(6,1,1) = {"
a
p
p
p
p
a
a
a
a
a
a
a
a
a
a
a
a
a
X
X
X
X
X
a
a
a
a
a
a
a
a
a
a
a
p
p
p
p
p
p
"}
(7,1,1) = {"
a
p
p
p
p
a
a
a
a
a
a
a
a
a
a
a
a
a
X
X
X
X
X
a
a
a
a
a
a
a
a
a
a
a
a
a
a
a
a
a
"}
(8,1,1) = {"
p
p
a
a
p
p
a
a
a
a
a
a
a
a
a
a
a
a
X
X
X
X
X
a
a
a
a
a
a
a
a
a
a
a
a
a
a
a
a
a
"}
(9,1,1) = {"
p
p
a
a
p
p
a
a
a
a
a
a
a
a
a
a
a
a
X
X
X
X
X
a
a
a
a
a
a
a
a
a
a
a
a
a
a
a
a
a
"}
(10,1,1) = {"
p
p
a
a
p
p
a
a
a
a
a
a
a
a
a
a
a
a
X
X
X
X
X
a
a
a
a
a
a
a
a
a
a
a
a
a
a
a
a
a
"}
(11,1,1) = {"
p
p
a
a
a
a
a
a
a
a
a
a
a
a
a
a
a
a
X
X
X
X
X
a
a
a
a
a
a
a
a
a
a
a
a
a
a
a
a
a
"}
(12,1,1) = {"
p
p
a
a
a
a
a
a
a
a
a
a
a
a
a
a
a
a
X
X
X
X
X
a
a
a
a
a
a
a
a
a
a
a
a
a
a
a
a
a
"}
(13,1,1) = {"
p
p
p
p
a
a
a
a
a
a
a
a
a
a
a
a
a
a
X
X
X
X
X
a
a
a
a
a
a
a
a
a
a
a
a
a
a
a
a
a
"}
(14,1,1) = {"
p
p
p
p
a
a
a
a
a
a
a
a
a
a
a
a
a
a
X
X
X
X
X
a
a
a
a
a
a
a
a
a
a
a
a
a
a
a
a
a
"}
(15,1,1) = {"
p
p
a
a
a
a
a
a
a
a
a
a
a
a
a
a
a
a
X
X
X
X
X
a
a
a
a
a
a
a
a
a
a
a
a
a
a
a
a
a
"}
(16,1,1) = {"
p
p
a
a
p
p
a
a
a
a
a
a
a
a
a
a
a
a
X
X
X
X
X
a
a
a
a
a
a
a
a
a
a
a
a
a
a
a
a
a
"}
(17,1,1) = {"
p
p
p
p
p
p
a
a
a
a
a
a
a
a
a
a
a
a
X
X
X
X
X
a
a
a
a
a
a
a
a
a
a
a
a
a
a
a
a
a
"}
(18,1,1) = {"
p
p
p
p
p
a
a
a
a
a
a
a
a
a
a
a
a
a
X
X
X
X
X
a
a
a
a
a
a
a
a
a
a
a
a
a
a
a
a
a
"}
(19,1,1) = {"
a
p
p
p
p
a
a
a
a
a
a
a
a
a
a
a
a
a
X
X
X
X
X
a
a
a
a
a
a
a
a
a
a
a
a
a
a
a
a
a
"}
(20,1,1) = {"
a
p
p
p
p
a
a
a
a
a
a
a
a
a
a
a
a
a
X
X
X
X
X
a
a
a
a
a
a
a
a
a
a
a
a
a
a
a
a
a
"}
(21,1,1) = {"
a
a
a
p
p
p
a
a
a
a
a
a
a
a
a
a
a
a
X
X
X
X
X
a
a
a
a
a
a
a
a
a
a
a
a
a
a
a
a
a
"}
(22,1,1) = {"
a
a
a
p
p
p
a
a
a
a
a
a
a
a
a
a
a
a
X
X
X
X
X
a
a
a
a
a
a
a
a
a
a
a
a
a
a
a
a
a
"}
(23,1,1) = {"
a
a
a
p
p
p
a
a
a
a
a
a
a
a
a
a
a
a
X
X
X
X
X
a
a
a
a
a
a
a
a
a
a
a
a
a
a
a
a
a
"}
(24,1,1) = {"
a
a
a
a
a
d
a
a
a
a
a
a
a
a
a
a
a
a
X
X
X
X
X
a
a
a
a
a
a
a
a
a
a
a
a
a
a
a
a
a
"}
(25,1,1) = {"
a
a
a
a
a
d
a
a
a
a
a
a
a
a
a
a
a
a
X
X
X
X
X
a
a
a
a
a
a
a
a
a
a
a
a
a
a
a
a
a
"}
(26,1,1) = {"
a
a
a
a
a
d
a
a
a
a
a
a
a
a
a
a
a
a
X
X
X
X
X
a
a
a
a
a
a
a
a
a
a
a
a
a
a
a
a
a
"}
(27,1,1) = {"
a
a
a
a
a
d
a
a
a
a
a
a
a
a
a
a
a
a
X
X
X
X
X
a
a
a
a
a
a
a
a
a
a
a
a
a
a
a
a
a
"}
(28,1,1) = {"
a
a
a
a
a
d
a
a
a
a
a
a
a
a
a
a
a
a
X
X
X
X
X
a
a
a
a
a
a
a
a
a
a
a
a
a
a
a
a
a
"}
(29,1,1) = {"
a
a
a
a
a
d
a
a
a
a
a
a
a
a
a
a
a
a
X
X
X
X
X
a
a
a
a
a
a
a
a
a
a
a
a
a
a
a
a
a
"}
(30,1,1) = {"
a
a
a
a
a
d
a
a
a
a
a
a
a
a
a
a
a
a
X
X
X
X
X
a
a
a
a
a
a
a
a
a
a
a
a
a
a
a
a
a
"}
(31,1,1) = {"
a
a
a
a
a
d
a
a
a
a
a
a
a
a
a
a
a
a
X
X
X
X
X
a
a
a
a
a
a
a
a
a
a
a
a
a
a
a
a
a
"}
(32,1,1) = {"
a
a
a
a
a
d
a
a
a
a
a
a
a
a
a
a
a
a
X
X
X
X
X
a
a
a
a
a
a
a
a
a
a
a
a
a
a
a
a
a
"}
(33,1,1) = {"
a
a
a
a
a
d
a
a
p
p
a
p
p
a
p
p
a
a
X
X
X
X
X
a
p
p
a
p
p
p
p
a
a
a
a
a
a
a
a
a
"}
(34,1,1) = {"
a
a
a
a
a
d
a
p
p
p
p
p
p
p
p
p
p
G
X
X
X
X
X
G
p
p
p
p
p
p
p
p
p
a
a
a
a
a
a
a
"}
(35,1,1) = {"
a
a
a
p
p
p
p
p
p
p
p
p
p
p
p
p
p
q
X
X
X
X
X
q
p
p
p
p
p
p
p
p
p
p
a
a
a
a
a
a
"}
(36,1,1) = {"
a
p
p
p
p
p
p
p
p
p
p
p
p
p
p
p
p
q
T
o
o
o
T
q
p
p
p
p
p
p
p
p
p
p
p
a
a
a
a
a
"}
(37,1,1) = {"
p
p
p
p
p
p
p
p
p
p
p
p
p
p
p
p
p
q
c
c
c
c
c
q
p
p
p
p
p
p
p
p
p
p
p
p
a
a
a
a
"}
(38,1,1) = {"
a
p
p
p
p
p
p
p
p
p
p
p
p
p
p
p
p
q
M
x
x
x
M
q
p
p
p
p
p
p
p
p
p
p
p
p
a
a
a
a
"}
(39,1,1) = {"
p
p
p
p
p
p
p
p
p
p
p
p
p
p
p
p
p
q
X
X
X
X
X
q
p
p
p
p
p
p
p
p
p
p
p
a
a
a
a
a
"}
(40,1,1) = {"
a
a
p
p
p
p
p
p
p
p
p
p
p
p
p
p
a
G
X
X
X
X
X
G
p
p
p
p
p
p
p
p
p
p
p
a
a
a
a
a
"}
(41,1,1) = {"
a
a
p
p
p
p
p
p
p
p
a
a
a
a
a
a
a
a
a
a
a
a
a
a
a
p
a
a
p
p
p
p
p
p
p
a
a
a
a
a
"}
(42,1,1) = {"
a
p
p
p
p
p
p
p
p
p
a
a
a
a
a
a
a
a
a
a
a
a
a
a
a
a
a
a
a
a
p
p
p
p
p
a
a
a
a
a
"}
(43,1,1) = {"
a
p
p
p
p
p
p
p
p
a
a
a
a
a
a
a
a
a
a
a
a
a
a
a
a
a
a
a
a
a
p
p
p
p
p
a
a
a
a
a
"}
(44,1,1) = {"
a
p
p
p
p
a
a
a
a
a
a
a
a
a
a
a
a
a
a
a
a
a
a
a
a
a
a
a
a
a
p
p
p
p
p
a
a
a
a
a
"}
(45,1,1) = {"
a
p
p
p
p
a
a
a
a
a
a
a
a
a
a
a
a
a
a
a
a
a
a
a
a
a
a
a
a
a
p
p
p
p
p
a
a
a
a
a
"}
(46,1,1) = {"
a
p
p
p
p
a
a
a
a
a
a
a
a
a
a
a
a
a
a
a
a
a
a
a
a
a
a
a
a
a
p
p
p
p
p
a
a
a
a
a
"}
(47,1,1) = {"
a
p
p
p
a
a
a
a
a
a
a
a
a
a
a
a
a
a
a
a
a
a
a
a
a
a
a
a
a
a
p
p
p
p
a
a
a
a
a
a
"}
(48,1,1) = {"
a
a
p
p
a
a
a
a
a
a
a
a
a
a
a
a
a
a
a
a
a
a
a
a
a
a
a
a
a
a
p
p
p
p
p
a
a
a
a
a
"}
(49,1,1) = {"
a
p
p
p
p
a
a
a
a
a
a
a
a
a
a
a
a
a
a
a
a
a
a
a
a
a
a
a
a
a
p
p
p
p
p
p
a
a
a
a
"}
(50,1,1) = {"
a
p
p
p
p
a
a
a
a
a
a
a
a
a
a
a
a
a
a
a
a
a
a
a
a
a
a
a
a
a
p
p
p
p
p
p
a
a
a
a
"}
(51,1,1) = {"
p
p
p
p
a
a
a
a
a
a
a
a
a
a
a
a
a
a
a
a
a
a
a
a
a
a
a
a
a
a
p
p
p
p
p
p
a
a
a
a
"}
(52,1,1) = {"
a
p
p
p
p
a
a
a
a
a
a
a
a
a
a
a
a
a
a
a
a
a
a
a
a
a
a
a
a
a
p
p
p
p
p
p
a
a
a
a
"}
(53,1,1) = {"
a
a
p
p
a
a
a
a
a
a
a
a
a
a
a
a
a
a
a
a
a
a
a
a
a
a
a
a
a
a
p
p
p
p
p
p
a
a
a
a
"}
(54,1,1) = {"
a
p
p
p
p
a
a
a
a
a
a
a
a
a
a
a
a
a
a
a
a
a
a
a
a
a
a
a
a
a
p
p
p
p
p
p
a
a
a
a
"}
(55,1,1) = {"
a
p
p
p
a
a
a
a
a
a
a
a
a
a
a
a
a
a
a
a
a
a
a
a
a
a
a
a
a
a
a
p
p
p
p
p
a
a
a
a
"}
(56,1,1) = {"
a
p
p
p
a
a
a
a
a
a
a
a
a
a
a
a
a
a
a
a
a
a
a
a
a
a
a
a
a
a
a
p
p
p
p
a
a
a
a
a
"}
(57,1,1) = {"
a
a
p
p
p
a
a
a
a
a
a
a
a
a
a
a
a
a
a
a
a
a
a
a
a
a
a
a
a
a
a
p
p
p
a
a
a
a
a
a
"}
(58,1,1) = {"
a
a
p
p
a
a
a
a
a
a
a
a
a
a
a
a
a
a
a
a
a
a
a
a
a
a
a
a
a
a
a
p
p
p
p
p
a
a
a
a
"}
(59,1,1) = {"
a
p
p
p
p
a
a
a
a
a
a
a
a
a
a
a
a
a
a
a
a
a
a
a
a
a
a
a
a
a
a
p
p
p
p
p
a
a
a
a
"}
(60,1,1) = {"
a
p
p
p
p
a
a
a
a
a
a
a
a
a
a
a
a
a
a
a
a
a
a
a
a
a
a
a
a
a
a
p
p
p
p
p
a
a
a
a
"}
(61,1,1) = {"
a
p
p
p
p
a
a
a
a
a
a
a
a
a
a
a
a
a
a
a
a
a
a
a
a
a
a
a
a
p
p
p
p
p
p
a
a
a
a
a
"}
(62,1,1) = {"
a
p
p
p
p
p
p
p
p
p
p
p
p
p
a
a
a
a
a
a
a
a
a
a
a
a
p
p
a
p
p
p
p
p
p
a
a
a
a
a
"}
(63,1,1) = {"
a
a
p
p
p
p
p
p
p
p
p
p
p
p
p
p
p
p
p
p
p
p
p
p
p
p
p
p
p
p
p
p
p
p
p
a
a
a
a
a
"}
(64,1,1) = {"
a
a
p
p
p
p
p
p
p
p
p
p
p
p
p
p
p
p
p
p
p
p
p
p
p
p
p
p
p
p
p
p
p
p
p
a
a
a
a
a
"}
(65,1,1) = {"
a
a
p
p
p
p
p
p
p
p
p
p
p
p
p
p
p
p
p
p
p
p
p
p
p
p
p
p
p
p
p
p
p
p
p
p
a
a
a
a
"}
(66,1,1) = {"
a
a
p
p
p
p
p
p
p
p
p
p
p
p
p
p
p
p
p
p
p
p
p
p
p
p
p
p
p
p
p
p
p
p
p
a
a
a
a
a
"}
(67,1,1) = {"
a
a
a
p
p
p
p
p
p
p
p
p
p
p
p
p
p
p
p
p
p
p
p
p
p
p
p
p
p
p
p
p
p
p
p
a
a
a
a
a
"}
(68,1,1) = {"
a
a
a
a
p
p
p
p
p
p
p
p
p
p
p
p
p
p
p
p
p
p
p
p
p
p
p
p
p
p
p
p
p
p
p
a
a
a
a
a
"}
(69,1,1) = {"
a
a
a
a
a
a
p
p
p
p
p
p
p
p
p
p
p
p
p
p
a
p
p
p
p
p
a
p
p
p
p
p
p
p
a
a
a
a
a
a
"}
(70,1,1) = {"
a
a
a
a
a
a
a
a
a
p
p
p
p
p
p
p
p
p
p
p
p
p
p
p
p
p
a
p
a
p
a
a
a
a
a
a
a
a
a
a
"}
