//MAP CONVERTED BY dmm2tgm.py THIS HEADER COMMENT PREVENTS RECONVERSION, DO NOT REMOVE
"af" = (
/turf/closed/wall/mineral/plastitanium/nodiagonal,
/area/ship/engineering)
"aE" = (
/obj/structure/closet{
	name = "pirate outfits"
	},
/obj/item/clothing/head/collectable/pirate,
/obj/item/clothing/suit/pirate,
/obj/item/clothing/under/costume/pirate,
/obj/item/clothing/shoes/jackboots,
/obj/item/clothing/head/bandana,
/obj/effect/turf_decal/corner/black{
	dir = 1
	},
/obj/effect/turf_decal/corner/black,
/obj/effect/turf_decal/corner/black{
	dir = 4
	},
/turf/open/floor/plasteel,
/area/ship/crew)
"bd" = (
/obj/structure/table/reinforced,
/obj/machinery/button/door{
	id = "caravanpirate_bridge";
	name = "Bridge Blast Door Control";
	pixel_x = -16
	},
/obj/effect/turf_decal/corner/red,
/obj/effect/turf_decal/corner/red{
	dir = 8
	},
/turf/open/floor/plasteel/dark,
/area/ship/bridge)
"bH" = (
/obj/machinery/atmospherics/pipe/simple/supply/hidden{
	dir = 5
	},
/obj/effect/decal/cleanable/dirt,
/obj/structure/cable{
	icon_state = "4-8"
	},
/turf/open/floor/plasteel,
/area/ship/medical)
"de" = (
/obj/machinery/atmospherics/pipe/manifold/supply/hidden{
	dir = 8
	},
/obj/effect/turf_decal/corner/neutral{
	dir = 1
	},
/obj/effect/turf_decal/corner/neutral,
/obj/effect/turf_decal/corner/neutral{
	dir = 4
	},
/obj/effect/turf_decal/corner/neutral{
	dir = 8
	},
/obj/structure/cable{
	icon_state = "1-4"
	},
/obj/structure/cable{
	icon_state = "2-4"
	},
/turf/open/floor/plasteel/dark,
/area/ship/crew)
"dE" = (
/obj/effect/turf_decal/corner/neutral{
	dir = 1
	},
/obj/effect/turf_decal/corner/neutral,
/obj/effect/turf_decal/corner/neutral{
	dir = 4
	},
/obj/effect/turf_decal/corner/neutral{
	dir = 8
	},
/turf/open/floor/plasteel/dark,
/area/ship/bridge)
"fh" = (
/obj/machinery/atmospherics/pipe/manifold/supply/hidden{
	dir = 4
	},
/obj/structure/cable{
	icon_state = "1-2"
	},
/turf/open/floor/plating,
/area/ship/engineering)
"fL" = (
/obj/effect/turf_decal/corner/red{
	dir = 1
	},
/obj/effect/turf_decal/corner/red{
	dir = 8
	},
/obj/machinery/computer/ship/helm{
	dir = 8
	},
/turf/open/floor/plasteel/dark,
/area/ship/bridge)
"fS" = (
/obj/structure/bed,
/obj/item/bedsheet/brown,
/obj/machinery/airalarm/all_access{
	dir = 4;
	pixel_x = -24
	},
/obj/effect/turf_decal/corner/red{
	dir = 8
	},
/turf/open/floor/plasteel/dark,
/area/ship/crew)
"fU" = (
/obj/machinery/atmospherics/pipe/manifold/supply/hidden,
/obj/effect/turf_decal/corner/red,
/obj/effect/turf_decal/corner/red{
	dir = 8
	},
/turf/open/floor/plasteel,
/area/ship/security)
"hh" = (
/mob/living/simple_animal/hostile/pirate{
	environment_smash = 0
	},
/obj/structure/cable{
	icon_state = "4-8"
	},
/turf/open/floor/plasteel,
/area/ship/security)
"hI" = (
/obj/machinery/atmospherics/pipe/simple/supply/hidden,
/obj/structure/cable{
	icon_state = "1-8"
	},
/obj/structure/cable{
	icon_state = "2-8"
	},
/turf/open/floor/plating,
/area/ship/engineering)
"hN" = (
/obj/machinery/light/small{
	dir = 8
	},
/obj/structure/sign/warning/vacuum{
	pixel_x = -32
	},
/turf/open/floor/plating,
/area/ship/security)
"hT" = (
/obj/machinery/light/small{
	dir = 1
	},
/obj/structure/bed,
/obj/item/bedsheet/brown,
/turf/open/floor/plasteel/dark,
/area/ship/crew)
"hZ" = (
/obj/machinery/atmospherics/pipe/simple/supply/hidden,
/obj/effect/turf_decal/corner/neutral{
	dir = 1
	},
/obj/effect/turf_decal/corner/neutral,
/obj/effect/turf_decal/corner/neutral{
	dir = 4
	},
/obj/effect/turf_decal/corner/neutral{
	dir = 8
	},
/obj/structure/cable{
	icon_state = "1-2"
	},
/turf/open/floor/plasteel/dark,
/area/ship/crew)
"iF" = (
/obj/machinery/atmospherics/pipe/simple/supply/hidden{
	dir = 9
	},
/obj/effect/turf_decal/corner/neutral{
	dir = 1
	},
/obj/effect/turf_decal/corner/neutral,
/obj/effect/turf_decal/corner/neutral{
	dir = 4
	},
/obj/effect/turf_decal/corner/neutral{
	dir = 8
	},
/obj/structure/cable{
	icon_state = "1-8"
	},
/turf/open/floor/plasteel/dark,
/area/ship/crew)
"iX" = (
/obj/structure/table,
/obj/machinery/door/window/southleft{
	base_state = "right";
	icon_state = "right";
	name = "Weapon Storage"
	},
/obj/item/gun/energy/laser,
/obj/effect/turf_decal/corner/neutral{
	dir = 1
	},
/obj/effect/turf_decal/corner/neutral,
/obj/effect/turf_decal/corner/neutral{
	dir = 4
	},
/obj/effect/turf_decal/corner/neutral{
	dir = 8
	},
/turf/open/floor/plasteel/dark,
/area/ship/security)
"jh" = (
/obj/machinery/power/port_gen/pacman{
	anchored = 1
	},
/obj/item/wrench,
/obj/effect/turf_decal/industrial/warning{
	dir = 6
	},
/obj/machinery/atmospherics/pipe/manifold/orange/hidden{
	dir = 4
	},
/obj/structure/cable/yellow,
/turf/open/floor/plating,
/area/ship/engineering)
"jo" = (
/obj/structure/table,
/obj/machinery/airalarm/all_access{
	pixel_y = 24
	},
/obj/item/ammo_box/a40mm,
/obj/effect/turf_decal/corner/neutral{
	dir = 1
	},
/obj/effect/turf_decal/corner/neutral,
/obj/effect/turf_decal/corner/neutral{
	dir = 4
	},
/obj/effect/turf_decal/corner/neutral{
	dir = 8
	},
/turf/open/floor/plasteel/dark,
/area/ship/security)
"kl" = (
/obj/machinery/atmospherics/pipe/manifold/supply/hidden{
	dir = 1
	},
/obj/effect/turf_decal/corner/white{
	dir = 1
	},
/obj/effect/turf_decal/corner/white{
	dir = 4
	},
/turf/open/floor/plasteel,
/area/ship/medical)
"ku" = (
/obj/structure/rack,
/obj/item/storage/bag/money/vault,
/obj/effect/turf_decal/corner/blue{
	dir = 4
	},
/mob/living/simple_animal/parrot{
	faction = list("pirate");
	name = "Pegwing"
	},
/turf/open/floor/plasteel/dark,
/area/ship/crew)
"kY" = (
/obj/machinery/atmospherics/pipe/manifold/supply/hidden{
	dir = 8
	},
/obj/machinery/meter,
/obj/structure/cable{
	icon_state = "2-4"
	},
/turf/open/floor/plating,
/area/ship/engineering)
"le" = (
/obj/machinery/porta_turret/syndicate/pod{
	dir = 5;
	faction = list("pirate")
	},
/turf/closed/wall/mineral/plastitanium,
/area/ship/bridge)
"lu" = (
/turf/closed/wall/mineral/plastitanium/nodiagonal,
/area/ship/bridge)
"lG" = (
/obj/machinery/atmospherics/components/unary/vent_pump/on,
/obj/effect/turf_decal/corner/neutral{
	dir = 1
	},
/obj/effect/turf_decal/corner/neutral,
/obj/effect/turf_decal/corner/neutral{
	dir = 4
	},
/obj/effect/turf_decal/corner/neutral{
	dir = 8
	},
/turf/open/floor/plasteel/dark,
/area/ship/bridge)
"lY" = (
/obj/effect/decal/cleanable/dirt,
/obj/structure/cable{
	icon_state = "4-8"
	},
/turf/open/floor/plasteel,
/area/ship/medical)
"mr" = (
/obj/machinery/atmospherics/pipe/simple/supply/hidden{
	dir = 4
	},
/obj/machinery/door/firedoor,
/obj/machinery/door/airlock/command{
	name = "Bridge"
	},
/obj/effect/turf_decal/corner/neutral{
	dir = 1
	},
/obj/effect/turf_decal/corner/neutral,
/obj/effect/turf_decal/corner/neutral{
	dir = 4
	},
/obj/effect/turf_decal/corner/neutral{
	dir = 8
	},
/obj/structure/cable{
	icon_state = "4-8"
	},
/turf/open/floor/plasteel/dark,
/area/ship/bridge)
"mF" = (
/obj/structure/grille,
/obj/structure/window/plasma/reinforced/plastitanium,
/obj/machinery/door/poddoor{
	id = "caravanpirate_bridge"
	},
/turf/open/floor/plating,
/area/ship/security)
"mI" = (
/obj/structure/table,
/obj/item/storage/firstaid/brute{
	pixel_x = 3;
	pixel_y = 3
	},
/obj/item/storage/firstaid/fire,
/obj/machinery/firealarm{
	dir = 1;
	pixel_y = -24
	},
/turf/open/floor/plasteel/white,
/area/ship/medical)
"na" = (
/obj/machinery/atmospherics/pipe/simple/supply/hidden{
	dir = 4
	},
/obj/machinery/power/apc/auto_name/north,
/obj/machinery/power/terminal{
	dir = 1
	},
/obj/structure/cable{
	icon_state = "0-2"
	},
/obj/effect/turf_decal/corner/white{
	dir = 1
	},
/obj/effect/turf_decal/corner/white{
	dir = 4
	},
/turf/open/floor/plasteel,
/area/ship/medical)
"nD" = (
/obj/machinery/light/small{
	dir = 4
	},
/obj/machinery/atmospherics/pipe/simple/supply/hidden{
	dir = 10
	},
/obj/effect/turf_decal/corner/white{
	dir = 1
	},
/obj/effect/turf_decal/corner/white{
	dir = 4
	},
/turf/open/floor/plasteel,
/area/ship/medical)
"oe" = (
/obj/structure/table,
/obj/item/circular_saw,
/obj/item/scalpel{
	pixel_y = 12
	},
/obj/item/cautery{
	pixel_x = 4
	},
/obj/machinery/light/small{
	dir = 8
	},
/obj/structure/cable{
	icon_state = "1-4"
	},
/obj/effect/turf_decal/corner/white{
	dir = 1
	},
/obj/effect/turf_decal/corner/white{
	dir = 8
	},
/turf/open/floor/plasteel,
/area/ship/medical)
"oF" = (
/obj/structure/closet{
	name = "pirate outfits"
	},
/obj/item/clothing/head/collectable/pirate,
/obj/item/clothing/suit/pirate,
/obj/item/clothing/under/costume/pirate,
/obj/item/clothing/shoes/jackboots,
/obj/item/clothing/head/bandana,
/obj/effect/turf_decal/corner/red{
	dir = 1
	},
/turf/open/floor/plasteel/dark,
/area/ship/crew)
"oL" = (
/turf/closed/wall/mineral/plastitanium,
/area/ship/medical)
"oO" = (
/obj/effect/turf_decal/corner/red{
	dir = 1
	},
/obj/effect/turf_decal/corner/red{
	dir = 4
	},
/obj/machinery/computer/autopilot,
/turf/open/floor/plasteel/dark,
/area/ship/bridge)
"oT" = (
/obj/structure/table,
/obj/structure/window/reinforced{
	dir = 8
	},
/obj/machinery/door/window/southleft{
	name = "Weapon Storage"
	},
/obj/item/grenade/smokebomb{
	pixel_x = -4
	},
/obj/item/grenade/smokebomb{
	pixel_x = 2
	},
/obj/effect/turf_decal/corner/neutral{
	dir = 1
	},
/obj/effect/turf_decal/corner/neutral,
/obj/effect/turf_decal/corner/neutral{
	dir = 4
	},
/obj/effect/turf_decal/corner/neutral{
	dir = 8
	},
/turf/open/floor/plasteel/dark,
/area/ship/security)
"pK" = (
/obj/item/stack/sheet/mineral/gold{
	amount = 25
	},
/obj/item/stack/sheet/mineral/bananium{
	amount = 5
	},
/obj/item/stack/sheet/mineral/silver{
	amount = 25
	},
/obj/item/stack/sheet/mineral/uranium{
	amount = 10
	},
/obj/item/stack/sheet/mineral/diamond{
	amount = 5
	},
/obj/structure/closet/crate,
/obj/item/coin/silver,
/obj/item/coin/silver,
/obj/item/coin/silver,
/obj/item/coin/gold,
/obj/item/coin/gold,
/obj/effect/turf_decal/corner/blue,
/obj/machinery/power/apc/auto_name/east,
/obj/machinery/power/terminal{
	dir = 4
	},
/obj/structure/cable{
	icon_state = "0-8"
	},
/turf/open/floor/plasteel/dark,
/area/ship/crew)
"pS" = (
/obj/machinery/atmospherics/components/unary/vent_pump/on,
/obj/effect/decal/cleanable/dirt,
/obj/structure/cable{
	icon_state = "4-8"
	},
/turf/open/floor/plasteel,
/area/ship/security)
"pZ" = (
/obj/structure/tank_dispenser/oxygen,
/obj/machinery/firealarm{
	pixel_y = 24
	},
/obj/effect/turf_decal/corner/neutral{
	dir = 1
	},
/obj/effect/turf_decal/corner/neutral,
/obj/effect/turf_decal/corner/neutral{
	dir = 4
	},
/obj/effect/turf_decal/corner/neutral{
	dir = 8
	},
/turf/open/floor/plasteel/dark,
/area/ship/security)
"qo" = (
/obj/machinery/porta_turret/syndicate/pod{
	dir = 6;
	faction = list("pirate")
	},
/turf/closed/wall/mineral/plastitanium,
/area/ship/bridge)
"qC" = (
/obj/structure/table,
/obj/item/storage/fancy/donut_box{
	pixel_y = 18
	},
/obj/item/storage/box/donkpockets{
	pixel_x = -3;
	pixel_y = 7
	},
/obj/item/storage/box/donkpockets{
	pixel_x = -6
	},
/obj/item/reagent_containers/food/drinks/bottle/rum{
	pixel_x = 8;
	pixel_y = 3
	},
/obj/structure/sign/poster/contraband/red_rum{
	pixel_x = 32
	},
/turf/open/floor/plasteel/dark,
/area/ship/crew)
"qX" = (
/obj/structure/reagent_dispensers/watertank,
/obj/item/reagent_containers/glass/bucket,
/obj/item/mop,
/obj/effect/turf_decal/industrial/warning{
	dir = 5
	},
/obj/machinery/atmospherics/pipe/manifold/orange/hidden{
	dir = 4
	},
/turf/open/floor/plating,
/area/ship/engineering)
"rI" = (
/turf/closed/wall/mineral/plastitanium/nodiagonal,
/area/ship/crew)
"sr" = (
/obj/machinery/atmospherics/pipe/simple/supply/hidden{
	dir = 4
	},
/obj/effect/turf_decal/corner/red,
/obj/effect/turf_decal/corner/red{
	dir = 8
	},
/obj/machinery/power/apc/auto_name/south,
/obj/machinery/power/terminal,
/obj/structure/cable,
/turf/open/floor/plasteel,
/area/ship/security)
"su" = (
/obj/effect/decal/cleanable/dirt,
/obj/structure/cable{
	icon_state = "1-4"
	},
/obj/structure/cable{
	icon_state = "1-8"
	},
/turf/open/floor/plasteel,
/area/ship/medical)
"th" = (
/obj/machinery/atmospherics/pipe/simple/supply/hidden{
	dir = 4
	},
/obj/machinery/door/firedoor,
/obj/machinery/door/airlock/engineering{
	name = "Engineering"
	},
/obj/structure/cable{
	icon_state = "4-8"
	},
/turf/open/floor/plating,
/area/ship/engineering)
"to" = (
/obj/structure/table,
/obj/item/reagent_containers/food/drinks/bottle/rum{
	pixel_x = 3;
	pixel_y = 6
	},
/obj/item/reagent_containers/food/drinks/bottle/rum,
/turf/open/floor/plasteel/dark,
/area/ship/bridge)
"tM" = (
/obj/effect/decal/cleanable/dirt,
/mob/living/simple_animal/hostile/pirate/ranged{
	environment_smash = 0
	},
/obj/structure/cable{
	icon_state = "2-4"
	},
/obj/structure/cable{
	icon_state = "2-8"
	},
/turf/open/floor/plasteel,
/area/ship/security)
"ul" = (
/obj/structure/table,
/obj/item/retractor,
/obj/item/hemostat,
/turf/open/floor/plasteel/white,
/area/ship/medical)
"un" = (
/obj/machinery/atmospherics/pipe/simple/supply/hidden{
	dir = 4
	},
/obj/effect/turf_decal/corner/red{
	dir = 1
	},
/obj/effect/turf_decal/corner/red,
/obj/effect/turf_decal/corner/red{
	dir = 8
	},
/obj/structure/cable{
	icon_state = "1-8"
	},
/turf/open/floor/plasteel,
/area/ship/security)
"vd" = (
/obj/machinery/atmospherics/pipe/simple/supply/hidden{
	dir = 6
	},
/obj/effect/decal/cleanable/dirt,
/obj/structure/cable{
	icon_state = "4-8"
	},
/turf/open/floor/plasteel,
/area/ship/security)
"vq" = (
/obj/structure/bed,
/obj/item/bedsheet/brown,
/obj/machinery/firealarm{
	dir = 8;
	pixel_x = -26
	},
/obj/effect/turf_decal/corner/black,
/obj/effect/turf_decal/corner/black{
	dir = 4
	},
/obj/effect/turf_decal/corner/black{
	dir = 8
	},
/turf/open/floor/plasteel,
/area/ship/crew)
"vW" = (
/obj/machinery/light/small{
	dir = 4
	},
/obj/machinery/atmospherics/pipe/simple/supply/hidden,
/obj/structure/cable{
	icon_state = "1-2"
	},
/turf/open/floor/plating,
/area/ship/engineering)
"wL" = (
/obj/machinery/button/door{
	id = "caravanpirate_bolt_port";
	name = "External Bolt Control";
	normaldoorcontrol = 1;
	pixel_x = -4;
	pixel_y = 25;
	specialfunctions = 4
	},
/obj/machinery/atmospherics/pipe/simple/supply/hidden{
	dir = 4
	},
/obj/effect/turf_decal/corner/white{
	dir = 1
	},
/obj/effect/turf_decal/corner/white{
	dir = 4
	},
/turf/open/floor/plasteel,
/area/ship/medical)
"wX" = (
/obj/machinery/light/small{
	dir = 8
	},
/obj/effect/turf_decal/corner/red{
	dir = 1
	},
/obj/effect/turf_decal/corner/red{
	dir = 8
	},
/obj/structure/cable{
	icon_state = "2-4"
	},
/turf/open/floor/plasteel,
/area/ship/security)
"wZ" = (
/obj/machinery/atmospherics/pipe/manifold/supply/hidden{
	dir = 4
	},
/obj/effect/turf_decal/corner/neutral{
	dir = 1
	},
/obj/effect/turf_decal/corner/neutral,
/obj/effect/turf_decal/corner/neutral{
	dir = 4
	},
/obj/effect/turf_decal/corner/neutral{
	dir = 8
	},
/obj/structure/cable{
	icon_state = "1-4"
	},
/obj/structure/cable{
	icon_state = "2-4"
	},
/turf/open/floor/plasteel/dark,
/area/ship/crew)
"xg" = (
/obj/structure/table,
/obj/machinery/microwave{
	pixel_y = 5
	},
/turf/open/floor/plasteel/dark,
/area/ship/crew)
"xR" = (
/obj/machinery/atmospherics/pipe/simple/supply/hidden{
	dir = 4
	},
/obj/machinery/power/apc/auto_name/south,
/obj/machinery/power/terminal,
/obj/structure/cable{
	icon_state = "0-8"
	},
/turf/open/floor/plasteel/dark,
/area/ship/bridge)
"yt" = (
/obj/structure/reagent_dispensers/fueltank,
/obj/effect/turf_decal/industrial/warning{
	dir = 4
	},
/obj/machinery/atmospherics/pipe/manifold/orange/hidden{
	dir = 4
	},
/turf/open/floor/plating,
/area/ship/engineering)
"yu" = (
/obj/machinery/atmospherics/pipe/simple/supply/hidden{
	dir = 10
	},
/obj/effect/turf_decal/corner/neutral{
	dir = 1
	},
/obj/effect/turf_decal/corner/neutral,
/obj/effect/turf_decal/corner/neutral{
	dir = 4
	},
/obj/effect/turf_decal/corner/neutral{
	dir = 8
	},
/obj/structure/cable{
	icon_state = "2-8"
	},
/turf/open/floor/plasteel/dark,
/area/ship/crew)
"yW" = (
/obj/machinery/atmospherics/components/unary/vent_pump/on{
	dir = 4
	},
/obj/machinery/space_heater,
/obj/effect/turf_decal/industrial/warning{
	dir = 6
	},
/obj/machinery/atmospherics/pipe/simple/orange/hidden{
	dir = 9
	},
/turf/open/floor/plating,
/area/ship/engineering)
"zB" = (
/obj/machinery/button/door{
	id = "caravanpirate_bolt_starboard";
	name = "External Bolt Control";
	normaldoorcontrol = 1;
	pixel_x = -4;
	pixel_y = -25;
	specialfunctions = 4
	},
/obj/machinery/atmospherics/pipe/simple/supply/hidden{
	dir = 4
	},
/obj/effect/turf_decal/corner/red,
/obj/effect/turf_decal/corner/red{
	dir = 8
	},
/turf/open/floor/plasteel,
/area/ship/security)
"Ag" = (
/obj/structure/table/optable,
/obj/effect/turf_decal/industrial/outline/yellow,
/turf/open/floor/plasteel/white,
/area/ship/medical)
"Ah" = (
/obj/effect/mapping_helpers/airlock/cyclelink_helper{
	dir = 1
	},
/obj/effect/mapping_helpers/airlock/locked,
/obj/machinery/door/airlock/external{
	id_tag = "caravanpirate_bolt_starboard"
	},
/turf/open/floor/plating,
/area/ship/security)
"Av" = (
/obj/machinery/atmospherics/pipe/simple/supply/hidden{
	dir = 4
	},
/obj/machinery/door/firedoor,
/obj/machinery/door/airlock/medical/glass{
	name = "Medbay"
	},
/obj/effect/decal/cleanable/dirt,
/obj/structure/cable{
	icon_state = "4-8"
	},
/turf/open/floor/plasteel,
/area/ship/medical)
"AP" = (
/obj/structure/sign/departments/medbay/alt,
/turf/closed/wall/mineral/plastitanium/nodiagonal,
/area/ship/medical)
"Bi" = (
/obj/structure/grille,
/obj/structure/window/plasma/reinforced/plastitanium,
/obj/machinery/door/poddoor{
	id = "caravanpirate_bridge"
	},
/turf/open/floor/plating,
/area/ship/medical)
"BI" = (
/obj/structure/table,
/obj/machinery/light/small{
	brightness = 3;
	dir = 8
	},
/obj/item/stack/spacecash/c200,
/turf/open/floor/plasteel/dark,
/area/ship/bridge)
"BL" = (
/obj/structure/table,
/obj/machinery/cell_charger,
/obj/item/stack/cable_coil,
/obj/item/stock_parts/cell/high,
/obj/effect/turf_decal/industrial/outline/yellow,
/turf/open/floor/plating,
/area/ship/engineering)
"Cb" = (
/obj/machinery/atmospherics/pipe/simple/supply/hidden,
/obj/machinery/airalarm/all_access{
	dir = 8;
	pixel_x = 24
	},
/obj/machinery/power/apc/auto_name/west,
/obj/machinery/power/terminal{
	dir = 8
	},
/obj/structure/cable{
	icon_state = "0-2"
	},
/obj/structure/cable{
	icon_state = "1-2"
	},
/turf/open/floor/plating,
/area/ship/engineering)
"DY" = (
/obj/structure/closet/crate/secure/loot,
/obj/machinery/airalarm/all_access{
	pixel_y = 24
	},
/turf/open/floor/plasteel/dark,
/area/ship/bridge)
"Ek" = (
/obj/machinery/atmospherics/components/unary/tank/toxins{
	dir = 1
	},
/obj/effect/turf_decal/industrial/hatch/yellow,
/turf/open/floor/plating,
/area/ship/engineering)
"EB" = (
/obj/structure/chair/office{
	dir = 4
	},
/obj/machinery/turretid{
	icon_state = "control_kill";
	lethal = 1;
	locked = 0;
	pixel_y = -30;
	req_access = null
	},
/obj/effect/turf_decal/corner/neutral{
	dir = 1
	},
/obj/effect/turf_decal/corner/neutral,
/obj/effect/turf_decal/corner/neutral{
	dir = 4
	},
/obj/effect/turf_decal/corner/neutral{
	dir = 8
	},
/mob/living/simple_animal/hostile/pirate/ranged{
	environment_smash = 0
	},
/turf/open/floor/plasteel/dark,
/area/ship/bridge)
"EK" = (
/obj/machinery/atmospherics/components/unary/vent_pump/on{
	dir = 1
	},
/obj/structure/cable{
	icon_state = "4-8"
	},
/turf/open/floor/plasteel,
/area/ship/medical)
"FM" = (
/obj/machinery/power/terminal{
	dir = 1
	},
/obj/structure/closet/crate,
/obj/item/stack/sheet/metal/twenty,
/obj/item/stack/sheet/glass{
	amount = 10
	},
/obj/item/storage/toolbox/mechanical,
/obj/item/flashlight{
	pixel_x = 3;
	pixel_y = 3
	},
/obj/item/stack/sheet/mineral/plasma{
	amount = 20
	},
/obj/effect/turf_decal/industrial/warning{
	dir = 4
	},
/obj/machinery/atmospherics/pipe/manifold/orange/hidden{
	dir = 4
	},
/obj/structure/cable/yellow{
	icon_state = "0-2"
	},
/turf/open/floor/plating,
/area/ship/engineering)
"Gh" = (
/obj/machinery/atmospherics/components/unary/tank/air,
/obj/effect/turf_decal/industrial/outline/yellow,
/turf/open/floor/plating,
/area/ship/engineering)
"Gw" = (
/obj/machinery/suit_storage_unit/open,
/obj/effect/turf_decal/corner/neutral{
	dir = 1
	},
/obj/effect/turf_decal/corner/neutral,
/obj/effect/turf_decal/corner/neutral{
	dir = 4
	},
/obj/effect/turf_decal/corner/neutral{
	dir = 8
	},
/turf/open/floor/plasteel/dark,
/area/ship/security)
"GO" = (
/obj/machinery/porta_turret/syndicate/pod{
	dir = 9;
	faction = list("pirate")
	},
/turf/closed/wall/mineral/plastitanium,
/area/ship/bridge)
"GQ" = (
/obj/machinery/light/small{
	dir = 4
	},
/obj/machinery/atmospherics/pipe/simple/supply/hidden{
	dir = 9
	},
/obj/effect/turf_decal/corner/red,
/obj/effect/turf_decal/corner/red{
	dir = 8
	},
/turf/open/floor/plasteel,
/area/ship/security)
"GR" = (
/obj/structure/table,
/obj/item/coin/gold,
/obj/item/coin/silver,
/obj/item/coin/silver,
/turf/open/floor/plasteel/dark,
/area/ship/bridge)
"Hp" = (
/turf/closed/wall/mineral/plastitanium/nodiagonal,
/area/ship/security)
"HD" = (
/obj/structure/window/reinforced{
	dir = 4
	},
/obj/machinery/atmospherics/components/unary/shuttle/heater{
	dir = 4
	},
/turf/open/floor/plating/airless,
/area/ship/engineering)
"HO" = (
/obj/machinery/atmospherics/pipe/simple/supply/hidden{
	dir = 4
	},
/obj/machinery/door/firedoor,
/obj/machinery/door/airlock/security{
	name = "Armory"
	},
/obj/effect/decal/cleanable/dirt,
/obj/structure/cable{
	icon_state = "4-8"
	},
/turf/open/floor/plasteel,
/area/ship/security)
"II" = (
/obj/structure/closet/crate/freezer/surplus_limbs,
/obj/effect/turf_decal/industrial/outline/yellow,
/turf/open/floor/plasteel/white,
/area/ship/medical)
"Jb" = (
/obj/effect/mapping_helpers/airlock/cyclelink_helper,
/obj/effect/mapping_helpers/airlock/locked,
/obj/machinery/door/airlock/external{
	id_tag = "caravanpirate_bolt_port"
	},
/obj/docking_port/mobile{
	callTime = 150;
	dir = 2;
	dwidth = 14;
	height = 13;
	movement_force = list("KNOCKDOWN" = 0, "THROW" = 0);
	name = "Pirate Cutter";
	port_direction = 8;
	preferred_direction = 4;
	width = 22
	},
/turf/open/floor/plating,
/area/ship/medical)
"Jv" = (
/turf/template_noop,
/area/template_noop)
"Kd" = (
/obj/machinery/sleeper{
	dir = 1
	},
/obj/effect/turf_decal/industrial/hatch/yellow,
/obj/machinery/airalarm/all_access{
	dir = 1;
	pixel_y = -24
	},
/turf/open/floor/plasteel/white,
/area/ship/medical)
"Ku" = (
/obj/effect/mapping_helpers/airlock/cyclelink_helper,
/obj/effect/mapping_helpers/airlock/locked,
/obj/machinery/door/airlock/external{
	id_tag = "caravanpirate_bolt_starboard"
	},
/turf/open/floor/plating,
/area/ship/security)
"Ld" = (
/obj/machinery/suit_storage_unit/open,
/obj/effect/turf_decal/corner/neutral{
	dir = 1
	},
/obj/effect/turf_decal/corner/neutral,
/obj/effect/turf_decal/corner/neutral{
	dir = 4
	},
/obj/effect/turf_decal/corner/neutral{
	dir = 8
	},
/turf/open/floor/plasteel/dark,
/area/ship/medical)
"LG" = (
/turf/closed/wall/mineral/plastitanium/nodiagonal,
/area/ship/medical)
"NM" = (
/obj/machinery/light/small{
	dir = 8
	},
/obj/structure/closet/crate/secure/loot,
/obj/machinery/atmospherics/components/unary/vent_pump/on{
	dir = 4
	},
/obj/structure/extinguisher_cabinet{
	pixel_x = -27
	},
/turf/open/floor/plasteel/dark,
/area/ship/crew)
"ON" = (
/obj/machinery/porta_turret/syndicate/pod{
	dir = 10;
	faction = list("pirate")
	},
/turf/closed/wall/mineral/plastitanium,
/area/ship/bridge)
"Pc" = (
/obj/structure/sign/departments/engineering,
/turf/closed/wall/mineral/plastitanium/nodiagonal,
/area/ship/engineering)
"Pn" = (
/obj/machinery/power/shuttle/engine/fueled/plasma{
	dir = 4
	},
/turf/open/floor/plating/airless,
/area/ship/engineering)
"QQ" = (
/turf/closed/wall/mineral/plastitanium,
/area/ship/security)
"Rq" = (
/obj/machinery/atmospherics/pipe/simple/supply/hidden{
	dir = 4
	},
/obj/structure/cable{
	icon_state = "2-8"
	},
/obj/effect/turf_decal/corner/white{
	dir = 1
	},
/obj/effect/turf_decal/corner/white{
	dir = 4
	},
/obj/effect/turf_decal/corner/white{
	dir = 8
	},
/turf/open/floor/plasteel,
/area/ship/medical)
"Rz" = (
/obj/effect/mapping_helpers/airlock/cyclelink_helper{
	dir = 1
	},
/obj/effect/mapping_helpers/airlock/locked,
/obj/machinery/door/airlock/external{
	id_tag = "caravanpirate_bolt_port"
	},
/turf/open/floor/plating,
/area/ship/medical)
"RC" = (
/obj/machinery/atmospherics/pipe/simple/supply/hidden{
	dir = 4
	},
/obj/effect/turf_decal/corner/red{
	dir = 1
	},
/obj/effect/turf_decal/corner/red{
	dir = 8
	},
/obj/structure/cable{
	icon_state = "4-8"
	},
/turf/open/floor/plasteel/dark,
/area/ship/crew)
"RK" = (
/obj/machinery/power/smes{
	charge = 5e+006
	},
/obj/effect/turf_decal/industrial/warning{
	dir = 5
	},
/obj/machinery/atmospherics/pipe/simple/orange/hidden{
	dir = 10
	},
/obj/structure/cable{
	icon_state = "0-4"
	},
/turf/open/floor/plating,
/area/ship/engineering)
"Sd" = (
/obj/machinery/light/small{
	dir = 8
	},
/obj/structure/sign/warning/vacuum{
	pixel_x = -32
	},
/turf/open/floor/plating,
/area/ship/medical)
"Sk" = (
/obj/machinery/atmospherics/pipe/simple/supply/hidden{
	dir = 4
	},
/obj/effect/turf_decal/corner/blue,
/obj/effect/turf_decal/corner/blue{
	dir = 4
	},
/obj/structure/cable{
	icon_state = "4-8"
	},
/turf/open/floor/plasteel/dark,
/area/ship/crew)
"SF" = (
/obj/machinery/atmospherics/pipe/simple/supply/hidden{
	dir = 4
	},
/obj/structure/cable{
	icon_state = "4-8"
	},
/obj/effect/turf_decal/corner/black,
/obj/effect/turf_decal/corner/black{
	dir = 4
	},
/turf/open/floor/plasteel,
/area/ship/crew)
"SR" = (
/obj/machinery/atmospherics/pipe/simple/supply/hidden{
	dir = 9
	},
/obj/machinery/firealarm{
	dir = 1;
	pixel_y = -24
	},
/obj/machinery/holopad/emergency/command,
/turf/open/floor/plasteel/dark,
/area/ship/bridge)
"Ty" = (
/obj/machinery/atmospherics/components/unary/tank/toxins,
/obj/effect/turf_decal/industrial/hatch/yellow,
/turf/open/floor/plating,
/area/ship/engineering)
"UP" = (
/obj/structure/rack,
/obj/item/storage/toolbox/emergency,
/obj/item/weldingtool,
/obj/effect/turf_decal/corner/red{
	dir = 4
	},
/turf/open/floor/plasteel/dark,
/area/ship/bridge)
"Wb" = (
/obj/machinery/light/small,
/obj/structure/bed,
/obj/item/bedsheet/brown,
/turf/open/floor/plasteel/dark,
/area/ship/crew)
"Wd" = (
/turf/closed/wall/mineral/plastitanium,
/area/ship/engineering)
"Xq" = (
/obj/structure/table/reinforced,
/obj/machinery/recharger,
/obj/item/melee/classic_baton,
/obj/effect/turf_decal/corner/red,
/obj/item/radio/intercom/wideband{
	pixel_y = -29
	},
/turf/open/floor/plasteel/dark,
/area/ship/bridge)
"Yb" = (
/turf/closed/wall/mineral/plastitanium,
/area/ship/crew)
"Yo" = (
/obj/structure/table,
/obj/item/storage/box/lethalshot,
/obj/effect/turf_decal/corner/neutral{
	dir = 1
	},
/obj/effect/turf_decal/corner/neutral,
/obj/effect/turf_decal/corner/neutral{
	dir = 4
	},
/obj/effect/turf_decal/corner/neutral{
	dir = 8
	},
/turf/open/floor/plasteel/dark,
/area/ship/security)
"Yw" = (
/obj/machinery/atmospherics/pipe/simple/supply/hidden{
	dir = 4
	},
/obj/structure/cable{
	icon_state = "4-8"
	},
/turf/open/floor/plasteel/dark,
/area/ship/bridge)
"Zo" = (
/obj/machinery/atmospherics/pipe/simple/supply/hidden{
	dir = 5
	},
/obj/structure/cable{
	icon_state = "1-4"
	},
/turf/open/floor/plating,
/area/ship/engineering)
"Zp" = (
/obj/structure/grille,
/obj/structure/window/plasma/reinforced/plastitanium,
/obj/machinery/door/poddoor{
	id = "caravanpirate_bridge"
	},
/turf/open/floor/plating,
/area/ship/bridge)
"ZY" = (
/obj/structure/chair/office{
	dir = 8
	},
/obj/effect/turf_decal/corner/neutral{
	dir = 1
	},
/obj/effect/turf_decal/corner/neutral,
/obj/effect/turf_decal/corner/neutral{
	dir = 4
	},
/obj/effect/turf_decal/corner/neutral{
	dir = 8
	},
/turf/open/floor/plasteel/dark,
/area/ship/bridge)

(1,1,1) = {"
Jv
Jv
Wd
Pn
Pn
Pn
Jv
Pn
Pn
Pn
Wd
Jv
Jv
"}
(2,1,1) = {"
Jv
GO
af
HD
HD
HD
af
HD
HD
HD
af
ON
Jv
"}
(3,1,1) = {"
Jv
af
Ty
qX
yt
yW
af
RK
FM
jh
Ek
af
Jv
"}
(4,1,1) = {"
Jv
af
Gh
kY
vW
fh
Cb
hI
vW
Zo
BL
af
Jv
"}
(5,1,1) = {"
Jv
af
af
th
Pc
af
af
af
Pc
th
af
af
Jv
"}
(6,1,1) = {"
Jv
LG
Ld
Rq
oe
ul
Hp
Yo
wX
un
Gw
Hp
Jv
"}
(7,1,1) = {"
oL
LG
LG
na
su
Ag
Hp
jo
tM
sr
Hp
Hp
QQ
"}
(8,1,1) = {"
Jb
Sd
Rz
kl
EK
mI
Hp
pZ
pS
fU
Ku
hN
Ah
"}
(9,1,1) = {"
oL
LG
LG
wL
lY
Kd
Hp
oT
hh
zB
Hp
Hp
QQ
"}
(10,1,1) = {"
Jv
Bi
Ld
nD
bH
II
Hp
iX
vd
GQ
Gw
mF
Jv
"}
(11,1,1) = {"
Jv
oL
LG
AP
Av
LG
Hp
Hp
HO
Hp
Hp
QQ
Jv
"}
(12,1,1) = {"
Jv
Jv
rI
aE
SF
vq
NM
fS
RC
oF
rI
Jv
Jv
"}
(13,1,1) = {"
Jv
Jv
rI
hT
yu
hZ
wZ
de
iF
Wb
rI
Jv
Jv
"}
(14,1,1) = {"
Jv
Jv
le
rI
xg
qC
pK
Sk
ku
rI
qo
Jv
Jv
"}
(15,1,1) = {"
Jv
Jv
Jv
Yb
lu
lu
lu
mr
lu
Yb
Jv
Jv
Jv
"}
(16,1,1) = {"
Jv
Jv
Jv
Jv
lu
to
BI
Yw
lu
Jv
Jv
Jv
Jv
"}
(17,1,1) = {"
Jv
Jv
Jv
Jv
lu
GR
ZY
xR
lu
Jv
Jv
Jv
Jv
"}
(18,1,1) = {"
Jv
Jv
Jv
Jv
lu
DY
lG
SR
lu
Jv
Jv
Jv
Jv
"}
(19,1,1) = {"
Jv
Jv
Jv
Jv
lu
UP
dE
Xq
lu
Jv
Jv
Jv
Jv
"}
(20,1,1) = {"
Jv
Jv
Jv
Jv
Zp
oO
EB
bd
Zp
Jv
Jv
Jv
Jv
"}
(21,1,1) = {"
Jv
Jv
Jv
Jv
Zp
Zp
fL
Zp
Zp
Jv
Jv
Jv
Jv
"}
(22,1,1) = {"
Jv
Jv
Jv
Jv
Jv
Zp
Zp
Zp
Jv
Jv
Jv
Jv
Jv
"}
