//MAP CONVERTED BY dmm2tgm.py THIS HEADER COMMENT PREVENTS RECONVERSION, DO NOT REMOVE
"bT" = (
/obj/effect/decal/cleanable/dirt/dust,
/obj/effect/turf_decal/bot_white,
/obj/machinery/door/poddoor{
	id = "whiteship_starboard"
	},
/obj/structure/fans/tiny,
/turf/open/floor/plating,
/area/whitesands/surface/outdoors)
"cX" = (
/obj/effect/turf_decal/box/white/corners,
/obj/effect/decal/cleanable/dirt/dust,
/obj/structure/closet/crate,
/obj/effect/spawner/lootdrop/maintenance{
	lootcount = 3;
	name = "3maintenance loot spawner"
	},
/turf/open/floor/plasteel/dark,
/area/whitesands/surface/outdoors)
"du" = (
/obj/effect/decal/cleanable/dirt/dust,
/obj/effect/turf_decal/corner/neutral{
	dir = 1
	},
/obj/effect/turf_decal/corner/neutral,
/obj/effect/turf_decal/corner/neutral{
	dir = 4
	},
/obj/effect/turf_decal/corner/neutral{
	dir = 8
	},
/turf/open/floor/plasteel/dark,
/area/whitesands/surface/outdoors)
"dy" = (
/obj/effect/decal/cleanable/dirt/dust,
/obj/structure/cable{
	icon_state = "4-8"
	},
/obj/effect/turf_decal/corner/neutral{
	dir = 1
	},
/obj/effect/turf_decal/corner/neutral,
/obj/effect/turf_decal/corner/neutral{
	dir = 4
	},
/obj/effect/turf_decal/corner/neutral{
	dir = 8
	},
/obj/machinery/atmospherics/pipe/simple/supply/hidden/layer1{
	dir = 4
	},
/turf/open/floor/plasteel/dark,
/area/whitesands/surface/outdoors)
"fC" = (
/obj/effect/turf_decal/box/white/corners,
/obj/effect/decal/cleanable/dirt/dust,
/obj/effect/decal/cleanable/dirt/dust,
/turf/open/floor/plasteel/dark,
/area/whitesands/surface/outdoors)
"fF" = (
/obj/machinery/power/smes/shuttle/precharged{
	dir = 4
	},
/obj/structure/cable{
	icon_state = "0-8"
	},
/obj/structure/window/reinforced{
	dir = 8
	},
/obj/machinery/door/window/northright{
	dir = 4;
	name = "Engine Access"
	},
/turf/open/floor/plating/airless,
/area/whitesands/surface/outdoors)
"hD" = (
/obj/effect/decal/cleanable/dirt/dust,
/obj/structure/cable{
	icon_state = "1-2"
	},
/obj/machinery/door/airlock/engineering{
	name = "Engineering"
	},
/obj/machinery/door/firedoor/border_only{
	dir = 1
	},
/obj/machinery/door/firedoor/border_only,
/obj/machinery/atmospherics/pipe/simple/supply/hidden/layer1,
/obj/machinery/atmospherics/pipe/simple/orange/hidden,
/obj/item/melee/transforming/energy/axe,
/turf/open/floor/plating,
/area/whitesands/surface/outdoors)
"kp" = (
/obj/effect/decal/cleanable/dirt/dust,
/turf/open/floor/plasteel/dark,
/area/whitesands/surface/outdoors)
"kw" = (
/obj/effect/decal/cleanable/dirt/dust,
/obj/structure/cable{
	icon_state = "1-4"
	},
/obj/structure/cable{
	icon_state = "1-2"
	},
/obj/effect/decal/cleanable/oil,
/obj/machinery/atmospherics/pipe/simple/orange/hidden{
	dir = 4
	},
/turf/open/floor/plating,
/area/whitesands/surface/outdoors)
"kO" = (
/mob/living/simple_animal/hostile/pirate/melee,
/turf/open/floor/plating{
	icon_state = "panelscorched"
	},
/area/whitesands/surface/outdoors)
"lf" = (
/obj/effect/decal/cleanable/dirt/dust,
/obj/machinery/door/airlock/external,
/obj/effect/mapping_helpers/airlock/cyclelink_helper{
	dir = 4
	},
/obj/structure/cable{
	icon_state = "4-8"
	},
/obj/machinery/door/firedoor/border_only{
	dir = 4
	},
/obj/machinery/door/firedoor/border_only{
	dir = 8
	},
/obj/machinery/atmospherics/pipe/simple/supply/hidden/layer1{
	dir = 4
	},
/turf/open/floor/plating,
/area/whitesands/surface/outdoors)
"lN" = (
/turf/closed/wall/mineral/titanium/nodiagonal,
/area/whitesands/surface/outdoors)
"mz" = (
/obj/effect/decal/cleanable/dirt/dust,
/obj/structure/cable{
	icon_state = "1-2"
	},
/obj/effect/decal/cleanable/dirt/dust,
/obj/machinery/atmospherics/pipe/simple/supply/hidden/layer1,
/obj/machinery/atmospherics/pipe/simple/orange/hidden,
/turf/open/floor/plating,
/area/whitesands/surface/outdoors)
"nD" = (
/obj/machinery/door/airlock/external,
/obj/effect/mapping_helpers/airlock/cyclelink_helper{
	dir = 8
	},
/obj/effect/decal/cleanable/dirt/dust,
/obj/structure/cable{
	icon_state = "4-8"
	},
/obj/machinery/atmospherics/pipe/simple/supply/hidden/layer1{
	dir = 4
	},
/turf/open/floor/plating,
/area/whitesands/surface/outdoors)
"nF" = (
/obj/effect/decal/cleanable/dirt/dust,
/obj/structure/cable{
	icon_state = "0-4"
	},
/obj/effect/decal/cleanable/dirt/dust,
/obj/effect/decal/cleanable/dirt/dust,
/obj/effect/turf_decal/industrial/outline/yellow,
/obj/structure/frame/machine,
/obj/item/circuitboard/machine/smes,
/obj/item/stack/cable_coil/cut,
/turf/open/floor/plating,
/area/whitesands/surface/outdoors)
"nL" = (
/obj/effect/decal/cleanable/dirt/dust,
/obj/effect/decal/cleanable/dirt/dust,
/turf/open/floor/plasteel/dark,
/area/whitesands/surface/outdoors)
"oF" = (
/obj/effect/turf_decal/bot_white,
/obj/effect/decal/cleanable/dirt/dust,
/obj/effect/decal/cleanable/dirt/dust,
/obj/structure/rack,
/obj/item/reagent_containers/glass/bucket,
/obj/item/mop,
/obj/item/storage/bag/trash{
	pixel_x = 6
	},
/obj/effect/turf_decal/corner/neutral{
	dir = 1
	},
/obj/effect/turf_decal/corner/neutral,
/obj/effect/turf_decal/corner/neutral{
	dir = 4
	},
/obj/effect/turf_decal/corner/neutral{
	dir = 8
	},
/turf/open/floor/plasteel/dark,
/area/whitesands/surface/outdoors)
"pJ" = (
/obj/effect/decal/cleanable/dirt/dust,
/obj/structure/cable{
	icon_state = "1-2"
	},
/obj/structure/cable{
	icon_state = "2-8"
	},
/obj/effect/turf_decal/stripes/white/line{
	dir = 8
	},
/obj/effect/turf_decal/corner/neutral{
	dir = 1
	},
/obj/effect/turf_decal/corner/neutral,
/obj/effect/turf_decal/corner/neutral{
	dir = 4
	},
/obj/effect/turf_decal/corner/neutral{
	dir = 8
	},
/obj/machinery/atmospherics/pipe/simple/orange/hidden,
/obj/machinery/atmospherics/pipe/manifold4w/supply/hidden/layer1,
/turf/open/floor/plasteel/dark,
/area/whitesands/surface/outdoors)
"pP" = (
/obj/effect/turf_decal/box/white/corners{
	dir = 4
	},
/obj/effect/decal/cleanable/dirt/dust,
/obj/effect/decal/cleanable/dirt/dust,
/obj/structure/closet/crate{
	icon_state = "crateopen"
	},
/obj/effect/spawner/lootdrop/maintenance{
	lootcount = 3;
	name = "3maintenance loot spawner"
	},
/turf/open/floor/plasteel/dark,
/area/whitesands/surface/outdoors)
"qb" = (
/obj/effect/turf_decal/box/white/corners,
/obj/effect/decal/cleanable/dirt/dust,
/turf/template_noop,
/area/whitesands/surface/outdoors)
"qi" = (
/obj/effect/spawner/structure/window/shuttle,
/obj/machinery/door/poddoor{
	id = "whiteship_windows"
	},
/obj/machinery/door/firedoor/window,
/turf/open/floor/plating,
/area/whitesands/surface/outdoors)
"qK" = (
/obj/effect/decal/cleanable/dirt/dust,
/obj/structure/cable{
	icon_state = "2-8"
	},
/obj/machinery/firealarm{
	pixel_y = 24
	},
/obj/effect/turf_decal/industrial/outline/yellow,
/obj/structure/table,
/obj/machinery/cell_charger,
/obj/item/stack/cable_coil/red,
/obj/item/stock_parts/cell/high,
/obj/item/multitool,
/turf/open/floor/plating,
/area/whitesands/surface/outdoors)
"rl" = (
/obj/effect/decal/cleanable/dirt/dust,
/obj/structure/closet/crate/medical,
/obj/item/storage/firstaid/fire,
/obj/item/reagent_containers/glass/bottle/morphine,
/obj/item/reagent_containers/syringe,
/obj/item/storage/firstaid/advanced,
/turf/open/floor/plasteel/dark,
/area/whitesands/surface/outdoors)
"sn" = (
/obj/structure/lattice,
/obj/machinery/door/poddoor{
	id = "whiteship_starboard"
	},
/turf/template_noop,
/area/whitesands/surface/outdoors)
"sw" = (
/obj/machinery/door/poddoor{
	id = "whiteship_starboard"
	},
/turf/open/floor/plating{
	icon_state = "platingdmg2"
	},
/area/whitesands/surface/outdoors)
"ui" = (
/obj/effect/decal/cleanable/dirt/dust,
/obj/effect/decal/cleanable/dirt/dust,
/obj/item/stack/sheet/glass{
	amount = 10
	},
/obj/item/stack/rods/twentyfive,
/obj/item/wrench,
/turf/open/floor/plasteel/dark,
/area/whitesands/surface/outdoors)
"wo" = (
/obj/effect/decal/cleanable/dirt/dust,
/obj/effect/decal/cleanable/dirt/dust,
/obj/structure/closet/emcloset/anchored,
/obj/effect/turf_decal/bot_white,
/turf/open/floor/plasteel/dark,
/area/whitesands/surface/outdoors)
"xA" = (
/obj/effect/decal/cleanable/dirt/dust,
/obj/structure/table,
/obj/machinery/cell_charger,
/obj/item/stack/cable_coil/red{
	pixel_x = 2;
	pixel_y = 6
	},
/obj/item/stock_parts/cell/high/plus,
/turf/open/floor/plasteel/dark,
/area/whitesands/surface/outdoors)
"yi" = (
/turf/open/floor/plating{
	initial_gas_mix = "LAVALAND_ATMOS"
	},
/area/whitesands/surface/outdoors)
"yS" = (
/obj/machinery/door/airlock/external,
/obj/effect/mapping_helpers/airlock/cyclelink_helper{
	dir = 4
	},
/obj/structure/cable{
	icon_state = "4-8"
	},
/turf/open/floor/plating,
/area/whitesands/surface/outdoors)
"Az" = (
/obj/effect/spawner/structure/window/shuttle,
/obj/machinery/door/firedoor/window,
/turf/open/floor/plating,
/area/whitesands/surface/outdoors)
"AA" = (
/obj/effect/turf_decal/box/white/corners{
	dir = 4
	},
/obj/effect/decal/cleanable/dirt/dust,
/turf/open/floor/plasteel/dark,
/area/whitesands/surface/outdoors)
"Bb" = (
/obj/structure/cable{
	icon_state = "0-4"
	},
/turf/open/floor/plating/airless,
/area/whitesands/surface/outdoors)
"BN" = (
/obj/effect/decal/cleanable/dirt/dust,
/obj/structure/cable,
/obj/structure/closet/crate,
/obj/effect/turf_decal/industrial/outline/yellow,
/turf/open/floor/plating,
/area/whitesands/surface/outdoors)
"BY" = (
/obj/effect/decal/cleanable/dirt/dust,
/obj/structure/cable{
	icon_state = "1-2"
	},
/obj/effect/decal/cleanable/dirt/dust,
/obj/machinery/firealarm{
	dir = 8;
	pixel_x = -26
	},
/obj/effect/turf_decal/stripes/white/corner{
	dir = 8
	},
/obj/effect/turf_decal/corner/neutral{
	dir = 1
	},
/obj/effect/turf_decal/corner/neutral,
/obj/effect/turf_decal/corner/neutral{
	dir = 4
	},
/obj/effect/turf_decal/corner/neutral{
	dir = 8
	},
/obj/machinery/atmospherics/pipe/simple/supply/hidden/layer1,
/obj/machinery/atmospherics/pipe/simple/orange/hidden,
/turf/open/floor/plasteel/dark,
/area/whitesands/surface/outdoors)
"Ed" = (
/obj/effect/turf_decal/box/white/corners{
	dir = 8
	},
/obj/effect/decal/cleanable/dirt/dust,
/obj/machinery/button/door{
	id = "whiteship_starboard";
	name = "Starboard Blast Door Control";
	pixel_x = -24;
	pixel_y = -5
	},
/turf/open/floor/plasteel/dark,
/area/whitesands/surface/outdoors)
"ED" = (
/obj/effect/decal/cleanable/dirt/dust,
/obj/machinery/power/port_gen/pacman{
	anchored = 1
	},
/obj/structure/cable,
/obj/effect/decal/cleanable/dirt/dust,
/obj/effect/turf_decal/industrial/outline/yellow,
/obj/item/wrench,
/turf/open/floor/plating,
/area/whitesands/surface/outdoors)
"FM" = (
/turf/closed/wall/mineral/titanium,
/area/whitesands/surface/outdoors)
"FW" = (
/obj/effect/turf_decal/box/white/corners{
	dir = 8
	},
/obj/effect/decal/cleanable/dirt/dust,
/obj/effect/decal/cleanable/dirt/dust,
/turf/open/floor/plasteel/dark,
/area/whitesands/surface/outdoors)
"Gs" = (
/mob/living/simple_animal/hostile/pirate/melee,
/turf/open/floor/plating{
	icon_state = "platingdmg1"
	},
/area/whitesands/surface/outdoors)
"Gz" = (
/turf/open/floor/plating{
	icon_state = "platingdmg2"
	},
/area/whitesands/surface/outdoors)
"GW" = (
/obj/effect/turf_decal/box/white/corners{
	dir = 1
	},
/obj/effect/decal/cleanable/dirt/dust,
/obj/effect/decal/cleanable/dirt/dust,
/turf/open/floor/plasteel/dark,
/area/whitesands/surface/outdoors)
"Hb" = (
/obj/effect/turf_decal/industrial/warning{
	dir = 8
	},
/obj/effect/decal/cleanable/dirt/dust,
/obj/structure/cable{
	icon_state = "0-2"
	},
/obj/machinery/power/terminal{
	dir = 1
	},
/obj/machinery/atmospherics/pipe/simple/orange/hidden{
	dir = 4
	},
/turf/open/floor/plating,
/area/whitesands/surface/outdoors)
"HY" = (
/obj/effect/turf_decal/industrial/warning{
	dir = 8
	},
/obj/effect/decal/cleanable/dirt/dust,
/obj/structure/cable{
	icon_state = "1-2"
	},
/obj/machinery/power/terminal{
	dir = 8
	},
/obj/structure/cable{
	icon_state = "0-4"
	},
/mob/living/simple_animal/hostile/pirate/ranged,
/turf/open/floor/plating,
/area/whitesands/surface/outdoors)
"Iv" = (
/obj/effect/decal/cleanable/dirt/dust,
/obj/effect/decal/cleanable/oil,
/turf/open/floor/plasteel/dark,
/area/whitesands/surface/outdoors)
"Kj" = (
/obj/structure/sign/warning/vacuum/external{
	pixel_y = 32
	},
/obj/structure/cable{
	icon_state = "4-8"
	},
/obj/machinery/light/small/built{
	dir = 1
	},
/obj/machinery/advanced_airlock_controller{
	pixel_y = -24
	},
/obj/machinery/atmospherics/components/unary/vent_pump/layer1{
	dir = 4
	},
/turf/open/floor/plating,
/area/whitesands/surface/outdoors)
"Ku" = (
/mob/living/simple_animal/hostile/pirate/melee,
/turf/open/floor/plating{
	icon_state = "titanium_dam5"
	},
/area/whitesands/surface/outdoors)
"KX" = (
/obj/effect/decal/cleanable/dirt/dust,
/obj/effect/turf_decal/corner/neutral{
	dir = 1
	},
/obj/effect/turf_decal/corner/neutral,
/obj/effect/turf_decal/corner/neutral{
	dir = 4
	},
/obj/effect/turf_decal/corner/neutral{
	dir = 8
	},
/obj/machinery/atmospherics/components/unary/vent_pump/on/layer1,
/turf/open/floor/plasteel/dark,
/area/whitesands/surface/outdoors)
"Lp" = (
/obj/effect/decal/cleanable/dirt/dust,
/obj/structure/cable{
	icon_state = "4-8"
	},
/obj/structure/cable{
	icon_state = "1-8"
	},
/obj/machinery/atmospherics/pipe/simple/supply/hidden/layer1{
	dir = 5
	},
/obj/machinery/atmospherics/pipe/simple/orange/hidden{
	dir = 9
	},
/turf/open/floor/plating,
/area/whitesands/surface/outdoors)
"Mc" = (
/obj/effect/turf_decal/bot_white,
/obj/machinery/door/poddoor{
	id = "whiteship_starboard"
	},
/obj/structure/fans/tiny,
/turf/open/floor/plating,
/area/whitesands/surface/outdoors)
"MB" = (
/obj/effect/decal/cleanable/dirt/dust,
/obj/structure/cable{
	icon_state = "1-2"
	},
/obj/structure/cable{
	icon_state = "1-8"
	},
/obj/item/wallframe/apc,
/obj/item/electronics/apc,
/turf/open/floor/plating,
/area/whitesands/surface/outdoors)
"MV" = (
/obj/effect/turf_decal/box/white/corners{
	dir = 1
	},
/obj/effect/decal/cleanable/dirt/dust,
/obj/effect/decal/cleanable/dirt/dust,
/obj/structure/closet/crate,
/obj/effect/spawner/lootdrop/maintenance{
	lootcount = 3;
	name = "3maintenance loot spawner"
	},
/turf/open/floor/plasteel/dark,
/area/whitesands/surface/outdoors)
"No" = (
/obj/machinery/door/poddoor{
	id = "whiteship_starboard"
	},
/turf/open/floor/plating{
	initial_gas_mix = "LAVALAND_ATMOS"
	},
/area/whitesands/surface/outdoors)
"Np" = (
/obj/effect/decal/cleanable/dirt/dust,
/obj/effect/decal/cleanable/dirt/dust,
/obj/structure/cable{
	icon_state = "4-8"
	},
/obj/effect/turf_decal/corner/neutral{
	dir = 1
	},
/obj/effect/turf_decal/corner/neutral,
/obj/effect/turf_decal/corner/neutral{
	dir = 4
	},
/obj/effect/turf_decal/corner/neutral{
	dir = 8
	},
/obj/machinery/atmospherics/pipe/simple/supply/hidden/layer1{
	dir = 4
	},
/turf/open/floor/plasteel/dark,
/area/whitesands/surface/outdoors)
"NI" = (
/turf/open/floor/plating{
	icon_state = "titanium_dam5"
	},
/area/whitesands/surface/outdoors)
"NP" = (
/obj/effect/turf_decal/bot_white,
/obj/effect/decal/cleanable/dirt/dust,
/obj/effect/decal/cleanable/dirt/dust,
/obj/structure/rack,
/obj/item/analyzer,
/obj/item/wrench,
/obj/item/clothing/mask/breath{
	pixel_x = -3;
	pixel_y = 3
	},
/obj/item/clothing/mask/breath,
/obj/effect/turf_decal/corner/neutral{
	dir = 1
	},
/obj/effect/turf_decal/corner/neutral,
/obj/effect/turf_decal/corner/neutral{
	dir = 4
	},
/obj/effect/turf_decal/corner/neutral{
	dir = 8
	},
/turf/open/floor/plasteel/dark,
/area/whitesands/surface/outdoors)
"Oe" = (
/turf/open/floor/plating{
	icon_state = "panelscorched"
	},
/area/whitesands/surface/outdoors)
"OM" = (
/obj/machinery/light/built{
	dir = 4
	},
/obj/effect/decal/cleanable/dirt/dust,
/obj/effect/decal/cleanable/dirt/dust,
/obj/machinery/firealarm{
	dir = 4;
	pixel_x = 24
	},
/turf/open/floor/plasteel/dark,
/area/whitesands/surface/outdoors)
"Po" = (
/obj/effect/decal/cleanable/dirt/dust,
/obj/machinery/airalarm/all_access{
	pixel_y = 24
	},
/obj/machinery/light/small/built{
	dir = 1
	},
/obj/machinery/atmospherics/components/unary/vent_pump/on/layer1{
	dir = 4
	},
/obj/machinery/autolathe,
/turf/open/floor/plating,
/area/whitesands/surface/outdoors)
"Pz" = (
/obj/effect/decal/cleanable/dirt/dust,
/obj/structure/closet/crate/secure/weapon,
/obj/item/gun/energy/laser/retro,
/obj/item/melee/transforming/energy/sword/pirate,
/obj/item/melee/transforming/energy/sword/pirate,
/obj/item/gun/energy/laser/retro,
/turf/open/floor/plasteel/dark,
/area/whitesands/surface/outdoors)
"PW" = (
/obj/effect/decal/cleanable/dirt/dust,
/obj/effect/decal/cleanable/dirt/dust,
/obj/effect/turf_decal/industrial/outline/yellow,
/obj/structure/cable,
/obj/machinery/computer/monitor{
	dir = 1
	},
/turf/open/floor/plating,
/area/whitesands/surface/outdoors)
"QX" = (
/turf/open/floor/plating{
	icon_state = "platingdmg1"
	},
/area/whitesands/surface/outdoors)
"RQ" = (
/obj/effect/decal/cleanable/dirt/dust,
/mob/living/simple_animal/hostile/pirate/ranged,
/turf/open/floor/plasteel/dark,
/area/whitesands/surface/outdoors)
"RV" = (
/obj/machinery/atmospherics/components/unary/shuttle/heater{
	dir = 4
	},
/obj/structure/window/reinforced{
	dir = 8
	},
/obj/machinery/door/window/northleft{
	dir = 4;
	name = "Engine Access"
	},
/turf/open/floor/plating/airless,
/area/whitesands/surface/outdoors)
"Sf" = (
/obj/effect/turf_decal/bot_white,
/obj/effect/decal/cleanable/dirt/dust,
/obj/structure/tank_dispenser/oxygen,
/obj/effect/turf_decal/corner/neutral{
	dir = 1
	},
/obj/effect/turf_decal/corner/neutral,
/obj/effect/turf_decal/corner/neutral{
	dir = 4
	},
/obj/effect/turf_decal/corner/neutral{
	dir = 8
	},
/turf/open/floor/plasteel/dark,
/area/whitesands/surface/outdoors)
"Sv" = (
/obj/effect/turf_decal/box/white/corners{
	dir = 8
	},
/obj/effect/decal/cleanable/dirt/dust,
/obj/structure/cable{
	icon_state = "1-2"
	},
/turf/open/floor/plasteel/dark,
/area/whitesands/surface/outdoors)
"Tp" = (
/obj/effect/decal/cleanable/dirt/dust,
/obj/effect/decal/cleanable/dirt/dust,
/obj/structure/closet/crate,
/obj/item/shovel,
/obj/item/storage/box/lights/mixed,
/obj/effect/turf_decal/industrial/outline/yellow,
/turf/open/floor/plating,
/area/whitesands/surface/outdoors)
"TB" = (
/obj/effect/decal/cleanable/dirt/dust,
/obj/structure/cable{
	icon_state = "0-2"
	},
/turf/open/floor/plasteel/dark,
/area/whitesands/surface/outdoors)
"Uc" = (
/obj/effect/decal/cleanable/dirt/dust,
/obj/structure/cable{
	icon_state = "4-8"
	},
/obj/structure/cable{
	icon_state = "2-8"
	},
/obj/effect/decal/cleanable/dirt/dust,
/obj/machinery/atmospherics/pipe/simple/orange/hidden{
	dir = 4
	},
/turf/open/floor/plating,
/area/whitesands/surface/outdoors)
"Um" = (
/obj/structure/lattice,
/turf/template_noop,
/area/whitesands/surface/outdoors)
"UV" = (
/obj/effect/decal/cleanable/dirt/dust,
/obj/effect/decal/cleanable/dirt/dust,
/obj/structure/closet,
/obj/effect/spawner/lootdrop/maintenance{
	lootcount = 3;
	name = "3maintenance loot spawner"
	},
/turf/open/floor/plasteel/dark,
/area/whitesands/surface/outdoors)
"Wv" = (
/obj/machinery/light/built{
	dir = 8
	},
/obj/effect/decal/cleanable/dirt/dust,
/obj/effect/decal/cleanable/dirt/dust,
/obj/machinery/airalarm/all_access{
	dir = 4;
	pixel_x = -24
	},
/obj/structure/cable{
	icon_state = "1-2"
	},
/turf/open/floor/plasteel/dark,
/area/whitesands/surface/outdoors)
"Xl" = (
/turf/template_noop,
/area/space)
"Ya" = (
/obj/effect/decal/cleanable/dirt/dust,
/obj/effect/decal/cleanable/dirt/dust,
/obj/machinery/space_heater,
/obj/machinery/atmospherics/components/unary/vent_pump/on/layer1{
	dir = 8
	},
/turf/open/floor/plasteel/dark,
/area/whitesands/surface/outdoors)
"YN" = (
/obj/effect/turf_decal/box/white/corners{
	dir = 1
	},
/obj/effect/decal/cleanable/dirt/dust,
/obj/effect/decal/cleanable/blood,
/turf/open/floor/plasteel/dark,
/area/whitesands/surface/outdoors)
"Zz" = (
/obj/machinery/power/shuttle/engine/fueled/plasma{
	dir = 4
	},
/turf/open/floor/plating/airless,
/area/whitesands/surface/outdoors)

(1,1,1) = {"
Xl
Xl
Xl
Xl
Xl
Xl
Xl
Xl
Xl
Xl
Um
Um
Xl
"}
(2,1,1) = {"
Xl
Xl
Xl
Xl
Xl
Xl
Xl
Xl
FM
Zz
Bb
FM
Xl
"}
(3,1,1) = {"
Xl
Xl
Xl
Xl
Xl
Xl
Xl
FM
lN
RV
fF
lN
FM
"}
(4,1,1) = {"
Xl
Xl
Xl
FM
yS
FM
Xl
lN
nF
Hb
HY
ED
lN
"}
(5,1,1) = {"
Xl
Xl
Um
lN
Kj
yi
qi
lN
qK
kw
MB
PW
lN
"}
(6,1,1) = {"
Xl
Um
Um
lN
nD
Gs
wo
lN
Po
Uc
BN
lN
FM
"}
(7,1,1) = {"
Um
Um
yi
BY
pJ
Gz
Oe
hD
mz
Lp
Tp
qi
Xl
"}
(8,1,1) = {"
Um
yi
yi
ui
Ya
xA
yi
lN
lN
lf
lN
lN
Xl
"}
(9,1,1) = {"
Xl
Um
lN
Az
QX
Az
lN
Oe
oF
NI
yi
lN
FM
"}
(10,1,1) = {"
Xl
Xl
sn
FW
du
MV
TB
Wv
Sv
QX
GW
Ed
No
"}
(11,1,1) = {"
Xl
Um
No
qb
NI
QX
kO
Pz
NI
dy
Iv
nL
sw
"}
(12,1,1) = {"
Xl
Um
No
du
du
Gz
QX
Oe
KX
Ku
kp
kp
bT
"}
(13,1,1) = {"
Xl
Um
No
yi
Oe
YN
Oe
RQ
Oe
QX
kp
rl
Mc
"}
(14,1,1) = {"
Um
yi
No
cX
QX
AA
UV
OM
QX
Gz
pP
fC
bT
"}
(15,1,1) = {"
Um
yi
lN
Az
Az
Az
lN
lN
NP
Np
Sf
lN
FM
"}
(16,1,1) = {"
Um
Um
yi
Um
yi
yi
Um
yi
yi
yi
yi
Um
Um
"}
(17,1,1) = {"
Um
Um
yi
yi
Um
yi
Um
Um
Um
yi
Um
Um
Um
"}
(18,1,1) = {"
Xl
yi
Xl
Xl
yi
Um
yi
yi
Um
Um
Um
yi
yi
"}
(19,1,1) = {"
Xl
Xl
Xl
Xl
Xl
Xl
yi
Um
yi
Um
yi
Um
Xl
"}
(20,1,1) = {"
Xl
Xl
Xl
Xl
Xl
Xl
Xl
Xl
Xl
yi
Um
yi
Xl
"}
