//MAP CONVERTED BY dmm2tgm.py THIS HEADER COMMENT PREVENTS RECONVERSION, DO NOT REMOVE
"aL" = (
/obj/machinery/atmospherics/pipe/simple/supply/hidden/layer2{
	dir = 1
	},
/obj/machinery/atmospherics/pipe/simple/scrubbers/hidden/layer4,
/obj/effect/decal/cleanable/dirt,
/obj/effect/decal/cleanable/dirt/dust,
/turf/open/floor/plating{
	icon_state = "platingdmg1"
	},
/area/whitesands/surface/outdoors)
"bK" = (
/obj/structure/girder,
/obj/effect/decal/cleanable/dirt/dust,
/turf/open/floor/plating,
/area/whitesands/surface/outdoors)
"bN" = (
/obj/effect/decal/cleanable/dirt,
/obj/effect/decal/cleanable/dirt,
/obj/effect/decal/cleanable/oil,
/turf/open/floor/plating{
	icon_state = "platingdmg1"
	},
/area/whitesands/surface/outdoors)
"bU" = (
/obj/structure/table/wood/fancy/black,
/obj/item/reagent_containers/food/condiment/peppermill,
/obj/item/reagent_containers/food/condiment/saltshaker{
	pixel_x = 5;
	pixel_y = 5
	},
/obj/effect/decal/cleanable/ash,
/turf/open/floor/wood,
/area/whitesands/surface/outdoors)
"bV" = (
/obj/machinery/atmospherics/pipe/manifold/supply/hidden/layer2{
	dir = 4
	},
/obj/machinery/atmospherics/pipe/manifold4w/scrubbers/hidden/layer4,
/turf/open/floor/carpet/nanoweave,
/area/whitesands/surface/outdoors)
"cP" = (
/obj/structure/barricade/sandbags,
/turf/open/floor/plating,
/area/whitesands/surface/outdoors)
"dl" = (
/obj/effect/decal/cleanable/dirt/dust,
/obj/structure/table/wood/bar,
/turf/open/floor/wood{
	icon_state = "wood-broken2"
	},
/area/whitesands/surface/outdoors)
"dR" = (
/obj/machinery/atmospherics/pipe/simple/supply/hidden/layer2{
	dir = 8
	},
/obj/machinery/atmospherics/pipe/simple/scrubbers/hidden/layer4{
	dir = 8
	},
/obj/structure/cable{
	icon_state = "4-8"
	},
/obj/structure/cable{
	icon_state = "2-4"
	},
/turf/open/floor/plasteel,
/area/whitesands/surface/outdoors)
"ed" = (
/obj/structure/cable{
	icon_state = "1-2"
	},
/obj/effect/decal/cleanable/dirt,
/obj/effect/decal/cleanable/dirt/dust,
/obj/effect/decal/cleanable/blood/gibs/core,
/turf/open/floor/carpet/nanoweave,
/area/whitesands/surface/outdoors)
"eh" = (
/obj/item/toy/figure/bartender{
	desc = "you feel like you recognize this...";
	name = "Familiar Bartender action figure";
	toysay = "What can I get ya?"
	},
/obj/structure/table/wood/bar,
/turf/open/floor/wood{
	icon_state = "wood-broken"
	},
/area/whitesands/surface/outdoors)
"el" = (
/obj/effect/decal/cleanable/dirt,
/turf/open/floor/plating,
/area/whitesands/surface/outdoors)
"eP" = (
/obj/structure/barricade/sandbags,
/turf/open/floor/plating{
	icon_state = "panelscorched"
	},
/area/whitesands/surface/outdoors)
"fj" = (
/obj/structure/lattice,
/turf/template_noop,
/area/whitesands/surface/outdoors)
"fn" = (
/obj/machinery/chem_master/condimaster,
/obj/item/storage/box/beakers,
/obj/effect/turf_decal/corner/white/half{
	dir = 4
	},
/obj/effect/turf_decal/box,
/turf/open/floor/plasteel/mono/dark,
/area/whitesands/surface/outdoors)
"fG" = (
/obj/effect/decal/cleanable/dirt,
/turf/open/floor/plating{
	icon_state = "platingdmg1"
	},
/area/whitesands/surface/outdoors)
"gp" = (
/turf/open/floor/wood{
	icon_state = "wood-broken4"
	},
/area/whitesands/surface/outdoors)
"gR" = (
/obj/machinery/atmospherics/components/unary/vent_pump/on/layer2,
/obj/structure/chair/stool/bar{
	dir = 1
	},
/turf/open/floor/plating{
	icon_state = "panelscorched"
	},
/area/whitesands/surface/outdoors)
"gX" = (
/obj/machinery/atmospherics/pipe/simple/supply/hidden/layer2{
	dir = 8
	},
/obj/machinery/atmospherics/pipe/simple/scrubbers/hidden/layer4{
	dir = 8
	},
/obj/effect/decal/cleanable/dirt,
/obj/effect/decal/cleanable/glass,
/turf/open/floor/plating,
/area/whitesands/surface/outdoors)
"he" = (
/obj/machinery/atmospherics/pipe/manifold/supply/hidden/layer2,
/obj/machinery/atmospherics/pipe/simple/scrubbers/hidden/layer4{
	dir = 8
	},
/turf/open/floor/wood{
	icon_state = "wood-broken7"
	},
/area/whitesands/surface/outdoors)
"hf" = (
/obj/machinery/atmospherics/pipe/simple/supply/hidden/layer2{
	dir = 8
	},
/obj/machinery/atmospherics/pipe/simple/scrubbers/hidden/layer4{
	dir = 8
	},
/obj/structure/chair/wood,
/obj/structure/cable{
	icon_state = "2-4"
	},
/obj/structure/barricade/sandbags,
/turf/open/floor/plating,
/area/whitesands/surface/outdoors)
"hm" = (
/mob/living/simple_animal/hostile/whitesands/survivor{
	faction = list("saloon")
	},
/turf/open/floor/plating,
/area/whitesands/surface/outdoors)
"iu" = (
/obj/machinery/chem_dispenser/drinks/beer{
	dir = 8
	},
/obj/machinery/light{
	dir = 4
	},
/obj/structure/table/wood/bar,
/turf/open/floor/wood{
	icon_state = "wood-broken3"
	},
/area/whitesands/surface/outdoors)
"iD" = (
/obj/machinery/atmospherics/pipe/simple/supply/hidden/layer2{
	dir = 8
	},
/obj/machinery/atmospherics/pipe/manifold/scrubbers/hidden/layer4,
/obj/structure/cable{
	icon_state = "4-8"
	},
/turf/open/floor/plating{
	icon_state = "platingdmg1"
	},
/area/whitesands/surface/outdoors)
"iV" = (
/obj/machinery/atmospherics/pipe/simple/supply/hidden/layer2{
	dir = 8
	},
/obj/machinery/atmospherics/pipe/simple/scrubbers/hidden/layer4{
	dir = 8
	},
/obj/structure/cable{
	icon_state = "4-8"
	},
/turf/open/floor/plating{
	icon_state = "platingdmg1"
	},
/area/whitesands/surface/outdoors)
"jT" = (
/obj/item/paper_bin,
/obj/structure/table/wood/bar,
/turf/open/floor/wood{
	icon_state = "wood-broken5"
	},
/area/whitesands/surface/outdoors)
"kk" = (
/obj/effect/decal/cleanable/dirt,
/obj/effect/decal/cleanable/dirt,
/turf/open/floor/plating,
/area/whitesands/surface/outdoors)
"lx" = (
/obj/effect/decal/cleanable/dirt,
/obj/effect/decal/cleanable/dirt/dust,
/turf/closed/wall,
/area/whitesands/surface/outdoors)
"lH" = (
/obj/machinery/atmospherics/pipe/simple/supply/hidden/layer2{
	dir = 8
	},
/obj/machinery/atmospherics/pipe/simple/scrubbers/hidden/layer4{
	dir = 8
	},
/obj/item/reagent_containers/food/condiment/saltshaker{
	pixel_x = 5;
	pixel_y = 5
	},
/obj/item/reagent_containers/food/condiment/peppermill,
/obj/effect/decal/cleanable/dirt/dust,
/obj/effect/decal/cleanable/glass,
/obj/structure/table/wood/bar,
/turf/open/floor/wood{
	icon_state = "wood-broken3"
	},
/area/whitesands/surface/outdoors)
"lI" = (
/obj/structure/table/wood/bar,
/obj/item/gun/ballistic/automatic/pistol/m1911,
/obj/item/ammo_box/c45,
/obj/item/ammo_box/magazine/m45,
/turf/open/floor/plating,
/area/whitesands/surface/outdoors)
"mp" = (
/obj/effect/decal/cleanable/dirt,
/obj/effect/decal/cleanable/food/flour,
/turf/open/floor/plating{
	icon_state = "platingdmg1"
	},
/area/whitesands/surface/outdoors)
"ni" = (
/obj/machinery/atmospherics/pipe/simple/supply/hidden/layer2{
	dir = 8
	},
/obj/machinery/atmospherics/pipe/simple/scrubbers/hidden/layer4{
	dir = 8
	},
/obj/structure/cable{
	icon_state = "1-2"
	},
/obj/effect/decal/cleanable/blood{
	icon_state = "floor7"
	},
/turf/open/floor/carpet/nanoweave,
/area/whitesands/surface/outdoors)
"od" = (
/turf/closed/wall/mineral/sandstone,
/area/whitesands/surface/outdoors)
"oV" = (
/mob/living/simple_animal/hostile/whitesands/ranged/gunslinger{
	desc = "One of the few survivors on the planet with working weaponry. Doesn't seem as friendly as the bartenders you're used to.";
	faction = list("saloon")
	},
/turf/open/floor/wood{
	icon_state = "wood-broken5"
	},
/area/whitesands/surface/outdoors)
"pa" = (
/obj/item/toy/cards/deck/kotahi,
/obj/item/storage/pill_bottle/dice,
/obj/effect/decal/cleanable/dirt,
/turf/open/floor/wood,
/area/whitesands/surface/outdoors)
"qe" = (
/obj/machinery/atmospherics/pipe/simple/supply/hidden/layer2{
	dir = 6
	},
/obj/machinery/atmospherics/pipe/simple/scrubbers/hidden/layer4{
	dir = 6
	},
/obj/structure/barricade/sandbags,
/turf/open/floor/plating{
	icon_state = "platingdmg1"
	},
/area/whitesands/surface/outdoors)
"qx" = (
/obj/effect/decal/cleanable/dirt,
/obj/effect/decal/cleanable/dirt/dust,
/obj/effect/decal/cleanable/glass,
/turf/open/floor/wood{
	icon_state = "wood-broken5"
	},
/area/whitesands/surface/outdoors)
"qy" = (
/obj/effect/decal/cleanable/oil,
/turf/open/floor/plating,
/area/whitesands/surface/outdoors)
"qW" = (
/obj/machinery/atmospherics/pipe/simple/supply/hidden/layer2{
	dir = 8
	},
/obj/machinery/atmospherics/pipe/simple/scrubbers/hidden/layer4{
	dir = 5
	},
/obj/item/reagent_containers/food/condiment/enzyme,
/obj/structure/table/wood/bar,
/obj/effect/decal/cleanable/dirt,
/turf/open/floor/plating,
/area/whitesands/surface/outdoors)
"ry" = (
/obj/machinery/newscaster{
	pixel_x = -30;
	pixel_y = 30
	},
/obj/effect/decal/cleanable/dirt,
/turf/open/floor/plasteel/mono,
/area/whitesands/surface/outdoors)
"rR" = (
/obj/structure/chair/stool/bar,
/turf/open/floor/wood{
	icon_state = "wood-broken3"
	},
/area/whitesands/surface/outdoors)
"rY" = (
/obj/structure/table/wood/bar,
/obj/item/gun/ballistic/rifle/boltaction/polymer,
/obj/item/ammo_box/aac_300blk_stripper,
/obj/item/ammo_box/aac_300blk_stripper,
/obj/item/ammo_box/aac_300blk_stripper,
/obj/item/ammo_box/aac_300blk_stripper,
/turf/open/floor/plating,
/area/whitesands/surface/outdoors)
"sn" = (
/obj/machinery/atmospherics/components/unary/vent_scrubber/on/layer4{
	dir = 8
	},
/obj/structure/cable{
	icon_state = "1-2"
	},
/obj/structure/chair/stool/bar{
	dir = 4
	},
/obj/effect/decal/cleanable/dirt,
/turf/open/floor/plating,
/area/whitesands/surface/outdoors)
"sA" = (
/obj/structure/chair/wood,
/obj/effect/decal/cleanable/generic,
/turf/open/floor/wood{
	icon_state = "wood-broken3"
	},
/area/whitesands/surface/outdoors)
"sN" = (
/obj/machinery/vending/cigarette,
/turf/open/floor/plasteel/dark,
/area/whitesands/surface/outdoors)
"tI" = (
/obj/structure/chair/stool/bar,
/obj/machinery/atmospherics/pipe/simple/supply/hidden/layer2{
	dir = 8
	},
/obj/machinery/atmospherics/pipe/simple/scrubbers/hidden/layer4{
	dir = 8
	},
/obj/effect/decal/cleanable/generic,
/obj/effect/decal/cleanable/blood{
	icon_state = "floor7"
	},
/turf/open/floor/wood{
	icon_state = "wood-broken3"
	},
/area/whitesands/surface/outdoors)
"tV" = (
/obj/structure/barricade/sandbags,
/turf/open/floor/plating{
	icon_state = "platingdmg1"
	},
/area/whitesands/surface/outdoors)
"ud" = (
/turf/open/floor/plating{
	icon_state = "platingdmg2"
	},
/area/whitesands/surface/outdoors)
"uD" = (
/obj/machinery/atmospherics/pipe/simple/supply/hidden/layer2{
	dir = 8
	},
/obj/machinery/atmospherics/pipe/simple/scrubbers/hidden/layer4{
	dir = 8
	},
/turf/open/floor/wood{
	icon_state = "wood-broken"
	},
/area/whitesands/surface/outdoors)
"vc" = (
/obj/effect/decal/cleanable/oil/streak,
/turf/open/floor/plating{
	icon_state = "platingdmg1"
	},
/area/whitesands/surface/outdoors)
"vR" = (
/mob/living/simple_animal/hostile/whitesands/survivor{
	faction = list("saloon")
	},
/turf/open/floor/plasteel/dark,
/area/whitesands/surface/outdoors)
"wy" = (
/obj/effect/decal/cleanable/dirt,
/turf/open/floor/plating{
	icon_state = "platingdmg2"
	},
/area/whitesands/surface/outdoors)
"wL" = (
/obj/effect/decal/cleanable/dirt,
/mob/living/simple_animal/hostile/whitesands/survivor{
	faction = list("saloon")
	},
/turf/open/floor/plating,
/area/whitesands/surface/outdoors)
"wP" = (
/obj/structure/chair/stool/bar,
/turf/open/floor/wood{
	icon_state = "wood-broken6"
	},
/area/whitesands/surface/outdoors)
"xh" = (
/obj/structure/closet/secure_closet/bar{
	req_access = null
	},
/obj/item/gun/ballistic/shotgun/doublebarrel,
/obj/item/storage/box/lethalshot,
/obj/item/storage/box/lethalshot,
/turf/open/floor/wood{
	icon_state = "wood-broken5"
	},
/area/whitesands/surface/outdoors)
"xX" = (
/obj/machinery/atmospherics/pipe/manifold4w/supply/hidden/layer2,
/obj/machinery/atmospherics/pipe/manifold/scrubbers/hidden/layer4{
	dir = 4
	},
/obj/structure/chair/wood{
	dir = 4
	},
/obj/structure/cable{
	icon_state = "4-8"
	},
/obj/effect/decal/cleanable/dirt/dust,
/turf/open/floor/plating{
	icon_state = "platingdmg1"
	},
/area/whitesands/surface/outdoors)
"yv" = (
/obj/structure/chair/stool/bar,
/turf/open/floor/wood{
	icon_state = "wood-broken2"
	},
/area/whitesands/surface/outdoors)
"yU" = (
/turf/open/floor/plating{
	icon_state = "platingdmg1"
	},
/area/whitesands/surface/outdoors)
"zn" = (
/obj/machinery/door/airlock,
/obj/machinery/atmospherics/pipe/simple/supply/hidden/layer2{
	dir = 8
	},
/obj/machinery/atmospherics/pipe/simple/scrubbers/hidden/layer4{
	dir = 8
	},
/obj/machinery/door/firedoor/border_only{
	dir = 4
	},
/obj/machinery/door/firedoor/border_only{
	dir = 8
	},
/turf/open/floor/plasteel/dark,
/area/whitesands/surface/outdoors)
"Ai" = (
/obj/machinery/atmospherics/pipe/simple/scrubbers/hidden/layer4{
	dir = 5
	},
/obj/machinery/atmospherics/pipe/simple/supply/hidden/layer2{
	dir = 5
	},
/turf/open/floor/plating,
/area/whitesands/surface/outdoors)
"Ar" = (
/turf/open/floor/plating,
/area/whitesands/surface/outdoors)
"Av" = (
/obj/machinery/smartfridge/drinks,
/turf/closed/wall,
/area/whitesands/surface/outdoors)
"Ax" = (
/obj/structure/lattice,
/obj/effect/decal/cleanable/dirt,
/obj/effect/decal/cleanable/dirt,
/obj/effect/decal/cleanable/dirt,
/turf/template_noop,
/area/whitesands/surface/outdoors)
"Br" = (
/obj/machinery/atmospherics/pipe/simple/supply/hidden/layer2{
	dir = 8
	},
/obj/machinery/atmospherics/pipe/simple/scrubbers/hidden/layer4{
	dir = 8
	},
/obj/structure/cable{
	icon_state = "4-8"
	},
/obj/structure/barricade/sandbags,
/turf/open/floor/plating,
/area/whitesands/surface/outdoors)
"BE" = (
/obj/machinery/atmospherics/components/unary/vent_scrubber/on/layer4{
	dir = 1
	},
/turf/open/floor/wood,
/area/whitesands/surface/outdoors)
"BQ" = (
/obj/structure/table/wood/bar,
/obj/effect/decal/cleanable/dirt,
/turf/open/floor/plating,
/area/whitesands/surface/outdoors)
"Cn" = (
/obj/structure/cable{
	icon_state = "4-8"
	},
/turf/closed/wall/mineral/sandstone,
/area/space)
"CS" = (
/obj/machinery/status_display/shuttle,
/obj/structure/girder,
/turf/open/floor/plating,
/area/whitesands/surface/outdoors)
"DU" = (
/obj/structure/table/wood/poker,
/obj/item/toy/cards/deck/cas{
	pixel_y = 8
	},
/obj/item/toy/cards/deck/cas/black,
/obj/effect/decal/cleanable/dirt/dust,
/turf/open/floor/wood,
/area/whitesands/surface/outdoors)
"Eg" = (
/obj/machinery/atmospherics/pipe/simple/supply/hidden/layer2{
	dir = 8
	},
/obj/machinery/atmospherics/pipe/simple/scrubbers/hidden/layer4{
	dir = 8
	},
/obj/machinery/holopad/emergency/bar,
/turf/open/floor/wood{
	icon_state = "wood-broken2"
	},
/area/whitesands/surface/outdoors)
"Eq" = (
/obj/structure/rack,
/obj/effect/decal/cleanable/dirt,
/obj/effect/decal/cleanable/dirt/dust,
/obj/item/electronics/apc,
/turf/open/floor/plasteel/dark,
/area/whitesands/surface/outdoors)
"EP" = (
/obj/machinery/atmospherics/pipe/simple/supply/hidden/layer2{
	dir = 8
	},
/obj/machinery/atmospherics/pipe/simple/scrubbers/hidden/layer4{
	dir = 9
	},
/turf/open/floor/plating{
	icon_state = "platingdmg1"
	},
/area/whitesands/surface/outdoors)
"Fc" = (
/obj/structure/barricade/sandbags,
/obj/effect/decal/cleanable/dirt,
/turf/open/floor/plating,
/area/whitesands/surface/outdoors)
"FA" = (
/obj/structure/chair/wood{
	dir = 8
	},
/turf/open/floor/wood{
	icon_state = "wood-broken"
	},
/area/whitesands/surface/outdoors)
"FI" = (
/obj/effect/decal/cleanable/dirt,
/obj/effect/decal/cleanable/dirt/dust,
/turf/open/floor/plating{
	icon_state = "panelscorched"
	},
/area/whitesands/surface/outdoors)
"FV" = (
/obj/machinery/atmospherics/pipe/simple/scrubbers/hidden/layer4{
	dir = 10
	},
/mob/living/simple_animal/hostile/whitesands/ranged/gunslinger{
	faction = list("saloon")
	},
/turf/open/floor/plating{
	icon_state = "panelscorched"
	},
/area/whitesands/surface/outdoors)
"Gz" = (
/obj/effect/decal/cleanable/glass,
/turf/open/floor/plating{
	icon_state = "platingdmg1"
	},
/area/whitesands/surface/outdoors)
"Ha" = (
/obj/machinery/power/terminal{
	dir = 8
	},
/obj/structure/cable,
/obj/effect/decal/cleanable/dirt,
/obj/effect/decal/cleanable/dirt/dust,
/obj/effect/decal/cleanable/generic,
/turf/open/floor/plasteel/dark,
/area/whitesands/surface/outdoors)
"Hc" = (
/obj/machinery/light,
/turf/closed/wall/mineral/sandstone,
/area/whitesands/surface/outdoors)
"HA" = (
/obj/structure/girder,
/turf/open/floor/plating,
/area/whitesands/surface/outdoors)
"HM" = (
/obj/structure/chair/wood{
	dir = 8
	},
/turf/open/floor/wood,
/area/whitesands/surface/outdoors)
"HU" = (
/obj/effect/decal/cleanable/dirt,
/obj/effect/decal/cleanable/dirt/dust,
/turf/open/floor/plating,
/area/whitesands/surface/outdoors)
"HZ" = (
/obj/structure/table/wood/bar,
/turf/open/floor/wood{
	icon_state = "wood-broken2"
	},
/area/whitesands/surface/outdoors)
"Ig" = (
/obj/effect/decal/cleanable/dirt/dust,
/turf/closed/wall,
/area/whitesands/surface/outdoors)
"IX" = (
/obj/structure/barricade/sandbags,
/turf/open/floor/plating{
	icon_state = "platingdmg2"
	},
/area/whitesands/surface/outdoors)
"Jw" = (
/obj/machinery/atmospherics/pipe/simple/supply/hidden/layer2{
	dir = 8
	},
/obj/machinery/atmospherics/pipe/simple/scrubbers/hidden/layer4{
	dir = 8
	},
/obj/structure/chair/wood,
/obj/structure/cable{
	icon_state = "4-8"
	},
/turf/open/floor/carpet/nanoweave,
/area/whitesands/surface/outdoors)
"JH" = (
/obj/machinery/atmospherics/pipe/simple/supply/hidden/layer2{
	dir = 8
	},
/obj/machinery/atmospherics/pipe/manifold/scrubbers/hidden/layer4{
	dir = 1
	},
/obj/structure/cable{
	icon_state = "4-8"
	},
/turf/open/floor/carpet/nanoweave,
/area/whitesands/surface/outdoors)
"JJ" = (
/obj/item/toy/cards/deck/syndicate,
/obj/effect/decal/cleanable/dirt,
/obj/effect/decal/cleanable/dirt/dust,
/obj/effect/decal/cleanable/blood/gibs/limb,
/turf/open/floor/wood,
/area/whitesands/surface/outdoors)
"JS" = (
/obj/machinery/deepfryer,
/obj/effect/turf_decal/corner/white/half{
	dir = 4
	},
/obj/effect/turf_decal/box,
/turf/open/floor/plasteel/mono/dark,
/area/whitesands/surface/outdoors)
"JT" = (
/obj/effect/decal/cleanable/dirt/dust,
/obj/effect/decal/remains/human,
/obj/effect/decal/cleanable/blood/splatter,
/turf/open/floor/wood{
	icon_state = "wood-broken4"
	},
/area/whitesands/surface/outdoors)
"Ka" = (
/obj/structure/chair/stool/bar,
/obj/effect/decal/cleanable/dirt,
/obj/effect/decal/cleanable/dirt/dust,
/turf/open/floor/wood{
	icon_state = "wood-broken4"
	},
/area/whitesands/surface/outdoors)
"Ko" = (
/obj/item/storage/box/donkpockets,
/obj/effect/turf_decal/corner/white/half,
/obj/effect/turf_decal/corner/white{
	dir = 4
	},
/obj/structure/table/wood/bar,
/obj/effect/decal/cleanable/dirt,
/obj/effect/decal/cleanable/food/flour,
/turf/open/floor/plasteel/mono/dark,
/area/whitesands/surface/outdoors)
"Kz" = (
/obj/effect/decal/cleanable/dirt/dust,
/obj/effect/decal/cleanable/ash,
/turf/open/floor/wood{
	icon_state = "wood-broken4"
	},
/area/whitesands/surface/outdoors)
"KB" = (
/obj/machinery/atmospherics/pipe/simple/supply/hidden/layer2{
	dir = 8
	},
/obj/machinery/atmospherics/components/unary/vent_scrubber/on/layer4{
	dir = 1
	},
/obj/effect/decal/cleanable/dirt,
/turf/open/floor/plating{
	icon_state = "platingdmg1"
	},
/area/whitesands/surface/outdoors)
"KZ" = (
/obj/structure/cable{
	icon_state = "1-2"
	},
/obj/effect/decal/cleanable/dirt,
/turf/open/floor/plating{
	icon_state = "panelscorched"
	},
/area/whitesands/surface/outdoors)
"Lg" = (
/obj/machinery/atmospherics/pipe/simple/scrubbers/hidden/layer4{
	dir = 10
	},
/obj/machinery/atmospherics/pipe/simple/supply/hidden/layer2{
	dir = 10
	},
/obj/structure/cable{
	icon_state = "1-2"
	},
/obj/effect/decal/cleanable/blood/gibs/down,
/turf/open/floor/carpet/nanoweave,
/area/whitesands/surface/outdoors)
"LS" = (
/obj/machinery/atmospherics/pipe/simple/supply/hidden/layer2{
	dir = 1
	},
/obj/machinery/atmospherics/pipe/simple/scrubbers/hidden/layer4,
/obj/effect/decal/cleanable/dirt/dust,
/turf/open/floor/carpet/nanoweave,
/area/whitesands/surface/outdoors)
"ME" = (
/obj/effect/decal/cleanable/dirt,
/turf/closed/wall,
/area/whitesands/surface/outdoors)
"MO" = (
/obj/machinery/vending/boozeomat/all_access{
	density = 0;
	pixel_x = 32
	},
/obj/item/reagent_containers/food/drinks/shaker,
/obj/machinery/reagentgrinder{
	pixel_y = 5
	},
/obj/item/reagent_containers/glass/rag,
/obj/structure/table/wood/bar,
/obj/effect/decal/cleanable/dirt,
/obj/effect/decal/cleanable/dirt/dust,
/turf/open/floor/wood{
	icon_state = "wood-broken4"
	},
/area/whitesands/surface/outdoors)
"Np" = (
/obj/structure/lattice,
/obj/structure/lattice,
/turf/template_noop,
/area/whitesands/surface/outdoors)
"Nr" = (
/obj/machinery/power/port_gen/pacman,
/turf/open/floor/plating,
/area/whitesands/surface/outdoors)
"Nt" = (
/obj/machinery/atmospherics/pipe/simple/supply/hidden/layer2{
	dir = 1
	},
/obj/machinery/atmospherics/pipe/simple/scrubbers/hidden/layer4,
/obj/machinery/holopad,
/obj/effect/decal/cleanable/generic,
/turf/open/floor/wood{
	icon_state = "wood-broken"
	},
/area/whitesands/surface/outdoors)
"NH" = (
/obj/machinery/atmospherics/pipe/manifold/supply/hidden/layer2{
	dir = 8
	},
/obj/machinery/atmospherics/pipe/manifold/scrubbers/hidden/layer4{
	dir = 8
	},
/obj/structure/table/wood/fancy/black,
/obj/item/reagent_containers/food/condiment/peppermill,
/obj/item/reagent_containers/food/condiment/saltshaker{
	pixel_x = 5;
	pixel_y = 5
	},
/obj/effect/decal/cleanable/dirt,
/turf/open/floor/wood,
/area/whitesands/surface/outdoors)
"Od" = (
/obj/machinery/atmospherics/pipe/simple/supply/hidden/layer2{
	dir = 8
	},
/obj/machinery/atmospherics/pipe/simple/scrubbers/hidden/layer4{
	dir = 8
	},
/obj/effect/decal/cleanable/dirt,
/turf/open/floor/wood{
	icon_state = "wood-broken4"
	},
/area/whitesands/surface/outdoors)
"OK" = (
/obj/machinery/chem_dispenser/drinks{
	dir = 8
	},
/obj/structure/table/wood/bar,
/obj/effect/decal/cleanable/cobweb/cobweb2,
/turf/open/floor/wood{
	icon_state = "wood-broken"
	},
/area/whitesands/surface/outdoors)
"OM" = (
/obj/structure/table/reinforced,
/obj/machinery/microwave,
/obj/effect/turf_decal/box,
/obj/effect/turf_decal/corner/white/half,
/obj/effect/decal/cleanable/dirt,
/turf/open/floor/plasteel/mono/dark,
/area/whitesands/surface/outdoors)
"OY" = (
/obj/effect/decal/cleanable/dirt,
/obj/effect/decal/cleanable/dirt/dust,
/turf/open/floor/wood{
	icon_state = "wood-broken4"
	},
/area/whitesands/surface/outdoors)
"OZ" = (
/turf/closed/wall/mineral/sandstone,
/area/space)
"PG" = (
/obj/structure/table/wood/bar,
/obj/item/stack/sheet/metal/twenty,
/obj/item/stack/sheet/glass{
	amount = 10
	},
/obj/item/stack/sheet/glass{
	amount = 10
	},
/obj/effect/decal/cleanable/cobweb/cobweb2,
/turf/open/floor/plating,
/area/whitesands/surface/outdoors)
"PW" = (
/obj/machinery/processor,
/obj/machinery/atmospherics/pipe/simple/scrubbers/hidden/layer4{
	dir = 6
	},
/obj/machinery/light{
	dir = 8
	},
/turf/open/floor/plasteel/mono/dark,
/area/whitesands/surface/outdoors)
"Qk" = (
/obj/structure/table/wood/bar,
/obj/item/storage/firstaid/brute{
	pixel_x = 4;
	pixel_y = 4
	},
/obj/item/storage/firstaid/advanced,
/turf/open/floor/plating,
/area/whitesands/surface/outdoors)
"QG" = (
/obj/effect/decal/cleanable/dirt,
/turf/open/floor/wood{
	icon_state = "wood-broken4"
	},
/area/whitesands/surface/outdoors)
"QJ" = (
/obj/machinery/atmospherics/pipe/manifold/scrubbers/hidden/layer4{
	dir = 1
	},
/turf/open/floor/plating,
/area/whitesands/surface/outdoors)
"RK" = (
/obj/effect/decal/cleanable/dirt,
/obj/effect/decal/cleanable/dirt,
/turf/open/floor/plating{
	icon_state = "panelscorched"
	},
/area/whitesands/surface/outdoors)
"Sd" = (
/obj/structure/lattice,
/obj/effect/decal/cleanable/dirt,
/turf/template_noop,
/area/whitesands/surface/outdoors)
"Tj" = (
/obj/structure/cable{
	icon_state = "1-2"
	},
/obj/effect/decal/cleanable/dirt/dust,
/turf/open/floor/plating{
	icon_state = "platingdmg1"
	},
/area/whitesands/surface/outdoors)
"TU" = (
/obj/structure/extinguisher_cabinet{
	pixel_y = -30
	},
/obj/effect/decal/cleanable/dirt,
/obj/effect/decal/cleanable/dirt/dust,
/turf/open/floor/wood{
	icon_state = "wood-broken4"
	},
/area/whitesands/surface/outdoors)
"Uc" = (
/obj/effect/decal/cleanable/oil,
/turf/open/floor/plasteel/dark,
/area/whitesands/surface/outdoors)
"Ut" = (
/obj/structure/chair/stool/bar,
/obj/effect/decal/cleanable/dirt,
/turf/open/floor/wood{
	icon_state = "wood-broken2"
	},
/area/whitesands/surface/outdoors)
"Uu" = (
/obj/structure/girder,
/obj/effect/decal/cleanable/dirt,
/turf/open/space/basic,
/area/whitesands/surface/outdoors)
"Uy" = (
/obj/structure/chair/stool/bar{
	dir = 1
	},
/obj/effect/decal/cleanable/dirt,
/turf/open/floor/wood{
	icon_state = "wood-broken4"
	},
/area/whitesands/surface/outdoors)
"UH" = (
/obj/structure/sink/kitchen{
	dir = 4;
	pixel_x = -12
	},
/obj/structure/extinguisher_cabinet{
	pixel_x = -30;
	pixel_y = -30
	},
/obj/effect/decal/cleanable/glass,
/turf/open/floor/plating,
/area/whitesands/surface/outdoors)
"Vw" = (
/obj/machinery/atmospherics/pipe/simple/supply/hidden/layer2{
	dir = 8
	},
/obj/machinery/atmospherics/pipe/simple/scrubbers/hidden/layer4{
	dir = 8
	},
/obj/structure/cable{
	icon_state = "4-8"
	},
/turf/open/floor/carpet/nanoweave,
/area/whitesands/surface/outdoors)
"Wu" = (
/obj/structure/barricade/sandbags,
/obj/effect/decal/cleanable/dirt/dust,
/turf/open/floor/plating{
	icon_state = "platingdmg1"
	},
/area/whitesands/surface/outdoors)
"Wv" = (
/turf/template_noop,
/area/template_noop)
"WV" = (
/obj/machinery/power/terminal{
	dir = 8
	},
/obj/structure/cable{
	icon_state = "0-4"
	},
/turf/closed/wall/mineral/sandstone,
/area/space)
"XE" = (
/obj/structure/chair/stool/bar,
/obj/effect/decal/cleanable/dirt/dust,
/turf/open/floor/plating{
	icon_state = "platingdmg2"
	},
/area/whitesands/surface/outdoors)
"XT" = (
/turf/closed/wall,
/area/whitesands/surface/outdoors)
"Yp" = (
/obj/machinery/atmospherics/pipe/simple/supply/hidden/layer2{
	dir = 8
	},
/obj/machinery/atmospherics/pipe/simple/scrubbers/hidden/layer4{
	dir = 8
	},
/obj/structure/cable{
	icon_state = "4-8"
	},
/obj/machinery/door/firedoor/border_only{
	dir = 4
	},
/obj/machinery/door/firedoor/border_only{
	dir = 8
	},
/turf/open/floor/plasteel/dark,
/area/whitesands/surface/outdoors)
"Ys" = (
/obj/item/storage/box/drinkingglasses,
/obj/machinery/firealarm{
	pixel_y = -28
	},
/obj/effect/decal/cleanable/dirt,
/obj/effect/decal/cleanable/dirt/dust,
/obj/effect/decal/cleanable/dirt/dust,
/obj/structure/table/wood/bar,
/turf/open/floor/wood{
	icon_state = "wood-broken4"
	},
/area/whitesands/surface/outdoors)
"Yy" = (
/obj/effect/decal/cleanable/dirt,
/obj/effect/decal/cleanable/dirt,
/obj/effect/decal/cleanable/dirt/dust,
/turf/closed/wall,
/area/whitesands/surface/outdoors)
"ZL" = (
/turf/open/floor/plating{
	icon_state = "panelscorched"
	},
/area/whitesands/surface/outdoors)
"ZO" = (
/obj/machinery/atmospherics/components/unary/vent_pump/on/layer2{
	dir = 8
	},
/obj/structure/table/wood/fancy/black,
/obj/structure/cable{
	icon_state = "1-2"
	},
/obj/structure/cable{
	icon_state = "2-8"
	},
/obj/item/reagent_containers/food/condiment/peppermill,
/obj/item/reagent_containers/food/condiment/saltshaker{
	pixel_x = 5;
	pixel_y = 5
	},
/turf/open/floor/wood,
/area/whitesands/surface/outdoors)
"ZU" = (
/mob/living/simple_animal/hostile/whitesands/survivor{
	faction = list("saloon")
	},
/turf/open/floor/plating{
	icon_state = "platingdmg1"
	},
/area/whitesands/surface/outdoors)

(1,1,1) = {"
Wv
Wv
Wv
Wv
Wv
Wv
Wv
Wv
Wv
Ar
Wv
Wv
Wv
Wv
Wv
"}
(2,1,1) = {"
Wv
Wv
Ar
fj
fj
fj
Ar
fj
fj
Np
Ar
Wv
Wv
Wv
Wv
"}
(3,1,1) = {"
Wv
Wv
Np
Fc
cP
cP
fj
fj
cP
cP
fj
fj
fj
Wv
Wv
"}
(4,1,1) = {"
Wv
fj
IX
Wu
hm
ZL
gX
qy
Ar
cP
cP
cP
Sd
Wv
Wv
"}
(5,1,1) = {"
fj
fj
qe
xX
Nt
aL
bV
LS
NH
Ai
ZU
cP
Ax
fj
Wv
"}
(6,1,1) = {"
fj
Ar
hf
ZO
KZ
Tj
sn
ed
ni
Lg
wy
Gz
kk
el
fj
"}
(7,1,1) = {"
fj
fj
Br
FA
QG
sA
DU
gR
he
FI
vc
eP
el
Sd
fj
"}
(8,1,1) = {"
Wv
fj
JH
BE
yv
pa
JJ
Uy
Od
Kz
HU
tV
Ar
kk
fj
"}
(9,1,1) = {"
fj
Ar
Jw
bU
gp
rR
wP
XE
tI
rR
TU
XT
Ar
Sd
fj
"}
(10,1,1) = {"
Ar
fj
Vw
HM
Ut
jT
eh
HZ
lH
Ys
lx
ME
fj
el
Wv
"}
(11,1,1) = {"
Ar
Np
Vw
sN
Ka
dl
JT
oV
Eg
qx
OY
Av
wL
Sd
Wv
"}
(12,1,1) = {"
fj
fj
Yp
XT
Yy
CS
OK
iu
uD
MO
xh
XT
fj
Wv
Wv
"}
(13,1,1) = {"
fj
fj
dR
Ha
Eq
bK
HA
XT
zn
Ig
HA
HA
fj
Wv
Wv
"}
(14,1,1) = {"
Ar
fj
iV
Uc
od
Uu
JS
PW
EP
UH
fn
HA
Wv
Wv
Wv
"}
(15,1,1) = {"
Ar
Np
iD
vR
od
OM
ry
QJ
KB
ud
fG
WV
fj
Wv
Wv
"}
(16,1,1) = {"
fj
fj
ud
Hc
od
Ko
el
FV
qW
yU
fG
Cn
fj
Wv
Wv
"}
(17,1,1) = {"
Wv
Np
Ar
od
lI
mp
tV
cP
BQ
Ar
el
OZ
fj
Wv
Wv
"}
(18,1,1) = {"
Wv
fj
Ar
od
Qk
ZL
wy
bN
RK
Ar
od
OZ
fj
fj
Wv
"}
(19,1,1) = {"
Wv
fj
Ar
od
od
PG
rY
fG
Nr
od
od
Ar
fj
fj
Wv
"}
(20,1,1) = {"
Wv
Wv
Wv
fj
OZ
OZ
OZ
OZ
OZ
OZ
Ar
Ar
fj
Wv
Wv
"}
(21,1,1) = {"
Wv
Wv
Wv
fj
fj
Ar
hm
fj
Ar
Ar
fj
Ar
Wv
Wv
Wv
"}
(22,1,1) = {"
Wv
Wv
Wv
Wv
Np
fj
fj
Ar
fj
fj
Ar
Wv
Wv
Wv
Wv
"}
