//MAP CONVERTED BY dmm2tgm.py THIS HEADER COMMENT PREVENTS RECONVERSION, DO NOT REMOVE
"aa" = (
/turf/closed/mineral/random/whitesands,
/area/overmap_encounter/planetoid/cave/explored)
"ab" = (
/turf/open/floor/plating/asteroid/whitesands/dried,
/area/overmap_encounter/planetoid/cave/explored)
"ac" = (
/turf/closed/wall/r_wall,
/area/ruin/powered/seedvault)
"ad" = (
/obj/machinery/vending/hydronutrients{
	all_items_free = 1
	},
/obj/effect/turf_decal/trimline/opaque/green/filled/line,
/turf/open/floor/plasteel/dark,
/area/ruin/powered/seedvault)
"ae" = (
/obj/machinery/smartfridge,
/obj/effect/turf_decal/trimline/opaque/green/filled/line,
/turf/open/floor/plasteel/dark,
/area/ruin/powered/seedvault)
"ag" = (
/obj/item/storage/toolbox/syndicate,
/obj/structure/table/wood,
/obj/effect/turf_decal/trimline/opaque/green/filled/line,
/turf/open/floor/plasteel/dark,
/area/ruin/powered/seedvault)
"ah" = (
/turf/open/floor/plasteel/freezer,
/area/ruin/powered/seedvault)
"ai" = (
/obj/item/reagent_containers/glass/beaker/bluespace,
/obj/item/reagent_containers/glass/beaker/bluespace,
/obj/item/reagent_containers/glass/beaker/bluespace,
/obj/item/reagent_containers/glass/beaker/bluespace,
/obj/structure/table/wood,
/obj/effect/turf_decal/trimline/opaque/green/filled/line,
/turf/open/floor/plasteel/dark,
/area/ruin/powered/seedvault)
"aj" = (
/obj/structure/table/wood,
/obj/item/gun/energy/floragun,
/obj/item/gun/energy/floragun,
/obj/item/gun/energy/floragun,
/obj/item/gun/energy/floragun,
/obj/effect/decal/cleanable/cobweb/cobweb2,
/obj/effect/turf_decal/trimline/opaque/green/filled/line,
/turf/open/floor/plasteel/dark,
/area/ruin/powered/seedvault)
"al" = (
/turf/open/floor/plasteel/dark,
/area/ruin/powered/seedvault)
"ao" = (
/obj/structure/loom,
/turf/open/floor/plasteel/dark,
/area/ruin/powered/seedvault)
"ar" = (
/obj/structure/closet/crate/hydroponics,
/obj/item/clothing/under/rank/civilian/hydroponics,
/obj/item/clothing/under/rank/civilian/hydroponics,
/obj/item/clothing/under/rank/civilian/hydroponics,
/obj/item/clothing/under/rank/civilian/hydroponics,
/obj/effect/decal/cleanable/cobweb,
/obj/effect/turf_decal/trimline/opaque/green/filled/line{
	dir = 4
	},
/turf/open/floor/plasteel/dark,
/area/ruin/powered/seedvault)
"as" = (
/obj/machinery/door/airlock/glass_large,
/turf/open/floor/plasteel/freezer,
/area/ruin/powered/seedvault)
"at" = (
/obj/structure/closet/crate/hydroponics,
/obj/item/cultivator,
/obj/item/cultivator,
/obj/item/cultivator,
/obj/item/cultivator,
/obj/item/shovel/spade,
/obj/item/shovel/spade,
/obj/item/shovel/spade,
/obj/item/shovel/spade,
/obj/item/hatchet,
/obj/item/hatchet,
/obj/item/hatchet,
/obj/item/hatchet,
/obj/effect/turf_decal/trimline/opaque/green/filled/line{
	dir = 4
	},
/turf/open/floor/plasteel/dark,
/area/ruin/powered/seedvault)
"au" = (
/obj/machinery/door/airlock/titanium,
/turf/open/floor/vault,
/area/ruin/powered/seedvault)
"av" = (
/obj/machinery/door/airlock/external,
/obj/effect/mapping_helpers/airlock/cyclelink_helper,
/turf/open/floor/plasteel/dark,
/area/ruin/powered/seedvault)
"aw" = (
/obj/machinery/reagentgrinder{
	pixel_y = 5
	},
/obj/structure/table/glass,
/obj/effect/turf_decal/trimline/opaque/green/filled/end,
/obj/machinery/airalarm/directional/north,
/turf/open/floor/plasteel/dark,
/area/ruin/powered/seedvault)
"ax" = (
/obj/structure/reagent_dispensers/watertank/high,
/obj/effect/turf_decal/trimline/opaque/green/line{
	dir = 9
	},
/obj/effect/turf_decal/trimline/opaque/green/filled/corner,
/turf/open/floor/plasteel/dark,
/area/ruin/powered/seedvault)
"ay" = (
/obj/structure/reagent_dispensers/watertank/high,
/obj/effect/turf_decal/trimline/opaque/green/line{
	dir = 5
	},
/obj/effect/turf_decal/trimline/opaque/green/filled/corner{
	dir = 8
	},
/turf/open/floor/plasteel/dark,
/area/ruin/powered/seedvault)
"az" = (
/obj/structure/closet/crate/hydroponics,
/obj/item/soap/homemade,
/obj/item/soap/homemade,
/obj/effect/turf_decal/trimline/opaque/green/filled/line{
	dir = 6
	},
/turf/open/floor/plasteel/dark,
/area/ruin/powered/seedvault)
"aA" = (
/turf/open/floor/vault,
/area/ruin/powered/seedvault)
"aF" = (
/obj/structure/table/wood,
/obj/item/lighter,
/obj/item/lighter,
/obj/item/storage/fancy/rollingpapers,
/obj/item/storage/fancy/rollingpapers,
/obj/item/storage/fancy/rollingpapers,
/obj/item/storage/fancy/rollingpapers,
/turf/open/floor/plasteel/dark,
/area/ruin/powered/seedvault)
"aG" = (
/turf/closed/mineral/random/whitesands,
/area/ruin/powered/seedvault)
"aH" = (
/obj/machinery/door/airlock/vault,
/obj/machinery/atmospherics/pipe/simple/supply/hidden,
/turf/open/floor/plasteel/freezer,
/area/ruin/powered/seedvault)
"aJ" = (
/obj/structure/reagent_dispensers/watertank/high,
/obj/effect/turf_decal/trimline/opaque/green/line{
	dir = 10
	},
/obj/effect/turf_decal/trimline/opaque/green/filled/corner{
	dir = 4
	},
/turf/open/floor/plasteel/dark,
/area/ruin/powered/seedvault)
"aL" = (
/obj/structure/table/wood,
/obj/item/storage/box/disks_plantgene,
/obj/item/storage/box/disks_plantgene,
/obj/item/storage/box/disks_plantgene,
/turf/open/floor/vault,
/area/ruin/powered/seedvault)
"aM" = (
/obj/structure/table/wood,
/obj/machinery/smartfridge/disks{
	pixel_y = 2
	},
/turf/open/floor/vault,
/area/ruin/powered/seedvault)
"aN" = (
/turf/open/floor/mineral/titanium/blue,
/area/ruin/powered/seedvault)
"aQ" = (
/obj/effect/decal/cleanable/dirt,
/turf/open/floor/plasteel/freezer,
/area/ruin/powered/seedvault)
"aR" = (
/obj/machinery/door/airlock/vault,
/obj/effect/mapping_helpers/airlock/cyclelink_helper{
	dir = 1
	},
/turf/open/floor/plasteel/dark,
/area/ruin/powered/seedvault)
"aS" = (
/obj/structure/table/wood,
/obj/item/storage/bag/plants,
/obj/item/storage/bag/plants,
/obj/item/storage/bag/plants,
/obj/item/storage/bag/plants,
/obj/effect/turf_decal/trimline/opaque/green/filled/line{
	dir = 1
	},
/turf/open/floor/plasteel/dark,
/area/ruin/powered/seedvault)
"aT" = (
/obj/item/reagent_containers/glass/bucket,
/obj/structure/table/wood,
/obj/item/reagent_containers/glass/bucket,
/obj/item/reagent_containers/glass/bucket,
/obj/item/reagent_containers/glass/bucket,
/obj/effect/turf_decal/trimline/opaque/green/filled/line{
	dir = 5
	},
/turf/open/floor/plasteel/dark,
/area/ruin/powered/seedvault)
"aV" = (
/obj/effect/turf_decal/trimline/opaque/green/line,
/obj/effect/turf_decal/trimline/opaque/green/line{
	dir = 1
	},
/obj/structure/table/reinforced,
/turf/open/floor/mineral/plastitanium,
/area/ruin/powered/seedvault)
"aW" = (
/obj/machinery/disposal/bin,
/obj/structure/disposalpipe/trunk{
	dir = 4
	},
/turf/open/floor/mineral/titanium/blue,
/area/ruin/powered/seedvault)
"aX" = (
/obj/structure/closet/crate/hydroponics,
/obj/structure/beebox,
/obj/item/melee/flyswatter,
/obj/item/honey_frame,
/obj/item/honey_frame,
/obj/item/honey_frame,
/obj/item/queen_bee/bought,
/obj/item/clothing/head/beekeeper_head,
/obj/item/clothing/suit/beekeeper_suit,
/obj/effect/decal/cleanable/cobweb,
/turf/open/floor/vault,
/area/ruin/powered/seedvault)
"aY" = (
/obj/effect/decal/cleanable/food/plant_smudge,
/obj/machinery/atmospherics/components/unary/vent_pump/on{
	dir = 1
	},
/turf/open/floor/vault,
/area/ruin/powered/seedvault)
"ba" = (
/obj/effect/turf_decal/trimline/opaque/green/line{
	dir = 4
	},
/obj/effect/turf_decal/trimline/opaque/green/line{
	dir = 8
	},
/obj/structure/table/reinforced,
/turf/open/floor/mineral/plastitanium,
/area/ruin/powered/seedvault)
"bb" = (
/obj/effect/decal/cleanable/dirt,
/turf/open/floor/mineral/titanium/blue,
/area/ruin/powered/seedvault)
"bd" = (
/obj/machinery/chem_dispenser/mutagensaltpeter,
/obj/effect/turf_decal/trimline/opaque/green/corner,
/obj/effect/turf_decal/trimline/opaque/green/line{
	dir = 9
	},
/turf/open/floor/mineral/plastitanium,
/area/ruin/powered/seedvault)
"be" = (
/obj/effect/turf_decal/trimline/opaque/green/line,
/obj/effect/turf_decal/trimline/opaque/green/line{
	dir = 1
	},
/turf/open/floor/mineral/plastitanium,
/area/ruin/powered/seedvault)
"bh" = (
/obj/machinery/hydroponics/constructable,
/obj/effect/turf_decal/trimline/opaque/green/line{
	dir = 6
	},
/turf/open/floor/mineral/plastitanium,
/area/ruin/powered/seedvault)
"bi" = (
/obj/structure/disposalpipe/segment{
	dir = 4
	},
/obj/effect/turf_decal/trimline/opaque/green/line{
	dir = 4
	},
/obj/effect/turf_decal/trimline/opaque/green/line{
	dir = 8
	},
/obj/structure/table/reinforced,
/turf/open/floor/mineral/plastitanium,
/area/ruin/powered/seedvault)
"bj" = (
/obj/machinery/hydroponics/constructable,
/obj/effect/turf_decal/trimline/opaque/green/line{
	dir = 10
	},
/turf/open/floor/mineral/plastitanium,
/area/ruin/powered/seedvault)
"bk" = (
/obj/structure/disposalpipe/segment{
	dir = 4
	},
/obj/effect/decal/cleanable/dirt,
/turf/open/floor/mineral/titanium/blue,
/area/ruin/powered/seedvault)
"bn" = (
/obj/structure/window/spawner/east,
/obj/structure/flora/ausbushes/palebush,
/obj/structure/flora/ausbushes/ppflowers,
/turf/open/floor/plating/grass/whitesands,
/area/ruin/powered/seedvault)
"bo" = (
/obj/machinery/chem_master/condimaster,
/obj/effect/turf_decal/trimline/opaque/green/corner{
	dir = 4
	},
/obj/effect/turf_decal/trimline/opaque/green/line{
	dir = 10
	},
/turf/open/floor/mineral/plastitanium,
/area/ruin/powered/seedvault)
"bp" = (
/obj/machinery/seed_extractor,
/obj/effect/turf_decal/trimline/opaque/green/corner{
	dir = 1
	},
/obj/effect/turf_decal/trimline/opaque/green/line{
	dir = 6
	},
/turf/open/floor/mineral/plastitanium,
/area/ruin/powered/seedvault)
"br" = (
/obj/structure/flora/ausbushes/sunnybush,
/obj/structure/flora/grass/jungle/b,
/turf/open/floor/plating/grass/whitesands,
/area/ruin/powered/seedvault)
"bs" = (
/obj/structure/window/spawner/east,
/obj/structure/flora/ausbushes/sparsegrass,
/turf/open/floor/plating/grass/whitesands,
/area/ruin/powered/seedvault)
"bt" = (
/obj/structure/window/spawner,
/obj/structure/flora/ausbushes/ppflowers,
/obj/structure/flora/ausbushes/genericbush,
/obj/structure/flora/ausbushes/brflowers,
/turf/open/floor/plating/grass/whitesands,
/area/ruin/powered/seedvault)
"bu" = (
/obj/structure/window/spawner/east,
/obj/structure/flora/ausbushes/fernybush,
/obj/structure/flora/ausbushes/ywflowers,
/obj/structure/flora/ausbushes/sparsegrass,
/obj/effect/decal/cleanable/glass,
/turf/open/floor/plating/grass/whitesands,
/area/ruin/powered/seedvault)
"bx" = (
/obj/effect/decal/cleanable/glass,
/turf/open/floor/plating/asteroid/whitesands/dried,
/area/overmap_encounter/planetoid/cave/explored)
"by" = (
/obj/structure/disposalpipe/segment{
	dir = 6
	},
/turf/closed/wall/r_wall,
/area/ruin/powered/seedvault)
"bz" = (
/obj/structure/disposalpipe/segment{
	dir = 4
	},
/turf/open/floor/mineral/titanium/blue,
/area/ruin/powered/seedvault)
"bA" = (
/obj/structure/disposalpipe/segment{
	dir = 9
	},
/turf/closed/wall/r_wall,
/area/ruin/powered/seedvault)
"bB" = (
/obj/machinery/hydroponics/constructable,
/obj/effect/turf_decal/trimline/opaque/green/line{
	dir = 5
	},
/turf/open/floor/mineral/plastitanium,
/area/ruin/powered/seedvault)
"bC" = (
/obj/machinery/hydroponics/constructable,
/obj/effect/turf_decal/trimline/opaque/green/line{
	dir = 9
	},
/turf/open/floor/mineral/plastitanium,
/area/ruin/powered/seedvault)
"ca" = (
/obj/machinery/atmospherics/components/unary/tank/air{
	dir = 4
	},
/turf/open/floor/plasteel/freezer,
/area/ruin/powered/seedvault)
"cn" = (
/obj/machinery/light/directional/north,
/turf/open/floor/vault,
/area/ruin/powered/seedvault)
"dc" = (
/obj/machinery/light/directional/west,
/obj/machinery/hydroponics/constructable,
/obj/effect/decal/cleanable/dirt,
/obj/effect/turf_decal/trimline/opaque/green/line{
	dir = 8
	},
/obj/effect/turf_decal/trimline/opaque/green/line{
	dir = 4
	},
/turf/open/floor/mineral/plastitanium,
/area/ruin/powered/seedvault)
"iJ" = (
/obj/machinery/light/directional/south,
/obj/machinery/hydroponics/constructable,
/obj/effect/decal/cleanable/dirt,
/obj/effect/decal/cleanable/dirt,
/obj/effect/turf_decal/trimline/opaque/green/line{
	dir = 1
	},
/obj/effect/turf_decal/trimline/opaque/green/line,
/turf/open/floor/mineral/plastitanium,
/area/ruin/powered/seedvault)
"iM" = (
/obj/machinery/light/directional/south,
/obj/machinery/hydroponics/constructable,
/obj/effect/decal/cleanable/dirt,
/obj/effect/turf_decal/trimline/opaque/green/line{
	dir = 1
	},
/obj/effect/turf_decal/trimline/opaque/green/line,
/turf/open/floor/mineral/plastitanium,
/area/ruin/powered/seedvault)
"nX" = (
/turf/open/floor/plating/asteroid/whitesands,
/area/overmap_encounter/planetoid/sand/explored)
"oR" = (
/obj/machinery/atmospherics/pipe/simple/supply/hidden{
	dir = 10
	},
/turf/open/floor/plasteel/freezer,
/area/ruin/powered/seedvault)
"pW" = (
/obj/machinery/atmospherics/pipe/manifold4w/supply/hidden,
/turf/open/floor/plasteel/freezer,
/area/ruin/powered/seedvault)
"qQ" = (
/obj/machinery/atmospherics/pipe/manifold/supply/hidden,
/turf/open/floor/plasteel/freezer,
/area/ruin/powered/seedvault)
"qW" = (
/obj/effect/mob_spawn/human/seed_vault,
/obj/machinery/light/directional/north,
/turf/open/floor/plasteel/freezer,
/area/ruin/powered/seedvault)
"rf" = (
/turf/closed/mineral/random/whitesands,
/area/overmap_encounter/planetoid/sand/explored)
"sv" = (
/obj/machinery/atmospherics/pipe/simple/supply/hidden,
/turf/open/floor/vault,
/area/ruin/powered/seedvault)
"tr" = (
/obj/effect/turf_decal/trimline/opaque/green/filled/line,
/obj/structure/closet/crate/hydroponics,
/obj/item/seeds/watermelon,
/obj/item/seeds/random,
/obj/item/seeds/random,
/obj/item/seeds/whitebeet,
/obj/item/seeds/replicapod,
/turf/open/floor/plasteel/dark,
/area/ruin/powered/seedvault)
"tu" = (
/obj/machinery/light/directional/south,
/turf/open/floor/plasteel/freezer,
/area/ruin/powered/seedvault)
"tK" = (
/obj/machinery/light/directional/south,
/obj/machinery/atmospherics/pipe/simple/supply/hidden{
	dir = 4
	},
/turf/open/floor/plasteel/freezer,
/area/ruin/powered/seedvault)
"uK" = (
/obj/structure/fans/tiny,
/turf/open/floor/plasteel/dark,
/area/ruin/powered/seedvault)
"uL" = (
/obj/structure/sink{
	dir = 4;
	pixel_x = -12;
	pixel_y = 2
	},
/obj/machinery/light/directional/north,
/obj/effect/decal/cleanable/cobweb,
/turf/open/floor/plasteel/dark,
/area/ruin/powered/seedvault)
"wi" = (
/obj/machinery/light/directional/east,
/obj/structure/fans/tiny,
/turf/open/floor/plasteel/dark,
/area/ruin/powered/seedvault)
"xT" = (
/obj/structure/sink{
	dir = 8;
	pixel_x = 11
	},
/obj/machinery/light/directional/north,
/turf/open/floor/plasteel/dark,
/area/ruin/powered/seedvault)
"zs" = (
/obj/machinery/light/directional/west,
/turf/open/floor/plasteel/dark,
/area/ruin/powered/seedvault)
"Bb" = (
/obj/machinery/atmospherics/pipe/simple/supply/hidden,
/turf/open/floor/plasteel/freezer,
/area/ruin/powered/seedvault)
"BM" = (
/obj/structure/sink{
	dir = 8;
	pixel_x = 11
	},
/obj/machinery/light/directional/south,
/turf/open/floor/plasteel/dark,
/area/ruin/powered/seedvault)
"DA" = (
/obj/effect/decal/cleanable/dirt,
/obj/machinery/atmospherics/pipe/simple/supply/hidden,
/turf/open/floor/mineral/titanium/blue,
/area/ruin/powered/seedvault)
"Kj" = (
/obj/effect/spawner/lootdrop/seed_vault,
/obj/structure/closet/crate/hydroponics,
/obj/effect/spawner/lootdrop/seed_vault,
/obj/effect/spawner/lootdrop/seed_vault,
/obj/item/vending_refill/hydronutrients,
/turf/open/floor/vault,
/area/ruin/powered/seedvault)
"KF" = (
/obj/machinery/door/airlock/titanium,
/obj/machinery/atmospherics/pipe/simple/supply/hidden,
/turf/open/floor/vault,
/area/ruin/powered/seedvault)
"Mm" = (
/turf/open/floor/plating/asteroid/whitesands,
/area/overmap_encounter/planetoid/cave/explored)
"Mn" = (
/obj/machinery/light/directional/east,
/obj/structure/reagent_dispensers/watertank/high,
/obj/effect/turf_decal/trimline/opaque/green/line{
	dir = 6
	},
/obj/effect/turf_decal/trimline/opaque/green/filled/corner{
	dir = 1
	},
/turf/open/floor/plasteel/dark,
/area/ruin/powered/seedvault)
"MX" = (
/obj/machinery/light/directional/north,
/obj/effect/mob_spawn/human/seed_vault,
/turf/open/floor/plasteel/freezer,
/area/ruin/powered/seedvault)
"OD" = (
/obj/machinery/light/directional/east,
/obj/machinery/hydroponics/constructable,
/obj/effect/decal/cleanable/dirt,
/obj/effect/turf_decal/trimline/opaque/green/line{
	dir = 8
	},
/obj/effect/turf_decal/trimline/opaque/green/line{
	dir = 4
	},
/turf/open/floor/mineral/plastitanium,
/area/ruin/powered/seedvault)
"OM" = (
/obj/effect/spawner/lootdrop/seed_vault,
/obj/structure/closet/crate/hydroponics,
/obj/effect/spawner/lootdrop/seed_vault,
/obj/effect/spawner/lootdrop/seed_vault,
/turf/open/floor/vault,
/area/ruin/powered/seedvault)
"Pw" = (
/obj/machinery/light/directional/north,
/obj/effect/mob_spawn/human/seed_vault,
/obj/effect/decal/cleanable/cobweb/cobweb2,
/turf/open/floor/plasteel/freezer,
/area/ruin/powered/seedvault)
"PH" = (
/obj/machinery/atmospherics/pipe/simple/supply/hidden{
	dir = 4
	},
/turf/open/floor/plasteel/freezer,
/area/ruin/powered/seedvault)
"QB" = (
/obj/machinery/light/directional/east,
/obj/structure/disposalpipe/segment{
	dir = 4
	},
/obj/machinery/hydroponics/constructable,
/obj/effect/decal/cleanable/dirt,
/obj/effect/turf_decal/trimline/opaque/green/line{
	dir = 8
	},
/obj/effect/turf_decal/trimline/opaque/green/line{
	dir = 4
	},
/turf/open/floor/mineral/plastitanium,
/area/ruin/powered/seedvault)
"QJ" = (
/obj/machinery/plantgenes/seedvault{
	pixel_y = 6
	},
/obj/structure/table/wood,
/turf/open/floor/vault,
/area/ruin/powered/seedvault)
"Sz" = (
/obj/structure/disposalpipe/trunk{
	dir = 8
	},
/obj/structure/flora/ausbushes/fullgrass,
/obj/structure/disposaloutlet,
/obj/structure/flora/ausbushes/fullgrass,
/obj/machinery/light/directional/north,
/turf/open/floor/plating/grass/whitesands,
/area/ruin/powered/seedvault)
"Tl" = (
/obj/structure/sink{
	dir = 4;
	pixel_x = -12;
	pixel_y = 2
	},
/obj/machinery/light/directional/south,
/turf/open/floor/plasteel/dark,
/area/ruin/powered/seedvault)
"Uz" = (
/obj/machinery/atmospherics/components/unary/vent_pump/on{
	dir = 1
	},
/turf/open/floor/mineral/titanium/blue,
/area/ruin/powered/seedvault)
"Vn" = (
/obj/machinery/atmospherics/components/unary/vent_pump/on,
/turf/open/floor/plasteel/freezer,
/area/ruin/powered/seedvault)
"VA" = (
/obj/machinery/light/directional/east,
/turf/open/floor/plasteel/dark,
/area/ruin/powered/seedvault)
"WA" = (
/obj/structure/closet/crate/hydroponics,
/obj/structure/beebox,
/obj/item/melee/flyswatter,
/obj/item/honey_frame,
/obj/item/honey_frame,
/obj/item/honey_frame,
/obj/item/queen_bee/bought,
/obj/item/clothing/head/beekeeper_head,
/obj/item/clothing/suit/beekeeper_suit,
/obj/machinery/light/directional/west,
/turf/open/floor/vault,
/area/ruin/powered/seedvault)
"XL" = (
/obj/effect/decal/cleanable/dirt,
/obj/effect/turf_decal/trimline/opaque/green/corner{
	dir = 8
	},
/obj/effect/turf_decal/trimline/opaque/green/line{
	dir = 5
	},
/obj/machinery/biogenerator/vault,
/turf/open/floor/mineral/plastitanium,
/area/ruin/powered/seedvault)
"Zq" = (
/obj/machinery/light/directional/east,
/obj/machinery/hydroponics/constructable,
/obj/effect/decal/cleanable/dirt,
/obj/effect/decal/cleanable/cobweb/cobweb2,
/obj/effect/turf_decal/trimline/opaque/green/line{
	dir = 8
	},
/obj/effect/turf_decal/trimline/opaque/green/line{
	dir = 4
	},
/turf/open/floor/mineral/plastitanium,
/area/ruin/powered/seedvault)

(1,1,1) = {"
aa
aa
aa
aa
aa
aa
aa
aa
aa
aa
aa
aa
aa
aa
aa
aa
aa
aa
nX
nX
"}
(2,1,1) = {"
aa
aa
aa
aa
ab
ab
aa
aa
aa
aa
aa
aa
ab
aa
aa
aa
aa
aa
aa
nX
"}
(3,1,1) = {"
aa
ac
ac
ac
ac
ac
ac
aa
aa
aa
aa
ab
ab
ab
aa
aa
aa
Mm
Mm
nX
"}
(4,1,1) = {"
aa
ac
qW
ah
ac
ca
ac
ac
ac
ac
ab
ab
ab
ab
Mm
Mm
Mm
Mm
aa
aa
"}
(5,1,1) = {"
aa
ac
MX
ah
as
PH
aQ
av
uK
aR
ab
ab
ab
ab
ab
aa
aa
aa
aa
aa
"}
(6,1,1) = {"
aa
ac
MX
Vn
Bb
qQ
ah
av
wi
aR
ab
ab
ac
ac
ac
ac
ac
aa
aa
aa
"}
(7,1,1) = {"
aa
ac
Pw
ah
ac
PH
tu
ac
ac
ac
ac
ac
ac
dc
dc
dc
ac
ac
ac
aa
"}
(8,1,1) = {"
aa
ac
ac
ac
ac
PH
ah
aS
ac
aG
ac
bh
aN
aN
aN
aN
aN
bB
ac
aa
"}
(9,1,1) = {"
ac
ac
ar
at
az
PH
ah
aT
ac
ac
ac
bb
bb
aN
aN
aN
aN
aN
ac
ac
"}
(10,1,1) = {"
ac
ad
al
al
al
PH
ah
al
Tl
ac
uL
bb
aN
bd
ba
bo
aN
aN
iM
ac
"}
(11,1,1) = {"
ac
ae
al
Vn
Bb
pW
Bb
Bb
Bb
aH
Bb
DA
Uz
aV
aW
be
aN
aN
iJ
ac
"}
(12,1,1) = {"
ac
tr
VA
al
al
PH
ah
al
BM
ac
xT
bb
aN
XL
bi
bp
aN
aN
iM
ac
"}
(13,1,1) = {"
ac
ac
ac
aw
al
PH
ah
aF
ac
ac
ac
aN
aN
aN
bz
aN
aN
aN
ac
ac
"}
(14,1,1) = {"
ac
ag
zs
al
al
PH
ah
ah
au
aA
ac
bj
aN
bb
bk
aN
bb
bC
ac
aa
"}
(15,1,1) = {"
ac
ai
al
Vn
Bb
qQ
ah
aF
ac
aA
ac
ac
ac
Zq
QB
OD
ac
ac
ac
aa
"}
(16,1,1) = {"
ac
aj
al
al
al
tK
ac
ac
ac
cn
aA
aL
ac
by
bA
ac
ac
ab
ab
aa
"}
(17,1,1) = {"
ac
ac
ao
al
al
PH
ac
aX
WA
aA
aA
QJ
ac
Sz
br
bt
ab
ab
aa
aa
"}
(18,1,1) = {"
aa
ac
ac
ax
aJ
oR
KF
sv
sv
aY
aM
ac
ac
bn
bs
bu
bx
ab
ab
nX
"}
(19,1,1) = {"
aa
aa
ac
ay
Mn
ah
ac
Kj
OM
Kj
ac
ac
aa
aa
aa
aa
ab
ab
nX
nX
"}
(20,1,1) = {"
aa
aa
ac
ac
ac
ac
ac
ac
ac
ac
ac
aa
aa
aa
aa
aa
aa
ab
nX
rf
"}
