//MAP CONVERTED BY dmm2tgm.py THIS HEADER COMMENT PREVENTS RECONVERSION, DO NOT REMOVE
"a" = (
/turf/template_noop,
/area/template_noop)
"d" = (
/obj/structure/closet/secure_closet{
	icon_state = "sec"
	},
/obj/item/gun/ballistic/automatic/pistol/commander,
/obj/item/ammo_box/magazine/co9mm,
/obj/item/ammo_box/magazine/co9mm,
/turf/open/floor/plating/asteroid/whitesands,
/area/whitesands/surface/outdoors)
"e" = (
/obj/structure/sign/poster/official/here_for_your_safety,
/turf/closed/wall/mineral/sandstone,
/area/whitesands/surface/outdoors)
"f" = (
/obj/item/banner/security/mundane,
/turf/open/floor/plating/asteroid/whitesands/dried,
/area/whitesands/surface/outdoors)
"g" = (
/obj/structure/bed,
/obj/item/bedsheet/hos,
/mob/living/simple_animal/hostile/nanotrasen{
	atmos_requirements = list("min_oxy" = 5, "max_oxy" = 0, "min_tox" = 0, "max_tox" = 0, "min_co2" = 0, "max_co2" = 999, "min_n2" = 0, "max_n2" = 0);
	name = "\improper NanoTrasen Stranded Security Officer"
	},
/turf/open/floor/plating/asteroid/whitesands/dried,
/area/whitesands/surface/outdoors)
"h" = (
/mob/living/simple_animal/hostile/nanotrasen{
	atmos_requirements = list("min_oxy" = 5, "max_oxy" = 0, "min_tox" = 0, "max_tox" = 0, "min_co2" = 0, "max_co2" = 999, "min_n2" = 0, "max_n2" = 0);
	dir = 4;
	name = "\improper NanoTrasen Stranded Security Officer"
	},
/turf/open/floor/plating/asteroid/whitesands/dried,
/area/whitesands/surface/outdoors)
"i" = (
/obj/structure/chair/wood{
	dir = 8
	},
/mob/living/simple_animal/hostile/nanotrasen{
	atmos_requirements = list("min_oxy" = 5, "max_oxy" = 0, "min_tox" = 0, "max_tox" = 0, "min_co2" = 0, "max_co2" = 999, "min_n2" = 0, "max_n2" = 0);
	dir = 8;
	name = "\improper NanoTrasen Stranded Security Officer"
	},
/turf/open/floor/plating/asteroid/whitesands/dried,
/area/whitesands/surface/outdoors)
"j" = (
/obj/item/banner/security,
/turf/open/floor/plating/asteroid/whitesands/dried,
/area/whitesands/surface/outdoors)
"k" = (
/obj/effect/mob_spawn/human/corpse/whitesands/survivor,
/obj/effect/decal/cleanable/blood,
/turf/open/floor/plating/asteroid/whitesands,
/area/whitesands/surface/outdoors)
"n" = (
/obj/structure/sign/poster/official/ion_rifle,
/turf/closed/wall/mineral/sandstone,
/area/whitesands/surface/outdoors)
"p" = (
/obj/structure/sign/poster/official/safety_report,
/turf/closed/wall/mineral/sandstone,
/area/whitesands/surface/outdoors)
"r" = (
/obj/structure/closet/cabinet,
/obj/item/clothing/head/helmet/knight/blue,
/obj/item/clothing/suit/armor/riot/knight/blue,
/obj/item/spear,
/obj/item/shield/riot/buckler,
/turf/open/floor/plating/asteroid/whitesands,
/area/whitesands/surface/outdoors)
"u" = (
/turf/open/floor/plating/asteroid/whitesands,
/area/whitesands/surface/outdoors)
"v" = (
/mob/living/simple_animal/hostile/nanotrasen/ranged{
	atmos_requirements = list("min_oxy" = 5, "max_oxy" = 0, "min_tox" = 0, "max_tox" = 0, "min_co2" = 0, "max_co2" = 999, "min_n2" = 0, "max_n2" = 0);
	dir = 8;
	name = "\improper NanoTrasen Stranded Security Officer"
	},
/turf/open/floor/plating/asteroid/whitesands/dried,
/area/whitesands/surface/outdoors)
"x" = (
/obj/structure/sign/poster/official/space_cops,
/turf/closed/wall/mineral/sandstone,
/area/whitesands/surface/outdoors)
"z" = (
/turf/open/floor/plating/asteroid/whitesands/dried,
/area/whitesands/surface/outdoors)
"E" = (
/obj/item/banner/security/mundane,
/turf/open/floor/plating/asteroid/whitesands,
/area/whitesands/surface/outdoors)
"H" = (
/obj/structure/sign/poster/official/report_crimes,
/turf/closed/wall/mineral/sandstone,
/area/whitesands/surface/outdoors)
"I" = (
/obj/structure/sign/poster/official/twelve_gauge,
/turf/closed/wall/mineral/sandstone,
/area/whitesands/surface/outdoors)
"J" = (
/obj/item/cigbutt,
/obj/item/cigbutt{
	pixel_x = 7;
	pixel_y = -5
	},
/turf/open/floor/plating/asteroid/whitesands/dried,
/area/whitesands/surface/outdoors)
"K" = (
/obj/structure/barricade/sandbags,
/turf/open/floor/plating/asteroid/whitesands/dried,
/area/whitesands/surface/outdoors)
"L" = (
/obj/structure/sign/poster/official/love_ian,
/turf/closed/wall/mineral/sandstone,
/area/whitesands/surface/outdoors)
"M" = (
/obj/structure/mineral_door/sandstone,
/turf/open/floor/plating/asteroid/whitesands/dried,
/area/whitesands/surface/outdoors)
"N" = (
/obj/structure/sign/poster/official/work_for_a_future,
/turf/closed/wall/mineral/sandstone,
/area/whitesands/surface/outdoors)
"P" = (
/obj/structure/sign/poster/official/do_not_question,
/turf/closed/wall/mineral/sandstone,
/area/whitesands/surface/outdoors)
"Q" = (
/turf/closed/mineral/random/whitesands,
/area/whitesands/surface/outdoors)
"S" = (
/obj/effect/mob_spawn/human/corpse/whitesands/survivor,
/obj/effect/decal/cleanable/blood{
	icon_state = "floor3"
	},
/turf/open/floor/plating/asteroid/whitesands,
/area/whitesands/surface/outdoors)
"T" = (
/obj/structure/table/wood,
/obj/item/reagent_containers/food/drinks/bottle/whiskey{
	pixel_x = -5;
	pixel_y = 6
	},
/obj/item/clothing/mask/gas/sechailer/swat{
	pixel_x = 7;
	pixel_y = 2
	},
/turf/open/floor/plating/asteroid/whitesands/dried,
/area/whitesands/surface/outdoors)
"U" = (
/obj/structure/table/wood,
/obj/item/holosign_creator/security,
/turf/open/floor/plating/asteroid/whitesands/dried,
/area/whitesands/surface/outdoors)
"W" = (
/obj/structure/sign/poster/official/obey,
/turf/closed/wall/mineral/sandstone,
/area/whitesands/surface/outdoors)
"X" = (
/turf/closed/wall/mineral/sandstone,
/area/whitesands/surface/outdoors)
"Y" = (
/obj/structure/sign/poster/official/nanotrasen_logo,
/turf/closed/wall/mineral/sandstone,
/area/whitesands/surface/outdoors)

(1,1,1) = {"
a
a
a
a
a
a
a
a
a
a
a
a
a
"}
(2,1,1) = {"
a
a
a
a
u
u
S
a
a
a
a
a
a
"}
(3,1,1) = {"
a
a
u
u
u
u
z
z
a
a
a
a
a
"}
(4,1,1) = {"
Q
f
u
k
u
u
E
K
Q
Q
Q
Q
Q
"}
(5,1,1) = {"
Q
Q
K
K
z
K
K
X
n
H
X
Q
Q
"}
(6,1,1) = {"
Q
Q
z
z
z
v
z
e
r
d
I
Q
Q
"}
(7,1,1) = {"
Q
U
z
z
z
z
z
X
u
z
Y
Q
Q
"}
(8,1,1) = {"
Q
i
z
z
z
z
z
M
u
z
N
X
Q
"}
(9,1,1) = {"
Q
Q
z
z
z
z
z
W
u
u
T
p
Q
"}
(10,1,1) = {"
Q
Q
J
z
z
z
h
x
j
u
g
P
Q
"}
(11,1,1) = {"
Q
Q
K
K
z
K
K
X
X
L
X
X
Q
"}
(12,1,1) = {"
Q
Q
f
u
u
u
u
E
Q
Q
Q
Q
Q
"}
(13,1,1) = {"
a
a
u
u
u
u
u
u
a
a
a
a
a
"}
(14,1,1) = {"
a
a
a
a
a
a
a
a
a
a
a
a
a
"}
(15,1,1) = {"
a
a
a
a
a
a
a
a
a
a
a
a
a
"}
(16,1,1) = {"
a
a
a
a
a
a
a
a
a
a
a
a
a
"}
