//MAP CONVERTED BY dmm2tgm.py THIS HEADER COMMENT PREVENTS RECONVERSION, DO NOT REMOVE
"a" = (
/turf/open/space/basic,
/area/space)
"b" = (
/obj/structure/platform/wood{
	dir = 4
	},
/turf/open/water/acid/whitesands,
/area/space)
"c" = (
/obj/structure/crate_shelf,
/obj/effect/turf_decal/box,
/turf/open/floor/plating/whitesands/lit,
/area/space)
"d" = (
/obj/structure/disposalpipe/segment{
	dir = 4
	},
/turf/open/space/basic,
/area/space)
"e" = (
/turf/open/floor/plating/asteroid/whitesands/grass/dead/lit,
/area/space)
"f" = (
/obj/structure/platform/wood,
/turf/open/water/acid/whitesands,
/area/space)
"g" = (
/obj/structure/platform/wood{
	dir = 6
	},
/obj/structure/railing/thin,
/turf/open/water/acid/whitesands,
/area/space)
"h" = (
/obj/structure/platform/wood/corner{
	dir = 8
	},
/turf/open/water/acid/whitesands,
/area/space)
"i" = (
/obj/machinery/computer/helm,
/obj/effect/turf_decal/techfloor/hole{
	dir = 4
	},
/turf/open/floor/plating/whitesands/lit,
/area/space)
"j" = (
/turf/open/floor/concrete/reinforced/whitesands/lit,
/area/space)
"k" = (
/obj/effect/anomaly/melter/planetary,
/turf/open/water/acid/whitesands,
/area/space)
"l" = (
/obj/structure/platform/wood{
	dir = 6
	},
/turf/open/water/acid/whitesands,
/area/space)
"m" = (
/obj/machinery/conveyor{
	id = "doohickey";
	dir = 8
	},
/turf/open/space/basic,
/area/space)
"n" = (
/turf/open/floor/concrete/pavement/whitesands/lit,
/area/space)
"o" = (
/obj/machinery/conveyor{
	id = "doohickey";
	dir = 4
	},
/obj/structure/railing/thin,
/turf/open/space/basic,
/area/space)
"p" = (
/obj/effect/anomaly/flux/big/planetary,
/turf/open/floor/plating/asteroid/whitesands/grass/dead/lit,
/area/space)
"q" = (
/obj/machinery/disposal/deliveryChute{
	dir = 4
	},
/obj/structure/disposalpipe/trunk{
	dir = 8
	},
/turf/open/space/basic,
/area/space)
"r" = (
/turf/open/water/acid/whitesands,
/area/space)
"s" = (
/obj/structure/railing/thin{
	dir = 10
	},
/turf/open/space/basic,
/area/space)
"t" = (
/turf/open/floor/plating/whitesands/lit,
/area/space)
"u" = (
/obj/structure/platform/wood{
	dir = 5
	},
/turf/open/water/acid/whitesands,
/area/space)
"v" = (
/obj/machinery/power/tesla_coil/power,
/turf/open/floor/plating/whitesands/lit,
/area/space)
"w" = (
/obj/structure/railing/thin{
	dir = 8
	},
/turf/open/space/basic,
/area/space)
"x" = (
/obj/machinery/conveyor{
	id = "doohickey";
	dir = 6
	},
/obj/structure/railing/thin{
	dir = 4
	},
/turf/open/space/basic,
/area/space)
"y" = (
/turf/closed/wall/concrete,
/area/space)
"z" = (
/turf/open/floor/concrete/slab_1/whitesands/lit,
/area/space)
"A" = (
/turf/open/floor/plasteel/dark,
/area/space)
"B" = (
/turf/open/floor/plasteel,
/area/space)
"C" = (
/obj/machinery/conveyor{
	id = "doohickey";
	dir = 10
	},
/obj/structure/railing/thin{
	dir = 4
	},
/turf/open/space/basic,
/area/space)
"D" = (
/turf/closed/wall/mineral/titanium/survival,
/area/space)
"E" = (
/obj/structure/platform/wood{
	dir = 6
	},
/obj/structure/railing/thin{
	dir = 6
	},
/turf/open/water/acid/whitesands,
/area/space)
"F" = (
/obj/structure/railing/thin,
/turf/open/space/basic,
/area/space)
"G" = (
/obj/structure/disposalpipe/trunk{
	dir = 4
	},
/obj/structure/disposaloutlet{
	dir = 8;
	eject_range = 7;
	name = "trash cannon"
	},
/obj/structure/railing/thin{
	dir = 8
	},
/turf/open/space/basic,
/area/space)
"H" = (
/obj/structure/barricade/sandbags,
/turf/open/floor/concrete/whitesands/lit,
/area/space)
"J" = (
/turf/open/floor/concrete/whitesands/lit,
/area/space)
"K" = (
/obj/structure/chair/handrail{
	dir = 4
	},
/obj/effect/turf_decal/industrial/warning{
	dir = 6
	},
/turf/open/floor/plating/whitesands/lit,
/area/space)
"L" = (
/obj/structure/chair/handrail{
	dir = 4
	},
/obj/effect/turf_decal/industrial/warning{
	dir = 5
	},
/turf/open/floor/plating/whitesands/lit,
/area/space)
"M" = (
/obj/structure/platform/wood{
	dir = 4
	},
/obj/structure/railing/thin{
	dir = 4
	},
/turf/open/water/acid/whitesands,
/area/space)
"N" = (
/turf/open/floor/plating/asteroid/whitesands/grass/lit,
/area/space)
"O" = (
/obj/machinery/power/grounding_rod,
/turf/open/floor/plating/whitesands/lit,
/area/space)
"P" = (
/obj/machinery/power/smes/shuttle{
	dir = 1
	},
/turf/open/floor/plating/whitesands/lit,
/area/space)
"Q" = (
/obj/machinery/power/terminal,
/obj/structure/chair/comfy/shuttle{
	dir = 1
	},
/obj/effect/turf_decal/techfloor{
	dir = 8
	},
/obj/effect/turf_decal/techfloor{
	dir = 4
	},
/obj/effect/turf_decal/techfloor/orange{
	dir = 8
	},
/turf/open/floor/plating/whitesands/lit,
/area/space)
"R" = (
/turf/closed/mineral/random/whitesands,
/area/space)
"S" = (
/obj/structure/platform/wood/corner,
/obj/structure/railing/thin/corner,
/turf/open/water/acid/whitesands,
/area/space)
"T" = (
/turf/closed/wall/concrete/reinforced,
/area/space)
"U" = (
/turf/open/floor/plating/asteroid/whitesands/lit,
/area/space)
"V" = (
/obj/structure/barricade/sandbags,
/turf/open/space/basic,
/area/space)
"W" = (
/obj/structure/railing/thin/corner{
	dir = 8
	},
/turf/open/space/basic,
/area/space)
"X" = (
/obj/machinery/power/shuttle/engine/electric{
	dir = 1
	},
/turf/open/floor/plating/whitesands/lit,
/area/space)
"Y" = (
/turf/open/floor/plating,
/area/space)
"Z" = (
/turf/open/floor/plating/asteroid/whitesands/dried/lit,
/area/space)

(1,1,1) = {"
U
Z
e
N
a
a
a
U
U
U
U
U
U
U
U
U
U
U
U
U
U
U
R
R
a
a
a
a
a
a
a
a
a
a
a
a
a
a
U
U
U
a
a
a
a
a
a
a
a
a
"}
(2,1,1) = {"
y
J
j
a
a
a
U
U
U
r
r
r
r
U
U
r
r
r
r
r
U
U
U
R
R
R
a
a
a
a
a
a
a
a
U
U
a
U
U
U
n
U
U
a
a
a
a
a
a
a
"}
(3,1,1) = {"
T
z
n
a
a
U
U
U
r
r
r
r
r
r
r
r
r
r
r
r
r
r
R
R
R
R
R
R
a
a
a
a
a
U
U
U
U
U
n
U
n
U
U
U
a
a
a
a
a
a
"}
(4,1,1) = {"
R
a
a
a
a
U
U
r
r
r
r
r
r
r
r
r
r
r
r
r
r
r
R
R
R
R
R
R
R
R
R
R
a
U
U
U
U
U
U
n
n
U
U
U
U
a
a
a
a
a
"}
(5,1,1) = {"
a
a
a
R
R
R
U
r
r
r
r
k
r
r
r
r
r
r
k
r
r
r
r
f
R
R
R
R
R
R
R
R
R
R
U
U
U
U
n
n
n
U
U
U
U
a
a
a
a
a
"}
(6,1,1) = {"
a
a
R
R
R
R
R
r
r
r
r
r
r
r
r
r
r
r
r
r
r
r
S
E
e
e
R
R
R
R
R
R
R
R
R
Z
Z
Z
n
n
n
Z
U
U
U
a
a
a
a
a
"}
(7,1,1) = {"
a
a
R
R
R
R
R
r
r
r
r
r
r
r
r
r
r
r
r
r
S
M
E
U
e
e
e
N
N
N
R
R
R
R
R
R
Z
Z
n
n
n
Z
Z
Z
U
a
a
a
a
a
"}
(8,1,1) = {"
a
R
R
R
R
R
R
b
b
h
r
r
r
r
b
b
b
b
b
b
g
U
U
U
Z
Z
e
e
N
N
N
R
R
R
R
R
Z
Z
n
n
n
Z
Z
Z
R
R
R
a
a
a
"}
(9,1,1) = {"
a
R
R
R
R
R
R
w
s
u
b
b
b
l
y
Y
Y
Y
D
D
D
a
D
Y
Y
D
D
e
N
N
N
R
R
R
R
R
H
H
n
n
n
H
H
R
R
R
R
R
a
a
"}
(10,1,1) = {"
a
R
R
R
R
R
a
a
W
w
D
G
w
y
y
B
B
B
B
B
D
D
D
B
B
B
y
y
N
N
N
N
R
R
R
R
J
H
n
n
n
H
J
R
R
R
R
R
R
a
"}
(11,1,1) = {"
a
R
R
R
R
N
N
N
a
a
F
d
a
y
B
B
B
B
B
B
B
D
B
B
B
B
B
y
a
N
N
R
R
R
R
R
J
J
n
n
n
e
e
e
R
R
R
R
R
a
"}
(12,1,1) = {"
a
R
R
R
R
N
N
N
a
a
o
q
a
y
B
B
B
B
B
B
B
Y
B
B
B
B
B
y
a
a
a
R
R
R
Z
Z
Z
N
n
n
n
e
e
e
R
R
R
R
a
a
"}
(13,1,1) = {"
a
R
R
R
R
N
N
N
a
a
o
m
a
y
B
B
B
B
B
B
B
D
B
B
B
B
B
y
a
a
a
R
R
R
N
N
N
N
n
n
n
Z
e
e
e
e
R
R
a
a
"}
(14,1,1) = {"
a
a
R
R
R
N
N
N
a
a
x
C
a
D
B
B
B
B
B
B
D
y
y
B
B
B
D
y
a
a
R
R
R
R
N
N
N
N
n
n
n
Z
Z
e
e
J
J
H
a
a
"}
(15,1,1) = {"
a
a
a
R
R
R
a
a
a
a
a
a
a
D
B
B
B
B
B
B
D
a
y
y
Y
Y
D
a
a
a
a
R
R
N
N
N
N
N
n
n
n
Z
Z
Z
Z
J
H
H
a
a
"}
(16,1,1) = {"
a
a
R
R
R
R
R
a
a
a
a
a
a
Y
Y
Y
D
D
Y
Y
Y
a
a
D
B
B
D
a
a
U
U
U
N
N
N
N
N
U
n
n
n
n
n
n
n
n
n
n
n
a
"}
(17,1,1) = {"
a
a
a
R
R
R
R
a
a
a
a
a
a
a
a
a
a
a
a
a
a
a
a
D
Y
Y
D
a
a
U
U
U
U
N
N
N
U
U
n
n
n
n
n
n
n
n
n
n
a
a
"}
(18,1,1) = {"
a
a
a
R
R
R
R
R
a
a
a
a
a
a
a
a
a
a
a
a
a
a
a
a
n
n
a
a
a
a
a
a
U
U
N
N
U
n
n
n
n
n
n
n
n
n
n
a
a
n
"}
(19,1,1) = {"
a
a
a
a
R
R
R
R
a
a
a
a
a
a
a
a
a
a
a
a
a
a
a
a
n
n
a
a
a
n
n
n
n
n
n
n
n
n
n
n
n
Z
Z
Z
Z
H
H
a
a
a
"}
(20,1,1) = {"
a
a
a
a
R
R
R
a
a
a
a
a
a
a
a
a
a
a
a
a
a
a
a
a
n
n
n
n
n
n
n
n
n
n
n
n
n
n
n
n
N
N
N
N
Z
J
H
a
a
a
"}
(21,1,1) = {"
a
a
a
a
R
a
a
a
a
a
a
a
a
a
a
a
a
a
a
a
a
a
a
n
n
n
n
n
n
n
n
n
n
n
n
n
n
n
n
N
N
N
N
N
Z
R
R
a
a
a
"}
(22,1,1) = {"
a
a
a
a
V
a
a
a
a
a
a
a
a
a
a
a
a
a
a
a
a
a
n
n
n
n
n
n
n
n
n
n
a
a
a
a
U
U
N
N
N
N
N
N
R
R
R
a
a
a
"}
(23,1,1) = {"
a
a
a
a
V
a
a
a
a
a
a
a
a
a
a
a
a
a
a
a
a
n
n
n
n
n
a
a
a
a
a
a
a
a
a
a
U
U
U
U
N
N
R
R
R
R
R
a
a
a
"}
(24,1,1) = {"
a
a
a
a
V
V
a
a
a
a
a
a
a
a
a
a
a
a
a
a
n
n
n
n
n
a
a
a
a
a
a
a
a
a
a
a
U
U
U
U
U
N
R
R
a
a
R
R
a
a
"}
(25,1,1) = {"
a
n
a
n
n
n
n
n
n
n
n
n
n
n
n
n
n
n
n
n
n
n
n
n
a
a
a
a
a
a
a
a
a
a
a
a
U
U
U
U
U
U
R
a
a
a
a
R
a
a
"}
(26,1,1) = {"
a
a
n
a
n
n
n
n
n
n
n
n
n
n
n
n
n
n
n
n
n
n
n
a
a
i
Q
P
X
a
a
a
a
a
a
a
a
U
U
U
a
a
R
a
a
a
a
R
R
a
"}
(27,1,1) = {"
a
a
a
a
n
n
n
n
n
n
n
n
n
n
n
n
n
n
n
n
n
n
n
a
a
L
K
c
c
a
a
i
Q
P
X
a
a
a
a
a
a
a
R
R
a
a
R
R
a
a
"}
(28,1,1) = {"
a
a
a
V
V
a
a
a
a
a
a
a
a
a
a
a
a
a
a
a
n
n
n
a
a
a
a
a
a
a
a
L
K
c
c
a
a
a
a
a
a
a
R
R
R
R
R
a
a
a
"}
(29,1,1) = {"
a
a
a
V
a
a
a
a
a
a
a
a
a
a
a
a
a
a
a
a
n
n
n
a
a
a
a
a
a
a
a
a
a
a
a
a
a
a
a
a
a
a
a
R
R
R
R
a
a
a
"}
(30,1,1) = {"
a
a
a
V
a
a
R
a
a
a
a
a
a
a
a
a
a
a
a
a
n
n
n
a
a
a
a
a
a
a
a
a
a
a
a
a
a
a
a
a
a
a
a
R
R
a
R
a
a
a
"}
(31,1,1) = {"
a
a
a
V
a
R
R
a
a
a
a
a
a
a
a
a
a
a
a
a
n
n
n
a
a
a
a
i
Q
P
X
a
a
a
a
a
a
a
a
a
a
a
a
R
a
a
R
R
a
a
"}
(32,1,1) = {"
a
a
a
R
R
R
R
a
a
a
a
a
a
a
a
a
a
a
a
a
n
n
n
a
a
a
a
L
K
c
c
a
a
a
a
i
Q
P
X
a
a
a
R
R
a
a
a
R
a
a
"}
(33,1,1) = {"
a
a
a
R
R
R
a
a
a
a
a
a
a
a
a
a
a
a
a
a
n
n
n
a
a
a
a
a
a
a
a
a
a
a
a
L
K
c
c
a
a
R
R
R
a
R
R
R
a
a
"}
(34,1,1) = {"
a
a
a
R
R
a
a
a
a
a
a
a
a
a
a
a
a
a
a
a
n
n
n
n
a
a
a
a
a
a
a
a
a
a
a
a
a
a
a
a
a
R
R
R
R
R
R
R
a
a
"}
(35,1,1) = {"
a
a
R
R
R
a
a
a
a
a
a
a
a
a
a
a
a
a
a
a
n
n
n
n
a
a
a
a
a
a
a
a
a
a
a
a
a
a
a
R
R
R
R
R
R
R
a
a
a
a
"}
(36,1,1) = {"
a
a
R
R
R
a
a
a
a
a
a
a
a
a
a
a
a
a
a
a
a
n
n
n
a
y
y
Y
Y
Y
y
y
y
y
y
a
a
a
a
R
R
a
a
R
R
R
R
a
a
a
"}
(37,1,1) = {"
a
a
R
R
R
a
a
a
a
a
a
z
z
z
a
a
a
a
a
a
a
n
n
n
a
y
A
A
A
A
A
A
A
A
y
a
a
a
a
R
a
a
a
a
R
R
R
a
a
a
"}
(38,1,1) = {"
a
a
R
R
R
a
a
a
a
z
z
z
z
z
z
z
a
a
a
a
a
n
n
n
a
y
A
A
A
A
A
A
A
A
y
y
y
y
R
R
a
a
a
R
R
R
a
a
a
a
"}
(39,1,1) = {"
a
a
R
R
R
a
a
D
a
z
z
z
z
z
z
z
a
D
a
a
a
n
n
n
a
Y
A
A
A
A
A
A
A
A
y
a
a
y
R
R
R
R
R
R
R
R
a
a
a
a
"}
(40,1,1) = {"
a
R
R
R
Z
a
a
D
Z
Z
t
z
z
z
t
Z
Z
D
a
a
a
n
n
n
a
Y
A
A
A
A
A
A
A
A
Y
a
a
y
R
R
R
R
R
a
a
a
a
a
a
a
"}
(41,1,1) = {"
a
R
R
R
Z
Z
a
D
Z
Z
t
z
z
z
t
Z
Z
D
a
a
a
n
n
n
a
Y
A
A
A
A
A
A
A
A
y
a
a
y
R
R
R
R
R
a
a
a
a
a
a
a
"}
(42,1,1) = {"
a
a
R
R
Z
Z
D
D
Z
Z
t
e
e
e
t
Z
Z
D
D
a
a
n
n
n
a
D
A
A
A
A
A
D
y
a
y
y
y
y
R
R
R
a
a
a
a
a
a
a
a
a
"}
(43,1,1) = {"
a
a
R
R
Z
Z
D
Z
Z
O
v
e
p
e
v
O
Z
Z
D
a
a
n
n
n
a
D
D
D
A
A
A
D
A
A
y
R
R
R
R
R
a
a
a
a
a
a
a
a
a
a
"}
(44,1,1) = {"
a
a
R
R
Z
Z
D
Z
Z
Z
t
e
e
e
t
Z
Z
Z
D
a
n
n
n
n
n
Y
a
Y
A
A
A
D
A
A
y
R
a
a
R
R
a
a
a
a
a
a
a
a
a
a
"}
(45,1,1) = {"
a
a
R
R
Z
Z
D
D
D
D
t
v
v
v
t
D
D
D
D
a
n
n
n
n
n
Y
a
Y
A
A
A
D
y
y
y
R
R
a
R
a
a
a
a
a
a
a
a
a
a
a
"}
(46,1,1) = {"
a
a
R
R
R
Z
Z
Z
Z
D
Z
O
O
O
Z
D
Z
Z
Z
Z
n
n
n
n
U
D
D
D
D
Y
D
D
a
R
R
R
R
R
R
a
a
a
a
a
a
a
a
a
a
a
"}
(47,1,1) = {"
a
R
R
R
R
R
Z
Z
Z
D
D
D
D
D
D
D
Z
Z
Z
Z
n
n
n
U
U
U
D
A
A
A
A
D
R
R
R
a
R
a
a
a
a
a
a
a
a
a
a
a
a
a
"}
(48,1,1) = {"
a
R
R
R
R
R
R
Z
Z
Z
Z
Z
Z
Z
Z
Z
Z
Z
Z
Z
n
n
n
U
U
U
Y
A
A
A
A
D
R
R
a
a
R
a
a
a
a
a
a
a
a
a
a
a
a
a
"}
(49,1,1) = {"
a
R
R
R
R
R
R
R
Z
N
N
N
Z
Z
Z
Z
N
N
Z
Z
n
n
n
U
U
U
Y
A
A
A
A
D
R
R
R
R
R
a
a
a
a
a
a
a
a
a
a
a
a
a
"}
(50,1,1) = {"
a
R
R
R
R
R
R
R
R
N
N
N
N
N
N
N
N
Z
U
U
n
n
n
U
U
U
Y
A
A
A
A
D
R
R
R
R
R
a
a
a
a
a
a
a
a
a
a
a
a
a
"}
(51,1,1) = {"
a
a
a
R
R
R
R
R
R
N
N
N
N
N
N
N
N
N
U
U
n
n
n
U
U
U
D
A
A
A
A
y
R
R
R
R
R
R
a
a
a
a
a
a
a
a
a
a
a
a
"}
(52,1,1) = {"
a
a
a
a
R
R
R
R
R
N
N
N
N
N
a
R
N
N
J
J
n
n
n
J
J
U
D
D
y
y
y
y
R
R
R
R
R
R
a
a
a
a
a
a
a
a
a
a
a
a
"}
(53,1,1) = {"
a
a
a
a
a
a
R
R
R
R
N
N
N
a
a
R
R
J
J
H
n
n
n
H
J
J
R
R
R
R
R
R
R
R
a
a
R
R
a
a
a
a
a
a
a
a
a
a
a
a
"}
(54,1,1) = {"
a
a
a
a
a
a
a
a
R
R
V
a
a
a
R
R
R
H
H
H
n
n
n
H
H
H
R
R
R
a
R
R
R
R
a
a
a
a
a
a
a
a
a
a
a
a
a
a
a
a
"}
(55,1,1) = {"
a
a
a
a
a
a
a
a
a
a
V
a
a
V
R
a
R
a
a
a
n
n
n
a
a
a
a
a
a
a
R
R
a
a
a
a
a
a
a
a
a
a
a
a
a
a
a
a
a
a
"}
(56,1,1) = {"
a
a
a
a
a
a
a
a
a
a
V
V
V
V
a
a
a
a
a
a
n
n
n
a
a
a
a
a
a
a
a
R
a
a
a
a
a
a
a
a
a
a
a
a
a
a
a
a
a
a
"}
(57,1,1) = {"
a
a
a
a
a
a
a
a
a
a
a
a
a
a
a
a
a
a
a
a
n
n
n
a
a
a
a
a
a
a
a
a
a
a
a
a
a
a
a
a
a
a
a
a
a
a
a
a
a
a
"}
(58,1,1) = {"
a
a
a
a
a
a
a
a
a
a
a
a
a
a
a
a
a
a
a
a
a
n
n
a
a
a
a
a
a
a
a
a
a
a
a
a
a
a
a
a
a
a
a
a
a
a
a
a
a
a
"}
(59,1,1) = {"
a
a
a
a
a
a
a
a
a
a
a
a
a
a
a
a
a
a
a
a
n
a
a
a
a
a
a
a
a
a
a
a
a
a
a
a
a
a
a
a
a
a
a
a
a
a
a
a
a
a
"}
(60,1,1) = {"
a
a
a
a
a
a
a
a
a
a
a
a
a
a
a
a
a
a
a
a
a
a
n
a
a
a
a
a
a
a
a
a
a
a
a
a
a
a
a
a
a
a
a
a
a
a
a
a
a
a
"}
