//MAP CONVERTED BY dmm2tgm.py THIS HEADER COMMENT PREVENTS RECONVERSION, DO NOT REMOVE
"at" = (
/obj/item/mining_scanner,
/turf/open/floor/plating{
	icon_state = "platingdmg1"
	},
/area/whitesands/surface/outdoors/unexplored)
"aZ" = (
/turf/closed/wall/mineral/titanium/nodiagonal,
/area/whitesands/surface/outdoors/unexplored)
"bb" = (
/obj/item/shard{
	icon_state = "small"
	},
/obj/effect/decal/cleanable/dirt,
/turf/open/floor/plating{
	icon_state = "platingdmg1"
	},
/area/whitesands/surface/outdoors/unexplored)
"bW" = (
/obj/structure/shuttle/engine/heater{
	dir = 1
	},
/obj/structure/window/reinforced,
/turf/open/floor/plating,
/area/whitesands/surface/outdoors/unexplored)
"cj" = (
/obj/effect/mob_spawn/human/corpse{
	mob_species = /datum/species/golem
	},
/obj/effect/decal/cleanable/dirt,
/obj/effect/decal/cleanable/blood/old,
/turf/open/floor/mineral/titanium/white,
/area/whitesands/surface/outdoors/unexplored)
"cs" = (
/obj/effect/turf_decal/tile/neutral{
	dir = 8
	},
/obj/effect/turf_decal/trimline/white/line{
	dir = 5
	},
/obj/effect/decal/cleanable/dirt,
/turf/open/floor/plasteel/dark,
/area/whitesands/surface/outdoors/unexplored)
"cB" = (
/obj/effect/turf_decal/trimline/white/corner{
	dir = 4
	},
/obj/effect/turf_decal/tile/neutral{
	dir = 8
	},
/obj/effect/turf_decal/tile/neutral,
/obj/machinery/mecha_part_fabricator/maint,
/turf/open/floor/plasteel/dark,
/area/whitesands/surface/outdoors/unexplored)
"cW" = (
/obj/structure/door_assembly/door_assembly_min,
/turf/open/floor/plating,
/area/whitesands/surface/outdoors/unexplored)
"dz" = (
/obj/structure/rack,
/obj/item/pickaxe,
/turf/open/floor/mineral/plastitanium,
/area/whitesands/surface/outdoors/unexplored)
"eM" = (
/obj/item/pickaxe{
	pixel_x = 3;
	pixel_y = -3
	},
/obj/item/card/id/mining,
/obj/effect/decal/cleanable/dirt,
/turf/open/floor/mineral/titanium/yellow,
/area/whitesands/surface/outdoors/unexplored)
"fb" = (
/obj/item/crowbar,
/turf/open/floor/plating{
	icon_state = "platingdmg1"
	},
/area/whitesands/surface/outdoors/unexplored)
"fo" = (
/obj/effect/decal/cleanable/dirt,
/obj/effect/decal/cleanable/blood/old,
/turf/open/floor/mineral/titanium/purple,
/area/whitesands/surface/outdoors/unexplored)
"ha" = (
/obj/item/rack_parts,
/turf/open/floor/mineral/plastitanium,
/area/whitesands/surface/outdoors/unexplored)
"hh" = (
/turf/open/floor/plating{
	icon_state = "panelscorched"
	},
/area/whitesands/surface/outdoors/unexplored)
"hi" = (
/obj/item/resonator,
/obj/effect/decal/cleanable/blood/old,
/turf/open/floor/plating{
	icon_state = "platingdmg1"
	},
/area/whitesands/surface/outdoors/unexplored)
"ht" = (
/obj/structure/girder/displaced,
/turf/open/floor/plating{
	icon_state = "panelscorched"
	},
/area/whitesands/surface/outdoors/unexplored)
"hJ" = (
/obj/item/shard{
	icon_state = "medium"
	},
/turf/open/floor/plating/asteroid/whitesands,
/area/whitesands/surface/outdoors/unexplored)
"hM" = (
/obj/item/storage/box,
/obj/item/light/bulb/broken,
/obj/item/light/tube/broken,
/obj/effect/decal/cleanable/dirt,
/turf/open/floor/plasteel,
/area/whitesands/surface/outdoors/unexplored)
"iE" = (
/obj/structure/AIcore/deactivated,
/turf/open/floor/mineral/titanium/white,
/area/whitesands/surface/outdoors/unexplored)
"jp" = (
/obj/effect/turf_decal/tile/neutral,
/obj/effect/turf_decal/tile/neutral{
	dir = 4
	},
/obj/effect/turf_decal/trimline/white/line{
	dir = 8
	},
/obj/structure/table,
/obj/item/storage/firstaid/brute,
/turf/open/floor/plasteel/dark,
/area/whitesands/surface/outdoors/unexplored)
"jw" = (
/obj/item/bedsheet/rd/royal_cape,
/obj/item/toy/figure/rd{
	name = "the Liberator action figure";
	pixel_x = 7;
	pixel_y = -5;
	toysay = "Yeah, go do whatever."
	},
/obj/effect/decal/cleanable/blood/old,
/turf/open/floor/plating,
/area/whitesands/surface/outdoors/unexplored)
"jy" = (
/obj/effect/turf_decal/tile/neutral,
/obj/effect/turf_decal/trimline/purple/line{
	dir = 8
	},
/obj/effect/turf_decal/tile/neutral{
	dir = 4
	},
/obj/effect/turf_decal/tile/neutral,
/obj/effect/decal/cleanable/dirt,
/turf/open/floor/plasteel/dark,
/area/whitesands/surface/outdoors/unexplored)
"jO" = (
/obj/item/storage/part_replacer/bluespace/tier2,
/turf/open/floor/mineral/titanium/white,
/area/whitesands/surface/outdoors/unexplored)
"kJ" = (
/obj/item/stack/sheet/mineral/wood,
/obj/item/stack/sheet/mineral/wood,
/obj/item/stack/sheet/mineral/wood,
/obj/item/stack/sheet/mineral/wood,
/obj/item/mining_scanner{
	pixel_x = -7;
	pixel_y = 5
	},
/turf/open/floor/mineral/plastitanium,
/area/whitesands/surface/outdoors/unexplored)
"kT" = (
/obj/structure/girder/displaced,
/turf/open/floor/plating{
	icon_state = "platingdmg1"
	},
/area/whitesands/surface/outdoors/unexplored)
"mO" = (
/obj/structure/window/reinforced,
/obj/structure/shuttle/engine/heater{
	dir = 1
	},
/turf/open/floor/plating,
/area/whitesands/surface/outdoors/unexplored)
"mS" = (
/obj/item/shard{
	icon_state = "tiny"
	},
/turf/open/floor/plating,
/area/whitesands/surface/outdoors/unexplored)
"nL" = (
/obj/item/light/bulb/broken{
	pixel_x = 8;
	pixel_y = 8
	},
/obj/item/light/tube/broken{
	pixel_x = -10;
	pixel_y = 6
	},
/obj/effect/decal/cleanable/oil,
/obj/effect/decal/cleanable/dirt,
/obj/effect/decal/cleanable/blood/old,
/turf/open/floor/plasteel,
/area/whitesands/surface/outdoors/unexplored)
"nX" = (
/obj/machinery/door/airlock/titanium,
/turf/open/floor/plating,
/area/whitesands/surface/outdoors/unexplored)
"nZ" = (
/obj/item/storage/bag/ore,
/obj/effect/turf_decal/bot,
/obj/effect/turf_decal/trimline/yellow/line{
	dir = 8
	},
/obj/effect/turf_decal/tile/neutral{
	dir = 4
	},
/obj/effect/turf_decal/tile/neutral,
/obj/item/rack_parts,
/obj/item/resonator{
	pixel_x = -6;
	pixel_y = -6
	},
/turf/open/floor/mineral/plastitanium,
/area/whitesands/surface/outdoors/unexplored)
"oP" = (
/obj/item/toy/plush/lizardplushie{
	desc = "Awww! It looks like it will snuggle all of your internal organs!";
	name = "ashwalker plushie"
	},
/obj/effect/mob_spawn/human/corpse{
	mob_species = /datum/species/lizard/ashwalker
	},
/obj/effect/decal/cleanable/dirt,
/obj/effect/decal/cleanable/blood/old,
/turf/open/floor/mineral/titanium/white,
/area/whitesands/surface/outdoors/unexplored)
"pb" = (
/turf/open/floor/plating{
	icon_state = "platingdmg1"
	},
/area/whitesands/surface/outdoors/unexplored)
"pC" = (
/turf/open/floor/plasteel/dark,
/area/whitesands/surface/outdoors/unexplored)
"pQ" = (
/obj/effect/decal/cleanable/dirt,
/turf/open/floor/plating{
	icon_state = "platingdmg1"
	},
/area/whitesands/surface/outdoors/unexplored)
"qU" = (
/obj/structure/table,
/turf/open/floor/plating{
	icon_state = "panelscorched"
	},
/area/whitesands/surface/outdoors/unexplored)
"qY" = (
/obj/structure/door_assembly/door_assembly_com,
/turf/open/floor/plating{
	icon_state = "platingdmg1"
	},
/area/whitesands/surface/outdoors/unexplored)
"rm" = (
/obj/structure/girder,
/turf/open/floor/plating{
	icon_state = "platingdmg1"
	},
/area/whitesands/surface/outdoors/unexplored)
"rC" = (
/obj/effect/turf_decal/tile/neutral,
/obj/effect/turf_decal/tile/neutral{
	dir = 8
	},
/obj/effect/turf_decal/trimline/white/corner{
	dir = 1
	},
/obj/structure/table,
/obj/item/areaeditor/blueprints{
	desc = "Use to build new structures in the wastes.";
	name = "land claim"
	},
/obj/effect/decal/cleanable/blood/old,
/turf/open/floor/plasteel/dark,
/area/whitesands/surface/outdoors/unexplored)
"sb" = (
/obj/structure/frame/machine,
/obj/effect/decal/cleanable/dirt,
/turf/open/floor/plasteel/dark,
/area/whitesands/surface/outdoors/unexplored)
"sh" = (
/obj/machinery/door/airlock/titanium,
/turf/open/floor/plating/asteroid/whitesands,
/area/whitesands/surface/outdoors/unexplored)
"sm" = (
/obj/structure/frame/machine,
/turf/open/floor/plating,
/area/whitesands/surface/outdoors/unexplored)
"sF" = (
/obj/item/rack_parts,
/obj/item/storage/bag/ore,
/turf/open/floor/plating,
/area/whitesands/surface/outdoors/unexplored)
"sO" = (
/obj/item/storage/box,
/obj/structure/table,
/obj/item/light/bulb/broken,
/obj/item/light/tube/broken{
	pixel_x = -1;
	pixel_y = 5
	},
/obj/item/shard,
/obj/effect/mob_spawn/human/corpse{
	mob_species = /datum/species/lizard/ashwalker
	},
/obj/effect/decal/cleanable/blood/old,
/turf/open/floor/plasteel/dark,
/area/whitesands/surface/outdoors/unexplored)
"tg" = (
/obj/item/light/bulb/broken{
	pixel_x = -3;
	pixel_y = -9
	},
/obj/item/shard{
	icon_state = "medium"
	},
/obj/effect/decal/cleanable/oil,
/obj/effect/decal/cleanable/dirt,
/turf/open/floor/plasteel,
/area/whitesands/surface/outdoors/unexplored)
"tv" = (
/obj/item/light/bulb/broken{
	pixel_x = -4;
	pixel_y = -4
	},
/obj/effect/decal/cleanable/dirt,
/turf/open/floor/plasteel,
/area/whitesands/surface/outdoors/unexplored)
"tw" = (
/obj/item/mining_scanner{
	pixel_y = 7
	},
/obj/effect/decal/cleanable/dirt,
/turf/open/floor/mineral/titanium/yellow,
/area/whitesands/surface/outdoors/unexplored)
"tH" = (
/obj/item/pickaxe{
	pixel_x = -6;
	pixel_y = 17
	},
/obj/item/mining_scanner,
/turf/open/floor/plating{
	icon_state = "panelscorched"
	},
/area/whitesands/surface/outdoors/unexplored)
"uY" = (
/obj/structure/reagent_dispensers/watertank,
/turf/open/floor/plating,
/area/whitesands/surface/outdoors/unexplored)
"vc" = (
/obj/item/pickaxe,
/obj/effect/decal/cleanable/dirt,
/obj/effect/decal/cleanable/blood/old,
/turf/open/floor/mineral/titanium/white,
/area/whitesands/surface/outdoors/unexplored)
"vd" = (
/obj/item/rack_parts,
/turf/open/floor/plating/asteroid/whitesands,
/area/whitesands/surface/outdoors/unexplored)
"vD" = (
/obj/item/shard{
	icon_state = "tiny"
	},
/obj/item/shard{
	icon_state = "medium"
	},
/obj/effect/decal/cleanable/dirt,
/turf/open/floor/plating{
	icon_state = "platingdmg1"
	},
/area/whitesands/surface/outdoors/unexplored)
"vI" = (
/obj/structure/rack,
/obj/effect/turf_decal/trimline/yellow/line{
	dir = 8
	},
/obj/effect/turf_decal/tile/neutral{
	dir = 4
	},
/obj/effect/turf_decal/tile/neutral,
/obj/effect/turf_decal/bot,
/obj/item/clothing/head/hardhat/mining{
	pixel_x = -6;
	pixel_y = -6
	},
/obj/item/clothing/head/hardhat/mining{
	pixel_x = -2;
	pixel_y = -2
	},
/obj/item/clothing/head/hardhat/mining{
	pixel_x = 6;
	pixel_y = 6
	},
/turf/open/floor/mineral/plastitanium,
/area/whitesands/surface/outdoors/unexplored)
"wd" = (
/obj/effect/turf_decal/trimline/purple/line{
	dir = 5
	},
/obj/effect/turf_decal/trimline/purple/corner{
	dir = 8
	},
/obj/item/shard{
	icon_state = "tiny"
	},
/obj/item/shard{
	icon_state = "small"
	},
/obj/effect/mob_spawn/human/corpse{
	mob_species = /datum/species/golem
	},
/turf/open/floor/plasteel/dark,
/area/whitesands/surface/outdoors/unexplored)
"wl" = (
/obj/machinery/washing_machine,
/turf/open/floor/plating{
	icon_state = "platingdmg1"
	},
/area/whitesands/surface/outdoors/unexplored)
"ww" = (
/obj/effect/decal/cleanable/blood/old,
/turf/open/floor/plating{
	icon_state = "platingdmg1"
	},
/area/whitesands/surface/outdoors/unexplored)
"wH" = (
/obj/structure/girder,
/turf/open/floor/plating,
/area/whitesands/surface/outdoors/unexplored)
"xA" = (
/obj/item/storage/box/rndboards,
/obj/effect/decal/cleanable/dirt,
/obj/effect/decal/cleanable/blood/old,
/turf/open/floor/mineral/titanium/white,
/area/whitesands/surface/outdoors/unexplored)
"xJ" = (
/obj/structure/shuttle/engine/propulsion{
	dir = 1
	},
/turf/open/floor/plating,
/area/whitesands/surface/outdoors/unexplored)
"xX" = (
/obj/effect/turf_decal/bot,
/obj/effect/turf_decal/tile/neutral,
/obj/effect/turf_decal/trimline/yellow/line{
	dir = 8
	},
/obj/effect/turf_decal/tile/neutral{
	dir = 4
	},
/turf/open/floor/mineral/plastitanium,
/area/whitesands/surface/outdoors/unexplored)
"yc" = (
/turf/open/floor/plating{
	icon_state = "platingdmg2"
	},
/area/whitesands/surface/outdoors/unexplored)
"yX" = (
/obj/item/light/bulb/broken{
	pixel_x = 3;
	pixel_y = -1
	},
/turf/open/floor/plating{
	icon_state = "platingdmg1"
	},
/area/whitesands/surface/outdoors/unexplored)
"zF" = (
/turf/template_noop,
/area/template_noop)
"zP" = (
/obj/effect/spawner/structure/window/shuttle,
/turf/open/floor/plating,
/area/whitesands/surface/outdoors/unexplored)
"Al" = (
/obj/item/shard{
	icon_state = "tiny"
	},
/obj/item/shard,
/obj/item/shard{
	icon_state = "small"
	},
/turf/open/floor/plating,
/area/whitesands/surface/outdoors/unexplored)
"AG" = (
/obj/machinery/mineral/ore_redemption{
	input_dir = 4;
	output_dir = 8
	},
/turf/open/floor/plating,
/area/whitesands/surface/outdoors/unexplored)
"AW" = (
/obj/effect/turf_decal/tile/neutral,
/obj/effect/turf_decal/trimline/white/line{
	dir = 9
	},
/obj/structure/table,
/obj/structure/frame/machine,
/obj/item/stack/cable_coil/cut/green,
/obj/item/circuitboard/machine/reagentgrinder,
/turf/open/floor/plasteel/dark,
/area/whitesands/surface/outdoors/unexplored)
"CL" = (
/obj/effect/turf_decal/tile/neutral{
	dir = 1
	},
/obj/effect/turf_decal/tile/neutral{
	dir = 8
	},
/obj/effect/turf_decal/trimline/white/line{
	dir = 4
	},
/obj/item/circuitboard/machine/autodoc,
/obj/structure/frame/machine,
/obj/item/stack/cable_coil/cut/random,
/obj/item/surgicaldrill/advanced,
/turf/open/floor/plasteel/dark,
/area/whitesands/surface/outdoors/unexplored)
"EO" = (
/obj/effect/turf_decal/trimline/purple/line{
	dir = 8
	},
/obj/effect/turf_decal/tile/neutral,
/obj/effect/turf_decal/tile/neutral{
	dir = 4
	},
/obj/effect/decal/cleanable/dirt,
/turf/open/floor/plasteel/dark,
/area/whitesands/surface/outdoors/unexplored)
"EZ" = (
/obj/machinery/door/airlock/titanium,
/obj/effect/turf_decal/stripes/line,
/obj/effect/turf_decal/stripes/line{
	dir = 1
	},
/turf/open/floor/plasteel/dark,
/area/whitesands/surface/outdoors/unexplored)
"FK" = (
/obj/item/resonator,
/obj/effect/mob_spawn/human/corpse{
	mob_species = /datum/species/golem
	},
/obj/effect/decal/cleanable/dirt,
/obj/effect/decal/cleanable/blood/old,
/turf/open/floor/mineral/titanium/purple,
/area/whitesands/surface/outdoors/unexplored)
"Gf" = (
/obj/effect/turf_decal/tile/neutral{
	dir = 8
	},
/obj/effect/turf_decal/tile/neutral{
	dir = 1
	},
/obj/effect/turf_decal/trimline/purple/line{
	dir = 4
	},
/obj/effect/decal/cleanable/dirt,
/turf/open/floor/plasteel/dark,
/area/whitesands/surface/outdoors/unexplored)
"Gm" = (
/turf/open/floor/plating,
/area/whitesands/surface/outdoors/unexplored)
"Gn" = (
/obj/effect/decal/cleanable/dirt,
/turf/open/floor/mineral/titanium/purple,
/area/whitesands/surface/outdoors/unexplored)
"Gs" = (
/obj/machinery/light/small{
	dir = 8
	},
/obj/effect/decal/cleanable/dirt,
/turf/open/floor/plasteel/freezer,
/area/whitesands/surface/outdoors/unexplored)
"GZ" = (
/obj/item/shard{
	icon_state = "tiny"
	},
/obj/item/shard{
	icon_state = "small"
	},
/turf/open/floor/plating,
/area/whitesands/surface/outdoors/unexplored)
"Hm" = (
/obj/item/card/id/mining,
/turf/open/floor/plating{
	icon_state = "platingdmg1"
	},
/area/whitesands/surface/outdoors/unexplored)
"HB" = (
/obj/effect/decal/cleanable/dirt,
/turf/open/floor/plasteel,
/area/whitesands/surface/outdoors/unexplored)
"HE" = (
/obj/machinery/cell_charger,
/obj/effect/decal/cleanable/dirt,
/turf/open/floor/mineral/titanium/purple,
/area/whitesands/surface/outdoors/unexplored)
"HK" = (
/obj/effect/decal/cleanable/dirt,
/obj/effect/decal/cleanable/blood/old,
/turf/open/floor/plasteel/dark,
/area/whitesands/surface/outdoors/unexplored)
"Ie" = (
/obj/structure/girder/displaced,
/turf/open/floor/plating,
/area/whitesands/surface/outdoors/unexplored)
"Il" = (
/obj/machinery/shower,
/obj/effect/decal/cleanable/dirt,
/turf/open/floor/plasteel/freezer,
/area/whitesands/surface/outdoors/unexplored)
"IC" = (
/turf/open/floor/mineral/titanium/purple,
/area/whitesands/surface/outdoors/unexplored)
"JF" = (
/obj/machinery/door/airlock/external,
/turf/open/floor/plasteel/dark,
/area/whitesands/surface/outdoors/unexplored)
"Ks" = (
/obj/effect/decal/cleanable/dirt,
/turf/open/floor/plasteel/freezer,
/area/whitesands/surface/outdoors/unexplored)
"Kt" = (
/obj/structure/reagent_dispensers/watertank,
/obj/effect/decal/cleanable/oil/slippery,
/turf/open/floor/plating{
	icon_state = "platingdmg1"
	},
/area/whitesands/surface/outdoors/unexplored)
"KT" = (
/obj/structure/rack,
/obj/item/card/id/mining,
/obj/item/clothing/head/hardhat/mining,
/turf/open/floor/plating{
	icon_state = "platingdmg1"
	},
/area/whitesands/surface/outdoors/unexplored)
"Lz" = (
/obj/structure/frame/machine,
/obj/effect/decal/cleanable/oil,
/obj/item/stack/cable_coil/cut/random,
/obj/item/clothing/suit/space/hardsuit/mining,
/turf/open/floor/plating{
	icon_state = "platingdmg1"
	},
/area/whitesands/surface/outdoors/unexplored)
"Mx" = (
/obj/effect/turf_decal/tile/neutral{
	dir = 8
	},
/obj/effect/turf_decal/tile/neutral{
	dir = 1
	},
/turf/open/floor/plating/asteroid/whitesands,
/area/whitesands/surface/outdoors/unexplored)
"MT" = (
/obj/structure/frame/machine,
/obj/item/shard,
/obj/item/book/manual/wiki/research_and_development{
	name = "Sacred Text of the Liberator";
	pixel_y = -5
	},
/turf/open/floor/plating{
	icon_state = "platingdmg1"
	},
/area/whitesands/surface/outdoors/unexplored)
"Nm" = (
/obj/machinery/door/airlock/titanium,
/turf/open/floor/plasteel/dark,
/area/whitesands/surface/outdoors/unexplored)
"Nz" = (
/turf/open/floor/plating/asteroid/whitesands,
/area/whitesands/surface/outdoors/unexplored)
"Pe" = (
/obj/structure/ore_box,
/turf/open/floor/mineral/plastitanium,
/area/whitesands/surface/outdoors/unexplored)
"PD" = (
/obj/item/pickaxe,
/turf/open/floor/plating,
/area/whitesands/surface/outdoors/unexplored)
"PN" = (
/obj/structure/rack,
/obj/item/spear,
/obj/item/shard{
	icon_state = "medium"
	},
/obj/item/shard{
	icon_state = "tiny"
	},
/obj/item/shard{
	icon_state = "small"
	},
/turf/open/floor/plasteel/dark,
/area/whitesands/surface/outdoors/unexplored)
"Qi" = (
/obj/item/light/bulb/broken{
	pixel_x = -13;
	pixel_y = -12
	},
/obj/item/light/tube/broken{
	pixel_x = -10;
	pixel_y = -6
	},
/obj/item/shard{
	icon_state = "small"
	},
/obj/effect/decal/cleanable/oil,
/obj/effect/decal/cleanable/dirt,
/obj/effect/decal/cleanable/blood/old,
/turf/open/floor/plasteel,
/area/whitesands/surface/outdoors/unexplored)
"Qr" = (
/obj/item/shard,
/obj/effect/turf_decal/tile/neutral{
	dir = 4
	},
/obj/effect/turf_decal/tile/neutral,
/obj/effect/turf_decal/trimline/purple/line{
	dir = 8
	},
/obj/effect/decal/cleanable/dirt,
/turf/open/floor/plasteel/dark,
/area/whitesands/surface/outdoors/unexplored)
"QX" = (
/obj/effect/turf_decal/tile/neutral{
	dir = 1
	},
/obj/effect/turf_decal/tile/neutral{
	dir = 8
	},
/obj/effect/turf_decal/trimline/purple/line{
	dir = 4
	},
/turf/open/floor/plasteel/dark,
/area/whitesands/surface/outdoors/unexplored)
"Rb" = (
/obj/effect/turf_decal/tile/neutral{
	dir = 1
	},
/obj/effect/turf_decal/tile/neutral{
	dir = 8
	},
/obj/effect/turf_decal/trimline/white/corner{
	dir = 4
	},
/obj/effect/decal/cleanable/dirt,
/obj/effect/turf_decal/trimline/white/corner,
/turf/open/floor/plasteel/dark,
/area/whitesands/surface/outdoors/unexplored)
"RJ" = (
/obj/effect/decal/cleanable/dirt,
/turf/open/floor/mineral/titanium/white,
/area/whitesands/surface/outdoors/unexplored)
"RX" = (
/obj/structure/rack,
/obj/item/storage/toolbox/electrical{
	pixel_x = -3;
	pixel_y = 3
	},
/obj/item/storage/toolbox/mechanical,
/obj/item/storage/toolbox/emergency{
	pixel_x = 3;
	pixel_y = -3
	},
/turf/open/floor/plating{
	icon_state = "platingdmg1"
	},
/area/whitesands/surface/outdoors/unexplored)
"SN" = (
/obj/item/shard{
	icon_state = "tiny"
	},
/obj/item/shard{
	icon_state = "small"
	},
/obj/effect/decal/cleanable/dirt,
/turf/open/floor/plating{
	icon_state = "platingdmg1"
	},
/area/whitesands/surface/outdoors/unexplored)
"Tc" = (
/obj/item/spear,
/obj/effect/mob_spawn/human/corpse{
	mob_species = /datum/species/lizard/ashwalker
	},
/obj/effect/decal/cleanable/dirt,
/obj/effect/decal/cleanable/blood/old,
/turf/open/floor/plating{
	icon_state = "platingdmg1"
	},
/area/whitesands/surface/outdoors/unexplored)
"Um" = (
/obj/effect/turf_decal/tile/neutral{
	dir = 4
	},
/obj/effect/turf_decal/tile/neutral,
/obj/effect/turf_decal/trimline/purple/line{
	dir = 8
	},
/obj/effect/decal/cleanable/dirt,
/turf/open/floor/plasteel/dark,
/area/whitesands/surface/outdoors/unexplored)
"Uz" = (
/turf/closed/wall/mineral/plastitanium,
/area/whitesands/surface/outdoors/unexplored)
"Wm" = (
/obj/structure/frame/machine,
/turf/open/floor/plasteel/dark,
/area/whitesands/surface/outdoors/unexplored)
"Wt" = (
/obj/effect/turf_decal/tile/neutral{
	dir = 4
	},
/obj/effect/turf_decal/tile/neutral,
/obj/effect/turf_decal/trimline/white/line{
	dir = 8
	},
/obj/machinery/autolathe,
/obj/effect/decal/cleanable/dirt,
/turf/open/floor/plasteel/dark,
/area/whitesands/surface/outdoors/unexplored)
"WO" = (
/obj/structure/door_assembly/door_assembly_com,
/turf/open/floor/plating{
	icon_state = "panelscorched"
	},
/area/whitesands/surface/outdoors/unexplored)
"Xx" = (
/obj/structure/table,
/obj/effect/decal/cleanable/blood/old,
/turf/open/floor/plating,
/area/whitesands/surface/outdoors/unexplored)
"XQ" = (
/obj/item/shard,
/obj/effect/decal/cleanable/dirt,
/turf/open/floor/plating{
	icon_state = "platingdmg1"
	},
/area/whitesands/surface/outdoors/unexplored)
"YG" = (
/obj/item/resonator/upgraded,
/obj/effect/mob_spawn/human/corpse{
	mob_species = /datum/species/golem
	},
/obj/effect/decal/cleanable/blood/old,
/turf/open/floor/plating{
	icon_state = "panelscorched"
	},
/area/whitesands/surface/outdoors/unexplored)
"YN" = (
/obj/item/light/tube/broken{
	pixel_x = -10;
	pixel_y = -7
	},
/turf/open/floor/plating{
	icon_state = "panelscorched"
	},
/area/whitesands/surface/outdoors/unexplored)
"YZ" = (
/obj/effect/decal/cleanable/oil/streak,
/obj/effect/decal/cleanable/dirt,
/turf/open/floor/plasteel,
/area/whitesands/surface/outdoors/unexplored)
"ZD" = (
/obj/structure/rack,
/obj/item/mop,
/obj/item/reagent_containers/glass/bucket,
/obj/item/storage/bag/trash{
	pixel_x = 6
	},
/turf/open/floor/plating,
/area/whitesands/surface/outdoors/unexplored)
"ZM" = (
/obj/item/spear/bonespear,
/turf/open/floor/plating{
	icon_state = "platingdmg1"
	},
/area/whitesands/surface/outdoors/unexplored)
"ZP" = (
/obj/effect/decal/cleanable/dirt,
/turf/open/floor/plating,
/area/whitesands/surface/outdoors/unexplored)
"ZT" = (
/obj/structure/reagent_dispensers/fueltank,
/obj/effect/decal/cleanable/oil/slippery,
/turf/open/floor/plasteel/dark,
/area/whitesands/surface/outdoors/unexplored)
"ZY" = (
/obj/item/light/bulb/broken{
	pixel_x = 7;
	pixel_y = 7
	},
/obj/item/light/tube/broken{
	pixel_x = 12;
	pixel_y = -7
	},
/obj/effect/decal/cleanable/oil/streak,
/obj/effect/decal/cleanable/dirt,
/turf/open/floor/plasteel,
/area/whitesands/surface/outdoors/unexplored)

(1,1,1) = {"
zF
zF
zF
zP
zP
aZ
aZ
rm
aZ
wH
Nz
zF
zF
zF
zF
zF
zF
zF
zF
zF
zF
zF
zF
"}
(2,1,1) = {"
Uz
Uz
aZ
zP
uY
ZD
RX
wH
Gs
pb
Nz
Nz
zF
zF
zF
zF
zF
zF
zF
zF
zF
zF
zF
"}
(3,1,1) = {"
xJ
mO
aZ
wl
ZP
ZP
Nz
aZ
Il
hh
pb
wH
Nz
zF
zF
zF
zF
zF
zF
zF
zF
zF
zF
"}
(4,1,1) = {"
xJ
mO
aZ
Xx
Tc
Nz
Nz
nX
Ks
Nz
hh
Nz
Nz
Nz
zF
zF
zF
zF
zF
zF
zF
zF
zF
"}
(5,1,1) = {"
Uz
Uz
kT
rm
Nm
kT
PD
rm
pb
hh
pQ
ht
hJ
Nz
zF
zF
zF
zF
zF
zF
zF
zF
zF
"}
(6,1,1) = {"
xJ
mO
pb
Gm
Nz
aZ
aZ
aZ
aZ
aZ
aZ
aZ
aZ
mS
mS
aZ
nX
nX
aZ
aZ
Nz
zF
zF
"}
(7,1,1) = {"
xJ
mO
rm
Nz
yX
hh
kT
AW
jp
qU
Wt
pb
Qr
jy
EO
pb
ZP
Um
pQ
Ie
Nz
Nz
zF
"}
(8,1,1) = {"
aZ
aZ
aZ
sm
YG
HK
aZ
rC
hi
RJ
RJ
pb
pb
Gn
Gn
jw
pQ
XQ
pQ
WO
fb
hh
Nz
"}
(9,1,1) = {"
JF
pC
JF
HB
ZY
YN
EZ
ww
cj
pb
iE
vc
IC
HE
sb
Gn
bb
SN
SN
Ie
yc
Nz
yc
"}
(10,1,1) = {"
JF
pC
JF
tv
hM
nL
EZ
RJ
RJ
oP
Gm
xA
pb
Gn
Wm
fo
MT
wd
vD
wH
Nz
pb
pb
"}
(11,1,1) = {"
aZ
aZ
aZ
Lz
Qi
sO
aZ
cB
RJ
ZM
RJ
jO
yc
FK
pb
pQ
pQ
pQ
pQ
qY
pb
hh
Nz
"}
(12,1,1) = {"
xJ
bW
aZ
Kt
tg
PN
aZ
cs
pb
Rb
CL
pb
QX
Gf
Mx
pQ
Gf
pQ
pb
pb
Nz
Nz
Nz
"}
(13,1,1) = {"
xJ
bW
aZ
ZT
YZ
aZ
aZ
aZ
aZ
cW
aZ
AG
Al
aZ
aZ
aZ
cW
GZ
Ie
Nz
zF
zF
zF
"}
(14,1,1) = {"
Uz
Uz
aZ
aZ
sh
aZ
vI
nZ
Hm
xX
Nz
Nz
Nz
zF
zF
zF
zF
zF
zF
zF
zF
zF
zF
"}
(15,1,1) = {"
xJ
mO
aZ
Pe
tw
pb
at
Nz
Nz
Nz
zF
zF
zF
zF
zF
zF
zF
zF
zF
zF
zF
zF
zF
"}
(16,1,1) = {"
xJ
mO
aZ
kJ
eM
tH
pb
Hm
Nz
zF
zF
zF
zF
zF
zF
zF
zF
zF
zF
zF
zF
zF
zF
"}
(17,1,1) = {"
Uz
Uz
aZ
aZ
dz
sF
ha
KT
vd
zF
zF
zF
zF
zF
zF
zF
zF
zF
zF
zF
zF
zF
zF
"}
(18,1,1) = {"
zF
zF
zF
aZ
aZ
Nz
Nz
zF
zF
zF
zF
zF
zF
zF
zF
zF
zF
zF
zF
zF
zF
zF
zF
"}
