//MAP CONVERTED BY dmm2tgm.py THIS HEADER COMMENT PREVENTS RECONVERSION, DO NOT REMOVE
"aO" = (
/obj/structure/cable{
	icon_state = "1-4"
	},
/obj/structure/cable{
	icon_state = "4-5"
	},
/obj/effect/turf_decal/corner_techfloor_gray/full{
	dir = 4
	},
/turf/open/floor/plasteel/dark,
/area/space)
"bF" = (
/obj/effect/turf_decal/corner_techfloor_gray/full,
/turf/open/floor/plasteel/dark,
/area/space)
"bX" = (
/obj/structure/cable{
	icon_state = "1-2"
	},
/obj/structure/catwalk,
/obj/machinery/door/window/brigdoor{
	dir = 8
	},
/turf/open/floor/plating,
/area/space)
"cd" = (
/turf/open/floor/plating/asteroid/whitesands/grass,
/area/space)
"dP" = (
/obj/structure/cable{
	icon_state = "2-5"
	},
/obj/effect/turf_decal/industrial/warning,
/turf/open/floor/plasteel/dark,
/area/space)
"dU" = (
/obj/effect/turf_decal/industrial/warning/corner{
	dir = 8
	},
/turf/open/floor/plasteel/dark,
/area/space)
"eh" = (
/obj/structure/cable{
	icon_state = "1-10"
	},
/obj/effect/turf_decal/industrial/warning{
	dir = 1
	},
/turf/open/floor/plasteel/dark,
/area/space)
"ek" = (
/obj/structure/cable{
	icon_state = "4-8"
	},
/turf/open/floor/plasteel/stairs/old{
	dir = 4
	},
/area/space)
"hm" = (
/obj/machinery/power/deck_relay{
	pixel_y = 28;
	pixel_x = 13
	},
/obj/structure/cable{
	icon_state = "5-8"
	},
/obj/structure/catwalk/over/plated_catwalk/dark,
/obj/structure/railing{
	dir = 8
	},
/obj/structure/cable{
	icon_state = "2-5"
	},
/turf/open/floor/plating,
/area/space)
"hw" = (
/turf/closed/wall/concrete/reinforced,
/area/space)
"it" = (
/obj/structure/cable{
	icon_state = "1-10"
	},
/turf/open/floor/plating/asteroid/whitesands/dried,
/area/space)
"iP" = (
/obj/item/ammo_box/magazine/crunch_shot{
	pixel_x = -11;
	pixel_y = -2
	},
/turf/closed/mineral/random/whitesands,
/area/space)
"kr" = (
/obj/structure/cable{
	icon_state = "1-2"
	},
/turf/open/floor/plasteel/tech/grid,
/area/space)
"mV" = (
/obj/machinery/power/apc/auto_name/directional/south,
/obj/structure/cable{
	icon_state = "0-8"
	},
/turf/open/floor/plasteel/tech,
/area/space)
"nq" = (
/turf/open/floor/plasteel/tech/grid,
/area/space)
"nL" = (
/obj/effect/turf_decal/industrial/warning/corner{
	dir = 8
	},
/turf/open/space/basic,
/area/space)
"od" = (
/obj/structure/cable{
	icon_state = "6-10"
	},
/turf/closed/wall/concrete/reinforced,
/area/space)
"oR" = (
/obj/effect/turf_decal/corner_techfloor_gray{
	dir = 9
	},
/turf/open/floor/plasteel/dark,
/area/space)
"pp" = (
/turf/open/water/acid/whitesands,
/area/space)
"pV" = (
/obj/structure/cable{
	icon_state = "0-4"
	},
/turf/closed/wall/concrete/reinforced,
/area/space)
"qK" = (
/obj/effect/turf_decal/industrial/warning/corner{
	dir = 4
	},
/turf/open/floor/plasteel/dark,
/area/space)
"qR" = (
/obj/machinery/telecomms/relay{
	pixel_y = 14;
	pixel_x = 2;
	network = "Operations Zone 107";
	id = "Groundbase-Omnicron"
	},
/obj/structure/cable{
	icon_state = "2-8"
	},
/obj/structure/cable{
	icon_state = "0-2"
	},
/obj/structure/window/reinforced/spawner{
	dir = 8
	},
/turf/open/floor/plasteel/telecomms_floor,
/area/space)
"qY" = (
/obj/structure/cable{
	icon_state = "4-8"
	},
/obj/effect/turf_decal/corner_techfloor_gray{
	dir = 9
	},
/turf/open/floor/plasteel/dark,
/area/space)
"rx" = (
/obj/effect/turf_decal/industrial/warning/corner,
/turf/open/space/basic,
/area/space)
"un" = (
/obj/machinery/porta_turret/ship{
	pixel_y = 14
	},
/turf/open/floor/plating/asteroid/whitesands/dried,
/area/space)
"ux" = (
/turf/closed/wall/concrete,
/area/space)
"vr" = (
/obj/structure/cable{
	icon_state = "1-2"
	},
/obj/effect/turf_decal/corner_techfloor_gray{
	dir = 6
	},
/obj/effect/turf_decal/steeldecal/steel_decals9{
	dir = 8
	},
/obj/item/grenade/c4/satchel_charge/cave_base,
/turf/open/floor/plasteel/dark,
/area/space)
"wD" = (
/obj/machinery/computer/security/retro,
/obj/structure/cable{
	icon_state = "4-8"
	},
/turf/open/floor/plasteel/telecomms_floor,
/area/space)
"xr" = (
/obj/effect/turf_decal/corner_techfloor_gray{
	dir = 5
	},
/obj/structure/cable{
	icon_state = "1-2"
	},
/obj/effect/turf_decal/industrial/warning{
	dir = 1
	},
/turf/open/floor/plasteel/dark,
/area/space)
"xV" = (
/obj/structure/table/greyscale,
/obj/effect/turf_decal/corner_techfloor_gray{
	dir = 6
	},
/turf/open/floor/plasteel/dark,
/area/space)
"zj" = (
/obj/structure/catwalk/over/plated_catwalk/dark,
/obj/structure/railing{
	dir = 10
	},
/obj/structure/cable,
/obj/structure/cable{
	icon_state = "1-10"
	},
/turf/open/floor/plating,
/area/space)
"zr" = (
/obj/effect/turf_decal/corner_techfloor_gray{
	dir = 9
	},
/obj/item/lighter{
	pixel_y = 11;
	pixel_x = 11
	},
/turf/open/floor/plasteel/dark,
/area/space)
"zs" = (
/obj/structure/cable{
	icon_state = "5-8"
	},
/obj/structure/cable{
	icon_state = "2-8"
	},
/turf/open/floor/plating/asteroid/whitesands/dried,
/area/space)
"Ak" = (
/obj/structure/bed,
/obj/item/bedsheet/cosmos{
	desc = "In the cosmos I had a dream, dreamt I saw this world's destiny..."
	},
/turf/open/floor/plasteel/dark,
/area/space)
"AH" = (
/turf/open/floor/plasteel/tech,
/area/space)
"Ca" = (
/obj/structure/railing{
	dir = 6
	},
/obj/machinery/power/deck_relay{
	pixel_y = 28;
	pixel_x = -12
	},
/obj/structure/cable{
	icon_state = "4-9"
	},
/obj/structure/catwalk/over/plated_catwalk/dark,
/turf/open/floor/plating,
/area/space)
"CB" = (
/obj/structure/cable{
	icon_state = "4-8"
	},
/turf/open/floor/plating/asteroid/whitesands/dried,
/area/space)
"EL" = (
/turf/open/floor/plating/asteroid/whitesands/grass/dead,
/area/space)
"EX" = (
/obj/structure/cable{
	icon_state = "4-8"
	},
/turf/open/floor/plasteel/tech,
/area/space)
"Ff" = (
/turf/closed/mineral/random/whitesands,
/area/space)
"FN" = (
/obj/structure/cable{
	icon_state = "2-8"
	},
/obj/effect/turf_decal/corner_techfloor_gray{
	dir = 6
	},
/turf/open/floor/plasteel/dark,
/area/space)
"FQ" = (
/turf/open/space/basic,
/area/space)
"Gk" = (
/obj/structure/cable{
	icon_state = "2-4"
	},
/turf/open/floor/plating/asteroid/whitesands/dried,
/area/space)
"GH" = (
/obj/structure/cable{
	icon_state = "6-8"
	},
/turf/open/floor/plating/asteroid/whitesands/dried,
/area/space)
"Ka" = (
/obj/structure/cable{
	icon_state = "1-2"
	},
/turf/open/floor/plating/asteroid/whitesands/dried,
/area/space)
"KF" = (
/obj/item/rack_parts{
	pixel_y = 7;
	pixel_x = -6
	},
/obj/item/gun/ballistic/rifle/crunch_gun{
	pixel_x = 11;
	pixel_y = -3
	},
/obj/item/ammo_box/magazine/crunch_shot{
	pixel_x = -11;
	pixel_y = -2
	},
/turf/open/floor/plasteel/tech,
/area/space)
"KG" = (
/obj/structure/table/greyscale,
/obj/effect/turf_decal/corner_techfloor_gray/full{
	dir = 8
	},
/obj/machinery/fax/ruin,
/turf/open/floor/plasteel/dark,
/area/space)
"LK" = (
/obj/machinery/porta_turret/ship{
	pixel_y = -6
	},
/turf/open/floor/plating/asteroid/whitesands/dried,
/area/space)
"Me" = (
/obj/effect/turf_decal/corner_techfloor_gray{
	dir = 10
	},
/turf/open/floor/plasteel/dark,
/area/space)
"Mi" = (
/obj/structure/cable{
	icon_state = "2-9"
	},
/obj/effect/turf_decal/industrial/warning,
/turf/open/space/basic,
/area/space)
"OG" = (
/obj/effect/turf_decal/corner_techfloor_gray/full{
	dir = 8
	},
/obj/effect/turf_decal/industrial/warning/corner{
	dir = 4
	},
/obj/item/clothing/suit/armor/vest/duster{
	pixel_y = -4;
	pixel_x = -6
	},
/obj/item/rack_parts{
	pixel_y = 7;
	pixel_x = 5
	},
/turf/open/floor/plasteel/dark,
/area/space)
"PS" = (
/obj/structure/cable{
	icon_state = "1-8"
	},
/turf/open/floor/plating/asteroid/whitesands/dried,
/area/space)
"Qg" = (
/obj/structure/cable{
	icon_state = "0-8"
	},
/turf/closed/wall/concrete/reinforced,
/area/space)
"Sk" = (
/obj/effect/turf_decal/corner_techfloor_gray{
	dir = 5
	},
/obj/effect/turf_decal/industrial/warning/corner{
	dir = 1
	},
/obj/structure/filingcabinet/double{
	pixel_y = 16;
	pixel_x = 5;
	density = 0
	},
/turf/open/floor/plasteel/dark,
/area/space)
"Va" = (
/obj/structure/cable{
	icon_state = "4-8"
	},
/turf/open/floor/plasteel/tech/grid,
/area/space)
"WR" = (
/turf/open/floor/plating/asteroid/whitesands,
/area/space)
"Xa" = (
/obj/machinery/power/rtg/geothermal,
/obj/structure/cable{
	icon_state = "0-4"
	},
/turf/open/space/basic,
/area/space)
"Xe" = (
/turf/open/floor/plating/asteroid/whitesands/dried,
/area/space)
"XG" = (
/turf/open/floor/plasteel/dark,
/area/space)
"Zy" = (
/obj/machinery/blackbox_recorder,
/obj/structure/cable{
	icon_state = "0-2"
	},
/obj/structure/window/reinforced/spawner{
	dir = 8
	},
/turf/open/floor/plasteel/telecomms_floor,
/area/space)
"ZB" = (
/obj/structure/cable{
	icon_state = "6-9"
	},
/obj/structure/cable{
	icon_state = "4-9"
	},
/turf/open/floor/plating/asteroid/whitesands/dried,
/area/space)
"ZJ" = (
/obj/structure/cable{
	icon_state = "1-4"
	},
/obj/machinery/holopad/secure,
/obj/effect/turf_decal/corner_techfloor_gray{
	dir = 6
	},
/obj/effect/turf_decal/box,
/turf/open/floor/plasteel/dark,
/area/space)

(1,1,1) = {"
Ff
Ff
Xe
Xe
cd
cd
EL
EL
FQ
FQ
FQ
FQ
FQ
FQ
FQ
FQ
FQ
FQ
FQ
FQ
FQ
FQ
FQ
FQ
FQ
FQ
FQ
FQ
FQ
FQ
FQ
FQ
FQ
FQ
FQ
FQ
FQ
FQ
FQ
FQ
FQ
FQ
FQ
FQ
FQ
FQ
FQ
FQ
FQ
FQ
FQ
FQ
FQ
FQ
FQ
FQ
FQ
FQ
FQ
FQ
"}
(2,1,1) = {"
Ff
Ff
Xe
Xe
cd
cd
EL
EL
FQ
FQ
FQ
FQ
FQ
FQ
FQ
FQ
FQ
FQ
FQ
FQ
FQ
FQ
FQ
FQ
Ff
Ff
Ff
Ff
Ff
Ff
Ff
Ff
Ff
FQ
FQ
FQ
FQ
FQ
FQ
FQ
FQ
FQ
FQ
FQ
FQ
FQ
FQ
FQ
FQ
FQ
FQ
FQ
FQ
FQ
FQ
FQ
FQ
FQ
FQ
FQ
"}
(3,1,1) = {"
FQ
FQ
WR
WR
pp
pp
FQ
FQ
FQ
FQ
FQ
FQ
FQ
FQ
FQ
FQ
FQ
FQ
FQ
FQ
FQ
FQ
Ff
Ff
Ff
Ff
Ff
Ff
Ff
Ff
Ff
Ff
Ff
Ff
Ff
Ff
Ff
Ff
Ff
FQ
FQ
FQ
FQ
FQ
FQ
FQ
FQ
FQ
FQ
FQ
FQ
FQ
FQ
FQ
FQ
FQ
FQ
FQ
FQ
FQ
"}
(4,1,1) = {"
FQ
FQ
WR
WR
pp
pp
FQ
FQ
FQ
FQ
FQ
FQ
FQ
FQ
FQ
FQ
FQ
FQ
FQ
FQ
FQ
Ff
Ff
Ff
Ff
Ff
Ff
Ff
Ff
Ff
Ff
Ff
Ff
Ff
Ff
Ff
Ff
Ff
Ff
Ff
Ff
FQ
FQ
FQ
FQ
FQ
FQ
FQ
FQ
FQ
FQ
FQ
FQ
FQ
FQ
FQ
FQ
FQ
FQ
FQ
"}
(5,1,1) = {"
FQ
FQ
FQ
FQ
FQ
FQ
FQ
FQ
Ff
Xe
Xe
Ff
FQ
FQ
FQ
FQ
FQ
FQ
FQ
FQ
Ff
Ff
Ff
Xe
Ff
Ff
Ff
Ff
Ff
Ff
Ff
Ff
Ff
Ff
Ff
Ff
Ff
Ff
Ff
Ff
Ff
Ff
Ff
FQ
FQ
FQ
FQ
FQ
FQ
FQ
FQ
FQ
FQ
FQ
FQ
FQ
FQ
FQ
FQ
FQ
"}
(6,1,1) = {"
FQ
FQ
FQ
FQ
FQ
FQ
FQ
Ff
Ff
Xe
Xe
Ff
FQ
FQ
FQ
FQ
FQ
FQ
Ff
Ff
Ff
Ff
Xe
Xe
Xe
Ff
Ff
Ff
Ff
Ff
Ff
Ff
Ff
Ff
Ff
Ff
Ff
Ff
Ff
Ff
Ff
Ff
Ff
Ff
FQ
FQ
FQ
FQ
FQ
FQ
FQ
FQ
FQ
FQ
FQ
FQ
FQ
FQ
FQ
FQ
"}
(7,1,1) = {"
FQ
FQ
FQ
FQ
FQ
FQ
Ff
Ff
Xe
Xe
Xe
Ff
FQ
FQ
FQ
FQ
FQ
Ff
Ff
Ff
Ff
Xe
Xe
Xe
Xe
Xe
Ff
Ff
Ff
Ff
Ff
Ff
Ff
Ff
Ff
Ff
Ff
Ff
Ff
Ff
Ff
Ff
Ff
Ff
FQ
FQ
FQ
FQ
FQ
FQ
FQ
FQ
FQ
FQ
FQ
FQ
FQ
FQ
FQ
FQ
"}
(8,1,1) = {"
FQ
FQ
FQ
FQ
FQ
Ff
Ff
Xe
Xe
Xe
Ff
Ff
Ff
FQ
FQ
FQ
Ff
Ff
Ff
Ff
Xe
Xe
Xe
Xe
Xe
Xe
Ff
Ff
Ff
Xe
Xe
Xe
Xe
Xe
Xe
Xe
Xe
Ff
Ff
Ff
Ff
Ff
Ff
Ff
Ff
FQ
FQ
FQ
FQ
FQ
FQ
FQ
FQ
FQ
FQ
FQ
FQ
FQ
FQ
FQ
"}
(9,1,1) = {"
FQ
FQ
FQ
FQ
FQ
Ff
Xe
Xe
Xe
Ff
Ff
Ff
Ff
FQ
FQ
FQ
Ff
Ff
Ff
Xe
Xe
Xe
Xe
Xe
Xe
Xe
Xe
Ff
Ff
Xe
Xe
Xe
Xe
Xe
Xe
Xe
Xe
Xe
Xe
Ff
Ff
Ff
Ff
Ff
Ff
FQ
FQ
FQ
FQ
FQ
FQ
FQ
FQ
FQ
FQ
FQ
FQ
FQ
FQ
FQ
"}
(10,1,1) = {"
FQ
FQ
FQ
FQ
Ff
Ff
Xe
Xe
Xe
Ff
Ff
FQ
FQ
FQ
FQ
FQ
Ff
Ff
Xe
Xe
Xe
Xe
Xe
Ff
Xe
Xe
Xe
Xe
Xe
Xe
Xe
Xe
Xe
Xe
Xe
Xe
Xe
Xe
Xe
Xe
Xe
Ff
Ff
Ff
Ff
Ff
FQ
FQ
FQ
FQ
FQ
FQ
FQ
FQ
FQ
FQ
FQ
FQ
FQ
FQ
"}
(11,1,1) = {"
FQ
FQ
FQ
Ff
Ff
Xe
Xe
Xe
Xe
Ff
Ff
FQ
Ff
FQ
FQ
FQ
Ff
Ff
Xe
Xe
Xe
Xe
Ff
Ff
Xe
Xe
Xe
Xe
Xe
Xe
Xe
Xe
Xe
Xe
Xe
Xe
Xe
Xe
Xe
Xe
Xe
Xe
Ff
Ff
Ff
Ff
FQ
FQ
FQ
FQ
FQ
FQ
FQ
FQ
FQ
FQ
FQ
FQ
FQ
FQ
"}
(12,1,1) = {"
FQ
FQ
Ff
Ff
Ff
Xe
Xe
Xe
Ff
Ff
Ff
Ff
Ff
FQ
Ff
Ff
Ff
Xe
Xe
Xe
Ff
Xe
Ff
Ff
Xe
Xe
Xe
Xe
Xe
Ff
Ff
Xe
Xe
Xe
Xe
Xe
Xe
Xe
Xe
Xe
Xe
Xe
Ff
Ff
Ff
Ff
FQ
FQ
FQ
FQ
FQ
FQ
FQ
FQ
FQ
FQ
FQ
FQ
FQ
FQ
"}
(13,1,1) = {"
FQ
FQ
Ff
Ff
Ff
Xe
Xe
Xe
Ff
Ff
Ff
Ff
Ff
Ff
Ff
Ff
Xe
Xe
Xe
Xe
Ff
Xe
Xe
Ff
Xe
Xe
Xe
Xe
Ff
Ff
Ff
Ff
Ff
Xe
Xe
Xe
Xe
Xe
Xe
Xe
Xe
Xe
Xe
Ff
Ff
Ff
FQ
FQ
FQ
FQ
FQ
FQ
FQ
FQ
FQ
FQ
FQ
FQ
FQ
FQ
"}
(14,1,1) = {"
FQ
FQ
Ff
Ff
Ff
Xe
Xe
Xe
Ff
Ff
Ff
Ff
Ff
Ff
Ff
Xe
Xe
Xe
Xe
Ff
Ff
Xe
Xe
Ff
Xe
Xe
Xe
Xe
Ff
Ff
Ff
Ff
Ff
Xe
Xe
Xe
Xe
Xe
Xe
Xe
Xe
Xe
Xe
Ff
Ff
Ff
Ff
FQ
FQ
FQ
FQ
FQ
FQ
FQ
FQ
FQ
FQ
FQ
FQ
FQ
"}
(15,1,1) = {"
FQ
FQ
Ff
Ff
Ff
Ff
Xe
Xe
Ff
Ff
Ff
Ff
Ff
Ff
Ff
Xe
Xe
Xe
Xe
Ff
Xe
Xe
Ff
Ff
Xe
Xe
Xe
Xe
Ff
Ff
Ff
Ff
Ff
Ff
Xe
Xe
Xe
Xe
Xe
Xe
Xe
Xe
Xe
Ff
Ff
Ff
Ff
FQ
FQ
FQ
FQ
FQ
FQ
FQ
FQ
FQ
FQ
FQ
FQ
FQ
"}
(16,1,1) = {"
FQ
Ff
Ff
Ff
Ff
Ff
Xe
Xe
Xe
Ff
Ff
Ff
Ff
Xe
Xe
Xe
Xe
Xe
Xe
Ff
Ff
Ff
Ff
Ff
Xe
Xe
Xe
Xe
Ff
Ff
Ff
Ff
Ff
Ff
Xe
Xe
Xe
Xe
Xe
Xe
Xe
Xe
Xe
Ff
Ff
Ff
Ff
FQ
FQ
FQ
FQ
FQ
FQ
FQ
FQ
FQ
FQ
FQ
FQ
FQ
"}
(17,1,1) = {"
FQ
Ff
Ff
Ff
Ff
Xe
Xe
Xe
Xe
Ff
Xe
Ff
Ff
Xe
Xe
Xe
Xe
Xe
Xe
Xe
Ff
Ff
Ff
Xe
Xe
Xe
Xe
Xe
Ff
Ff
Xe
Ff
Ff
Xe
Xe
Xe
Xe
Xe
Xe
Xe
Xe
Xe
Xe
Ff
Ff
Ff
Ff
FQ
FQ
FQ
FQ
FQ
FQ
FQ
FQ
FQ
FQ
FQ
FQ
FQ
"}
(18,1,1) = {"
FQ
Ff
Ff
Ff
Xe
Xe
Xe
Xe
Xe
Xe
Xe
Xe
Xe
Xe
Xe
Xe
Xe
Xe
Xe
Xe
Xe
Xe
Ff
Xe
Xe
Xe
Xe
Xe
Ff
Ff
Xe
Xe
Ff
Xe
Xe
Xe
Xe
Xe
Xe
Xe
Xe
Xe
Ff
Ff
Ff
Ff
Ff
FQ
FQ
FQ
FQ
FQ
FQ
FQ
FQ
FQ
FQ
FQ
FQ
FQ
"}
(19,1,1) = {"
FQ
Ff
Ff
Ff
Xe
Xe
Xe
Ff
Ff
Xe
Xe
Xe
Xe
Xe
Ff
Ff
Xe
Xe
Xe
Xe
Xe
Xe
Ff
Xe
Xe
Xe
Xe
Xe
Ff
Ff
Xe
Xe
Ff
Ff
Xe
Xe
Ff
Xe
Xe
Xe
Xe
Xe
Ff
Xe
Xe
Ff
Ff
Ff
Ff
FQ
FQ
FQ
FQ
FQ
FQ
FQ
FQ
FQ
FQ
FQ
"}
(20,1,1) = {"
FQ
Ff
Ff
Ff
Xe
Xe
Ff
Ff
Ff
Ff
Ff
Ff
Ff
Ff
Ff
Ff
Ff
Ff
Xe
Xe
Xe
Xe
Xe
Xe
Xe
Xe
Xe
Xe
Ff
Ff
Xe
Xe
Ff
Xe
Xe
Ff
Ff
Ff
Xe
Xe
Ff
Xe
Ff
Xe
Xe
Xe
Ff
Ff
Ff
Ff
FQ
FQ
FQ
FQ
FQ
FQ
FQ
FQ
FQ
FQ
"}
(21,1,1) = {"
FQ
Ff
Ff
Ff
Xe
Xe
Xe
Ff
Ff
Ff
Ff
Ff
Ff
Ff
pp
pp
Ff
Ff
Ff
Xe
Xe
Ff
Ff
Xe
Xe
Xe
Xe
Xe
Ff
Ff
Xe
Xe
Xe
Xe
Xe
Ff
Ff
Ff
Ff
Ff
Ff
Xe
Xe
Xe
Xe
Xe
Ff
Ff
Ff
Ff
FQ
FQ
FQ
FQ
FQ
FQ
FQ
FQ
FQ
FQ
"}
(22,1,1) = {"
FQ
FQ
Ff
Ff
Xe
Xe
Ff
Ff
Xe
Ff
Ff
Xe
Xe
Xe
Xe
pp
pp
pp
Ff
Ff
Xe
Ff
Ff
Ff
Xe
Xe
Xe
Xe
Ff
Ff
Ff
Xe
Xe
Xe
Xe
Xe
Ff
Ff
Ff
Ff
Xe
Xe
Xe
Xe
Xe
Xe
Ff
Ff
Ff
Ff
Ff
Ff
Ff
Ff
Ff
FQ
FQ
FQ
FQ
FQ
"}
(23,1,1) = {"
FQ
FQ
Ff
Ff
Ff
Ff
Ff
Ff
Xe
Ff
Xe
Xe
Xe
Xe
Xe
pp
pp
pp
Ff
Ff
Xe
Xe
Xe
Ff
Xe
Xe
Xe
Xe
Ff
Ff
Ff
Ff
Xe
Xe
Ff
Xe
Ff
Ff
Ff
Xe
Xe
Xe
Xe
Ff
Xe
Ff
Ff
Ff
Ff
Ff
Ff
Ff
Ff
Ff
Xe
FQ
FQ
FQ
FQ
FQ
"}
(24,1,1) = {"
FQ
Ff
Ff
Ff
Ff
Ff
Ff
Xe
Xe
Xe
Xe
LK
pV
un
Xe
Xe
pp
Ff
Ff
Ff
Xe
Xe
Xe
Ff
Ff
Xe
Xe
Xe
Xe
Ff
Ff
Ff
Ff
Xe
Ff
Ff
Ff
Ff
Ff
Ff
Ff
Ff
Ff
Ff
Ff
Ff
Ff
Ff
Ff
Ff
Ff
Ff
Ff
Xe
Xe
Xe
FQ
FQ
FQ
FQ
"}
(25,1,1) = {"
FQ
FQ
Ff
Ff
Ff
Xe
Ff
Xe
Xa
Xe
Xe
Xe
CB
Xe
Xe
Xe
Ff
Ff
Ff
Xe
Xe
Xe
Xe
Ff
Ff
Xe
Xe
Xe
Xe
Ff
Ff
Ff
Ff
Ff
Ff
Ff
Ff
Ff
Ff
Ff
Ff
Ff
Ff
Ff
Ff
Ff
Ff
Ff
Ff
Ff
Ff
Ff
Xe
Xe
Xe
Xe
FQ
FQ
FQ
FQ
"}
(26,1,1) = {"
FQ
Ff
Ff
Ff
Ff
Xe
Ff
Xe
zs
Ka
Ka
Ka
PS
Xe
Ff
Ff
Ff
Ff
Xe
Xe
Xe
Ff
Xe
Ff
Ff
Ff
Xe
Xe
Xe
Ff
Ff
Ff
Ff
Ff
Ff
Ff
Ff
Ff
Ff
Xe
Xe
Xe
Xe
Ff
Ff
Ff
Ff
Ff
Ff
Ff
Ff
Xe
Xe
Xe
Xe
Xe
FQ
FQ
FQ
FQ
"}
(27,1,1) = {"
FQ
Ff
Ff
Ff
Xe
Xe
Gk
it
Xe
Xe
Xe
Xe
Ff
Xe
Ff
iP
Ff
Xe
Xe
Ff
Ff
Ff
Xe
Ff
Ff
Ff
Ff
Xe
Xe
Xe
Ff
Ff
Ff
Ff
Ff
Ff
Ff
Ff
Xe
Xe
Xe
Xe
Xe
Xe
Xe
Ff
Ff
Ff
Ff
Xe
Xe
Xe
Xe
Xe
Xe
Xe
FQ
FQ
FQ
FQ
"}
(28,1,1) = {"
FQ
Ff
Ff
Ff
Xe
Xe
CB
Ff
hw
Ff
hw
Ff
Ff
Xe
Xe
Xe
Xe
Xe
Xe
Ff
Ff
Xe
Xe
Xe
Ff
Ff
Ff
Xe
Xe
Xe
Ff
Ff
Xe
Xe
Xe
Ff
Ff
Xe
Xe
Xe
Xe
Xe
Xe
Xe
Xe
Xe
Xe
Xe
Xe
Xe
Xe
Xe
Xe
Xe
Xe
Xe
FQ
FQ
FQ
FQ
"}
(29,1,1) = {"
FQ
Ff
Ff
Ff
Ff
Xe
CB
Ff
Ff
Ff
Ff
Ff
Ff
Ff
Xe
Xe
Ff
Ff
Ff
Ff
Ff
Xe
Xe
Xe
Xe
Ff
Ff
Ff
Xe
Xe
Xe
Xe
Xe
Xe
Xe
Xe
Xe
Xe
Xe
Xe
Xe
Xe
Xe
Xe
Xe
Xe
Xe
Xe
Xe
Xe
Xe
Xe
Xe
Xe
Xe
Xe
FQ
FQ
FQ
FQ
"}
(30,1,1) = {"
FQ
FQ
Ff
Ff
Ff
Xe
CB
hw
Ff
Ff
Ff
Ff
Ff
Ff
Ff
Ff
Ff
Ff
Ff
Ff
Ff
Ff
Xe
Xe
Xe
Ff
Ff
Ff
Ff
Xe
Xe
Xe
Xe
Xe
Xe
Xe
Xe
Xe
Xe
Xe
Xe
Xe
Xe
Xe
Xe
Xe
Xe
Xe
Xe
Xe
Xe
Xe
Xe
Xe
Xe
Ff
FQ
FQ
FQ
FQ
"}
(31,1,1) = {"
FQ
FQ
FQ
Ff
Ff
Xe
CB
Xe
Ff
Ff
Ff
Ff
hw
hw
hw
hw
hw
hw
hw
hw
hw
Ff
Ff
Xe
Xe
Ff
Ff
Ff
Ff
Ff
Xe
Xe
Xe
Xe
Xe
Xe
Xe
Xe
Xe
Xe
Xe
Ff
Xe
Xe
Xe
Xe
Xe
Xe
Xe
Xe
Xe
Xe
Xe
Xe
Ff
Ff
Ff
FQ
FQ
FQ
"}
(32,1,1) = {"
FQ
Ff
FQ
Ff
Ff
Xe
GH
Xe
Ff
hw
hw
hw
hw
OG
oR
oR
bF
hw
XG
XG
hw
Ff
Ff
Xe
Ff
Ff
Ff
Ff
Xe
Xe
Xe
Xe
Xe
Xe
Xe
Xe
Xe
Xe
Xe
Ff
Xe
Ff
Ff
Xe
Xe
Xe
Xe
Xe
Xe
Xe
Xe
Xe
Xe
Ff
Ff
Ff
FQ
FQ
FQ
FQ
"}
(33,1,1) = {"
FQ
Ff
Ff
Ff
Ff
Xe
Xe
ZB
rx
hw
qK
dP
kr
xr
vr
ZJ
Me
hw
nq
hw
hw
hw
Ff
Ff
Ff
Ff
Ff
Ff
Ff
Xe
Xe
Xe
Xe
Xe
Ff
Ff
Ff
Xe
Xe
Ff
Ff
Ff
Ff
Xe
Ff
Ff
Ff
Ff
Ff
Ff
Ff
Ff
Ff
Ff
Ff
FQ
FQ
FQ
FQ
FQ
"}
(34,1,1) = {"
FQ
FQ
Ff
Ff
Ff
Ff
Xe
CB
Mi
kr
eh
dU
hw
Sk
zr
qY
Me
nq
XG
XG
XG
hw
Ff
Ff
Ff
Ff
Ff
Ff
Ff
Xe
Xe
Xe
Xe
Ff
Ff
Ff
Ff
Xe
Ff
Ff
Ff
Ff
Ff
Ff
Ff
Xe
Xe
Xe
Xe
Xe
Ff
Ff
Ff
Ff
FQ
FQ
FQ
FQ
FQ
FQ
"}
(35,1,1) = {"
FQ
FQ
Ff
Ff
Ff
Xe
Xe
CB
nL
hw
hw
hw
hw
KG
xV
FN
aO
hw
XG
XG
Ak
hw
Ff
Xe
Xe
Xe
Xe
Ff
Ff
Xe
Xe
Xe
Ff
Ff
Ff
Ff
Ff
Xe
Xe
Xe
Xe
Ff
Ff
Xe
Xe
Xe
Xe
Xe
Xe
Xe
Ff
Ff
FQ
FQ
FQ
FQ
FQ
FQ
FQ
FQ
"}
(36,1,1) = {"
FQ
FQ
Ff
Ff
Xe
Xe
Xe
CB
FQ
Ff
Ff
Ff
hw
hw
hm
zj
ek
hw
XG
hw
hw
hw
Ff
Xe
Xe
Xe
Xe
Ff
Xe
Xe
Xe
Ff
Ff
Ff
Ff
Ff
Ff
Xe
Ff
Ff
Xe
Ff
Ff
Xe
Xe
Xe
Xe
Xe
Ff
Ff
Ff
FQ
FQ
FQ
FQ
FQ
FQ
FQ
FQ
FQ
"}
(37,1,1) = {"
FQ
FQ
Ff
Ff
Xe
Xe
Xe
CB
Ff
Ff
Ff
Ff
Ff
od
hw
hw
Va
hw
hw
hw
Ff
Ff
Ff
Xe
Xe
Xe
Xe
Xe
Xe
Xe
Ff
Ff
Ff
Ff
Ff
Ff
Xe
Xe
Xe
Ff
Ff
Ff
Ff
Xe
Xe
Xe
Ff
Ff
Ff
Ff
FQ
FQ
FQ
FQ
FQ
FQ
FQ
FQ
FQ
FQ
"}
(38,1,1) = {"
FQ
Ff
Ff
Ff
Ff
Ff
Xe
CB
Xe
Xe
Ff
Ff
Ff
hw
Ca
KF
EX
hw
Ff
Ff
Ff
Ff
Xe
Xe
Xe
Xe
Xe
Xe
Xe
Xe
Ff
Ff
Ff
Ff
Ff
Ff
Xe
Xe
Xe
Ff
Ff
Ff
Ff
Xe
Xe
Ff
Ff
Ff
Ff
Ff
FQ
FQ
FQ
FQ
FQ
FQ
FQ
FQ
FQ
FQ
"}
(39,1,1) = {"
FQ
Ff
Ff
Xe
Ff
Ff
Ff
CB
Xe
Xe
Ff
Ff
Ff
hw
wD
AH
mV
hw
Ff
Ff
Ff
Xe
Xe
Ff
Xe
Xe
Xe
Xe
Xe
Xe
Ff
Ff
Ff
Ff
Ff
Xe
Xe
Xe
Xe
Ff
Ff
Ff
Xe
Xe
Xe
Ff
Ff
Ff
Ff
Ff
Ff
Ff
FQ
FQ
FQ
FQ
FQ
FQ
FQ
FQ
"}
(40,1,1) = {"
FQ
Ff
Ff
Xe
Ff
Ff
Ff
CB
Xe
Xe
Xe
Ff
Ff
hw
qR
bX
Zy
hw
Ff
Ff
Ff
Xe
Ff
Ff
Ff
Xe
Xe
Xe
Xe
Xe
Ff
Ff
Ff
Ff
Ff
Xe
Xe
Xe
Ff
Ff
Xe
Xe
Xe
Xe
Xe
Ff
Ff
Ff
Ff
FQ
FQ
FQ
FQ
FQ
FQ
FQ
FQ
FQ
FQ
FQ
"}
(41,1,1) = {"
FQ
Ff
Ff
Xe
Xe
Xe
Ff
CB
Xe
Xe
Xe
Ff
Ff
Ff
hw
hw
hw
Ff
Ff
Ff
Ff
Ff
Ff
Ff
Ff
Ff
Xe
Xe
Xe
Xe
Ff
Ff
Ff
Ff
Xe
Xe
Xe
Xe
Ff
Ff
Xe
Xe
Xe
Xe
Ff
Ff
Ff
Ff
Ff
Ff
FQ
FQ
FQ
FQ
FQ
FQ
FQ
FQ
FQ
FQ
"}
(42,1,1) = {"
FQ
Ff
Ff
Xe
Xe
Xe
Ff
CB
Xe
Xe
Xe
Xe
Ff
Ff
Ff
Ff
Ff
Ff
Ff
Ff
Ff
Ff
Ff
Xe
Ff
Ff
Ff
Xe
Xe
Xe
Xe
Ff
Ff
Xe
Xe
Xe
Xe
Xe
Ff
Xe
Xe
Xe
Xe
Xe
Ff
Xe
Xe
Ff
Ff
Ff
FQ
FQ
FQ
FQ
FQ
FQ
FQ
FQ
FQ
FQ
"}
(43,1,1) = {"
FQ
Ff
Ff
Xe
Xe
Xe
Xe
CB
Xe
Xe
Xe
Xe
Xe
Ff
Ff
Ff
Ff
Xe
Xe
Ff
Ff
Ff
Xe
Xe
Xe
Ff
Ff
Xe
Xe
Xe
Xe
Xe
Ff
Xe
Xe
Xe
Ff
Ff
Ff
Xe
Xe
Xe
Xe
Xe
Ff
Xe
Xe
Ff
Ff
Ff
FQ
FQ
FQ
FQ
FQ
FQ
FQ
FQ
FQ
FQ
"}
(44,1,1) = {"
FQ
Ff
Ff
Ff
Xe
Xe
Xe
CB
Xe
Xe
Xe
Xe
Xe
Ff
Ff
Ff
Ff
Xe
Xe
Xe
Ff
Ff
Xe
Xe
Ff
Ff
Ff
Xe
Xe
Xe
Xe
Ff
Ff
Xe
Xe
Ff
Ff
Ff
Ff
Xe
Xe
Xe
Xe
Ff
Ff
Xe
Ff
Ff
Ff
Ff
FQ
FQ
FQ
FQ
FQ
FQ
FQ
FQ
FQ
FQ
"}
(45,1,1) = {"
FQ
Ff
Ff
Ff
Ff
Xe
Xe
CB
Xe
Xe
Ff
Xe
Xe
Xe
Xe
Ff
Ff
Ff
Xe
Xe
Ff
Xe
Xe
Xe
Xe
Ff
Ff
Xe
Xe
Xe
Xe
Ff
Ff
Xe
Xe
Ff
Ff
Ff
Ff
Xe
Xe
Xe
Xe
Ff
Xe
Xe
Ff
Ff
Ff
Ff
FQ
FQ
FQ
FQ
FQ
FQ
FQ
FQ
FQ
FQ
"}
(46,1,1) = {"
FQ
Ff
Ff
Ff
Ff
Xe
LK
Qg
un
Xe
Ff
Ff
Xe
Xe
Xe
Xe
Ff
Ff
Xe
Xe
Ff
Xe
Xe
Xe
Xe
Xe
Xe
Xe
Xe
Xe
Ff
Ff
Xe
Xe
Xe
Ff
Ff
Ff
Ff
Xe
Xe
Xe
Ff
Ff
Xe
Ff
Ff
Ff
Ff
FQ
FQ
FQ
FQ
FQ
FQ
FQ
FQ
FQ
FQ
FQ
"}
(47,1,1) = {"
FQ
Ff
Ff
Ff
Ff
Xe
Xe
Xe
Xe
Xe
Ff
Ff
Xe
Xe
Xe
Xe
Xe
Xe
Xe
Ff
Ff
Xe
Xe
Xe
Xe
Xe
Xe
Xe
Xe
Ff
Ff
Ff
Xe
Xe
Xe
Ff
Ff
Ff
Xe
Xe
Xe
Xe
Ff
Ff
Ff
Ff
Ff
Ff
Ff
FQ
FQ
FQ
FQ
FQ
ux
FQ
FQ
FQ
FQ
FQ
"}
(48,1,1) = {"
FQ
Ff
FQ
Ff
Ff
Ff
Xe
Xe
Xe
Xe
Ff
Ff
Xe
Xe
Xe
Xe
Xe
Xe
Xe
Ff
Xe
Xe
Xe
Xe
Ff
Xe
Xe
Xe
Ff
Ff
Ff
Xe
Xe
Xe
Xe
Ff
Ff
Ff
Xe
Xe
Xe
Xe
Ff
Ff
Ff
Ff
Ff
Ff
Ff
FQ
FQ
FQ
FQ
FQ
ux
FQ
FQ
FQ
FQ
FQ
"}
(49,1,1) = {"
FQ
FQ
FQ
Ff
Ff
Ff
Ff
Xe
Xe
Xe
Ff
Ff
Xe
Xe
Xe
Xe
Xe
Xe
Xe
Xe
Xe
Xe
Xe
Xe
Ff
Ff
Xe
Xe
Xe
Ff
Xe
Xe
Xe
Xe
Xe
Ff
Ff
Ff
Xe
Xe
Xe
Xe
Ff
Ff
Ff
Ff
Ff
Ff
FQ
FQ
FQ
FQ
FQ
FQ
ux
FQ
FQ
FQ
FQ
FQ
"}
(50,1,1) = {"
FQ
FQ
FQ
FQ
Ff
Ff
Ff
Ff
Xe
Xe
Ff
Ff
Xe
Xe
Xe
Xe
Xe
Ff
Ff
Ff
Xe
Xe
Xe
Ff
Ff
Ff
Xe
Xe
Xe
Ff
Xe
Xe
Xe
Xe
Xe
Xe
Xe
Xe
Xe
Xe
Xe
Xe
Ff
Ff
Ff
Ff
Ff
Ff
FQ
FQ
FQ
FQ
FQ
FQ
ux
FQ
FQ
FQ
FQ
FQ
"}
(51,1,1) = {"
FQ
FQ
FQ
FQ
Ff
Ff
Ff
Ff
Xe
Ff
Ff
Ff
Ff
Xe
Xe
Xe
Ff
Ff
Ff
Xe
Xe
Xe
Ff
Ff
Ff
Xe
Xe
Xe
Xe
Ff
Xe
Xe
Xe
Xe
Xe
Xe
Xe
Xe
Xe
Xe
Xe
Xe
Ff
Ff
Ff
Ff
FQ
FQ
FQ
FQ
FQ
FQ
FQ
FQ
ux
FQ
FQ
FQ
FQ
FQ
"}
(52,1,1) = {"
FQ
FQ
FQ
FQ
FQ
FQ
Ff
Ff
Ff
Ff
Ff
Ff
Ff
Ff
Xe
Xe
Ff
Ff
Ff
Xe
Xe
Xe
Ff
Ff
Xe
Xe
Xe
Xe
Ff
Ff
Ff
Ff
Ff
Xe
Xe
Xe
Xe
Xe
Xe
Xe
Xe
Xe
Ff
Ff
Ff
FQ
FQ
FQ
FQ
FQ
FQ
FQ
FQ
FQ
FQ
FQ
FQ
FQ
FQ
FQ
"}
(53,1,1) = {"
FQ
FQ
FQ
FQ
FQ
FQ
FQ
Ff
Ff
Ff
Ff
Ff
Ff
Ff
Ff
Ff
Ff
Ff
Ff
Ff
Xe
Xe
Xe
Xe
Xe
Xe
Xe
Xe
Ff
Ff
Ff
Ff
Ff
Ff
Xe
Xe
Xe
Xe
Xe
Ff
Ff
Ff
Ff
Ff
FQ
FQ
FQ
FQ
FQ
FQ
FQ
FQ
FQ
FQ
FQ
FQ
FQ
FQ
FQ
FQ
"}
(54,1,1) = {"
FQ
FQ
FQ
FQ
FQ
FQ
FQ
FQ
FQ
FQ
Ff
Ff
Ff
Ff
Ff
Ff
Ff
Ff
Ff
Ff
Xe
Xe
Xe
Xe
Xe
Xe
Xe
Ff
Ff
Ff
Ff
Ff
Ff
Ff
Xe
Xe
Xe
Xe
Ff
Ff
Ff
Ff
Ff
FQ
FQ
FQ
FQ
FQ
FQ
FQ
FQ
FQ
FQ
FQ
FQ
FQ
FQ
FQ
FQ
FQ
"}
(55,1,1) = {"
FQ
FQ
FQ
FQ
FQ
FQ
FQ
FQ
FQ
FQ
FQ
FQ
FQ
FQ
FQ
FQ
Ff
Ff
Ff
Ff
Xe
Xe
Xe
Xe
Xe
Xe
Ff
Ff
Ff
Ff
Ff
FQ
Ff
Ff
Ff
Ff
Xe
Ff
Ff
Ff
FQ
FQ
Ff
FQ
FQ
FQ
FQ
FQ
FQ
FQ
FQ
FQ
FQ
FQ
FQ
FQ
FQ
FQ
FQ
FQ
"}
(56,1,1) = {"
FQ
FQ
FQ
FQ
FQ
FQ
FQ
FQ
FQ
FQ
FQ
FQ
FQ
FQ
FQ
FQ
FQ
FQ
Ff
Ff
Ff
Xe
Xe
Xe
Ff
Ff
Ff
Ff
FQ
Ff
Ff
FQ
FQ
Ff
Ff
Ff
Ff
Ff
Ff
Ff
FQ
FQ
FQ
FQ
FQ
FQ
FQ
FQ
FQ
FQ
FQ
FQ
FQ
FQ
FQ
FQ
FQ
FQ
FQ
FQ
"}
(57,1,1) = {"
FQ
FQ
FQ
FQ
FQ
FQ
FQ
FQ
FQ
FQ
FQ
FQ
FQ
FQ
FQ
FQ
FQ
FQ
Ff
Ff
Ff
Ff
Ff
Ff
Ff
Ff
Ff
FQ
FQ
FQ
FQ
FQ
FQ
FQ
Ff
Ff
Ff
FQ
FQ
FQ
FQ
FQ
FQ
FQ
FQ
FQ
FQ
FQ
FQ
FQ
FQ
FQ
FQ
FQ
FQ
FQ
FQ
FQ
FQ
FQ
"}
(58,1,1) = {"
FQ
FQ
FQ
FQ
FQ
FQ
FQ
FQ
FQ
FQ
FQ
FQ
FQ
FQ
FQ
FQ
FQ
FQ
FQ
FQ
Ff
Ff
Ff
Ff
Ff
Ff
FQ
FQ
FQ
FQ
FQ
FQ
FQ
FQ
FQ
FQ
Ff
FQ
FQ
FQ
FQ
FQ
FQ
FQ
FQ
FQ
FQ
FQ
FQ
FQ
FQ
FQ
FQ
FQ
FQ
FQ
FQ
FQ
FQ
FQ
"}
(59,1,1) = {"
FQ
FQ
FQ
FQ
FQ
FQ
FQ
FQ
FQ
FQ
FQ
FQ
FQ
FQ
FQ
FQ
FQ
FQ
FQ
FQ
FQ
FQ
FQ
FQ
FQ
FQ
FQ
FQ
FQ
FQ
FQ
FQ
FQ
FQ
FQ
FQ
FQ
FQ
FQ
FQ
FQ
FQ
FQ
FQ
FQ
FQ
FQ
FQ
FQ
FQ
FQ
FQ
FQ
FQ
FQ
FQ
FQ
FQ
FQ
FQ
"}
(60,1,1) = {"
FQ
FQ
FQ
FQ
FQ
FQ
FQ
FQ
FQ
FQ
FQ
FQ
FQ
FQ
FQ
FQ
FQ
FQ
FQ
FQ
FQ
FQ
FQ
FQ
FQ
FQ
FQ
FQ
FQ
FQ
FQ
FQ
FQ
FQ
FQ
FQ
FQ
FQ
FQ
FQ
FQ
FQ
FQ
FQ
FQ
FQ
FQ
FQ
FQ
FQ
FQ
FQ
FQ
FQ
FQ
FQ
FQ
FQ
FQ
FQ
"}
