//MAP CONVERTED BY dmm2tgm.py THIS HEADER COMMENT PREVENTS RECONVERSION, DO NOT REMOVE
"ac" = (
/obj/effect/turf_decal/stripes/white{
	dir = 1
	},
/obj/machinery/atmospherics/pipe/simple/cyan/visible{
	dir = 5
	},
/turf/open/floor/engine,
/area/whitesands/surface/outdoors/unexplored)
"aO" = (
/obj/machinery/atmospherics/pipe/simple/cyan/visible{
	dir = 6
	},
/turf/open/floor/engine,
/area/whitesands/surface/outdoors/unexplored)
"bs" = (
/obj/effect/turf_decal/stripes/white{
	dir = 4
	},
/turf/open/floor/engine,
/area/whitesands/surface/outdoors/unexplored)
"cl" = (
/obj/item/clothing/head/hardhat/red{
	desc = "A piece of headgear used in dangerous working conditions to protect the head. On closer inspection it apears to be a regular hardhat painted red.";
	name = "syndicate hardhat"
	},
/obj/machinery/atmospherics/components/unary/portables_connector/visible{
	dir = 8
	},
/turf/open/floor/plating{
	icon_state = "panelscorched"
	},
/area/whitesands/surface/outdoors/unexplored)
"cs" = (
/obj/structure/door_assembly/door_assembly_hatch,
/turf/open/floor/plating,
/area/whitesands/surface/outdoors/unexplored)
"cG" = (
/obj/item/toy/plush/lizardplushie,
/turf/open/floor/plating/asteroid/whitesands,
/area/whitesands/surface/outdoors/unexplored)
"cL" = (
/obj/structure/safe/floor,
/obj/item/clothing/suit/space/hardsuit/syndi,
/obj/item/documents/syndicate,
/turf/open/floor/plating{
	icon_state = "panelscorched"
	},
/area/whitesands/surface/outdoors/unexplored)
"cO" = (
/obj/machinery/atmospherics/pipe/simple/scrubbers,
/turf/open/floor/plating{
	icon_state = "platingdmg1"
	},
/area/whitesands/surface/outdoors/unexplored)
"dw" = (
/obj/effect/turf_decal/stripes/white{
	dir = 5
	},
/turf/open/floor/engine,
/area/whitesands/surface/outdoors/unexplored)
"dz" = (
/obj/machinery/atmospherics/pipe/simple/scrubbers{
	dir = 8
	},
/turf/open/floor/engine,
/area/whitesands/surface/outdoors/unexplored)
"fx" = (
/obj/item/storage/firstaid/ancient,
/turf/open/floor/plating/asteroid/whitesands,
/area/whitesands/surface/outdoors/unexplored)
"fy" = (
/obj/effect/turf_decal/tile/blue,
/obj/effect/turf_decal/tile/blue{
	dir = 8
	},
/turf/open/floor/plasteel/dark,
/area/whitesands/surface/outdoors/unexplored)
"fz" = (
/obj/effect/turf_decal/bot,
/obj/machinery/portable_atmospherics/canister/toxins,
/obj/machinery/atmospherics/components/unary/portables_connector/visible{
	dir = 8
	},
/turf/open/floor/plasteel/dark,
/area/whitesands/surface/outdoors/unexplored)
"fB" = (
/obj/machinery/atmospherics/pipe/simple/cyan/visible{
	dir = 8
	},
/turf/open/floor/plating{
	icon_state = "platingdmg1"
	},
/area/whitesands/surface/outdoors/unexplored)
"fG" = (
/obj/effect/turf_decal/stripes/white{
	dir = 1
	},
/obj/machinery/atmospherics/pipe/simple/cyan/visible{
	dir = 8
	},
/turf/open/floor/engine,
/area/whitesands/surface/outdoors/unexplored)
"gW" = (
/obj/item/circuitboard/machine/sleeper,
/turf/open/floor/plating{
	icon_state = "platingdmg1"
	},
/area/whitesands/surface/outdoors/unexplored)
"hp" = (
/obj/machinery/atmospherics/pipe/simple/scrubbers{
	dir = 10
	},
/turf/open/floor/plating{
	icon_state = "platingdmg1"
	},
/area/whitesands/surface/outdoors/unexplored)
"hs" = (
/obj/machinery/atmospherics/pipe/simple/scrubbers,
/turf/open/floor/plating{
	icon_state = "panelscorched"
	},
/area/whitesands/surface/outdoors/unexplored)
"hD" = (
/obj/item/stack/tile/plasteel,
/turf/open/floor/plating/asteroid/whitesands/dried,
/area/whitesands/surface/outdoors/unexplored)
"hK" = (
/obj/machinery/atmospherics/pipe/simple/cyan/visible{
	dir = 8
	},
/turf/open/floor/plating,
/area/whitesands/surface/outdoors/unexplored)
"hS" = (
/obj/item/pickaxe/improvised,
/turf/open/floor/plating/asteroid/whitesands,
/area/whitesands/surface/outdoors/unexplored)
"iz" = (
/obj/structure/chair/comfy,
/turf/open/floor/plating{
	icon_state = "panelscorched"
	},
/area/whitesands/surface/outdoors/unexplored)
"iR" = (
/obj/machinery/atmospherics/components/binary/pump{
	dir = 4
	},
/turf/open/floor/plating{
	icon_state = "panelscorched"
	},
/area/whitesands/surface/outdoors/unexplored)
"iU" = (
/obj/machinery/atmospherics/pipe/manifold/dark/visible{
	dir = 4
	},
/turf/open/floor/engine,
/area/whitesands/surface/outdoors/unexplored)
"kE" = (
/obj/machinery/atmospherics/pipe/manifold/scrubbers/visible{
	dir = 4
	},
/turf/open/floor/engine,
/area/whitesands/surface/outdoors/unexplored)
"la" = (
/obj/machinery/power/generator,
/turf/open/floor/engine,
/area/whitesands/surface/outdoors/unexplored)
"mC" = (
/obj/structure/window/plasma/reinforced/plastitanium/unanchored,
/obj/machinery/atmospherics/pipe/simple/scrubbers,
/turf/open/floor/plating{
	icon_state = "platingdmg1"
	},
/area/whitesands/surface/outdoors/unexplored)
"nI" = (
/obj/machinery/suit_storage_unit{
	mask_type = /obj/item/clothing/mask/gas/syndicate;
	storage_type = null
	},
/turf/open/floor/mineral/plastitanium/red,
/area/whitesands/surface/outdoors/unexplored)
"nJ" = (
/mob/living/simple_animal/hostile/syndicate/ranged,
/turf/open/floor/plating,
/area/whitesands/surface/outdoors/unexplored)
"og" = (
/obj/machinery/atmospherics/components/unary/thermomachine/freezer{
	dir = 8
	},
/turf/open/floor/engine,
/area/whitesands/surface/outdoors/unexplored)
"oE" = (
/obj/effect/turf_decal/stripes/white{
	dir = 1
	},
/obj/machinery/atmospherics/components/binary/pump,
/obj/machinery/atmospherics/pipe/simple/dark/visible{
	dir = 8
	},
/turf/open/floor/engine,
/area/whitesands/surface/outdoors/unexplored)
"oZ" = (
/obj/machinery/atmospherics/pipe/simple/scrubbers{
	dir = 8
	},
/turf/open/floor/plating{
	icon_state = "panelscorched"
	},
/area/whitesands/surface/outdoors/unexplored)
"pj" = (
/obj/machinery/atmospherics/pipe/simple/cyan/visible,
/turf/open/floor/engine,
/area/whitesands/surface/outdoors/unexplored)
"pn" = (
/obj/machinery/atmospherics/pipe/simple/scrubbers{
	dir = 8
	},
/turf/open/floor/plating/asteroid/whitesands,
/area/whitesands/surface/outdoors/unexplored)
"qv" = (
/mob/living/simple_animal/hostile/syndicate/ranged/space/stormtrooper,
/turf/open/floor/plating{
	icon_state = "panelscorched"
	},
/area/whitesands/surface/outdoors/unexplored)
"qN" = (
/obj/machinery/portable_atmospherics/canister/toxins,
/turf/open/floor/plating{
	icon_state = "panelscorched"
	},
/area/whitesands/surface/outdoors/unexplored)
"se" = (
/obj/structure/frame/machine,
/obj/item/circuitboard/machine/smes,
/obj/item/stock_parts/capacitor,
/obj/item/stack/cable_coil/cut/blue,
/obj/item/stock_parts/cell/empty,
/turf/open/floor/plating{
	icon_state = "platingdmg2"
	},
/area/whitesands/surface/outdoors/unexplored)
"sC" = (
/obj/machinery/atmospherics/pipe/manifold/cyan/visible{
	dir = 8
	},
/turf/open/floor/plating,
/area/whitesands/surface/outdoors/unexplored)
"sI" = (
/obj/effect/turf_decal/delivery,
/obj/machinery/portable_atmospherics/canister/toxins,
/turf/open/floor/plasteel/dark,
/area/whitesands/surface/outdoors/unexplored)
"sS" = (
/obj/effect/turf_decal/stripes/white{
	dir = 8
	},
/turf/open/floor/engine,
/area/whitesands/surface/outdoors/unexplored)
"tw" = (
/turf/open/floor/plasteel/dark,
/area/whitesands/surface/outdoors/unexplored)
"ue" = (
/obj/effect/turf_decal/bot,
/obj/machinery/portable_atmospherics/canister/toxins,
/obj/machinery/atmospherics/components/unary/portables_connector/visible{
	dir = 4
	},
/turf/open/floor/plasteel/dark,
/area/whitesands/surface/outdoors/unexplored)
"uW" = (
/obj/item/stack/sheet/metal,
/turf/open/floor/plating/asteroid/whitesands,
/area/whitesands/surface/outdoors/unexplored)
"vl" = (
/obj/structure/window/plasma/reinforced/plastitanium/unanchored,
/turf/open/floor/plating{
	icon_state = "platingdmg1"
	},
/area/whitesands/surface/outdoors/unexplored)
"vJ" = (
/obj/machinery/door/airlock/hatch,
/turf/open/floor/plasteel/dark,
/area/whitesands/surface/outdoors/unexplored)
"vN" = (
/obj/effect/turf_decal/stripes/white{
	dir = 1
	},
/obj/machinery/atmospherics/pipe/simple/dark/visible{
	dir = 8
	},
/turf/open/floor/engine,
/area/whitesands/surface/outdoors/unexplored)
"vS" = (
/obj/item/stack/sheet/metal,
/turf/open/floor/plating{
	icon_state = "platingdmg1"
	},
/area/whitesands/surface/outdoors/unexplored)
"vW" = (
/obj/machinery/door/airlock/engineering,
/turf/open/floor/plating,
/area/whitesands/surface/outdoors/unexplored)
"wg" = (
/obj/item/storage/toolbox/syndicate,
/turf/open/floor/engine,
/area/whitesands/surface/outdoors/unexplored)
"wB" = (
/obj/machinery/portable_atmospherics/scrubber,
/turf/open/floor/plating/asteroid/whitesands,
/area/whitesands/surface/outdoors/unexplored)
"xc" = (
/turf/open/floor/mineral/plastitanium/red,
/area/whitesands/surface/outdoors/unexplored)
"xK" = (
/obj/machinery/suit_storage_unit,
/turf/open/floor/plating,
/area/whitesands/surface/outdoors/unexplored)
"xZ" = (
/obj/machinery/atmospherics/pipe/manifold/scrubbers/visible,
/turf/open/floor/plating{
	icon_state = "platingdmg1"
	},
/area/whitesands/surface/outdoors/unexplored)
"yM" = (
/obj/item/clothing/shoes/jackboots,
/turf/open/floor/plating/asteroid/whitesands,
/area/whitesands/surface/outdoors/unexplored)
"yV" = (
/obj/structure/frame/machine,
/obj/item/circuitboard/machine/sleeper,
/turf/open/floor/plating{
	icon_state = "panelscorched"
	},
/area/whitesands/surface/outdoors/unexplored)
"zk" = (
/obj/effect/turf_decal/stripes/white{
	dir = 1
	},
/turf/open/floor/engine,
/area/whitesands/surface/outdoors/unexplored)
"Ab" = (
/mob/living/simple_animal/hostile/syndicate/ranged/shotgun,
/turf/open/floor/plating/asteroid/whitesands,
/area/whitesands/surface/outdoors/unexplored)
"Aj" = (
/obj/item/stock_parts/cell/empty{
	pixel_x = 5;
	pixel_y = -6
	},
/obj/machinery/power/terminal{
	dir = 1
	},
/turf/open/floor/plating/asteroid/whitesands/dried,
/area/whitesands/surface/outdoors/unexplored)
"AF" = (
/obj/effect/turf_decal/loading_area/red,
/turf/open/floor/plasteel/dark,
/area/whitesands/surface/outdoors/unexplored)
"Ba" = (
/obj/effect/turf_decal/stripes/corner{
	dir = 4
	},
/obj/machinery/atmospherics/pipe/simple/scrubbers{
	dir = 6
	},
/turf/open/floor/engine,
/area/whitesands/surface/outdoors/unexplored)
"Bk" = (
/mob/living/simple_animal/hostile/syndicate/ranged/smg/space,
/turf/open/floor/plating{
	icon_state = "platingdmg2"
	},
/area/whitesands/surface/outdoors/unexplored)
"Cf" = (
/obj/machinery/atmospherics/pipe/simple/scrubbers{
	dir = 5
	},
/turf/open/floor/plating{
	icon_state = "platingdmg1"
	},
/area/whitesands/surface/outdoors/unexplored)
"CF" = (
/obj/machinery/atmospherics/components/binary/circulator/cold{
	dir = 8
	},
/turf/open/floor/engine,
/area/whitesands/surface/outdoors/unexplored)
"Dl" = (
/obj/item/stack/sheet/metal,
/obj/item/stack/sheet/metal,
/turf/open/floor/plating/asteroid/whitesands,
/area/whitesands/surface/outdoors/unexplored)
"Dn" = (
/obj/effect/turf_decal/tile/yellow{
	dir = 4
	},
/turf/open/floor/plasteel/dark,
/area/whitesands/surface/outdoors/unexplored)
"DE" = (
/obj/machinery/atmospherics/components/binary/pump{
	dir = 1
	},
/turf/open/floor/plating{
	icon_state = "platingdmg1"
	},
/area/whitesands/surface/outdoors/unexplored)
"Ec" = (
/obj/effect/decal/remains/human,
/obj/effect/decal/cleanable/blood/old,
/obj/item/clothing/under/syndicate{
	pixel_y = -11
	},
/turf/open/floor/plating/asteroid/whitesands,
/area/whitesands/surface/outdoors/unexplored)
"Ed" = (
/obj/effect/turf_decal/stripes/white{
	dir = 1
	},
/obj/machinery/atmospherics/pipe/simple/scrubbers,
/turf/open/floor/engine,
/area/whitesands/surface/outdoors/unexplored)
"Ep" = (
/obj/structure/frame/machine,
/turf/open/floor/plating{
	icon_state = "platingdmg1"
	},
/area/whitesands/surface/outdoors/unexplored)
"EG" = (
/obj/effect/turf_decal/tile/blue,
/turf/open/floor/plasteel/dark,
/area/whitesands/surface/outdoors/unexplored)
"EJ" = (
/obj/machinery/atmospherics/pipe/simple/dark/visible{
	dir = 5
	},
/turf/open/floor/plating/asteroid/whitesands{
	dir = 8
	},
/area/whitesands/surface/outdoors/unexplored)
"EM" = (
/obj/item/clothing/neck/stethoscope,
/turf/open/floor/plating,
/area/whitesands/surface/outdoors/unexplored)
"EX" = (
/turf/open/floor/engine,
/area/whitesands/surface/outdoors/unexplored)
"Fw" = (
/obj/effect/turf_decal/tile/yellow{
	dir = 4
	},
/obj/effect/turf_decal/tile/yellow{
	dir = 1
	},
/turf/open/floor/plasteel/dark,
/area/whitesands/surface/outdoors/unexplored)
"Fz" = (
/obj/machinery/portable_atmospherics/scrubber,
/turf/open/floor/plating{
	icon_state = "platingdmg1"
	},
/area/whitesands/surface/outdoors/unexplored)
"FZ" = (
/obj/item/stock_parts/cell/empty,
/obj/item/stock_parts/cell/empty{
	pixel_x = -8;
	pixel_y = -7
	},
/obj/item/stock_parts/cell/empty{
	pixel_x = 6;
	pixel_y = -10
	},
/obj/item/storage/box/stockparts/deluxe,
/turf/open/floor/plating/asteroid/whitesands,
/area/whitesands/surface/outdoors/unexplored)
"Gu" = (
/obj/machinery/atmospherics/components/unary/portables_connector/visible,
/obj/machinery/portable_atmospherics/canister/oxygen,
/turf/open/floor/plating{
	icon_state = "platingdmg1"
	},
/area/whitesands/surface/outdoors/unexplored)
"GE" = (
/obj/machinery/atmospherics/pipe/simple/cyan/visible{
	dir = 9
	},
/turf/open/floor/plating{
	icon_state = "platingdmg1"
	},
/area/whitesands/surface/outdoors/unexplored)
"GV" = (
/obj/machinery/atmospherics/components/unary/portables_connector/visible,
/obj/machinery/portable_atmospherics/canister/toxins,
/turf/open/floor/plating,
/area/whitesands/surface/outdoors/unexplored)
"IC" = (
/obj/structure/frame/machine,
/turf/open/floor/engine,
/area/whitesands/surface/outdoors/unexplored)
"IR" = (
/obj/item/stack/cable_coil/cut/blue,
/obj/item/stack/tile/plasteel,
/turf/open/floor/plating/asteroid/whitesands/dried,
/area/whitesands/surface/outdoors/unexplored)
"Jl" = (
/obj/item/stack/sheet/metal,
/obj/machinery/atmospherics/components/binary/pump{
	dir = 1
	},
/turf/open/floor/plating/asteroid/whitesands,
/area/whitesands/surface/outdoors/unexplored)
"JT" = (
/turf/open/floor/pod/dark,
/area/whitesands/surface/outdoors/unexplored)
"Kc" = (
/obj/effect/decal/cleanable/ash,
/obj/effect/decal/cleanable/ash{
	pixel_x = 3;
	pixel_y = -3
	},
/obj/effect/decal/cleanable/ash{
	pixel_x = 2;
	pixel_y = -2
	},
/turf/open/floor/plating{
	icon_state = "panelscorched"
	},
/area/whitesands/surface/outdoors/unexplored)
"Kw" = (
/turf/open/floor/plating/asteroid/whitesands,
/area/whitesands/surface/outdoors/unexplored)
"LB" = (
/obj/item/clothing/gloves/combat,
/turf/open/floor/plating/asteroid/whitesands,
/area/whitesands/surface/outdoors/unexplored)
"LE" = (
/obj/machinery/atmospherics/pipe/simple/cyan/visible{
	dir = 10
	},
/turf/open/floor/plating,
/area/whitesands/surface/outdoors/unexplored)
"LJ" = (
/obj/machinery/atmospherics/pipe/simple/dark/visible{
	dir = 10
	},
/turf/open/floor/plating{
	icon_state = "platingdmg1"
	},
/area/whitesands/surface/outdoors/unexplored)
"LR" = (
/obj/machinery/atmospherics/pipe/simple/dark/visible{
	dir = 8
	},
/turf/open/floor/plating{
	icon_state = "platingdmg1"
	},
/area/whitesands/surface/outdoors/unexplored)
"Mc" = (
/obj/item/stack/sheet/metal,
/turf/open/floor/engine,
/area/whitesands/surface/outdoors/unexplored)
"Mm" = (
/obj/effect/turf_decal/radiation,
/turf/open/floor/plasteel/dark,
/area/whitesands/surface/outdoors/unexplored)
"Mx" = (
/obj/machinery/atmospherics/pipe/simple/scrubbers{
	dir = 10
	},
/turf/open/floor/engine,
/area/whitesands/surface/outdoors/unexplored)
"MC" = (
/turf/template_noop,
/area/whitesands/surface/outdoors/unexplored)
"Ne" = (
/obj/machinery/atmospherics/components/binary/pump,
/turf/open/floor/plating,
/area/whitesands/surface/outdoors/unexplored)
"Nf" = (
/obj/machinery/atmospherics/pipe/simple/scrubbers{
	dir = 8
	},
/turf/open/floor/plating,
/area/whitesands/surface/outdoors/unexplored)
"Nk" = (
/obj/machinery/atmospherics/pipe/manifold/cyan/visible,
/turf/open/floor/engine,
/area/whitesands/surface/outdoors/unexplored)
"NC" = (
/obj/machinery/atmospherics/components/binary/circulator{
	dir = 4
	},
/turf/open/floor/engine,
/area/whitesands/surface/outdoors/unexplored)
"NM" = (
/obj/machinery/power/smes,
/turf/open/floor/plating{
	icon_state = "panelscorched"
	},
/area/whitesands/surface/outdoors/unexplored)
"Oe" = (
/obj/machinery/atmospherics/components/binary/pump,
/turf/open/floor/engine,
/area/whitesands/surface/outdoors/unexplored)
"OI" = (
/turf/open/floor/plating,
/area/whitesands/surface/outdoors/unexplored)
"ON" = (
/obj/machinery/power/smes,
/turf/open/floor/plating{
	icon_state = "platingdmg2"
	},
/area/whitesands/surface/outdoors/unexplored)
"Pm" = (
/obj/machinery/atmospherics/components/unary/portables_connector/visible{
	dir = 4
	},
/obj/effect/turf_decal/bot,
/turf/open/floor/plasteel/dark,
/area/whitesands/surface/outdoors/unexplored)
"RE" = (
/obj/machinery/atmospherics/pipe/manifold/scrubbers/visible{
	dir = 4
	},
/turf/open/floor/plating{
	icon_state = "platingdmg1"
	},
/area/whitesands/surface/outdoors/unexplored)
"RJ" = (
/turf/template_noop,
/area/template_noop)
"Tg" = (
/obj/effect/decal/cleanable/ash,
/obj/item/paper{
	desc = null;
	info = "Well, we failed. The undoable has been done. We were taken out. The great Starfury is stuck in orbit, and many of our systems are damaged. There is no other choice but to evacuate. However, me and a group of talented indviduals will go with me. I will activate the hyperdrive, one last time to scuttle the ship before Nanotrasen can get their grubby little hands on it, on the planet of our greatest victory.  If you are worried about me, I have my tegu plushie and all i need to survive for a year. Men and women, its been a honour.";
	name = "Starfury Status Report - January 15th, 2501"
	},
/turf/open/floor/plating{
	icon_state = "panelscorched"
	},
/area/whitesands/surface/outdoors/unexplored)
"Tl" = (
/obj/structure/frame/machine,
/obj/item/stack/cable_coil/cut/blue,
/turf/open/floor/mineral/plastitanium/red,
/area/whitesands/surface/outdoors/unexplored)
"Tm" = (
/obj/effect/turf_decal/tile/blue{
	dir = 8
	},
/turf/open/floor/plasteel/dark,
/area/whitesands/surface/outdoors/unexplored)
"Tt" = (
/turf/open/floor/plating/asteroid/whitesands/dried,
/area/whitesands/surface/outdoors/unexplored)
"Tx" = (
/obj/machinery/atmospherics/pipe/simple/scrubbers,
/turf/open/floor/engine,
/area/whitesands/surface/outdoors/unexplored)
"Uc" = (
/turf/open/floor/plating{
	icon_state = "platingdmg2"
	},
/area/whitesands/surface/outdoors/unexplored)
"Uv" = (
/obj/machinery/power/terminal{
	dir = 1
	},
/turf/open/floor/plating{
	icon_state = "platingdmg1"
	},
/area/whitesands/surface/outdoors/unexplored)
"Va" = (
/turf/closed/mineral/random/whitesands,
/area/whitesands/surface/outdoors/unexplored)
"Vc" = (
/turf/open/floor/plating{
	icon_state = "platingdmg1"
	},
/area/whitesands/surface/outdoors/unexplored)
"Vv" = (
/obj/machinery/atmospherics/pipe/manifold/cyan/visible{
	dir = 8
	},
/turf/open/floor/engine,
/area/whitesands/surface/outdoors/unexplored)
"VA" = (
/obj/machinery/atmospherics/pipe/simple/dark/visible,
/turf/closed/wall/r_wall/syndicate,
/area/whitesands/surface/outdoors/unexplored)
"VQ" = (
/obj/structure/frame/machine,
/turf/open/floor/plating,
/area/whitesands/surface/outdoors/unexplored)
"Wc" = (
/turf/closed/wall/r_wall/syndicate,
/area/whitesands/surface/outdoors/unexplored)
"Wd" = (
/obj/effect/turf_decal/stripes/white{
	dir = 1
	},
/obj/machinery/atmospherics/pipe/simple/dark/visible{
	dir = 5
	},
/turf/open/floor/engine,
/area/whitesands/surface/outdoors/unexplored)
"We" = (
/obj/machinery/atmospherics/pipe/simple/cyan/visible,
/turf/open/floor/plating{
	icon_state = "platingdmg1"
	},
/area/whitesands/surface/outdoors/unexplored)
"XV" = (
/turf/open/floor/plating{
	icon_state = "panelscorched"
	},
/area/whitesands/surface/outdoors/unexplored)
"XX" = (
/obj/machinery/atmospherics/pipe/simple/cyan/visible,
/turf/open/floor/plating,
/area/whitesands/surface/outdoors/unexplored)
"Yx" = (
/obj/machinery/atmospherics/pipe/manifold/scrubbers/visible{
	dir = 1
	},
/turf/open/floor/plating/asteroid/whitesands,
/area/whitesands/surface/outdoors/unexplored)
"YL" = (
/obj/machinery/atmospherics/pipe/simple/cyan/visible,
/obj/item/pipe_dispenser,
/turf/open/floor/plating{
	icon_state = "panelscorched"
	},
/area/whitesands/surface/outdoors/unexplored)
"ZJ" = (
/obj/effect/decal/cleanable/ash/large,
/turf/open/floor/plating{
	icon_state = "panelscorched"
	},
/area/whitesands/surface/outdoors/unexplored)
"ZP" = (
/obj/item/stack/sheet/metal,
/obj/item/stack/sheet/metal,
/obj/item/stack/sheet/metal,
/obj/machinery/atmospherics/pipe/simple/cyan/visible{
	dir = 8
	},
/turf/open/floor/plating{
	icon_state = "platingdmg1"
	},
/area/whitesands/surface/outdoors/unexplored)

(1,1,1) = {"
RJ
RJ
RJ
Va
Va
Va
Va
Va
Va
Va
Va
Va
NM
Aj
Va
Va
Va
MC
Va
Va
Va
Va
Va
RJ
RJ
"}
(2,1,1) = {"
RJ
RJ
Va
Va
Va
Va
Va
Va
Va
Va
Va
Wc
se
FZ
hD
wB
Va
MC
Wc
Wc
Wc
Wc
Va
Va
RJ
"}
(3,1,1) = {"
RJ
RJ
Va
Va
Va
Va
Kw
Vc
Wc
Va
Va
Wc
ON
Uv
IR
Va
Wc
vl
Wc
Kw
Kw
Kw
Va
Va
RJ
"}
(4,1,1) = {"
RJ
Va
Va
Va
Va
Kw
OI
Kw
Wc
Wc
Wc
Wc
Wc
Wc
vW
Wc
Wc
Vc
Kw
XV
Kw
Kw
Va
Va
Va
"}
(5,1,1) = {"
RJ
Va
Va
Va
Va
XV
XV
Vc
tw
Mm
AF
vW
XV
Kw
XV
Kw
XV
sS
sS
GV
EJ
Uc
Va
Va
Va
"}
(6,1,1) = {"
RJ
Va
Va
Va
Va
Va
Uc
Kw
XV
Mm
AF
vW
zk
Mc
Ab
Vc
EX
XV
Vc
Gu
iU
Wd
Va
Va
Va
"}
(7,1,1) = {"
Va
Va
Wc
Va
Wc
Wc
tw
Kw
Wc
Wc
Wc
Wc
dw
Ba
Tx
vS
Tx
Tx
Tx
cO
Cf
vN
Va
Va
Va
"}
(8,1,1) = {"
Va
Va
Va
fx
gW
Wc
Kw
OI
Wc
XV
ZJ
Wc
Wc
pn
Vc
Dl
XV
qN
Vc
EX
dz
LR
Wc
Va
Va
"}
(9,1,1) = {"
Va
Wc
Wc
Uc
Kw
Wc
Dn
EG
Wc
iz
Tg
Wc
Wc
oZ
Fz
XV
Vc
ue
Pm
Vc
Yx
oE
Va
Va
Va
"}
(10,1,1) = {"
Va
Va
Va
Kw
Uc
cs
Fw
fy
vJ
qv
Kc
Wc
Wc
Nf
OI
OI
Kw
hp
xZ
EX
iR
LJ
VA
Va
Va
"}
(11,1,1) = {"
Va
Va
Va
EM
OI
Wc
Uc
Tm
Wc
XV
XV
Wc
Wc
Mx
Tx
Jl
NC
DE
kE
hs
RE
Ed
mC
Va
Va
"}
(12,1,1) = {"
RJ
Va
Va
Va
VQ
Wc
tw
tw
Wc
cL
yV
Wc
Wc
XV
EX
EX
la
EX
OI
EX
EX
Uc
vl
Va
Va
"}
(13,1,1) = {"
RJ
Va
Va
Wc
Wc
Wc
vJ
vJ
Wc
Wc
Wc
Wc
Wc
aO
We
Oe
CF
Ne
sC
YL
XX
ac
vl
Va
Va
"}
(14,1,1) = {"
RJ
Va
Va
Va
Va
Va
XV
Vc
nI
xK
Tl
Wc
Wc
hK
OI
nJ
EX
aO
Nk
EX
XV
fB
Wc
Va
Va
"}
(15,1,1) = {"
RJ
Va
Va
Va
Va
Va
Kw
Kw
Vc
Bk
JT
Wc
Wc
ZP
uW
Kw
wg
fz
cl
EX
Vc
fG
Va
Va
Va
"}
(16,1,1) = {"
RJ
RJ
Va
Va
Va
Va
Kw
Kw
xc
Uc
OI
Wc
Wc
hK
uW
Vc
EX
Vc
sI
XV
Vc
fB
Wc
Va
Va
"}
(17,1,1) = {"
RJ
RJ
Va
Va
Va
Va
Kw
Kw
Kw
Kw
Kw
Wc
Va
LE
XX
XX
pj
Vv
Vv
Vv
sC
GE
Kw
Va
Va
"}
(18,1,1) = {"
RJ
RJ
Va
Va
Va
Kw
Kw
Kw
Kw
Kw
Kw
Va
Va
Va
Va
Va
Va
og
IC
Ep
og
zk
Kw
Va
Va
"}
(19,1,1) = {"
RJ
RJ
Va
Va
Kw
Kw
Ec
yM
Kw
Kw
Va
Va
Va
Va
Va
Va
Va
bs
bs
bs
bs
Tt
Va
Va
Va
"}
(20,1,1) = {"
RJ
Va
Va
Kw
Kw
hS
LB
Kw
Kw
Va
Va
RJ
RJ
RJ
Va
Va
Va
tw
Vc
Tt
Tt
Va
Va
Va
Va
"}
(21,1,1) = {"
RJ
Va
Va
cG
Kw
Kw
Va
Va
Va
Va
RJ
RJ
RJ
RJ
RJ
Va
Va
Wc
Wc
tw
tw
tw
Va
Va
RJ
"}
(22,1,1) = {"
RJ
Va
Va
Va
Va
Va
Va
Va
RJ
RJ
RJ
RJ
RJ
RJ
RJ
RJ
Va
Va
Wc
vl
Wc
Va
Va
RJ
RJ
"}
(23,1,1) = {"
RJ
RJ
Va
Va
Va
Va
RJ
RJ
RJ
RJ
RJ
RJ
RJ
RJ
RJ
RJ
RJ
RJ
RJ
RJ
RJ
RJ
RJ
RJ
RJ
"}
