//MAP CONVERTED BY dmm2tgm.py THIS HEADER COMMENT PREVENTS RECONVERSION, DO NOT REMOVE
"aE" = (
/obj/machinery/atmospherics/pipe/simple/scrubbers/hidden/layer1{
	dir = 4
	},
/turf/open/floor/concrete/pavement/whitesands/lit,
/area/space)
"aH" = (
/obj/structure/platform/wood{
	dir = 5
	},
/turf/open/water/acid/whitesands,
/area/space)
"bm" = (
/obj/structure/chair/plastic{
	dir = 8
	},
/turf/open/floor/concrete/whitesands/lit,
/area/space)
"bw" = (
/obj/structure/grille,
/turf/open/floor/plating,
/area/space)
"cb" = (
/obj/machinery/conveyor_switch{
	pixel_y = 17;
	pixel_x = 12
	},
/obj/structure/disposalpipe/segment{
	dir = 8
	},
/turf/open/floor/plasteel,
/area/space)
"dy" = (
/turf/closed/wall/concrete/reinforced,
/area/space)
"dz" = (
/obj/machinery/power/smes/engineering,
/turf/open/floor/plating/whitesands/lit,
/area/space)
"eA" = (
/obj/machinery/power/shuttle/engine/turbine{
	dir = 1
	},
/turf/open/floor/engine/hull,
/area/space)
"fc" = (
/obj/machinery/power/terminal,
/obj/structure/chair/comfy/shuttle{
	dir = 1
	},
/obj/effect/turf_decal/techfloor{
	dir = 8
	},
/obj/effect/turf_decal/techfloor{
	dir = 4
	},
/obj/effect/turf_decal/techfloor/orange{
	dir = 8
	},
/turf/open/floor/plating/whitesands/lit,
/area/space)
"ft" = (
/obj/machinery/atmospherics/pipe/simple/scrubbers/hidden/layer1{
	dir = 9
	},
/turf/open/floor/concrete/pavement/whitesands/lit,
/area/space)
"ge" = (
/obj/structure/platform/wood/corner{
	dir = 8
	},
/turf/open/water/acid/whitesands,
/area/space)
"gk" = (
/obj/machinery/power/smes/engineering,
/turf/open/floor/plasteel,
/area/space)
"go" = (
/obj/structure/platform/industrial_alt/corner{
	dir = 8
	},
/turf/open/floor/concrete/pavement/whitesands/lit,
/area/space)
"gU" = (
/obj/structure/platform/wood,
/turf/open/water/acid/whitesands,
/area/space)
"ht" = (
/obj/structure/platform/wood{
	dir = 6
	},
/obj/structure/railing/thin,
/turf/open/water/acid/whitesands,
/area/space)
"hx" = (
/obj/structure/crate_shelf,
/obj/effect/turf_decal/box/corners{
	dir = 1
	},
/obj/effect/turf_decal/box/corners{
	dir = 4
	},
/turf/open/floor/plasteel/patterned/cargo_one,
/area/space)
"hD" = (
/obj/structure/chair/handrail{
	dir = 4
	},
/obj/effect/turf_decal/industrial/warning{
	dir = 5
	},
/turf/open/floor/plating/whitesands/lit,
/area/space)
"ib" = (
/turf/open/floor/plating/asteroid/whitesands/dried,
/area/space)
"im" = (
/obj/structure/railing/thin{
	dir = 8
	},
/turf/open/floor/plating/asteroid/whitesands/dried/lit,
/area/space)
"is" = (
/turf/open/floor/plasteel/stairs/whitesand/lit{
	dir = 1
	},
/area/space)
"ji" = (
/obj/structure/platform/industrial_alt{
	dir = 8
	},
/turf/open/floor/plating/asteroid/whitesands/dried/lit,
/area/space)
"jo" = (
/obj/machinery/conveyor{
	id = "doohickey";
	dir = 6
	},
/obj/structure/railing/thin{
	dir = 4
	},
/turf/open/floor/plating,
/area/space)
"jB" = (
/obj/machinery/atmospherics/components/binary/dp_vent_pump/on/layer2{
	dir = 1
	},
/obj/effect/turf_decal/industrial/warning/full,
/turf/open/floor/plasteel,
/area/space)
"jK" = (
/obj/effect/turf_decal/industrial/warning{
	dir = 9
	},
/turf/open/floor/plasteel/patterned/ridged,
/area/space)
"jT" = (
/obj/machinery/disposal/deliveryChute{
	dir = 4
	},
/obj/structure/disposalpipe/trunk{
	dir = 8
	},
/turf/open/floor/plating,
/area/space)
"kc" = (
/obj/machinery/atmospherics/pipe/simple/supplymain/hidden/layer4,
/obj/machinery/atmospherics/pipe/simple/supplymain/hidden/layer2,
/obj/machinery/atmospherics/pipe/simple/scrubbers/hidden/layer1,
/turf/open/floor/engine/hull/interior,
/area/space)
"ku" = (
/obj/structure/flora/tree/dead/barren,
/turf/open/floor/plating/asteroid/whitesands/grass/dead/lit,
/area/space)
"kJ" = (
/turf/closed/mineral/random/whitesands,
/area/space)
"kN" = (
/obj/structure/crate_shelf,
/obj/effect/turf_decal/box,
/turf/open/floor/plating/whitesands/lit,
/area/space)
"ld" = (
/obj/machinery/conveyor{
	id = "twohickey";
	dir = 4
	},
/obj/structure/disposalpipe/segment{
	dir = 5
	},
/turf/open/floor/plating/rust/plasma,
/area/space)
"li" = (
/obj/effect/turf_decal/industrial/warning{
	dir = 8
	},
/turf/open/floor/concrete/slab_1/whitesands/lit,
/area/space)
"lj" = (
/obj/structure/platform/industrial_alt{
	dir = 4
	},
/turf/open/floor/concrete/pavement/whitesands/lit,
/area/space)
"lk" = (
/obj/structure/platform/wood/corner,
/obj/structure/railing/thin/corner,
/turf/open/water/acid/whitesands,
/area/space)
"mu" = (
/obj/structure/disposalpipe/segment{
	dir = 8
	},
/obj/structure/grille,
/turf/open/floor/plating,
/area/space)
"mx" = (
/obj/structure/disposalpipe/segment{
	dir = 1
	},
/turf/open/floor/plating/rust/plasma,
/area/space)
"mA" = (
/obj/machinery/atmospherics/pipe/simple/supplymain/hidden/layer2,
/obj/machinery/atmospherics/pipe/simple/scrubbers/hidden/layer1{
	dir = 5
	},
/turf/open/floor/plasteel,
/area/space)
"mC" = (
/obj/structure/disposalpipe/segment{
	dir = 4
	},
/turf/open/floor/plating,
/area/space)
"mM" = (
/obj/effect/turf_decal/industrial/stand_clear,
/obj/effect/turf_decal/industrial/warning{
	dir = 1
	},
/turf/open/floor/concrete/slab_1/whitesands/lit,
/area/space)
"mQ" = (
/obj/structure/platform/wood{
	dir = 6
	},
/turf/open/water/acid/whitesands,
/area/space)
"nd" = (
/obj/effect/turf_decal/industrial/warning{
	dir = 4
	},
/turf/open/floor/concrete/slab_1/whitesands/lit,
/area/space)
"nj" = (
/turf/open/floor/concrete/slab_4{
	light_power = 0.6;
	light_range = 2
	},
/area/space)
"nP" = (
/obj/machinery/conveyor{
	id = "twohickey"
	},
/turf/open/floor/plasteel,
/area/space)
"oE" = (
/obj/machinery/computer/turbine_computer{
	icon_state = "computer-right"
	},
/turf/open/floor/plasteel,
/area/space)
"oJ" = (
/obj/effect/turf_decal/industrial/warning{
	dir = 1
	},
/turf/open/floor/concrete/slab_1/whitesands/lit,
/area/space)
"pd" = (
/obj/structure/crate_shelf,
/obj/effect/turf_decal/box/corners{
	dir = 8
	},
/obj/effect/turf_decal/box/corners{
	dir = 1
	},
/turf/open/floor/plasteel/patterned/cargo_one,
/area/space)
"qn" = (
/obj/machinery/conveyor{
	id = "doohickey";
	dir = 8
	},
/turf/open/floor/plating,
/area/space)
"qt" = (
/obj/machinery/power/terminal,
/turf/open/floor/plating/whitesands/lit,
/area/space)
"rI" = (
/obj/structure/disposalpipe/segment{
	dir = 8
	},
/turf/open/floor/plasteel,
/area/space)
"sR" = (
/obj/machinery/conveyor{
	id = "doohickey";
	dir = 10
	},
/obj/structure/railing/thin{
	dir = 4
	},
/turf/open/floor/plating,
/area/space)
"sS" = (
/obj/effect/anomaly/plasmasoul/planetary{
	effectrange = 1
	},
/turf/open/floor/plating/rust/plasma,
/area/space)
"ti" = (
/turf/open/floor/plasteel/dark,
/area/space)
"tP" = (
/obj/structure/disposalpipe/trunk{
	dir = 4
	},
/obj/machinery/disposal/deliveryChute{
	dir = 1
	},
/turf/open/floor/plasteel,
/area/space)
"uH" = (
/obj/machinery/atmospherics/components/unary/thermomachine/heater,
/turf/open/floor/plasteel,
/area/space)
"uS" = (
/obj/structure/disposalpipe/segment{
	dir = 6
	},
/obj/structure/grille,
/turf/open/floor/plating,
/area/space)
"vk" = (
/obj/structure/chair/plastic{
	dir = 8
	},
/obj/machinery/atmospherics/components/unary/vent_scrubber/layer1{
	dir = 8
	},
/turf/open/floor/plasteel,
/area/space)
"vE" = (
/obj/machinery/power/terminal{
	dir = 4
	},
/turf/open/floor/plasteel,
/area/space)
"wl" = (
/obj/machinery/conveyor{
	id = "twohickey";
	dir = 4
	},
/turf/open/floor/plating/rust/plasma,
/area/space)
"wx" = (
/obj/structure/table,
/turf/open/floor/plasteel/dark,
/area/space)
"xn" = (
/turf/open/floor/concrete/slab_1/whitesands/lit,
/area/space)
"xO" = (
/obj/effect/spawner/bunk_bed,
/turf/open/floor/plasteel/patterned,
/area/space)
"yO" = (
/turf/open/floor/plasteel/patterned/ridged,
/area/space)
"yT" = (
/obj/effect/turf_decal/industrial/stand_clear{
	dir = 8
	},
/obj/effect/turf_decal/industrial/warning{
	dir = 4
	},
/turf/open/floor/concrete/slab_1/whitesands/lit,
/area/space)
"za" = (
/obj/machinery/atmospherics/pipe/simple/scrubbers/hidden/layer1,
/obj/machinery/atmospherics/pipe/simple/supplymain/hidden/layer2,
/turf/open/floor/engine/hull/interior,
/area/space)
"zK" = (
/obj/structure/disposalpipe/segment{
	dir = 9
	},
/obj/structure/grille,
/turf/open/floor/plating,
/area/space)
"Aj" = (
/obj/effect/turf_decal/industrial/warning/full,
/obj/machinery/atmospherics/components/binary/dp_vent_pump/on/layer4,
/obj/machinery/atmospherics/pipe/simple/scrubbers/hidden/layer1,
/obj/machinery/atmospherics/pipe/simple/supplymain/hidden/layer2,
/turf/open/floor/plasteel,
/area/space)
"Ar" = (
/obj/effect/turf_decal/industrial/warning,
/turf/open/floor/concrete/slab_1/whitesands/lit,
/area/space)
"As" = (
/obj/machinery/atmospherics/pipe/simple/scrubbers/hidden/layer1,
/turf/open/floor/engine/hull/interior,
/area/space)
"Bm" = (
/turf/open/floor/plasteel/stairs/whitesand/lit{
	dir = 8
	},
/area/space)
"Bv" = (
/obj/structure/platform/industrial_alt{
	dir = 10
	},
/turf/open/floor/plating/asteroid/whitesands/dried/lit,
/area/space)
"BS" = (
/obj/structure/railing/thin/corner{
	dir = 8
	},
/turf/open/floor/plating/asteroid/whitesands/dried/lit,
/area/space)
"Cp" = (
/turf/open/floor/plating/asteroid/whitesands/grass/dead/lit,
/area/space)
"DM" = (
/turf/open/floor/plasteel,
/area/space)
"DU" = (
/obj/structure/chair/plastic{
	dir = 4
	},
/turf/open/floor/plasteel/mono,
/area/space)
"Eh" = (
/turf/open/water/acid/whitesands,
/area/space)
"Ev" = (
/turf/open/floor/plating,
/area/space)
"EG" = (
/obj/structure/marker_beacon,
/turf/open/floor/concrete/slab_1/whitesands/lit,
/area/space)
"EK" = (
/obj/effect/turf_decal/atmos/oxygen,
/turf/open/floor/engine/o2,
/area/space)
"Fk" = (
/obj/effect/anomaly/melter/planetary,
/turf/open/water/acid/whitesands,
/area/space)
"Fo" = (
/obj/structure/platform/industrial_alt/corner{
	dir = 4
	},
/turf/open/floor/plating/asteroid/whitesands/dried/lit,
/area/space)
"Fr" = (
/obj/structure/platform/industrial_alt/corner,
/turf/open/floor/concrete/pavement/whitesands/lit,
/area/space)
"FP" = (
/obj/machinery/power/shuttle/engine/electric{
	dir = 1
	},
/turf/open/floor/plating/whitesands/lit,
/area/space)
"Gj" = (
/obj/machinery/atmospherics/pipe/simple/scrubbers/hidden/layer1{
	dir = 10
	},
/turf/open/floor/concrete/pavement/whitesands/lit,
/area/space)
"Gl" = (
/obj/structure/crate_shelf,
/obj/effect/turf_decal/box/corners{
	dir = 8
	},
/obj/effect/turf_decal/box/corners,
/turf/open/floor/plasteel/patterned/cargo_one,
/area/space)
"GH" = (
/obj/structure/platform/industrial_alt/corner{
	dir = 1
	},
/turf/open/floor/plating/asteroid/whitesands/dried/lit,
/area/space)
"Ha" = (
/turf/open/floor/plating/asteroid/whitesands/grass/lit,
/area/space)
"Hh" = (
/obj/structure/platform/wood{
	dir = 4
	},
/turf/open/water/acid/whitesands,
/area/space)
"Hn" = (
/turf/template_noop,
/area/space)
"Hw" = (
/obj/machinery/power/compressor,
/turf/open/floor/engine/hull,
/area/space)
"HD" = (
/obj/structure/railing/thin{
	dir = 10
	},
/turf/open/floor/plating/asteroid/whitesands/dried/lit,
/area/space)
"HM" = (
/obj/effect/turf_decal/industrial/stand_clear{
	dir = 4
	},
/obj/effect/turf_decal/industrial/warning{
	dir = 8
	},
/turf/open/floor/concrete/slab_1/whitesands/lit,
/area/space)
"HO" = (
/obj/machinery/power/smes/shuttle{
	dir = 1
	},
/turf/open/floor/plating/whitesands/lit,
/area/space)
"HQ" = (
/obj/structure/disposalpipe/trunk{
	dir = 4
	},
/obj/structure/disposaloutlet{
	dir = 8;
	eject_range = 7;
	name = "trash cannon"
	},
/obj/structure/railing/thin{
	dir = 8
	},
/turf/open/floor/plating,
/area/space)
"HR" = (
/obj/structure/platform/industrial_alt{
	dir = 1
	},
/turf/open/floor/plating/asteroid/whitesands/dried/lit,
/area/space)
"IA" = (
/obj/machinery/atmospherics/components/binary/dp_vent_pump/on/layer2,
/obj/effect/turf_decal/industrial/warning/full,
/obj/machinery/atmospherics/pipe/simple/scrubbers/hidden/layer1,
/turf/open/floor/plasteel,
/area/space)
"IK" = (
/turf/open/space/basic,
/area/space)
"JU" = (
/obj/structure/barricade/sandbags,
/turf/open/floor/concrete/whitesands/lit,
/area/space)
"Ko" = (
/obj/structure/platform/wood{
	dir = 4
	},
/obj/structure/railing/thin{
	dir = 4
	},
/turf/open/water/acid/whitesands,
/area/space)
"Kw" = (
/obj/machinery/atmospherics/pipe/simple/supplymain/hidden/layer4{
	dir = 5
	},
/obj/machinery/atmospherics/pipe/manifold/supply/hidden/layer2{
	dir = 8
	},
/obj/machinery/atmospherics/pipe/simple/scrubbers/hidden/layer1,
/turf/open/floor/plasteel,
/area/space)
"KB" = (
/obj/structure/platform/industrial_alt,
/turf/open/floor/plating/asteroid/whitesands/dried/lit,
/area/space)
"KO" = (
/turf/open/floor/plating/asteroid/whitesands/lit,
/area/space)
"KS" = (
/obj/machinery/photocopier,
/turf/open/floor/plasteel/dark,
/area/space)
"Li" = (
/obj/machinery/atmospherics/pipe/layer_manifold,
/turf/open/floor/plating,
/area/space)
"Ln" = (
/turf/open/floor/engine/hull,
/area/space)
"LH" = (
/obj/effect/turf_decal/industrial/stand_clear{
	dir = 1
	},
/obj/effect/turf_decal/industrial/warning,
/turf/open/floor/concrete/slab_1/whitesands/lit,
/area/space)
"Mc" = (
/obj/machinery/conveyor{
	id = "twohickey"
	},
/obj/structure/disposalpipe/trunk{
	dir = 8
	},
/turf/open/floor/plating/rust/plasma,
/area/space)
"Mm" = (
/obj/structure/disposalpipe/trunk{
	dir = 8
	},
/turf/open/floor/plating/rust/plasma,
/area/space)
"Mp" = (
/turf/closed/wall/concrete,
/area/space)
"Nh" = (
/obj/structure/railing/thin,
/turf/open/floor/plating,
/area/space)
"Nt" = (
/obj/machinery/power/terminal{
	dir = 8
	},
/turf/open/floor/plasteel,
/area/space)
"Nv" = (
/obj/effect/turf_decal/industrial/warning{
	dir = 1
	},
/turf/open/floor/plasteel/patterned/ridged,
/area/space)
"Oc" = (
/obj/machinery/atmospherics/pipe/simple/scrubbers/hidden/layer1,
/turf/open/floor/concrete/pavement/whitesands/lit,
/area/space)
"Oj" = (
/turf/open/floor/plasteel/stairs/whitesand/lit,
/area/space)
"Op" = (
/obj/machinery/computer/helm,
/obj/effect/turf_decal/techfloor/hole{
	dir = 4
	},
/turf/open/floor/plating/whitesands/lit,
/area/space)
"Ph" = (
/obj/effect/turf_decal/industrial/warning/corner{
	dir = 1
	},
/turf/open/floor/plasteel/patterned/ridged,
/area/space)
"PF" = (
/obj/machinery/atmospherics/pipe/layer_manifold{
	dir = 4
	},
/obj/structure/dresser,
/turf/open/floor/plasteel,
/area/space)
"PI" = (
/turf/closed/wall/mineral/titanium/survival,
/area/space)
"Qf" = (
/turf/open/floor/concrete/reinforced/whitesands/lit,
/area/space)
"Qj" = (
/obj/structure/disposalpipe/segment{
	dir = 8
	},
/turf/open/floor/plating/rust/plasma,
/area/space)
"QF" = (
/obj/machinery/atmospherics/components/trinary/mixer/airmix/flipped{
	dir = 4
	},
/turf/open/floor/plating,
/area/space)
"Rj" = (
/obj/structure/disposalpipe/trunk{
	dir = 4
	},
/obj/structure/disposaloutlet{
	dir = 4
	},
/turf/open/floor/plasteel,
/area/space)
"Ry" = (
/obj/structure/filingcabinet/double/grey{
	dir = 1
	},
/turf/open/floor/plasteel/dark,
/area/space)
"Sn" = (
/obj/machinery/conveyor{
	id = "doohickey";
	dir = 4
	},
/obj/structure/railing/thin,
/turf/open/floor/plating,
/area/space)
"Su" = (
/turf/open/floor/plasteel/mono,
/area/space)
"SW" = (
/obj/machinery/atmospherics/pipe/layer_manifold,
/turf/open/floor/concrete/pavement/whitesands/lit,
/area/space)
"Te" = (
/turf/open/floor/concrete/whitesands/lit,
/area/space)
"Ty" = (
/obj/effect/turf_decal/atmos/nitrogen,
/turf/open/floor/engine/n2,
/area/space)
"Tz" = (
/obj/machinery/atmospherics/pipe/simple/scrubbers/hidden/layer1{
	dir = 6
	},
/turf/open/floor/concrete/pavement/whitesands/lit,
/area/space)
"Vl" = (
/obj/structure/platform/wood{
	dir = 6
	},
/obj/structure/railing/thin{
	dir = 6
	},
/turf/open/water/acid/whitesands,
/area/space)
"Vt" = (
/turf/open/floor/engine/o2,
/area/space)
"VM" = (
/obj/structure/crate_shelf,
/obj/effect/turf_decal/box/corners{
	dir = 4
	},
/obj/effect/turf_decal/box/corners,
/turf/open/floor/plasteel/patterned/cargo_one,
/area/space)
"WH" = (
/turf/open/floor/plating/whitesands/lit,
/area/space)
"Xj" = (
/obj/structure/chair/handrail{
	dir = 4
	},
/obj/effect/turf_decal/industrial/warning{
	dir = 6
	},
/turf/open/floor/plating/whitesands/lit,
/area/space)
"Xk" = (
/turf/open/floor/engine/n2,
/area/space)
"XB" = (
/obj/machinery/computer/turbine_computer{
	icon_state = "computer-left"
	},
/turf/open/floor/plasteel,
/area/space)
"XS" = (
/turf/open/floor/concrete/pavement/whitesands/lit,
/area/space)
"Yk" = (
/obj/structure/barricade/sandbags,
/turf/open/floor/concrete/slab_1/whitesands/lit,
/area/space)
"Yn" = (
/obj/effect/turf_decal/industrial/warning{
	dir = 8
	},
/turf/open/floor/plasteel/patterned/ridged,
/area/space)
"Yw" = (
/turf/open/floor/plating/asteroid/whitesands/dried/lit,
/area/space)
"YS" = (
/obj/structure/disposalpipe/segment{
	dir = 10
	},
/turf/open/floor/plating/rust/plasma,
/area/space)
"Zw" = (
/obj/structure/closet/cabinet,
/obj/machinery/atmospherics/components/unary/vent_pump/layer2{
	dir = 1
	},
/turf/open/floor/plasteel,
/area/space)

(1,1,1) = {"
KO
Yw
Cp
Ha
IK
IK
IK
KO
KO
KO
KO
KO
KO
KO
KO
KO
KO
KO
KO
KO
KO
KO
kJ
kJ
Hn
Hn
Hn
Hn
Hn
Hn
Hn
Hn
Hn
Hn
Hn
Hn
Hn
Hn
KO
KO
KO
Hn
Hn
Hn
Hn
Hn
Hn
Hn
Hn
Hn
"}
(2,1,1) = {"
Mp
Te
Qf
IK
IK
IK
KO
KO
KO
Eh
Eh
Eh
Eh
KO
KO
Eh
Eh
Eh
Eh
Eh
KO
KO
KO
kJ
kJ
kJ
Hn
Hn
Hn
Hn
Hn
Hn
Hn
Hn
KO
KO
Hn
KO
KO
KO
XS
KO
KO
Hn
Hn
Hn
Hn
Hn
Hn
Hn
"}
(3,1,1) = {"
dy
xn
XS
IK
IK
KO
KO
KO
Eh
Eh
Eh
Eh
Eh
Eh
Eh
Eh
Eh
Eh
Eh
Eh
Eh
Eh
kJ
kJ
kJ
kJ
kJ
kJ
Hn
Hn
Hn
Hn
Hn
KO
KO
KO
KO
KO
XS
KO
XS
KO
KO
KO
Hn
Hn
Hn
Hn
Hn
Hn
"}
(4,1,1) = {"
kJ
IK
IK
IK
IK
KO
KO
Eh
Eh
Eh
Eh
Eh
Eh
Eh
Eh
Eh
Eh
Eh
Eh
Eh
Eh
Eh
kJ
kJ
kJ
kJ
kJ
kJ
kJ
kJ
kJ
Hn
Hn
KO
KO
KO
KO
KO
KO
XS
XS
KO
KO
KO
KO
Hn
Hn
Hn
Hn
Hn
"}
(5,1,1) = {"
IK
IK
IK
kJ
kJ
kJ
KO
Eh
Eh
Eh
Eh
Fk
Eh
Eh
Eh
Eh
Eh
Eh
Fk
Eh
Eh
Eh
Eh
gU
kJ
kJ
kJ
kJ
kJ
kJ
kJ
kJ
kJ
kJ
KO
KO
KO
KO
XS
XS
XS
KO
KO
KO
KO
Hn
Hn
Hn
Hn
Hn
"}
(6,1,1) = {"
IK
IK
kJ
kJ
kJ
kJ
kJ
Eh
Eh
Eh
Eh
Eh
Eh
Eh
Eh
Eh
Eh
Eh
Eh
Eh
Eh
Eh
lk
Vl
Cp
Cp
kJ
kJ
kJ
kJ
kJ
kJ
kJ
kJ
kJ
Yw
Yw
Yw
XS
XS
XS
Yw
KO
KO
KO
Hn
Hn
Hn
Hn
Hn
"}
(7,1,1) = {"
IK
IK
kJ
kJ
kJ
kJ
kJ
Eh
Eh
Eh
Eh
Eh
Eh
Eh
Eh
Eh
Eh
Eh
Eh
Eh
lk
Ko
Vl
KO
Cp
Cp
Cp
Ha
Ha
Ha
kJ
kJ
kJ
kJ
kJ
kJ
Yw
Yw
XS
XS
XS
Yw
Yw
Yw
KO
Hn
Hn
Hn
Hn
Hn
"}
(8,1,1) = {"
IK
kJ
kJ
kJ
kJ
kJ
kJ
Hh
Hh
ge
Eh
Eh
Eh
Eh
Hh
Hh
Hh
Hh
Hh
Hh
ht
KO
KO
KO
Yw
Yw
Cp
Cp
Ha
Ha
Ha
kJ
kJ
kJ
kJ
kJ
Yw
Yw
XS
XS
XS
Yw
Yw
Yw
kJ
kJ
kJ
Hn
Hn
Hn
"}
(9,1,1) = {"
kJ
kJ
kJ
kJ
kJ
kJ
kJ
im
HD
aH
Hh
Hh
Hh
mQ
Mp
bw
bw
bw
PI
PI
PI
KO
PI
bw
bw
PI
PI
Cp
Ha
Ha
Ha
kJ
kJ
kJ
kJ
kJ
JU
JU
XS
XS
XS
JU
JU
kJ
kJ
kJ
kJ
kJ
Hn
Hn
"}
(10,1,1) = {"
kJ
kJ
kJ
kJ
kJ
kJ
kJ
Yw
BS
im
PI
HQ
im
Mp
Mp
DM
DM
DM
DM
DM
PI
PI
PI
DM
DM
DM
Mp
Mp
Ha
Ha
Ha
Ha
kJ
kJ
kJ
kJ
bm
JU
XS
XS
XS
JU
Te
kJ
kJ
kJ
kJ
kJ
kJ
Hn
"}
(11,1,1) = {"
IK
IK
kJ
kJ
kJ
kJ
kJ
Yw
Yw
Yw
Nh
mC
Yw
Mp
DM
DM
DM
DM
DM
DM
DM
PI
DM
DM
DM
DM
DM
Mp
Ha
Ha
Ha
kJ
kJ
kJ
kJ
kJ
Te
Te
XS
XS
XS
Cp
Cp
Cp
kJ
kJ
kJ
kJ
kJ
Hn
"}
(12,1,1) = {"
IK
IK
kJ
kJ
kJ
kJ
kJ
kJ
Yw
Yw
Sn
jT
Yw
Mp
DM
DM
DM
DM
DM
DM
DM
Ev
DM
DM
DM
DM
DM
Mp
Yw
Yw
Ha
kJ
kJ
kJ
Yw
Yw
Yw
Ha
XS
XS
XS
Cp
Cp
Cp
kJ
kJ
kJ
kJ
Hn
Hn
"}
(13,1,1) = {"
IK
kJ
kJ
PI
PI
PI
PI
kJ
Yw
Yw
Sn
qn
Yw
Mp
DM
DM
DM
DM
DM
DM
DM
PI
DM
DM
DM
DM
DM
Mp
Yw
Yw
Ha
kJ
kJ
kJ
Ha
Ha
Ha
Ha
XS
XS
XS
Yw
Cp
Cp
Cp
Cp
kJ
kJ
Hn
Hn
"}
(14,1,1) = {"
IK
kJ
PI
PI
DM
DM
PI
PI
PI
Yw
jo
sR
Yw
PI
DM
DM
DM
DM
DM
DM
PI
Mp
Mp
DM
DM
DM
PI
Mp
Yw
Yw
kJ
kJ
kJ
kJ
Ha
Ha
Ha
Ha
XS
XS
XS
Yw
Yw
Cp
Cp
Te
Te
JU
Hn
Hn
"}
(15,1,1) = {"
kJ
kJ
PI
DM
DM
DM
Li
jB
Ev
Yw
Yw
Yw
Yw
PI
DM
DM
DM
DM
DM
DM
PI
KO
Mp
Mp
Ev
Ev
PI
Yw
Yw
Yw
Yw
kJ
kJ
Ha
Ha
Ha
Ha
Ha
XS
XS
XS
Yw
Yw
Yw
Yw
Te
JU
JU
Hn
Hn
"}
(16,1,1) = {"
kJ
kJ
PI
PI
DM
DM
PI
PI
PI
KO
KO
Yw
Yw
bw
bw
bw
PI
PI
bw
bw
bw
KO
KO
PI
DM
DM
PI
Yw
Yw
KO
KO
KO
Ha
Ha
Ha
Ha
Ha
KO
XS
XS
XS
XS
XS
XS
XS
XS
XS
XS
XS
Hn
"}
(17,1,1) = {"
Hn
kJ
kJ
PI
PI
PI
PI
kJ
kJ
KO
KO
KO
Yw
Yw
Yw
Yw
Yw
Yw
Yw
Yw
KO
KO
KO
PI
Ev
Ev
PI
Yw
Yw
KO
KO
KO
KO
Ha
Ha
Ha
KO
KO
XS
XS
XS
XS
XS
XS
XS
XS
XS
XS
Hn
Hn
"}
(18,1,1) = {"
Hn
kJ
KO
kJ
kJ
kJ
kJ
kJ
kJ
KO
KO
KO
Yw
Yw
Yw
Yw
Yw
Yw
Yw
KO
KO
KO
Yw
Yw
XS
XS
Yw
Yw
Yw
Yw
Yw
Yw
KO
KO
Ha
Ha
KO
XS
XS
XS
XS
XS
XS
XS
XS
XS
XS
Hn
Hn
XS
"}
(19,1,1) = {"
Hn
KO
KO
KO
kJ
kJ
kJ
kJ
kJ
Mp
Bm
Bm
Mp
Mp
Yw
Yw
Ha
Ha
Ha
Ha
KO
KO
KO
Yw
XS
XS
XS
Yw
Yw
XS
XS
XS
XS
XS
XS
XS
XS
XS
XS
XS
XS
Yw
Yw
Yw
Yw
JU
JU
Hn
Hn
Hn
"}
(20,1,1) = {"
Hn
Hn
KO
KO
kJ
kJ
kJ
Mp
Mp
Mp
nj
nj
nj
Mp
Mp
XS
Ha
Ha
Ha
Ha
KO
KO
KO
XS
XS
XS
XS
XS
XS
XS
XS
XS
XS
XS
XS
XS
XS
XS
XS
XS
Ha
Ha
Ha
Ha
Yw
Te
JU
Hn
Hn
Hn
"}
(21,1,1) = {"
Hn
Hn
Hn
KO
kJ
Yw
Yw
Bv
Yk
xn
xn
nj
nj
nj
Oj
XS
XS
XS
Ha
KO
KO
KO
KO
XS
XS
XS
XS
XS
XS
XS
XS
XS
XS
XS
XS
XS
XS
XS
XS
Ha
Ha
Ha
Ha
Ha
Yw
kJ
kJ
Hn
Hn
Hn
"}
(22,1,1) = {"
Hn
Hn
KO
KO
Yw
Yw
Yw
KB
Yk
xn
xn
nj
nj
nj
Oj
XS
XS
XS
Ha
KO
KO
KO
XS
XS
XS
XS
XS
XS
XS
XS
XS
XS
Yw
Yw
XS
XS
XS
XS
Ha
Ha
Ha
Ha
Ha
Ha
kJ
kJ
kJ
Hn
Hn
Hn
"}
(23,1,1) = {"
Hn
Hn
KO
KO
Yw
Yw
Yw
KB
Mp
Yk
Yk
Mp
Mp
Mp
Mp
XS
XS
XS
XS
KO
Yw
XS
XS
XS
XS
XS
Yw
Yw
Yw
Yw
Yw
Yw
Yw
Yw
XS
XS
XS
XS
XS
KO
Ha
Ha
kJ
kJ
kJ
kJ
kJ
Hn
Hn
Hn
"}
(24,1,1) = {"
Hn
KO
KO
KO
KO
Yw
Yw
GH
ji
ji
ji
Fo
Yw
Yw
Yw
XS
XS
XS
XS
XS
XS
XS
XS
XS
XS
Yw
Yw
Yw
Yw
Yw
Yw
Yw
Yw
Yw
Yw
Yw
XS
XS
XS
KO
KO
kJ
PI
PI
PI
PI
kJ
kJ
kJ
Hn
"}
(25,1,1) = {"
Hn
XS
KO
XS
XS
XS
XS
XS
XS
XS
XS
XS
XS
XS
XS
XS
XS
XS
XS
XS
XS
XS
XS
XS
Yw
Yw
Yw
Yw
Yw
Yw
Yw
Yw
Yw
Yw
Yw
Yw
XS
XS
XS
XS
PI
PI
PI
xO
xO
PI
PI
kJ
kJ
Hn
"}
(26,1,1) = {"
Hn
KO
XS
KO
XS
XS
XS
XS
XS
XS
XS
XS
XS
XS
XS
XS
XS
XS
XS
XS
XS
XS
XS
Yw
Yw
Op
fc
HO
FP
Yw
Yw
Yw
Yw
Yw
Yw
Yw
Yw
XS
XS
XS
za
Aj
kc
Kw
mA
Zw
PI
kJ
kJ
Hn
"}
(27,1,1) = {"
Hn
KO
KO
KO
XS
XS
XS
XS
XS
XS
XS
XS
XS
XS
Fr
lj
lj
lj
lj
go
XS
XS
XS
Yw
Yw
hD
Xj
kN
kN
Yw
Yw
Op
fc
HO
FP
Yw
Yw
XS
XS
aE
PI
PI
PI
PF
vk
PI
PI
kJ
kJ
kJ
"}
(28,1,1) = {"
Hn
KO
KO
JU
JU
Te
Te
kJ
Mp
Mp
Mp
Yw
Yw
Yw
KB
Mp
Yk
Yk
Mp
HR
XS
XS
XS
Yw
Yw
Yw
Yw
Yw
Yw
Yw
Yw
hD
Xj
kN
kN
Yw
Yw
Yw
Yw
aE
XS
kJ
PI
PI
PI
PI
kJ
kJ
kJ
kJ
"}
(29,1,1) = {"
Hn
Hn
KO
JU
Te
Te
kJ
kJ
Mp
KO
KO
KO
Yw
Yw
KB
Yk
xn
xn
Yk
HR
XS
XS
XS
Yw
Yw
Yw
Yw
Yw
Yw
Yw
Yw
Yw
Yw
Yw
Yw
Yw
Yw
Yw
Yw
XS
SW
kJ
kJ
kJ
kJ
kJ
kJ
kJ
kJ
kJ
"}
(30,1,1) = {"
Hn
Hn
KO
JU
Te
kJ
kJ
kJ
Mp
KO
KO
KO
KO
Yw
KB
Yk
xn
xn
Yk
HR
XS
XS
XS
Yw
Yw
Yw
Yw
Yw
Yw
Yw
Yw
Yw
Yw
Yw
Yw
Yw
Yw
Yw
Yw
aE
XS
kJ
kJ
kJ
PI
PI
PI
PI
kJ
kJ
"}
(31,1,1) = {"
Hn
Hn
KO
JU
Te
kJ
kJ
Yw
Yw
KO
KO
KO
KO
KO
Mp
Mp
nj
nj
Mp
Mp
XS
XS
XS
Yw
Yw
Yw
Yw
Op
fc
HO
FP
Yw
Yw
Yw
Op
fc
HO
FP
Yw
aE
XS
XS
PI
PI
PI
xO
xO
PI
PI
kJ
"}
(32,1,1) = {"
Hn
Hn
KO
kJ
kJ
kJ
kJ
Yw
Yw
Yw
KO
KO
KO
KO
KO
Mp
nj
nj
Mp
XS
XS
XS
XS
Yw
Yw
Yw
Yw
hD
Xj
kN
kN
Yw
Yw
Yw
hD
Xj
kN
kN
Yw
XS
Oc
Oc
za
Aj
kc
Kw
mA
Zw
PI
kJ
"}
(33,1,1) = {"
Hn
KO
KO
kJ
kJ
kJ
PI
PI
Yw
Yw
KO
KO
XS
XS
XS
is
nj
nj
Oj
XS
XS
XS
XS
Yw
Yw
Yw
Yw
Yw
Yw
Yw
Yw
Yw
Yw
Yw
Yw
Yw
Yw
Yw
Yw
aE
XS
kJ
PI
PI
PI
PF
vk
PI
PI
kJ
"}
(34,1,1) = {"
Hn
kJ
kJ
kJ
kJ
Yw
Yw
PI
Yw
Yw
Yw
Yw
XS
XS
XS
is
nj
nj
Oj
XS
XS
XS
XS
XS
Yw
Yw
Yw
xn
xn
xn
Yw
Yw
Yw
Yw
Yw
Yw
Yw
Tz
Oc
ft
XS
kJ
kJ
kJ
PI
PI
PI
PI
kJ
kJ
"}
(35,1,1) = {"
Hn
kJ
kJ
kJ
Yw
Yw
PI
PI
PI
PI
PI
PI
PI
PI
PI
PI
Ev
PI
PI
XS
XS
XS
XS
XS
Yw
Yw
EG
nd
yT
nd
EG
Yw
Yw
Yw
Yw
Yw
XS
aE
XS
kJ
PI
PI
PI
PI
kJ
kJ
kJ
kJ
kJ
kJ
"}
(36,1,1) = {"
kJ
kJ
kJ
kJ
Yw
Yw
eA
Hw
Ln
Ln
PI
Rj
uH
uH
PI
DM
DM
PI
PI
PI
WH
XS
XS
XS
Yw
Mp
Mp
yO
yO
yO
Mp
Mp
Mp
Mp
Mp
Yw
XS
aE
PI
PI
PI
xO
xO
PI
PI
kJ
kJ
kJ
kJ
Hn
"}
(37,1,1) = {"
kJ
kJ
kJ
kJ
KO
PI
PI
PI
bw
bw
PI
rI
DM
DM
PI
PI
Ev
PI
WH
WH
WH
XS
XS
XS
Yw
Mp
xn
li
HM
li
xn
Mp
hx
Gl
Mp
Yw
XS
Gj
As
IA
kc
Kw
mA
Zw
PI
kJ
kJ
Hn
Hn
Hn
"}
(38,1,1) = {"
Hn
kJ
kJ
kJ
KO
PI
DM
DM
vE
DM
PI
rI
DM
DM
DM
DM
DM
PI
qt
dz
WH
XS
XS
XS
EG
Mp
xn
xn
xn
xn
xn
Mp
Su
Su
Mp
Mp
Mp
Mp
PI
PI
PI
PF
vk
PI
PI
kJ
Hn
Hn
Hn
Hn
"}
(39,1,1) = {"
Hn
Hn
kJ
kJ
Yw
PI
XB
DM
gk
DM
Ev
rI
DM
DM
DM
DM
DM
PI
WH
WH
WH
XS
XS
xn
Ar
yO
oJ
xn
jK
Yn
Yn
Ph
Su
Su
Mp
hx
Gl
Mp
kJ
kJ
PI
PI
PI
PI
kJ
kJ
Hn
Hn
Hn
Hn
"}
(40,1,1) = {"
Hn
Hn
kJ
kJ
Yw
PI
oE
DM
DM
DM
PI
cb
nP
tP
PI
QF
Ev
PI
qt
dz
WH
XS
XS
xn
LH
yO
mM
xn
Nv
Su
Su
Su
Su
Su
Ev
Su
Su
Mp
kJ
kJ
kJ
kJ
kJ
kJ
kJ
Hn
Hn
Hn
Hn
Hn
"}
(41,1,1) = {"
Hn
kJ
kJ
kJ
Yw
PI
PI
DM
gk
DM
PI
mu
uS
zK
PI
Ev
Ev
PI
WH
WH
WH
XS
XS
xn
Ar
yO
oJ
xn
Nv
Su
Su
Su
Su
Su
Mp
hx
Gl
Mp
kJ
kJ
kJ
kJ
kJ
Hn
Hn
Hn
Hn
Hn
Hn
Hn
"}
(42,1,1) = {"
Hn
Hn
kJ
kJ
KO
KO
PI
DM
Nt
DM
PI
Qj
Mc
wl
PI
Ev
Ev
Mp
Mp
Mp
WH
XS
XS
XS
EG
PI
xn
xn
Nv
Su
DU
PI
Mp
Ev
Mp
Mp
Mp
Mp
kJ
kJ
kJ
Hn
Hn
Hn
Hn
Hn
Hn
Hn
Hn
Hn
"}
(43,1,1) = {"
Hn
Hn
kJ
kJ
KO
KO
PI
PI
bw
bw
PI
Qj
sS
wl
PI
Ev
Ev
Ev
Ev
Mp
XS
XS
XS
XS
Yw
PI
PI
PI
Ph
Su
Su
PI
pd
Su
pd
Mp
kJ
kJ
kJ
kJ
Hn
Hn
Hn
Hn
Hn
Hn
Hn
Hn
Hn
Hn
"}
(44,1,1) = {"
Hn
Hn
kJ
kJ
KO
KO
eA
Hw
Ln
Ln
PI
YS
mx
ld
PI
Mp
bw
Mp
bw
Mp
Mp
XS
XS
XS
XS
yO
DM
yO
Su
Su
Su
PI
VM
Su
VM
Mp
ib
ib
kJ
kJ
Hn
Hn
Hn
Hn
Hn
Hn
Hn
Hn
Hn
Hn
"}
(45,1,1) = {"
Hn
Hn
kJ
kJ
KO
KO
PI
PI
PI
PI
PI
PI
PI
Mm
PI
Vt
EK
Mp
Ty
Xk
Mp
XS
XS
XS
XS
yO
DM
yO
Su
Su
Su
PI
Mp
Mp
Mp
Mp
ib
ib
kJ
Hn
Hn
Hn
Hn
Hn
Hn
Hn
Hn
Hn
Hn
Hn
"}
(46,1,1) = {"
Hn
Hn
kJ
kJ
kJ
KO
PI
Yw
Yw
Mp
PI
PI
PI
PI
PI
Mp
Mp
Mp
Mp
Mp
Mp
XS
XS
XS
KO
PI
PI
PI
PI
Ev
PI
PI
kJ
kJ
kJ
kJ
kJ
kJ
kJ
Hn
Hn
Hn
Hn
Hn
Hn
Hn
Hn
Hn
Hn
Hn
"}
(47,1,1) = {"
Hn
kJ
kJ
kJ
kJ
kJ
PI
Yw
Yw
Mp
Yw
Yw
Yw
Yw
Yw
Mp
Yw
Yw
Yw
Yw
XS
XS
XS
KO
KO
KO
PI
ti
ti
ti
ti
PI
kJ
ib
ib
ib
kJ
Hn
Hn
Hn
Hn
Hn
Hn
Hn
Hn
Hn
Hn
Hn
Hn
Hn
"}
(48,1,1) = {"
Hn
kJ
kJ
kJ
kJ
kJ
kJ
Yw
Yw
Yw
Yw
Yw
Cp
Cp
Yw
Yw
Yw
Yw
Yw
Yw
XS
XS
XS
KO
KO
KO
bw
wx
ti
ti
ti
PI
kJ
kJ
ib
ib
kJ
Hn
Hn
Hn
Hn
Hn
Hn
Hn
Hn
Hn
Hn
Hn
Hn
Hn
"}
(49,1,1) = {"
Hn
kJ
kJ
kJ
kJ
kJ
kJ
kJ
Yw
Cp
Cp
Cp
Yw
Cp
Yw
Yw
Cp
Cp
Yw
Yw
XS
XS
KO
KO
KO
KO
bw
wx
ti
ti
IK
PI
kJ
kJ
kJ
kJ
kJ
Hn
Hn
Hn
Hn
Hn
Hn
Hn
Hn
Hn
Hn
Hn
Hn
Hn
"}
(50,1,1) = {"
Hn
kJ
kJ
kJ
kJ
kJ
kJ
kJ
kJ
Cp
ku
Cp
Cp
Cp
Cp
Cp
Cp
Yw
KO
KO
XS
XS
XS
KO
KO
KO
bw
ti
ti
ti
Ry
PI
kJ
kJ
kJ
kJ
kJ
Hn
Hn
Hn
Hn
Hn
Hn
Hn
Hn
Hn
Hn
Hn
Hn
Hn
"}
(51,1,1) = {"
Hn
Hn
Hn
kJ
kJ
kJ
kJ
kJ
kJ
Cp
Cp
Cp
Cp
Cp
Cp
Cp
ku
Cp
KO
KO
XS
XS
XS
KO
KO
KO
PI
KS
wx
wx
Ry
Mp
kJ
kJ
kJ
kJ
kJ
kJ
Hn
Hn
Hn
Hn
Hn
Hn
Hn
Hn
Hn
Hn
Hn
Hn
"}
(52,1,1) = {"
Hn
Hn
Hn
Hn
kJ
kJ
kJ
kJ
kJ
Cp
Cp
Cp
Cp
Cp
Te
kJ
Cp
Cp
Te
Te
XS
XS
XS
Te
Te
KO
PI
PI
Mp
Mp
Mp
Mp
kJ
kJ
kJ
kJ
kJ
kJ
Hn
Hn
Hn
Hn
Hn
Hn
Hn
Hn
Hn
Hn
Hn
Hn
"}
(53,1,1) = {"
Hn
Hn
Hn
Hn
Hn
Hn
kJ
kJ
kJ
kJ
kJ
Cp
Cp
Te
Te
kJ
kJ
Te
Te
JU
XS
XS
XS
JU
Te
Te
kJ
kJ
kJ
kJ
kJ
kJ
kJ
kJ
Hn
Hn
kJ
kJ
Hn
Hn
Hn
Hn
Hn
Hn
Hn
Hn
Hn
Hn
Hn
Hn
"}
(54,1,1) = {"
Hn
Hn
Hn
Hn
Hn
Hn
Hn
Hn
kJ
kJ
JU
Te
Te
Te
kJ
kJ
kJ
JU
JU
JU
XS
XS
XS
JU
JU
JU
kJ
kJ
kJ
KO
kJ
kJ
kJ
kJ
Hn
Hn
Hn
Hn
Hn
Hn
Hn
Hn
Hn
Hn
Hn
Hn
Hn
Hn
Hn
Hn
"}
(55,1,1) = {"
Hn
Hn
Hn
Hn
Hn
Hn
Hn
Hn
KO
KO
JU
Te
Te
JU
kJ
KO
kJ
KO
KO
KO
XS
XS
XS
KO
KO
KO
KO
KO
KO
KO
kJ
kJ
Hn
Hn
Hn
Hn
Hn
Hn
Hn
Hn
Hn
Hn
Hn
Hn
Hn
Hn
Hn
Hn
Hn
Hn
"}
(56,1,1) = {"
Hn
Hn
Hn
Hn
Hn
Hn
Hn
Hn
KO
KO
JU
JU
JU
JU
KO
KO
KO
KO
KO
KO
XS
XS
XS
KO
KO
KO
KO
KO
Hn
Hn
Hn
kJ
Hn
Hn
Hn
Hn
Hn
Hn
Hn
Hn
Hn
Hn
Hn
Hn
Hn
Hn
Hn
Hn
Hn
Hn
"}
(57,1,1) = {"
Hn
Hn
Hn
Hn
Hn
Hn
Hn
Hn
Hn
KO
KO
KO
KO
KO
KO
KO
KO
Hn
KO
KO
XS
XS
XS
KO
KO
KO
Hn
Hn
Hn
Hn
Hn
Hn
Hn
Hn
Hn
Hn
Hn
Hn
Hn
Hn
Hn
Hn
Hn
Hn
Hn
Hn
Hn
Hn
Hn
Hn
"}
(58,1,1) = {"
Hn
Hn
Hn
Hn
Hn
Hn
Hn
Hn
Hn
Hn
KO
KO
KO
KO
KO
Hn
Hn
Hn
Hn
Hn
Hn
XS
XS
KO
KO
Hn
Hn
Hn
Hn
Hn
Hn
Hn
Hn
Hn
Hn
Hn
Hn
Hn
Hn
Hn
Hn
Hn
Hn
Hn
Hn
Hn
Hn
Hn
Hn
Hn
"}
(59,1,1) = {"
Hn
Hn
Hn
Hn
Hn
Hn
Hn
Hn
Hn
Hn
Hn
Hn
Hn
Hn
Hn
Hn
Hn
Hn
Hn
Hn
XS
Hn
Hn
Hn
Hn
Hn
Hn
Hn
Hn
Hn
Hn
Hn
Hn
Hn
Hn
Hn
Hn
Hn
Hn
Hn
Hn
Hn
Hn
Hn
Hn
Hn
Hn
Hn
Hn
Hn
"}
(60,1,1) = {"
Hn
Hn
Hn
Hn
Hn
Hn
Hn
Hn
Hn
Hn
Hn
Hn
Hn
Hn
Hn
Hn
Hn
Hn
Hn
Hn
Hn
Hn
XS
Hn
Hn
Hn
Hn
Hn
Hn
Hn
Hn
Hn
Hn
Hn
Hn
Hn
Hn
Hn
Hn
Hn
Hn
Hn
Hn
Hn
Hn
Hn
Hn
Hn
Hn
Hn
"}
