//MAP CONVERTED BY dmm2tgm.py THIS HEADER COMMENT PREVENTS RECONVERSION, DO NOT REMOVE
"a" = (
/turf/template_noop,
/area/template_noop)
"b" = (
/obj/effect/decal/cleanable/blood/old,
/turf/open/floor/plating/asteroid/whitesands/dried,
/area/whitesands/surface/outdoors)
"d" = (
/obj/structure/barricade/sandbags,
/turf/open/floor/plating/asteroid/whitesands/dried,
/area/whitesands/surface/outdoors)
"e" = (
/obj/structure/table,
/obj/item/ammo_box/aac_300blk_stripper,
/obj/item/ammo_box/aac_300blk_stripper,
/turf/open/floor/plating/asteroid/whitesands/dried,
/area/whitesands/surface/outdoors)
"f" = (
/mob/living/simple_animal/hostile/whitesands/ranged/hunter{
	faction = list("adobe")
	},
/turf/open/floor/plating/asteroid/whitesands/dried,
/area/whitesands/surface/outdoors)
"h" = (
/obj/structure/table,
/obj/item/gun/ballistic/rifle/boltaction/polymer,
/turf/open/floor/plating/asteroid/whitesands/dried,
/area/whitesands/surface/outdoors)
"i" = (
/obj/item/stack/sheet/mineral/gold/five,
/obj/structure/table,
/turf/open/floor/plating/asteroid/whitesands/dried,
/area/whitesands/surface/outdoors)
"j" = (
/obj/structure/bonfire/prelit,
/turf/open/floor/plating/asteroid/whitesands,
/area/whitesands/surface/outdoors)
"k" = (
/obj/machinery/hydroponics/soil,
/turf/open/floor/plating/asteroid/whitesands/dried,
/area/whitesands/surface/outdoors)
"n" = (
/obj/structure/table,
/obj/item/gun/ballistic/automatic/aks74u,
/obj/item/ammo_box/magazine/aks74u,
/turf/open/floor/plating/asteroid/whitesands/dried,
/area/whitesands/surface/outdoors)
"p" = (
/obj/item/stack/sheet/mineral/plasma/twenty,
/obj/structure/table,
/turf/open/floor/plating/asteroid/whitesands/dried,
/area/whitesands/surface/outdoors)
"q" = (
/obj/item/trash/can{
	pixel_y = -6
	},
/turf/open/floor/plating/asteroid/whitesands/dried,
/area/whitesands/surface/outdoors)
"s" = (
/turf/open/floor/plating/asteroid/whitesands/dried,
/area/whitesands/surface/outdoors)
"t" = (
/obj/structure/table,
/obj/item/reagent_containers/food/drinks/bottle/sarsaparilla,
/turf/open/floor/plating/asteroid/whitesands/dried,
/area/whitesands/surface/outdoors)
"u" = (
/obj/structure/tank_dispenser/oxygen,
/turf/open/floor/plating/asteroid/whitesands/dried,
/area/whitesands/surface/outdoors)
"v" = (
/obj/item/stack/sheet/mineral/titanium/fifty,
/obj/structure/table,
/turf/open/floor/plating/asteroid/whitesands/dried,
/area/whitesands/surface/outdoors)
"w" = (
/mob/living/simple_animal/hostile/whitesands/ranged/hunter{
	dir = 4;
	faction = list("adobe")
	},
/turf/open/floor/plating/asteroid/whitesands/dried,
/area/whitesands/surface/outdoors)
"x" = (
/mob/living/simple_animal/hostile/asteroid/whitesands/survivor{
	dir = 4;
	faction = list("adobe")
	},
/turf/open/floor/plating/asteroid/whitesands/dried,
/area/whitesands/surface/outdoors)
"y" = (
/obj/structure/table,
/obj/item/clothing/glasses/meson/gar,
/turf/open/floor/plating/asteroid/whitesands/dried,
/area/whitesands/surface/outdoors)
"A" = (
/obj/item/cigbutt{
	pixel_x = -3;
	pixel_y = -1
	},
/obj/item/cigbutt{
	pixel_x = -9;
	pixel_y = -8
	},
/turf/open/floor/plating/asteroid/whitesands,
/area/whitesands/surface/outdoors)
"C" = (
/obj/structure/chair/plastic,
/mob/living/simple_animal/hostile/asteroid/whitesands/survivor{
	faction = list("adobe")
	},
/turf/open/floor/plating/asteroid/whitesands,
/area/whitesands/surface/outdoors)
"D" = (
/mob/living/simple_animal/hostile/whitesands/ranged/gunslinger{
	dir = 4;
	faction = list("adobe")
	},
/turf/open/floor/plating/asteroid/whitesands/dried,
/area/whitesands/surface/outdoors)
"E" = (
/mob/living/simple_animal/hostile/asteroid/whitesands/survivor{
	dir = 1;
	faction = list("adobe")
	},
/turf/open/floor/plating/asteroid/whitesands/dried,
/area/whitesands/surface/outdoors)
"F" = (
/obj/effect/decal/cleanable/blood/old{
	icon_state = "floor5-old"
	},
/turf/open/floor/plating/asteroid/whitesands/dried,
/area/whitesands/surface/outdoors)
"H" = (
/obj/effect/decal/cleanable/blood/old{
	icon_state = "floor3-old"
	},
/turf/open/floor/plating/asteroid/whitesands/dried,
/area/whitesands/surface/outdoors)
"I" = (
/obj/structure/falsewall/sandstone,
/turf/open/floor/plating/asteroid/whitesands/dried,
/area/whitesands/surface/outdoors)
"J" = (
/obj/structure/sign/poster/contraband/communist_state,
/turf/closed/wall/mineral/sandstone,
/area/whitesands/surface/outdoors)
"M" = (
/turf/open/floor/plating/asteroid/whitesands,
/area/whitesands/surface/outdoors)
"N" = (
/obj/item/stack/sheet/mineral/uranium/five,
/obj/structure/table,
/turf/open/floor/plating/asteroid/whitesands/dried,
/area/whitesands/surface/outdoors)
"O" = (
/obj/structure/chair/plastic{
	dir = 4
	},
/mob/living/simple_animal/hostile/asteroid/whitesands/survivor{
	dir = 4;
	faction = list("adobe")
	},
/turf/open/floor/plating/asteroid/whitesands/dried,
/area/whitesands/surface/outdoors)
"P" = (
/obj/structure/barricade/sandbags,
/turf/open/floor/plating/asteroid/whitesands,
/area/whitesands/surface/outdoors)
"Q" = (
/obj/structure/reagent_dispensers/watertank,
/turf/open/floor/plating/asteroid/whitesands/dried,
/area/whitesands/surface/outdoors)
"R" = (
/obj/effect/mob_spawn/human/corpse/damaged,
/obj/effect/decal/cleanable/blood/old{
	icon_state = "floor2-old"
	},
/turf/open/floor/plating/asteroid/whitesands/dried,
/area/whitesands/surface/outdoors)
"S" = (
/obj/structure/mineral_door/sandstone,
/turf/open/floor/plating/asteroid/whitesands/dried,
/area/whitesands/surface/outdoors)
"U" = (
/turf/closed/wall/mineral/sandstone,
/area/whitesands/surface/outdoors)
"V" = (
/obj/structure/table,
/obj/item/radio,
/obj/item/radio,
/obj/item/radio,
/turf/open/floor/plating/asteroid/whitesands/dried,
/area/whitesands/surface/outdoors)
"W" = (
/obj/structure/table,
/obj/item/gun/ballistic/automatic/pistol/m1911,
/turf/open/floor/plating/asteroid/whitesands/dried,
/area/whitesands/surface/outdoors)
"Z" = (
/obj/structure/table,
/obj/item/trash/can,
/obj/item/ammo_box/c45,
/turf/open/floor/plating/asteroid/whitesands/dried,
/area/whitesands/surface/outdoors)

(1,1,1) = {"
a
a
a
a
a
a
a
a
a
s
s
s
a
a
"}
(2,1,1) = {"
a
a
a
a
a
a
a
a
a
s
R
s
s
a
"}
(3,1,1) = {"
a
U
U
U
U
U
U
U
U
U
U
U
s
a
"}
(4,1,1) = {"
a
U
i
y
U
V
s
t
U
s
s
U
s
a
"}
(5,1,1) = {"
a
U
p
s
U
W
s
s
S
s
D
U
s
a
"}
(6,1,1) = {"
a
U
N
E
U
Z
s
s
J
s
d
U
s
a
"}
(7,1,1) = {"
a
U
u
s
S
s
s
e
U
w
s
U
s
a
"}
(8,1,1) = {"
a
U
v
s
U
k
f
Q
U
d
s
U
s
a
"}
(9,1,1) = {"
a
U
n
s
I
k
h
Q
U
s
b
U
s
a
"}
(10,1,1) = {"
a
U
U
U
U
U
U
U
U
F
H
U
s
a
"}
(11,1,1) = {"
a
a
a
s
s
s
O
q
U
U
S
U
s
a
"}
(12,1,1) = {"
a
a
a
M
M
C
j
s
s
s
s
x
s
a
"}
(13,1,1) = {"
a
a
a
P
M
A
M
s
d
s
s
s
s
a
"}
(14,1,1) = {"
a
a
a
P
M
M
M
d
d
s
s
s
s
a
"}
