//MAP CONVERTED BY dmm2tgm.py THIS HEADER COMMENT PREVENTS RECONVERSION, DO NOT REMOVE
"c" = (
/obj/structure/chair/comfy/shuttle{
	dir = 4
	},
/obj/effect/decal/cleanable/dirt/dust,
/turf/open/floor/mineral/plastitanium/red,
/area/whitesands/surface/outdoors)
"e" = (
/obj/structure/barricade/wooden,
/obj/machinery/door/airlock/centcom{
	aiControlDisabled = 1;
	name = "Assault Pod";
	req_access_txt = "150"
	},
/turf/open/floor/plating,
/area/whitesands/surface/outdoors)
"f" = (
/mob/living/simple_animal/hostile/asteroid/goliath/beast,
/turf/open/floor/mineral/plastitanium/red,
/area/whitesands/surface/outdoors)
"h" = (
/turf/closed/wall/mineral/plastitanium,
/area/whitesands/surface/outdoors)
"i" = (
/obj/item/ammo_casing/c10mm{
	pixel_x = -1
	},
/obj/item/ammo_casing/c10mm{
	pixel_x = 7;
	pixel_y = -7
	},
/obj/item/ammo_casing/c10mm{
	pixel_x = -2;
	pixel_y = -10
	},
/obj/item/ammo_casing/c10mm{
	pixel_x = -6;
	pixel_y = -5
	},
/obj/item/ammo_casing/c10mm{
	pixel_x = -6;
	pixel_y = 4
	},
/turf/open/floor/plating/asteroid/whitesands/dried,
/area/whitesands/surface/outdoors)
"j" = (
/obj/effect/decal/cleanable/blood/gibs,
/turf/open/floor/plating/asteroid/whitesands/dried,
/area/whitesands/surface/outdoors)
"k" = (
/obj/structure/chair/comfy/shuttle{
	dir = 4
	},
/turf/closed/mineral/random/whitesands,
/area/whitesands/surface/outdoors)
"l" = (
/obj/effect/decal/cleanable/blood/splatter,
/turf/open/floor/mineral/plastitanium/red,
/area/whitesands/surface/outdoors)
"o" = (
/obj/item/ammo_casing/shotgun/buckshot{
	pixel_x = -5;
	pixel_y = 2
	},
/turf/open/floor/plating/asteroid/whitesands,
/area/whitesands/surface/outdoors)
"p" = (
/obj/effect/decal/cleanable/dirt/dust,
/turf/open/floor/mineral/plastitanium/red,
/area/whitesands/surface/outdoors)
"q" = (
/obj/structure/chair/comfy/shuttle{
	dir = 4
	},
/turf/open/floor/mineral/plastitanium/red,
/area/whitesands/surface/outdoors)
"r" = (
/obj/effect/decal/cleanable/blood/gibs/core,
/obj/effect/decal/cleanable/dirt/dust,
/turf/open/floor/mineral/plastitanium/red,
/area/whitesands/surface/outdoors)
"t" = (
/obj/machinery/door/airlock/centcom{
	aiControlDisabled = 1;
	name = "Assault Pod";
	req_access_txt = "150"
	},
/turf/closed/mineral/random/whitesands,
/area/whitesands/surface/outdoors)
"u" = (
/obj/item/reagent_containers/food/drinks/waterbottle/large{
	pixel_x = -8;
	pixel_y = 2
	},
/obj/item/reagent_containers/food/snacks/canned/beans{
	pixel_x = 6;
	pixel_y = 1
	},
/turf/open/floor/mineral/plastitanium/red,
/area/whitesands/surface/outdoors)
"w" = (
/turf/open/floor/mineral/plastitanium/red,
/area/whitesands/surface/outdoors)
"z" = (
/obj/structure/barricade/sandbags,
/turf/open/floor/plating/asteroid/whitesands,
/area/whitesands/surface/outdoors)
"A" = (
/obj/effect/decal/cleanable/blood{
	icon_state = "floor7"
	},
/turf/open/floor/plating/asteroid/whitesands/dried,
/area/whitesands/surface/outdoors)
"B" = (
/turf/open/floor/plating/asteroid/whitesands,
/area/whitesands/surface/outdoors)
"D" = (
/obj/machinery/light/broken{
	dir = 1
	},
/obj/effect/decal/cleanable/dirt/dust,
/turf/open/floor/mineral/plastitanium/red,
/area/whitesands/surface/outdoors)
"E" = (
/turf/open/floor/plating/asteroid/whitesands/dried,
/area/whitesands/surface/outdoors)
"F" = (
/obj/effect/decal/cleanable/blood/gibs/up,
/obj/effect/decal/cleanable/blood,
/obj/item/clothing/under/syndicate/intern{
	pixel_x = 1;
	pixel_y = -6
	},
/turf/open/floor/mineral/plastitanium/red,
/area/whitesands/surface/outdoors)
"H" = (
/obj/structure/chair/comfy/shuttle{
	dir = 8
	},
/obj/effect/decal/cleanable/dirt/dust,
/turf/open/floor/mineral/plastitanium/red,
/area/whitesands/surface/outdoors)
"J" = (
/obj/structure/bed,
/obj/effect/decal/cleanable/blood{
	icon_state = "floor2"
	},
/turf/open/floor/mineral/plastitanium/red,
/area/whitesands/surface/outdoors)
"K" = (
/mob/living/simple_animal/hostile/asteroid/goliath/beast{
	dir = 4
	},
/turf/open/floor/plating/asteroid/whitesands/dried,
/area/whitesands/surface/outdoors)
"L" = (
/obj/machinery/light,
/turf/open/floor/mineral/plastitanium/red,
/area/whitesands/surface/outdoors)
"O" = (
/turf/template_noop,
/area/template_noop)
"P" = (
/obj/structure/closet/crate/secure/weapon,
/obj/item/gun/ballistic/automatic/ebr,
/obj/item/ammo_box/magazine/ebr,
/obj/effect/decal/cleanable/dirt/dust,
/turf/open/floor/mineral/plastitanium/red,
/area/whitesands/surface/outdoors)
"R" = (
/obj/machinery/door/airlock/centcom{
	name = "Assault Pod";
	req_access_txt = "150"
	},
/turf/open/floor/plating,
/area/whitesands/surface/outdoors)
"S" = (
/obj/effect/decal/cleanable/blood,
/obj/effect/mob_spawn/human/corpse/syndicatesoldier,
/turf/open/floor/plating/asteroid/whitesands,
/area/whitesands/surface/outdoors)
"T" = (
/obj/effect/decal/cleanable/blood/gibs/limb{
	icon_state = "gibarm";
	pixel_x = -14;
	pixel_y = 3
	},
/obj/effect/decal/cleanable/blood{
	icon_state = "floor5";
	pixel_x = -2
	},
/turf/open/floor/plating,
/area/whitesands/surface/outdoors)
"V" = (
/turf/closed/mineral/random/whitesands,
/area/whitesands/surface/outdoors)
"X" = (
/obj/item/ammo_casing/shotgun/buckshot{
	pixel_x = -4;
	pixel_y = 3
	},
/obj/item/ammo_casing/shotgun/buckshot{
	pixel_x = 11;
	pixel_y = -6
	},
/mob/living/simple_animal/hostile/asteroid/goliath/beast{
	dir = 8
	},
/turf/open/floor/plating/asteroid/whitesands,
/area/whitesands/surface/outdoors)
"Y" = (
/obj/structure/barricade/sandbags,
/turf/open/floor/plating/asteroid/whitesands/dried,
/area/whitesands/surface/outdoors)
"Z" = (
/mob/living/simple_animal/hostile/asteroid/goliath/beast{
	dir = 8
	},
/turf/open/floor/plating/asteroid/whitesands,
/area/whitesands/surface/outdoors)

(1,1,1) = {"
O
O
O
V
V
V
V
t
h
h
B
"}
(2,1,1) = {"
O
O
z
S
h
V
k
p
u
h
h
"}
(3,1,1) = {"
O
O
z
X
h
c
F
f
r
P
h
"}
(4,1,1) = {"
O
O
z
B
R
p
L
h
D
p
e
"}
(5,1,1) = {"
O
O
B
o
h
H
p
q
w
J
h
"}
(6,1,1) = {"
O
O
B
z
h
h
H
p
l
h
h
"}
(7,1,1) = {"
O
B
B
B
B
h
h
T
h
h
E
"}
(8,1,1) = {"
O
B
B
B
B
z
i
E
j
Y
O
"}
(9,1,1) = {"
O
Z
B
B
B
z
Y
A
K
B
O
"}
(10,1,1) = {"
O
O
O
O
O
B
B
B
B
O
O
"}
(11,1,1) = {"
O
O
O
O
O
O
O
O
O
O
O
"}
