//MAP CONVERTED BY dmm2tgm.py THIS HEADER COMMENT PREVENTS RECONVERSION, DO NOT REMOVE
"a" = (
/turf/template_noop,
/area/template_noop)
"b" = (
/turf/closed/mineral/random/whitesands,
/area/whitesands/surface)
"c" = (
/obj/structure/stone_tile/surrounding_tile{
	dir = 4
	},
/turf/open/floor/plating/asteroid/whitesands/dried,
/area/whitesands/surface)
"d" = (
/obj/structure/stone_tile/block{
	dir = 1
	},
/turf/open/floor/plating/asteroid/whitesands/dried,
/area/whitesands/surface)
"e" = (
/obj/structure/stone_tile/surrounding_tile/cracked{
	dir = 1
	},
/turf/open/floor/plating/asteroid/whitesands/dried,
/area/whitesands/surface)
"f" = (
/turf/open/floor/plating/asteroid/whitesands,
/area/whitesands/surface)
"g" = (
/obj/structure/stone_tile{
	dir = 4
	},
/turf/open/floor/plating/asteroid/whitesands/dried,
/area/whitesands/surface)
"h" = (
/obj/structure/stone_tile/block/cracked{
	dir = 8
	},
/turf/open/floor/plating/asteroid/whitesands/dried,
/area/whitesands/surface)
"i" = (
/obj/structure/stone_tile/surrounding_tile/cracked,
/turf/open/floor/plating/asteroid/whitesands/dried,
/area/whitesands/surface)
"j" = (
/obj/structure/stone_tile/block/cracked{
	dir = 4
	},
/turf/open/floor/plating/asteroid/whitesands/dried,
/area/whitesands/surface)
"k" = (
/obj/structure/stone_tile/surrounding_tile{
	dir = 8
	},
/turf/open/floor/plating/asteroid/whitesands/dried,
/area/whitesands/surface)
"l" = (
/obj/structure/stone_tile/surrounding_tile,
/turf/open/floor/plating/asteroid/whitesands/dried,
/area/whitesands/surface)
"m" = (
/obj/structure/stone_tile/cracked{
	dir = 4
	},
/turf/open/floor/plating/asteroid/whitesands/dried,
/area/whitesands/surface)
"n" = (
/obj/structure/stone_tile/block{
	dir = 4
	},
/turf/open/floor/plating/asteroid/whitesands/dried,
/area/whitesands/surface)
"o" = (
/obj/structure/stone_tile,
/obj/structure/stone_tile{
	dir = 1
	},
/obj/structure/stone_tile/cracked{
	dir = 8
	},
/turf/open/floor/plating/asteroid/whitesands/dried,
/area/whitesands/surface)
"p" = (
/obj/structure/stone_tile,
/obj/structure/stone_tile/block/cracked{
	dir = 1
	},
/turf/open/floor/plating/asteroid/whitesands/dried,
/area/whitesands/surface)
"q" = (
/obj/structure/stone_tile{
	dir = 8
	},
/obj/structure/stone_tile{
	dir = 1
	},
/turf/open/floor/plating/asteroid/whitesands/dried,
/area/whitesands/surface)
"s" = (
/mob/living/simple_animal/hostile/megafauna/blood_drunk_miner/guidance{
	dir = 8
	},
/turf/open/floor/plating/asteroid/whitesands/dried,
/area/whitesands/surface)
"t" = (
/obj/structure/stone_tile{
	dir = 1
	},
/obj/structure/stone_tile{
	dir = 4
	},
/obj/structure/stone_tile/cracked{
	dir = 8
	},
/turf/open/floor/plating/asteroid/whitesands/dried,
/area/whitesands/surface)
"u" = (
/obj/structure/stone_tile/surrounding_tile/cracked{
	dir = 4
	},
/turf/open/floor/plating/asteroid/whitesands/dried,
/area/whitesands/surface)
"v" = (
/obj/structure/stone_tile/block/cracked,
/turf/open/floor/plating/asteroid/whitesands/dried,
/area/whitesands/surface)
"w" = (
/obj/structure/stone_tile/block,
/turf/open/floor/plating/asteroid/whitesands/dried,
/area/whitesands/surface)
"x" = (
/obj/structure/stone_tile/block/cracked{
	dir = 1
	},
/turf/open/floor/plating/asteroid/whitesands/dried,
/area/whitesands/surface)
"y" = (
/obj/structure/stone_tile,
/turf/open/floor/plating/asteroid/whitesands/dried,
/area/whitesands/surface)
"z" = (
/obj/structure/stone_tile/surrounding_tile/cracked{
	dir = 8
	},
/turf/open/floor/plating/asteroid/whitesands/dried,
/area/whitesands/surface)
"A" = (
/obj/structure/stone_tile/cracked{
	dir = 8
	},
/turf/open/floor/plating/asteroid/whitesands/dried,
/area/whitesands/surface)
"M" = (
/obj/structure/stone_tile/block{
	dir = 8
	},
/obj/structure/stone_tile/cracked,
/turf/open/floor/plating/asteroid/whitesands/dried,
/area/whitesands/surface)
"P" = (
/turf/open/floor/plating/asteroid/whitesands/dried,
/area/whitesands/surface)

(1,1,1) = {"
a
a
b
b
b
b
a
b
b
a
a
a
a
a
a
"}
(2,1,1) = {"
a
b
b
b
b
b
b
b
b
b
b
a
a
a
a
"}
(3,1,1) = {"
b
b
c
h
k
f
f
f
k
f
b
b
a
a
a
"}
(4,1,1) = {"
b
b
d
c
l
f
f
f
v
f
b
b
b
a
a
"}
(5,1,1) = {"
b
b
e
i
m
k
f
u
w
f
f
b
b
b
a
"}
(6,1,1) = {"
a
b
f
f
P
o
M
q
w
f
f
f
f
b
b
"}
(7,1,1) = {"
b
b
b
f
f
p
s
t
f
f
q
n
A
f
b
"}
(8,1,1) = {"
b
b
g
f
c
q
t
q
k
x
P
z
d
f
b
"}
(9,1,1) = {"
a
b
P
j
n
j
P
e
n
y
P
n
y
b
b
"}
(10,1,1) = {"
a
b
b
f
f
f
f
f
f
b
b
f
f
b
b
"}
(11,1,1) = {"
a
a
b
b
b
b
b
b
b
b
b
b
b
b
a
"}
(12,1,1) = {"
a
a
a
b
b
b
b
b
b
a
a
b
b
a
a
"}
