//MAP CONVERTED BY dmm2tgm.py THIS HEADER COMMENT PREVENTS RECONVERSION, DO NOT REMOVE
"ag" = (
/obj/effect/overlay/palmtree_l,
/turf/open/floor/plating/beach/sand,
/area/ruin/unpowered{
	light_range = 2
	})
"aW" = (
/obj/item/instrument/guitar,
/turf/open/floor/carpet/blue,
/area/ruin/unpowered{
	light_range = 2
	})
"bt" = (
/obj/structure/flora/ausbushes/leafybush,
/turf/open/floor/plating/grass/beach,
/area/ruin/unpowered{
	light_range = 2
	})
"bO" = (
/turf/closed/wall/mineral/sandstone,
/area/ruin/unpowered{
	light_range = 2
	})
"cr" = (
/obj/item/reagent_containers/food/snacks/kebab/rat/double,
/turf/open/floor/plating/grass/beach,
/area/ruin/unpowered{
	light_range = 2
	})
"cC" = (
/obj/structure/flora/ausbushes/brflowers,
/turf/open/floor/plating/grass/beach,
/area/ruin/unpowered{
	light_range = 2
	})
"cS" = (
/obj/structure/flora/ausbushes/fernybush,
/turf/open/floor/plating/grass/beach,
/area/ruin/unpowered{
	light_range = 2
	})
"dE" = (
/obj/item/seeds/cocoapod,
/turf/open/floor/plating/dirt/jungle,
/area/ruin/unpowered{
	light_range = 2
	})
"dH" = (
/obj/structure/fence{
	icon_state = "corner"
	},
/turf/open/floor/plating/grass/beach,
/area/ruin/unpowered{
	light_range = 2
	})
"fd" = (
/obj/item/cultivator/rake,
/turf/open/floor/plating/dirt/jungle,
/area/ruin/unpowered{
	light_range = 2
	})
"fj" = (
/obj/item/storage/cans/sixbeer,
/turf/open/floor/carpet/orange,
/area/ruin/unpowered{
	light_range = 2
	})
"fC" = (
/obj/structure/flora/tree/palm,
/turf/open/floor/plating/beach/sand,
/area/ruin/unpowered{
	light_range = 2
	})
"gn" = (
/obj/structure/flora/ausbushes/sparsegrass,
/turf/open/floor/plating/grass/beach,
/area/ruin/unpowered{
	light_range = 2
	})
"gv" = (
/obj/structure/fluff/beach_umbrella/cap,
/turf/open/floor/plating/beach/sand,
/area/ruin/unpowered{
	light_range = 2
	})
"hh" = (
/obj/structure/barricade/sandbags,
/turf/open/floor/plating/beach/sand,
/area/ruin/unpowered{
	light_range = 2
	})
"hQ" = (
/obj/structure/fence{
	dir = 5;
	icon_state = "corner"
	},
/turf/open/floor/plating/grass/beach,
/area/ruin/unpowered{
	light_range = 2
	})
"iJ" = (
/obj/structure/railing{
	dir = 1
	},
/obj/item/melee/roastingstick,
/turf/open/floor/plating/grass/beach,
/area/ruin/unpowered{
	light_range = 2
	})
"kd" = (
/obj/effect/mob_spawn/human/corpse/pirate,
/turf/open/floor/plating/grass/beach,
/area/ruin/unpowered{
	light_range = 2
	})
"kV" = (
/obj/effect/decal/cleanable/crayon{
	icon_state = "carp"
	},
/turf/open/floor/concrete,
/area/ruin/unpowered{
	light_range = 2
	})
"lr" = (
/obj/item/toy/beach_ball,
/turf/open/floor/plating/beach/sand,
/area/ruin/unpowered{
	light_range = 2
	})
"lD" = (
/obj/structure/fence,
/turf/open/floor/plating/grass/beach,
/area/ruin/unpowered{
	light_range = 2
	})
"mt" = (
/turf/open/floor/wood,
/area/ruin/unpowered{
	light_range = 2
	})
"mI" = (
/obj/structure/toilet{
	dir = 4;
	pixel_y = 3
	},
/obj/structure/sink/kitchen{
	dir = 8;
	pixel_x = 15
	},
/turf/open/floor/wood,
/area/ruin/unpowered{
	light_range = 2
	})
"nl" = (
/obj/item/shovel/spade,
/turf/open/floor/plating/beach/sand,
/area/ruin/unpowered{
	light_range = 2
	})
"ns" = (
/obj/structure/fence{
	icon_state = "door_closed"
	},
/turf/open/floor/plating/grass/beach,
/area/ruin/unpowered{
	light_range = 2
	})
"nB" = (
/obj/structure/flora/ausbushes/ppflowers,
/turf/open/floor/plating/grass/beach,
/area/ruin/unpowered{
	light_range = 2
	})
"on" = (
/obj/structure/table/wood,
/obj/item/clothing/glasses/sunglasses/garb{
	pixel_y = -5
	},
/obj/item/clothing/glasses/sunglasses/big{
	pixel_y = 9
	},
/turf/open/floor/wood,
/area/ruin/unpowered{
	light_range = 2
	})
"pp" = (
/obj/structure/chair/plastic{
	dir = 4
	},
/turf/open/floor/plating/grass/beach,
/area/ruin/unpowered{
	light_range = 2
	})
"pv" = (
/turf/open/floor/plating/beach/sand{
	icon_state = "sand_dug"
	},
/area/ruin/unpowered{
	light_range = 2
	})
"pN" = (
/turf/open/floor/concrete,
/area/ruin/unpowered{
	light_range = 2
	})
"pU" = (
/obj/structure/fluff/fokoff_sign,
/turf/open/floor/plating/grass/beach,
/area/ruin/unpowered{
	light_range = 2
	})
"pY" = (
/obj/structure/bonfire/prelit,
/turf/open/floor/plating/grass/beach,
/area/ruin/unpowered{
	light_range = 2
	})
"qq" = (
/obj/effect/overlay/coconut,
/turf/open/floor/plating/beach/sand,
/area/ruin/unpowered{
	light_range = 2
	})
"qG" = (
/obj/item/clothing/suit/space/hardsuit/carp/old,
/turf/open/floor/plating/grass/beach,
/area/ruin/unpowered{
	light_range = 2
	})
"qP" = (
/obj/structure/window/reinforced{
	dir = 8
	},
/obj/structure/window/reinforced,
/obj/item/storage/firstaid/o2,
/turf/open/floor/wood,
/area/ruin/unpowered{
	light_range = 2
	})
"rD" = (
/obj/structure/bed,
/obj/item/bedsheet/dorms,
/turf/open/floor/wood,
/area/ruin/unpowered{
	light_range = 2
	})
"ta" = (
/turf/open/floor/carpet/blue,
/area/ruin/unpowered{
	light_range = 2
	})
"ug" = (
/obj/structure/closet/crate/freezer{
	name = "Cooler"
	},
/obj/item/reagent_containers/food/drinks/ice,
/obj/item/reagent_containers/food/drinks/colocup,
/obj/item/reagent_containers/food/drinks/colocup,
/obj/item/reagent_containers/food/drinks/beer{
	desc = "Beer advertised to be the best in space.";
	name = "Masterbrand Beer"
	},
/obj/item/reagent_containers/food/drinks/beer{
	desc = "Beer advertised to be the best in space.";
	name = "Masterbrand Beer"
	},
/obj/item/reagent_containers/food/drinks/beer{
	desc = "Beer advertised to be the best in space.";
	name = "Masterbrand Beer"
	},
/obj/item/reagent_containers/food/drinks/beer/light,
/obj/item/reagent_containers/food/drinks/beer/light,
/obj/item/reagent_containers/food/drinks/beer/light,
/turf/open/floor/plating/beach/sand,
/area/ruin/unpowered{
	light_range = 2
	})
"uw" = (
/obj/structure/flora/rock/beach,
/turf/open/floor/plating/beach/sand,
/area/ruin/unpowered{
	light_range = 2
	})
"vG" = (
/obj/effect/mob_spawn/human/corpse/charredskeleton,
/turf/open/floor/carpet/purple,
/area/ruin/unpowered{
	light_range = 2
	})
"wb" = (
/obj/structure/window/reinforced{
	dir = 1
	},
/obj/structure/window/reinforced{
	dir = 8
	},
/obj/structure/table/wood,
/obj/item/megaphone,
/turf/open/floor/wood,
/area/ruin/unpowered{
	light_range = 2
	})
"wf" = (
/obj/effect/spawner/structure/window/reinforced,
/obj/structure/grille,
/obj/structure/curtain,
/turf/open/floor/wood,
/area/ruin/unpowered{
	light_range = 2
	})
"xK" = (
/obj/structure/chair/plastic,
/turf/open/floor/plating/grass/beach,
/area/ruin/unpowered{
	light_range = 2
	})
"xT" = (
/obj/item/stack/sheet/sandblock,
/turf/open/floor/plating/beach/sand,
/area/ruin/unpowered{
	light_range = 2
	})
"Ap" = (
/obj/structure/fluff/beach_umbrella/security,
/turf/open/floor/plating/beach/sand,
/area/ruin/unpowered{
	light_range = 2
	})
"AV" = (
/obj/item/storage/crayons,
/turf/open/floor/concrete,
/area/ruin/unpowered{
	light_range = 2
	})
"CR" = (
/obj/structure/window/reinforced{
	dir = 4
	},
/obj/structure/window/reinforced{
	dir = 1;
	layer = 2.9
	},
/obj/structure/chair/stool,
/obj/item/storage/backpack/duffelbag,
/obj/item/clothing/under/shorts/red,
/obj/item/clothing/glasses/sunglasses,
/turf/open/floor/wood,
/area/ruin/unpowered{
	light_range = 2
	})
"Dl" = (
/obj/structure/mineral_door/sandstone,
/turf/open/floor/plating/grass/beach,
/area/ruin/unpowered{
	light_range = 2
	})
"Dx" = (
/obj/item/toy/crayon/spraycan{
	pixel_x = -5;
	pixel_y = 6
	},
/obj/item/toy/crayon/spraycan{
	pixel_x = 6;
	pixel_y = 3
	},
/turf/open/floor/concrete,
/area/ruin/unpowered{
	light_range = 2
	})
"EB" = (
/obj/structure/fence{
	dir = 4
	},
/obj/structure/fence{
	dir = 4
	},
/turf/open/floor/plating/grass/beach,
/area/ruin/unpowered{
	light_range = 2
	})
"EC" = (
/obj/item/toy/beach_ball/holoball/dodgeball,
/turf/open/floor/plating/beach/sand,
/area/ruin/unpowered{
	light_range = 2
	})
"Fm" = (
/obj/structure/catwalk/over/plated_catwalk,
/turf/open/floor/plating/beach/sand,
/area/ruin/unpowered{
	light_range = 2
	})
"FV" = (
/obj/effect/overlay/palmtree_r,
/turf/open/floor/plating/beach/sand,
/area/ruin/unpowered{
	light_range = 2
	})
"FW" = (
/mob/living/simple_animal/hostile/carp,
/turf/open/floor/plating/grass/beach,
/area/ruin/unpowered{
	light_range = 2
	})
"Gh" = (
/obj/structure/fence{
	dir = 9;
	icon_state = "corner"
	},
/turf/open/floor/plating/grass/beach,
/area/ruin/unpowered{
	light_range = 2
	})
"Hg" = (
/obj/machinery/hydroponics/soil,
/turf/open/floor/plating/dirt/jungle,
/area/ruin/unpowered{
	light_range = 2
	})
"IV" = (
/obj/item/stack/ore/glass/beach,
/turf/open/floor/plating/beach/sand,
/area/ruin/unpowered{
	light_range = 2
	})
"Ja" = (
/obj/structure/flora/tree/jungle/small,
/turf/open/floor/plating/grass/beach,
/area/ruin/unpowered{
	light_range = 2
	})
"Jb" = (
/obj/item/seeds/cocoapod/vanillapod,
/turf/open/floor/plating/dirt/jungle,
/area/ruin/unpowered{
	light_range = 2
	})
"JX" = (
/obj/structure/mineral_door/sandstone,
/turf/open/floor/wood,
/area/ruin/unpowered{
	light_range = 2
	})
"KA" = (
/turf/open/floor/plating/dirt/jungle,
/area/ruin/unpowered{
	light_range = 2
	})
"KM" = (
/turf/template_noop,
/area/template_noop)
"Ld" = (
/obj/structure/fluff/beach_umbrella/science,
/turf/open/floor/plating/beach/sand,
/area/ruin/unpowered{
	light_range = 2
	})
"Li" = (
/turf/open/water/beach/deep,
/area/ruin/unpowered{
	light_range = 2
	})
"Lz" = (
/obj/structure/fluff/beach_umbrella/engine,
/turf/open/floor/plating/beach/sand,
/area/ruin/unpowered{
	light_range = 2
	})
"ML" = (
/obj/item/reagent_containers/glass/bucket/wooden,
/turf/open/floor/plating/dirt/jungle,
/area/ruin/unpowered{
	light_range = 2
	})
"Nl" = (
/obj/item/toy/seashell,
/turf/open/floor/plating/beach/sand,
/area/ruin/unpowered{
	light_range = 2
	})
"Nz" = (
/turf/open/floor/plasteel/stairs/old,
/area/ruin/unpowered{
	light_range = 2
	})
"NG" = (
/obj/item/gun/ballistic/automatic/pistol/m1911/no_mag{
	pixel_x = 13
	},
/obj/item/toy/plush/carpplushie{
	desc = "An adorable stuffed toy that resembles a space carp with a gun.";
	name = "glock-ness monster plushie"
	},
/turf/open/water/beach/deep,
/area/ruin/unpowered{
	light_range = 2
	})
"NL" = (
/obj/structure/closet/cabinet,
/obj/item/storage/backpack/duffelbag,
/obj/item/clothing/under/shorts/purple,
/obj/item/clothing/shoes/cookflops{
	desc = "A very fashionable pair of flip flops.";
	name = "flip-flops"
	},
/obj/item/clothing/neck/beads,
/obj/item/clothing/under/color/red,
/obj/item/clothing/under/color/white,
/turf/open/floor/wood,
/area/ruin/unpowered{
	light_range = 2
	})
"Oa" = (
/obj/item/melee/skateboard/pro,
/turf/open/floor/wood,
/area/ruin/unpowered{
	light_range = 2
	})
"Om" = (
/obj/structure/fence{
	dir = 10;
	icon_state = "corner"
	},
/turf/open/floor/plating/grass/beach,
/area/ruin/unpowered{
	light_range = 2
	})
"Pd" = (
/obj/item/grown/log/tree,
/obj/item/grown/log/tree,
/obj/item/grown/log/tree,
/turf/open/floor/plating/grass/beach,
/area/ruin/unpowered{
	light_range = 2
	})
"Px" = (
/obj/structure/chair/plastic{
	dir = 1
	},
/turf/open/floor/plating/grass/beach,
/area/ruin/unpowered{
	light_range = 2
	})
"Qf" = (
/turf/open/floor/concrete/slab_1,
/area/ruin/unpowered{
	light_range = 2
	})
"RK" = (
/obj/item/toy/beach_ball/holoball/dodgeball,
/obj/item/melee/skateboard/hoverboard,
/turf/open/floor/plating/beach/sand,
/area/ruin/unpowered{
	light_range = 2
	})
"RM" = (
/obj/structure/sink/puddle,
/turf/open/floor/plating/dirt/jungle,
/area/ruin/unpowered{
	light_range = 2
	})
"RV" = (
/obj/structure/chair/plastic{
	dir = 8
	},
/turf/open/floor/plating/grass/beach,
/area/ruin/unpowered{
	light_range = 2
	})
"SS" = (
/turf/open/floor/carpet/red,
/area/ruin/unpowered{
	light_range = 2
	})
"Te" = (
/obj/structure/railing,
/turf/open/floor/plating/grass/beach,
/area/ruin/unpowered{
	light_range = 2
	})
"Tr" = (
/obj/item/reagent_containers/food/drinks/colocup{
	pixel_x = -7;
	pixel_y = -2
	},
/obj/item/reagent_containers/food/drinks/colocup{
	pixel_x = 5;
	pixel_y = 6
	},
/obj/item/reagent_containers/food/drinks/bottle/rum{
	pixel_x = 4;
	pixel_y = -3
	},
/turf/open/floor/carpet/red,
/area/ruin/unpowered{
	light_range = 2
	})
"TW" = (
/obj/structure/fence{
	dir = 4
	},
/turf/open/floor/plating/grass/beach,
/area/ruin/unpowered{
	light_range = 2
	})
"TZ" = (
/turf/open/floor/carpet/purple,
/area/ruin/unpowered{
	light_range = 2
	})
"US" = (
/turf/open/water/beach,
/area/ruin/unpowered{
	light_range = 2
	})
"Vn" = (
/turf/open/floor/plating/grass/beach,
/area/ruin/unpowered{
	light_range = 2
	})
"Vx" = (
/obj/structure/table/rolling,
/obj/item/reagent_containers/food/snacks/kebab/fiesta,
/obj/item/reagent_containers/food/snacks/kebab/fiesta{
	pixel_y = 7
	},
/obj/item/reagent_containers/food/snacks/kebab/fiesta{
	pixel_y = 13
	},
/turf/open/floor/plating/grass/beach,
/area/ruin/unpowered{
	light_range = 2
	})
"VG" = (
/obj/item/reagent_containers/spray/cleaner,
/turf/open/floor/concrete,
/area/ruin/unpowered{
	light_range = 2
	})
"VX" = (
/obj/structure/railing{
	dir = 8
	},
/turf/open/floor/plating/grass/beach,
/area/ruin/unpowered{
	light_range = 2
	})
"Ww" = (
/obj/item/melee/roastingstick,
/turf/open/floor/plating/grass/beach,
/area/ruin/unpowered{
	light_range = 2
	})
"Xd" = (
/obj/structure/railing{
	dir = 4
	},
/turf/open/floor/plating/grass/beach,
/area/ruin/unpowered{
	light_range = 2
	})
"Xe" = (
/obj/item/storage/cans/sixbeer,
/turf/open/floor/plating/grass/beach,
/area/ruin/unpowered{
	light_range = 2
	})
"Xh" = (
/obj/item/reagent_containers/glass/bucket,
/turf/open/floor/plating/beach/sand,
/area/ruin/unpowered{
	light_range = 2
	})
"Xo" = (
/obj/structure/statue/sandstone/assistant,
/turf/open/floor/plating/beach/sand,
/area/ruin/unpowered{
	light_range = 2
	})
"Xr" = (
/obj/structure/flora/ausbushes/sparsegrass,
/turf/open/floor/plating/beach/sand,
/area/ruin/unpowered{
	light_range = 2
	})
"Xz" = (
/obj/structure/window/reinforced{
	dir = 4
	},
/turf/open/floor/wood,
/area/ruin/unpowered{
	light_range = 2
	})
"Yi" = (
/obj/item/toy/plush/lizardplushie{
	name = "Soaks-The-Rays"
	},
/turf/open/floor/carpet/orange,
/area/ruin/unpowered{
	light_range = 2
	})
"Yq" = (
/obj/effect/decal/cleanable/crayon{
	icon_state = "#"
	},
/turf/open/floor/concrete,
/area/ruin/unpowered{
	light_range = 2
	})
"Zz" = (
/obj/structure/flora/ausbushes/grassybush,
/turf/open/floor/plating/beach/sand,
/area/ruin/unpowered{
	light_range = 2
	})
"ZA" = (
/obj/structure/flora/junglebush/large,
/turf/open/floor/plating/grass/beach,
/area/ruin/unpowered{
	light_range = 2
	})
"ZI" = (
/turf/open/floor/plating/beach/sand,
/area/ruin/unpowered{
	light_range = 2
	})

(1,1,1) = {"
KM
KM
KM
KM
KM
KM
Vn
Vn
Vn
Vn
Vn
Vn
Vn
Vn
Vn
Vn
Vn
Vn
Vn
KM
KM
KM
KM
KM
KM
KM
KM
KM
KM
KM
"}
(2,1,1) = {"
KM
KM
KM
bO
bO
bO
bO
bO
bO
Vn
cC
Vn
Hg
Hg
dE
Jb
Hg
Hg
Vn
Vn
gn
nB
Vn
Vn
KM
KM
KM
KM
KM
KM
"}
(3,1,1) = {"
KM
KM
bO
NL
mt
Oa
bO
mI
JX
Vn
Vn
Hg
KA
KA
ML
RM
KA
KA
Hg
Vn
Vn
Vn
Vn
ZA
Vn
Vn
Vn
Ja
KM
KM
"}
(4,1,1) = {"
KM
KM
bO
mt
mt
mt
bO
bO
bO
Vn
Vn
Vn
Hg
Hg
KA
fd
Hg
Hg
Vn
Vn
Vn
cS
Vn
Vn
Vn
Vn
Vn
Vn
Vn
KM
"}
(5,1,1) = {"
KM
bO
mt
mt
mt
Dl
Vn
Vn
Vn
Vn
gn
Vn
Vn
Vn
Vn
Vn
Vn
Vn
Vn
Vn
bt
Vn
gn
Vn
Xe
pp
Vn
cr
Vn
KM
"}
(6,1,1) = {"
KM
bO
rD
on
rD
bO
Vn
cC
Vn
bt
Vn
ZI
Xr
ZI
ZI
ZI
Vn
Vn
Vn
Vn
Vn
Vn
Vn
Vn
Vn
Xd
Vn
Px
Vn
KM
"}
(7,1,1) = {"
KM
Vn
bO
wf
bO
Vn
Vn
Vn
Vn
ZI
ZI
ZI
ZI
ZI
ZI
ZI
ZI
ZI
ZI
Vn
Vn
Vn
gn
xK
Te
pY
iJ
Pd
Vn
KM
"}
(8,1,1) = {"
KM
ZA
Vn
Vn
Vn
Vn
ZI
Zz
ZI
ZI
ZI
ZI
ZI
ZI
ZI
ZI
ZI
Xr
ZI
ZI
Vn
Vn
Vn
Vn
Ww
VX
Vn
Px
Vn
KM
"}
(9,1,1) = {"
Vn
Vn
Vn
Vn
ZI
ZI
ZI
ZI
ZI
ZI
qq
ZI
ZI
ZI
fC
Zz
ZI
ZI
ZI
ZI
Zz
ZI
Vn
Vn
RV
Vn
Vx
Vn
Vn
KM
"}
(10,1,1) = {"
Vn
cS
Vn
ZI
ZI
ZI
ZI
ZI
RK
ZI
ZI
ZI
Xr
ZI
ZI
ZI
ZI
Xr
ZI
ZI
ZI
Xr
Vn
Vn
Vn
Vn
Vn
gn
Vn
KM
"}
(11,1,1) = {"
Ja
Vn
Vn
ZI
ZI
ZI
Zz
ZI
ZI
ZI
ZI
ZI
ZI
ZI
ZI
ZI
ZI
ZI
ZI
ZI
ZI
ZI
Vn
Vn
cC
Gh
lD
lD
Om
Vn
"}
(12,1,1) = {"
Vn
Vn
gn
Zz
ZI
ZI
ZI
ZI
ZI
ZI
Xr
ZI
ZI
uw
US
US
ZI
ZI
Zz
ZI
ZI
ZI
Vn
Vn
Vn
TW
FW
cS
TW
Vn
"}
(13,1,1) = {"
Vn
Vn
ZI
ZI
ZI
ZI
fC
ZI
Ap
ZI
ZI
ZI
ZI
US
US
US
US
ZI
ZI
pv
IV
ZI
Vn
Vn
Vn
TW
Vn
FW
TW
pU
"}
(14,1,1) = {"
ZA
Vn
ZI
ZI
ZI
ZI
ZI
ZI
Tr
SS
ZI
ZI
US
US
US
US
US
ZI
ZI
Xh
nl
pv
ZI
Vn
Vn
TW
qG
Vn
ns
Vn
"}
(15,1,1) = {"
cS
Vn
Zz
ZI
ZI
Xr
ZI
ZI
ZI
ZI
ZI
ZI
US
US
US
US
US
ZI
ZI
xT
pv
IV
ZI
nB
Vn
TW
Vn
cC
TW
Vn
"}
(16,1,1) = {"
Vn
Vn
ZI
ZI
ZI
ZI
ZI
ZI
ug
Nl
ZI
US
US
US
Li
US
US
US
ZI
Xo
xT
ZI
ZI
Xr
Vn
TW
FW
kd
EB
ZA
"}
(17,1,1) = {"
Vn
Vn
Zz
ZI
ZI
fC
ZI
Ld
ZI
ZI
ZI
US
US
US
Li
Li
US
US
ZI
ZI
ZI
lr
ZI
ZI
Vn
hQ
lD
lD
dH
Vn
"}
(18,1,1) = {"
Vn
ZI
ZI
ZI
ZI
ZI
ZI
vG
TZ
ZI
ZI
US
US
Li
Li
Li
US
US
ZI
Xr
EC
ZI
ZI
ZI
gn
Vn
Vn
Vn
Vn
Vn
"}
(19,1,1) = {"
Xr
ZI
ZI
ZI
Zz
ZI
ZI
lr
ZI
ZI
ZI
US
US
Li
Li
Li
US
US
ZI
ZI
ZI
ZI
EC
ZI
Vn
bt
Vn
Vn
Vn
Vn
"}
(20,1,1) = {"
ZI
ZI
fC
ZI
Xr
ZI
ZI
ZI
ZI
ZI
ZI
US
US
Li
NG
Li
US
US
ZI
ZI
ZI
ZI
ZI
ZI
Vn
Vn
Vn
Vn
Vn
Vn
"}
(21,1,1) = {"
ZI
ZI
ZI
qq
ZI
ZI
ZI
gv
ZI
ZI
ZI
US
US
Li
Li
Li
US
US
ZI
ZI
hh
hh
hh
ZI
Vn
Vn
Ja
Vn
cS
Vn
"}
(22,1,1) = {"
KM
ZI
ZI
ZI
ZI
ZI
ZI
ta
aW
ZI
ZI
US
US
US
Li
Li
US
US
ZI
ZI
ZI
ZI
ZI
ZI
Qf
Qf
Qf
Qf
Qf
KM
"}
(23,1,1) = {"
KM
Zz
ZI
ZI
ZI
ZI
Xr
ZI
ZI
ZI
Zz
ZI
US
US
Li
US
US
US
ZI
ZI
EC
ZI
ZI
ZI
Qf
AV
pN
Yq
Qf
KM
"}
(24,1,1) = {"
KM
ZI
ZI
ZI
Lz
ZI
ZI
ZI
ZI
ZI
ZI
ZI
US
US
US
US
US
US
ZI
ZI
ZI
Zz
ZI
ZI
Qf
pN
pN
pN
Qf
KM
"}
(25,1,1) = {"
KM
ZI
ZI
ag
Yi
ZI
ZI
wb
qP
Fm
ZI
ZI
US
US
US
US
US
uw
ZI
ZI
ZI
ZI
ZI
ZI
Qf
Dx
kV
VG
Qf
KM
"}
(26,1,1) = {"
KM
ZI
ZI
FV
fj
ZI
ZI
CR
Xz
Nz
ZI
ZI
uw
US
US
US
ZI
ZI
ZI
fC
qq
ZI
ZI
Vn
Qf
Qf
Qf
Qf
Qf
KM
"}
(27,1,1) = {"
KM
ZI
ZI
ZI
Xr
ZI
ZI
ZI
ZI
ZI
ZI
ZI
ZI
ZI
ZI
ZI
ZI
Xr
ZI
ZI
ZI
ZI
ZI
Vn
cC
Vn
Vn
Vn
KM
KM
"}
(28,1,1) = {"
KM
KM
ZI
ZI
ZI
ZI
ZI
ZI
Xr
ZI
ZI
ZI
ZI
Xr
ZI
ZI
ZI
ZI
ZI
ZI
ZI
ZI
Vn
Vn
Vn
Vn
Vn
ZA
KM
KM
"}
(29,1,1) = {"
KM
KM
KM
KM
KM
ZI
Zz
ZI
ZI
ZI
ZI
ZI
ZI
ZI
ZI
ZI
ZI
Zz
ZI
ZI
ZI
Xr
Vn
Vn
Vn
Vn
Vn
KM
KM
KM
"}
(30,1,1) = {"
KM
KM
KM
KM
KM
KM
KM
KM
ZI
ZI
ZI
ZI
Zz
ZI
ZI
ZI
ZI
ZI
ZI
ZI
Vn
Vn
Vn
gn
KM
KM
KM
KM
KM
KM
"}
