//MAP CONVERTED BY dmm2tgm.py THIS HEADER COMMENT PREVENTS RECONVERSION, DO NOT REMOVE
"a" = (
/turf/open/space/basic,
/area/space)
"c" = (
/obj/structure/flora/ausbushes/sparsegrass,
/turf/open/floor/grass,
/area/space)
"e" = (
/turf/open/floor/plating/dirt,
/area/space)
"f" = (
/obj/structure/flora/ausbushes/brflowers,
/obj/structure/flora/ausbushes/ywflowers,
/turf/open/floor/grass,
/area/space)
"k" = (
/obj/structure/closet/crate/grave{
	icon_state = "grave_lead";
	desc = "An marked patch of soil, showing signs of a burial. The headstone cannot be read, its' message torn away by age."
	},
/obj/item/nullrod/claymore{
	name = "ancient claymore";
	desc = "The gold on the sword is tarnished, yet retains an human letter carved into it. R." 
	},
/turf/open/floor/plating/dirt/dark,
/area/space)
"l" = (
/obj/structure/flora/ausbushes/ywflowers,
/obj/structure/flora/ausbushes/brflowers,
/obj/structure/flora/ausbushes/ppflowers,
/turf/open/floor/grass,
/area/space)
"n" = (
/obj/structure/chair/pew/right{
	dir = 1
	},
/turf/open/floor/grass,
/area/space)
"r" = (
/obj/structure/chair/pew/left{
	dir = 1
	},
/turf/open/floor/grass,
/area/space)
"t" = (
/obj/structure/chair/pew{
	dir = 1
	},
/turf/open/floor/grass,
/area/space)
"x" = (
/obj/structure/flora/ausbushes/ppflowers,
/obj/structure/flora/ausbushes/brflowers,
/obj/structure/flora/ausbushes/ywflowers,
/obj/structure/flora/ausbushes/sparsegrass,
/turf/open/floor/grass,
/area/space)
"y" = (
/obj/structure/flora/ausbushes/ppflowers,
/obj/structure/flora/ausbushes/ywflowers,
/turf/open/floor/grass,
/area/space)
"z" = (
/obj/structure/flora/ausbushes/ppflowers,
/obj/structure/flora/ausbushes/brflowers,
/obj/structure/flora/ausbushes/ywflowers,
/turf/open/floor/grass,
/area/space)
"J" = (
/turf/open/floor/grass/fairy/beach,
/area/space)
"P" = (
/mob/living/simple_animal/butterfly,
/turf/open/floor/grass,
/area/space)
"R" = (
/turf/open/floor/grass,
/area/space)
"S" = (
/obj/structure/altar_of_gods,
/obj/item/reagent_containers/food/snacks/grown/poppy/lily,
/turf/open/floor/plating/dirt,
/area/space)
"U" = (
/obj/structure/flora/ausbushes/ppflowers,
/obj/structure/flora/ausbushes/brflowers,
/obj/structure/flora/ausbushes/sparsegrass,
/turf/open/floor/grass,
/area/space)
"V" = (
/obj/structure/flora/tree/chapel{
	desc = "A true earthen oak tree, it looks weathered and sturdy.";
	name = "oak tree"
	},
/turf/open/space/basic,
/area/space)
"W" = (
/turf/open/floor/plating/dirt/dark,
/area/space)
"X" = (
/obj/structure/flora/tree/chapel{
	desc = "A true earthen oak tree, it looks mighty, as if it has been standing guard for decades.";
	name = "oak tree"
	},
/turf/open/floor/grass,
/area/space)

(1,1,1) = {"
a
a
a
a
a
a
a
a
a
a
a
a
a
a
a
a
a
a
a
a
a
a
a
a
a
a
a
a
a
a
a
a
a
a
a
a
a
a
a
a
a
a
a
a
a
a
a
a
a
a
"}
(2,1,1) = {"
e
R
J
J
a
a
a
a
a
a
a
a
a
a
a
a
a
a
a
a
a
a
a
a
a
a
a
a
a
a
a
a
a
a
J
R
R
J
a
a
a
a
a
a
a
a
a
a
a
a
"}
(3,1,1) = {"
e
R
R
J
a
a
a
a
a
a
a
a
a
a
a
a
a
a
a
a
a
a
a
a
a
a
a
a
a
a
a
a
a
a
J
R
R
J
J
J
a
a
a
a
a
a
a
a
a
a
"}
(4,1,1) = {"
e
e
R
a
a
a
a
a
a
a
a
a
a
a
a
a
a
a
a
a
a
a
a
a
a
a
a
a
a
a
a
a
a
a
J
R
R
R
R
J
J
a
a
a
a
a
a
a
a
a
"}
(5,1,1) = {"
e
W
a
a
a
J
a
a
a
a
a
a
a
a
a
a
a
a
a
a
a
a
a
a
a
a
a
a
a
a
a
a
a
a
J
R
R
R
R
R
J
J
a
a
a
a
a
a
a
a
"}
(6,1,1) = {"
a
a
a
a
J
a
a
a
a
a
a
a
a
a
a
a
a
a
a
a
a
a
a
a
a
a
a
a
a
a
a
a
a
a
J
R
R
R
R
R
R
J
J
a
a
a
a
a
a
a
"}
(7,1,1) = {"
V
a
a
a
J
a
a
a
a
a
J
J
a
a
a
a
a
a
a
a
a
a
a
a
a
a
a
a
a
a
R
R
R
a
J
R
R
R
R
R
R
R
J
a
a
a
a
a
a
a
"}
(8,1,1) = {"
a
a
a
a
J
a
a
a
a
J
J
a
J
J
a
a
a
J
J
a
a
a
a
a
R
a
a
R
R
R
R
R
R
R
J
J
R
R
R
R
R
R
J
J
a
a
a
a
a
a
"}
(9,1,1) = {"
a
a
a
J
J
a
a
a
a
a
a
a
a
J
a
a
a
a
J
J
J
a
a
a
R
a
a
R
J
R
R
R
R
R
R
J
J
R
R
R
R
R
J
J
a
a
a
a
a
a
"}
(10,1,1) = {"
a
a
a
a
a
a
a
a
a
a
a
a
a
a
J
a
a
a
a
a
J
a
a
a
R
a
a
R
J
R
R
R
R
R
R
R
J
J
J
R
R
R
R
J
J
a
a
a
a
a
"}
(11,1,1) = {"
a
a
a
J
a
a
a
a
a
a
a
a
a
a
a
a
a
a
a
a
a
J
a
a
a
R
a
R
J
J
R
R
R
R
R
R
R
R
J
J
R
R
R
R
J
a
a
a
a
a
"}
(12,1,1) = {"
a
a
a
J
a
a
a
a
a
R
R
a
a
a
a
a
a
R
c
a
a
J
a
a
a
R
a
R
R
J
R
R
J
R
R
R
R
R
R
J
J
R
R
R
J
a
a
a
a
a
"}
(13,1,1) = {"
a
a
a
J
a
a
a
a
P
e
R
a
a
a
a
a
P
c
r
R
a
J
a
a
R
R
R
R
R
J
J
J
J
J
R
R
R
R
R
R
J
R
R
R
J
a
a
a
a
a
"}
(14,1,1) = {"
a
a
a
a
a
a
a
R
e
f
R
R
R
e
e
a
c
R
t
R
a
J
a
a
R
R
R
R
R
J
J
J
J
J
R
R
R
R
R
R
R
J
R
R
J
a
a
a
a
a
"}
(15,1,1) = {"
a
a
a
a
a
a
a
R
X
k
e
c
R
S
e
a
R
R
t
c
a
J
a
J
R
R
R
R
R
R
J
J
J
R
R
R
R
R
R
R
R
J
J
R
J
a
a
a
a
a
"}
(16,1,1) = {"
a
a
a
a
a
a
a
l
y
z
U
P
e
e
e
a
R
R
t
R
a
J
a
J
J
R
R
R
R
R
R
R
R
R
R
R
R
R
R
R
R
R
J
R
J
a
a
a
a
a
"}
(17,1,1) = {"
a
a
a
a
a
a
a
a
x
e
R
R
a
a
a
a
a
R
n
R
a
a
a
a
J
J
R
R
R
R
R
R
R
R
R
R
R
R
R
R
R
R
J
J
J
a
a
a
a
a
"}
(18,1,1) = {"
a
a
J
a
a
a
a
a
P
R
R
R
a
a
a
a
a
a
c
a
a
a
a
a
a
J
J
R
R
R
R
R
R
R
R
R
R
J
R
R
R
R
J
J
R
a
a
a
a
a
"}
(19,1,1) = {"
a
a
a
J
a
a
a
a
a
a
c
a
a
a
a
a
a
a
a
a
a
a
a
a
a
a
a
J
J
R
R
R
R
R
R
R
J
R
R
R
R
R
J
R
R
a
a
a
a
a
"}
(20,1,1) = {"
a
a
a
J
a
a
a
a
a
a
a
a
a
a
a
a
a
a
a
a
a
a
a
a
a
a
a
a
J
J
R
R
R
R
R
R
J
R
R
R
R
J
J
R
R
R
a
a
a
a
"}
(21,1,1) = {"
a
a
a
J
a
a
a
a
a
a
a
a
a
a
a
a
a
a
a
a
J
a
a
a
a
a
a
a
a
J
J
R
R
R
R
J
J
R
R
R
R
J
R
R
R
R
a
a
a
a
"}
(22,1,1) = {"
a
a
a
J
a
a
a
a
a
a
a
a
a
a
J
J
a
a
a
a
J
a
a
a
a
a
a
a
a
a
J
R
J
R
J
J
R
R
R
R
R
J
J
R
R
R
R
a
a
a
"}
(23,1,1) = {"
a
a
a
J
a
a
a
a
a
a
a
a
a
J
J
a
a
a
a
J
a
a
a
a
a
a
a
a
a
a
J
a
a
a
a
a
a
R
R
R
R
R
J
J
R
R
R
J
a
a
"}
(24,1,1) = {"
a
a
a
a
J
a
a
a
a
a
a
J
J
J
a
a
J
J
J
J
a
a
a
a
a
a
a
a
a
a
J
a
a
a
a
a
R
R
R
a
R
R
R
J
J
R
R
J
a
a
"}
(25,1,1) = {"
a
a
a
a
J
a
a
a
a
a
J
J
a
a
a
a
J
a
a
a
a
a
a
a
a
a
a
a
a
a
a
a
a
a
a
a
R
R
a
a
a
R
R
R
J
J
J
a
a
a
"}
(26,1,1) = {"
a
a
a
a
J
J
a
a
a
a
a
a
a
a
a
a
a
a
a
a
a
a
a
a
a
a
a
a
a
a
a
a
a
a
a
a
a
a
a
a
a
R
R
R
R
J
a
a
a
a
"}
(27,1,1) = {"
a
a
a
a
a
J
a
a
a
a
a
a
a
a
a
a
a
a
a
a
a
a
a
a
a
a
a
a
a
a
a
a
a
a
a
a
a
a
a
a
a
R
R
R
J
J
a
a
a
a
"}
(28,1,1) = {"
a
a
a
a
a
a
a
a
a
a
a
a
a
a
a
a
a
a
a
a
a
a
a
a
a
a
a
a
a
a
a
a
a
a
a
a
a
a
a
a
a
a
J
J
a
a
a
a
a
a
"}
(29,1,1) = {"
a
a
a
a
a
a
a
a
a
a
a
a
a
a
a
a
a
a
a
a
a
a
a
a
a
a
a
a
a
a
a
a
a
a
a
a
a
a
a
a
a
J
J
a
a
a
a
a
a
a
"}
(30,1,1) = {"
a
a
a
a
a
a
a
a
a
a
a
a
a
a
a
a
a
a
a
a
a
a
a
a
a
a
a
a
a
a
a
a
a
a
a
a
a
a
a
a
a
a
a
a
a
a
a
a
a
a
"}
