//MAP CONVERTED BY dmm2tgm.py THIS HEADER COMMENT PREVENTS RECONVERSION, DO NOT REMOVE
"bh" = (
/obj/structure/cable{
	icon_state = "1-8"
	},
/obj/structure/cable{
	icon_state = "4-8"
	},
/obj/effect/turf_decal/industrial/warning/corner{
	dir = 1
	},
/obj/effect/turf_decal/weather/sand{
	dir = 10
	},
/turf/open/floor/plating{
	light_range = 2
	},
/area/ruin/unpowered)
"bp" = (
/turf/open/floor/plating/beach/sand,
/area/ruin/unpowered)
"bv" = (
/obj/machinery/power/smes/shuttle/precharged{
	dir = 1
	},
/obj/structure/cable{
	icon_state = "0-2"
	},
/obj/structure/cable,
/turf/open/floor/plating,
/area/ruin/unpowered)
"cc" = (
/obj/effect/turf_decal/weather/sand{
	dir = 10
	},
/turf/open/floor/plating{
	light_range = 2
	},
/area/ruin/unpowered)
"ch" = (
/mob/living/simple_animal/crab{
	name = "\improper Crab"
	},
/turf/open/floor/plating/beach/sand{
	light_range = 2
	},
/area/ruin/unpowered)
"cj" = (
/obj/structure/cable{
	icon_state = "0-9"
	},
/obj/structure/curtain/cloth/grey,
/obj/effect/turf_decal/weather/sand{
	dir = 6
	},
/turf/open/floor/plating,
/area/ruin/unpowered)
"cq" = (
/obj/structure/curtain/cloth/grey,
/obj/structure/cable{
	icon_state = "4-8"
	},
/turf/open/floor/plating,
/area/ruin/unpowered)
"cr" = (
/obj/structure/cable{
	icon_state = "4-8"
	},
/obj/effect/turf_decal/weather/sand{
	dir = 4
	},
/turf/open/floor/plating,
/area/ruin/unpowered)
"cy" = (
/obj/structure/cable{
	icon_state = "4-9"
	},
/obj/structure/cable{
	icon_state = "2-9"
	},
/turf/open/floor/plating,
/area/ruin/unpowered)
"cO" = (
/obj/effect/turf_decal/industrial/hatch/yellow,
/obj/structure/cable{
	icon_state = "0-4"
	},
/obj/effect/turf_decal/weather/sand{
	dir = 9
	},
/turf/open/floor/plating{
	light_range = 2
	},
/area/ruin/unpowered)
"cW" = (
/obj/structure/radioactive,
/turf/open/water/beach,
/area/ruin/unpowered)
"dG" = (
/obj/structure/cable,
/obj/machinery/power/apc/auto_name/south,
/obj/structure/bed,
/turf/open/floor/carpet/nanoweave/orange,
/area/ruin/unpowered)
"dM" = (
/obj/structure/window/reinforced{
	dir = 4
	},
/obj/structure/window/reinforced{
	dir = 8
	},
/obj/effect/turf_decal/weather/sand,
/turf/open/floor/plating{
	light_range = 2
	},
/area/ruin/unpowered)
"dO" = (
/obj/structure/cable,
/obj/machinery/rnd/production/circuit_imprinter/department,
/turf/open/floor/plasteel/tech,
/area/ruin/unpowered)
"dX" = (
/turf/open/water/beach,
/area/ruin/unpowered)
"eM" = (
/obj/structure/flora/ausbushes/ppflowers,
/turf/open/floor/plating/grass/beach{
	light_range = 2
	},
/area/ruin/unpowered)
"fa" = (
/obj/effect/turf_decal/industrial/outline/yellow,
/obj/effect/decal/cleanable/glass,
/obj/effect/decal/cleanable/blood/old,
/obj/item/shard,
/obj/structure/cable{
	icon_state = "0-8"
	},
/turf/open/floor/plating,
/area/ruin/unpowered)
"fj" = (
/obj/effect/decal/cleanable/oil,
/obj/structure/cable,
/obj/structure/salvageable/server,
/turf/open/floor/plasteel/tech,
/area/ruin/unpowered)
"fB" = (
/obj/structure/flora/junglebush/large,
/turf/open/floor/plating/grass/beach{
	light_range = 2
	},
/area/ruin/unpowered)
"fT" = (
/obj/structure/barricade/wooden,
/turf/open/floor/plasteel/dark,
/area/ruin/unpowered)
"gH" = (
/mob/living/simple_animal/hostile/abandoned_minebot{
	name = "\improper Abandoned Tony"
	},
/turf/open/floor/plating/beach/sand{
	light_range = 2
	},
/area/ruin/unpowered)
"hA" = (
/obj/structure/grille,
/obj/structure/window/plasma/reinforced/fulltile,
/turf/open/floor/plating,
/area/ruin/unpowered)
"hL" = (
/obj/structure/ore_box,
/turf/open/floor/plating,
/area/ruin/unpowered)
"hM" = (
/obj/structure/cable,
/obj/machinery/power/shuttle/engine/electric{
	dir = 1
	},
/turf/open/floor/plating,
/area/ruin/unpowered)
"ij" = (
/obj/structure/girder,
/turf/open/floor/plating/rust,
/area/ruin/unpowered)
"iy" = (
/obj/effect/turf_decal/weather/sand{
	dir = 6
	},
/turf/open/floor/plating{
	light_range = 2
	},
/area/ruin/unpowered)
"iC" = (
/obj/structure/curtain/cloth/grey,
/turf/open/floor/plating/rust,
/area/ruin/unpowered)
"iH" = (
/obj/structure/cable{
	icon_state = "5-8"
	},
/obj/effect/turf_decal/weather/sand,
/turf/open/floor/plating{
	light_range = 2
	},
/area/ruin/unpowered)
"iZ" = (
/obj/effect/turf_decal/weather/sand{
	dir = 1
	},
/turf/open/floor/plating,
/area/ruin/unpowered)
"jP" = (
/obj/structure/cable{
	icon_state = "1-2"
	},
/turf/open/floor/plating,
/area/ruin/unpowered)
"kA" = (
/obj/machinery/portable_atmospherics/scrubber/huge/movable,
/turf/open/floor/plating/rust,
/area/ruin/unpowered)
"kF" = (
/obj/machinery/power/port_gen/pacman/super{
	anchored = 1
	},
/obj/structure/cable{
	icon_state = "0-8"
	},
/obj/effect/decal/cleanable/greenglow,
/turf/open/floor/plating,
/area/ruin/unpowered)
"kH" = (
/obj/item/book/manual/wiki/engineering_construction,
/turf/open/floor/plating/beach/sand{
	light_range = 2
	},
/area/ruin/unpowered)
"kK" = (
/obj/structure/cable{
	icon_state = "2-5"
	},
/obj/effect/turf_decal/weather/sand{
	dir = 1
	},
/obj/structure/radioactive,
/turf/open/floor/plating/rust,
/area/ruin/unpowered)
"kP" = (
/turf/open/floor/plating/beach/sand{
	light_range = 2
	},
/area/ruin/unpowered)
"kR" = (
/obj/effect/turf_decal/weather/sand{
	dir = 6
	},
/turf/open/floor/plating/rust,
/area/ruin/unpowered)
"lk" = (
/mob/living/simple_animal/hostile/asteroid/lobstrosity/beach,
/turf/open/floor/plating/beach/sand{
	light_range = 2
	},
/area/ruin/unpowered)
"lR" = (
/obj/machinery/power/floodlight,
/obj/structure/cable{
	icon_state = "0-2"
	},
/obj/effect/turf_decal/weather/sand{
	dir = 9
	},
/obj/effect/turf_decal/weather/sand{
	dir = 6
	},
/turf/open/floor/plating{
	light_range = 2
	},
/area/ruin/unpowered)
"ma" = (
/obj/structure/curtain/cloth/grey,
/turf/open/floor/plating,
/area/ruin/unpowered)
"mz" = (
/obj/structure/cable,
/obj/machinery/computer/rdconsole/core{
	dir = 1
	},
/turf/open/floor/plasteel/tech,
/area/ruin/unpowered)
"mH" = (
/obj/machinery/power/smes/shuttle/precharged{
	dir = 4
	},
/obj/effect/turf_decal/industrial/outline/yellow,
/obj/structure/window/reinforced{
	dir = 8
	},
/obj/structure/cable{
	icon_state = "0-8"
	},
/turf/open/floor/plating,
/area/ruin/unpowered)
"mM" = (
/obj/effect/turf_decal/weather/sand{
	dir = 10
	},
/turf/open/water/beach,
/area/ruin/unpowered)
"mU" = (
/obj/effect/turf_decal/weather/sand{
	dir = 9
	},
/turf/open/floor/plating/rust,
/area/ruin/unpowered)
"ni" = (
/obj/structure/closet/secure_closet/personal/cabinet{
	anchored = 1
	},
/obj/item/toy/beach_ball/holoball,
/obj/item/clothing/suit/hooded/survivor,
/obj/item/clothing/shoes/workboots,
/obj/item/clothing/glasses/welding,
/obj/item/storage/belt/mining/alt,
/obj/item/clothing/under/plasmaman/engineering,
/obj/item/clothing/gloves/color/plasmaman/engineer,
/obj/item/clothing/head/helmet/space/plasmaman/engineering,
/obj/item/binoculars,
/turf/open/floor/plasteel/tech,
/area/ruin/unpowered)
"oy" = (
/obj/machinery/door/airlock/hatch,
/obj/effect/mapping_helpers/airlock/locked,
/turf/open/floor/plating,
/area/ruin/unpowered)
"oS" = (
/obj/structure/rack,
/obj/effect/turf_decal/weather/sand{
	dir = 6
	},
/obj/item/stack/sheet/mineral/plasma/five,
/obj/item/weldingtool/mini,
/turf/open/floor/plating{
	light_range = 2
	},
/area/ruin/unpowered)
"oV" = (
/obj/structure/cable{
	icon_state = "0-10"
	},
/obj/effect/decal/cleanable/crayon{
	icon_state = "firedanger";
	pixel_y = 32
	},
/obj/effect/decal/cleanable/oil,
/obj/machinery/power/shieldwallgen/atmos{
	dir = 8
	},
/obj/effect/turf_decal/industrial/warning{
	dir = 5
	},
/turf/open/floor/plating{
	light_range = 2
	},
/area/ruin/unpowered)
"pp" = (
/obj/structure/rack,
/obj/item/storage/toolbox/mechanical,
/obj/item/screwdriver/power,
/obj/item/clothing/head/hardhat,
/obj/item/multitool,
/turf/open/floor/plasteel/dark,
/area/ruin/unpowered)
"pD" = (
/obj/structure/cable{
	icon_state = "4-8"
	},
/obj/effect/decal/cleanable/glass,
/obj/item/shard,
/turf/open/floor/plating,
/area/ruin/unpowered)
"pM" = (
/obj/item/stack/ore/salvage/scrapbluespace/five,
/obj/item/stack/ore/iron,
/obj/item/stack/ore/iron,
/obj/item/stack/ore/iron,
/obj/item/stack/ore/iron,
/obj/item/stack/ore/iron,
/obj/item/weldingtool/hugetank,
/obj/structure/table,
/turf/open/floor/plasteel/tech,
/area/ruin/unpowered)
"qD" = (
/turf/closed/wall,
/area/ruin/unpowered)
"qH" = (
/obj/structure/cable{
	icon_state = "6-9"
	},
/turf/open/floor/plating/beach/sand{
	light_range = 2
	},
/area/ruin/unpowered)
"qK" = (
/obj/machinery/power/terminal,
/obj/structure/cable,
/turf/open/floor/plating,
/area/ruin/unpowered)
"qZ" = (
/obj/machinery/atmospherics/pipe/simple/yellow/visible{
	dir = 10
	},
/turf/open/floor/plating/beach/sand{
	light_range = 2
	},
/area/ruin/unpowered)
"rW" = (
/obj/structure/cable{
	icon_state = "5-8"
	},
/obj/effect/decal/cleanable/ash/large,
/obj/effect/mob_spawn/human/skeleton,
/obj/item/wirecutters,
/turf/open/floor/plating,
/area/ruin/unpowered)
"sm" = (
/obj/structure/cable{
	icon_state = "4-10"
	},
/turf/open/floor/plating/beach/sand{
	light_range = 2
	},
/area/ruin/unpowered)
"sv" = (
/obj/machinery/atmospherics/components/binary/valve,
/turf/open/floor/plating/beach/sand{
	light_range = 2
	},
/area/ruin/unpowered)
"sA" = (
/obj/structure/cable{
	icon_state = "2-8"
	},
/obj/structure/cable{
	icon_state = "4-8"
	},
/turf/open/floor/plasteel/tech,
/area/ruin/unpowered)
"sB" = (
/obj/item/book/manual/wiki/engineering_guide,
/turf/open/floor/plating/beach/sand{
	light_range = 2
	},
/area/ruin/unpowered)
"sN" = (
/obj/structure/reagent_dispensers/fueltank,
/obj/effect/decal/cleanable/oil,
/turf/open/floor/plasteel/tech,
/area/ruin/unpowered)
"ts" = (
/obj/structure/cable{
	icon_state = "0-5"
	},
/turf/open/floor/plating/beach/sand{
	light_range = 2
	},
/area/ruin/unpowered)
"ty" = (
/obj/effect/turf_decal/weather/sand{
	dir = 1
	},
/turf/open/floor/plating{
	light_range = 2
	},
/area/ruin/unpowered)
"tB" = (
/turf/closed/wall/mineral/titanium,
/area/ruin/unpowered)
"tX" = (
/turf/open/floor/carpet/nanoweave/orange,
/area/ruin/unpowered)
"ug" = (
/obj/effect/turf_decal/industrial/warning,
/turf/open/floor/plasteel/dark,
/area/ruin/unpowered)
"um" = (
/obj/structure/cable{
	icon_state = "4-8"
	},
/turf/open/floor/plating/beach/sand{
	light_range = 2
	},
/area/ruin/unpowered)
"uw" = (
/obj/structure/girder,
/obj/effect/turf_decal/weather/sand,
/turf/open/floor/plating/rust,
/area/ruin/unpowered)
"vO" = (
/turf/open/floor/plating/beach/sand{
	icon_state = "sand_dug";
	light_range = 2
	},
/area/ruin/unpowered)
"wu" = (
/obj/structure/cable{
	icon_state = "2-4"
	},
/turf/open/floor/plating,
/area/ruin/unpowered)
"wC" = (
/obj/effect/turf_decal/weather/sand{
	dir = 8
	},
/obj/structure/barricade/wooden,
/turf/open/floor/plating,
/area/ruin/unpowered)
"xA" = (
/obj/structure/grille,
/obj/structure/window/plasma/reinforced/fulltile,
/turf/open/floor/plating{
	light_range = 2
	},
/area/ruin/unpowered)
"xV" = (
/obj/effect/decal/cleanable/glass,
/obj/item/shard,
/turf/open/floor/plating/beach/sand{
	light_range = 2
	},
/area/ruin/unpowered)
"yc" = (
/obj/effect/turf_decal/atmos/plasma,
/turf/open/floor/engine/plasma,
/area/ruin/unpowered)
"ye" = (
/obj/effect/turf_decal/weather/sand{
	dir = 5
	},
/turf/open/floor/plating,
/area/ruin/unpowered)
"yf" = (
/turf/open/floor/plasteel/tech,
/area/ruin/unpowered)
"ys" = (
/turf/template_noop,
/area/template_noop)
"yv" = (
/obj/effect/turf_decal/weather/sand{
	dir = 5
	},
/turf/open/floor/plating/beach/sand{
	light_range = 2
	},
/area/ruin/unpowered)
"yA" = (
/obj/effect/turf_decal/industrial/warning/corner{
	dir = 8
	},
/obj/machinery/portable_atmospherics/canister/toxins,
/turf/open/floor/plasteel/dark,
/area/ruin/unpowered)
"yM" = (
/obj/effect/turf_decal/industrial/warning{
	dir = 1
	},
/turf/open/floor/plating{
	light_range = 2
	},
/area/ruin/unpowered)
"zc" = (
/obj/effect/turf_decal/weather/sand,
/turf/open/floor/plating,
/area/ruin/unpowered)
"zh" = (
/obj/structure/cable{
	icon_state = "4-10"
	},
/obj/structure/cable{
	icon_state = "1-10"
	},
/turf/open/floor/plating/rust,
/area/ruin/unpowered)
"Ac" = (
/obj/structure/girder,
/turf/open/floor/plating{
	light_range = 2
	},
/area/ruin/unpowered)
"Ah" = (
/obj/machinery/atmospherics/pipe/simple/yellow/visible,
/obj/structure/grille,
/obj/structure/window/plasma/reinforced/fulltile,
/turf/open/floor/plating,
/area/ruin/unpowered)
"An" = (
/obj/structure/cable{
	icon_state = "4-9"
	},
/turf/open/floor/plating/beach/sand{
	light_range = 2
	},
/area/ruin/unpowered)
"At" = (
/obj/structure/cable{
	icon_state = "5-10"
	},
/turf/open/floor/plating/beach/sand{
	light_range = 2
	},
/area/ruin/unpowered)
"AT" = (
/obj/structure/cable{
	icon_state = "0-5"
	},
/obj/structure/curtain/cloth/grey,
/obj/effect/turf_decal/weather/sand,
/obj/structure/cable{
	icon_state = "0-2"
	},
/obj/structure/cable{
	icon_state = "2-5"
	},
/turf/open/floor/plating,
/area/ruin/unpowered)
"Bg" = (
/obj/effect/turf_decal/radiation,
/obj/effect/turf_decal/box/corners,
/obj/effect/turf_decal/box/corners{
	dir = 1
	},
/obj/effect/turf_decal/box/corners{
	dir = 4
	},
/obj/structure/cable{
	icon_state = "0-4"
	},
/turf/open/floor/plating/rust,
/area/ruin/unpowered)
"Bl" = (
/obj/effect/turf_decal/weather/sand{
	dir = 9
	},
/turf/open/water/beach,
/area/ruin/unpowered)
"BF" = (
/obj/structure/cable{
	icon_state = "4-8"
	},
/obj/structure/cable{
	icon_state = "4-8"
	},
/obj/structure/cable{
	icon_state = "2-8"
	},
/turf/open/floor/plating/rust,
/area/ruin/unpowered)
"Cp" = (
/obj/effect/turf_decal/industrial/warning/corner,
/obj/structure/cable{
	icon_state = "5-8"
	},
/turf/open/floor/plasteel/dark,
/area/ruin/unpowered)
"CC" = (
/obj/structure/cable{
	icon_state = "5-10"
	},
/obj/structure/cable{
	icon_state = "1-10"
	},
/turf/open/floor/plating/beach/sand{
	light_range = 2
	},
/area/ruin/unpowered)
"CW" = (
/obj/machinery/suit_storage_unit/inherit,
/obj/item/clothing/suit/space/hardsuit/ancient,
/turf/open/floor/plasteel/dark,
/area/ruin/unpowered)
"DB" = (
/obj/item/stack/cable_coil/red,
/turf/open/floor/plating/beach/sand{
	light_range = 2
	},
/area/ruin/unpowered)
"DC" = (
/turf/open/water/beach/deep,
/area/ruin/unpowered)
"DI" = (
/obj/structure/cable{
	icon_state = "0-9"
	},
/turf/open/floor/plating/beach/sand{
	light_range = 2
	},
/area/ruin/unpowered)
"DO" = (
/obj/structure/flora/tree/palm,
/turf/open/floor/plating/beach/sand{
	light_range = 2
	},
/area/ruin/unpowered)
"DU" = (
/obj/structure/cable{
	icon_state = "6-8"
	},
/turf/open/floor/plating,
/area/ruin/unpowered)
"EP" = (
/obj/item/banner/engineering{
	light_range = 2
	},
/turf/open/floor/plating{
	light_range = 2
	},
/area/ruin/unpowered)
"ET" = (
/obj/effect/turf_decal/weather/sand{
	dir = 8
	},
/turf/open/floor/plating/rust,
/area/ruin/unpowered)
"Fd" = (
/obj/structure/rack,
/obj/item/storage/bag/ore,
/obj/item/mining_scanner,
/turf/open/floor/plating{
	light_range = 2
	},
/area/ruin/unpowered)
"Fp" = (
/obj/effect/turf_decal/weather/sand,
/turf/open/water/beach,
/area/ruin/unpowered)
"FF" = (
/obj/effect/turf_decal/weather/sand{
	dir = 4
	},
/turf/open/floor/plating,
/area/ruin/unpowered)
"FN" = (
/obj/effect/turf_decal/weather/sand{
	dir = 1
	},
/obj/effect/turf_decal/weather/sand,
/obj/effect/decal/cleanable/oil,
/turf/open/floor/plating{
	light_range = 2
	},
/area/ruin/unpowered)
"Gj" = (
/obj/effect/decal/cleanable/glass,
/turf/open/floor/plating/beach/sand{
	light_range = 2
	},
/area/ruin/unpowered)
"Gl" = (
/turf/closed/wall/rust,
/area/ruin/unpowered)
"GJ" = (
/obj/structure/cable{
	icon_state = "0-2"
	},
/obj/machinery/power/shieldwallgen/atmos{
	dir = 4
	},
/obj/item/wrench,
/obj/effect/turf_decal/industrial/warning/corner{
	dir = 4
	},
/obj/effect/turf_decal/industrial/warning{
	dir = 8
	},
/turf/open/floor/plating{
	light_range = 2
	},
/area/ruin/unpowered)
"Hp" = (
/obj/structure/cable{
	icon_state = "0-6"
	},
/turf/open/floor/plating/beach/sand{
	light_range = 2
	},
/area/ruin/unpowered)
"HK" = (
/obj/structure/closet/secure_closet/engineering_welding,
/turf/open/floor/plating,
/area/ruin/unpowered)
"Ie" = (
/turf/closed/wall/mineral/titanium/nodiagonal,
/area/ruin/unpowered)
"Ih" = (
/obj/effect/turf_decal/weather/sand{
	dir = 5
	},
/obj/structure/barricade/wooden,
/turf/open/floor/plating,
/area/ruin/unpowered)
"Ir" = (
/obj/item/shovel,
/obj/item/stack/ore/glass/beach,
/turf/open/floor/plating/beach/sand{
	icon_state = "sand_dug";
	light_range = 2
	},
/area/ruin/unpowered)
"IZ" = (
/obj/machinery/power/shuttle/engine/electric{
	dir = 4
	},
/obj/structure/cable{
	icon_state = "0-4"
	},
/obj/effect/decal/fakelattice,
/turf/open/floor/plating/rust,
/area/ruin/unpowered)
"JE" = (
/turf/open/floor/plasteel/dark,
/area/ruin/unpowered)
"JW" = (
/turf/open/floor/plating/rust,
/area/ruin/unpowered)
"Kc" = (
/obj/effect/turf_decal/industrial/hatch/yellow,
/obj/structure/cable{
	icon_state = "0-4"
	},
/obj/effect/turf_decal/weather/sand{
	dir = 8
	},
/turf/open/floor/plating{
	light_range = 2
	},
/area/ruin/unpowered)
"Kf" = (
/obj/effect/turf_decal/weather/sand{
	dir = 10
	},
/turf/open/floor/plating/rust,
/area/ruin/unpowered)
"Kl" = (
/obj/effect/radiation,
/obj/item/book/manual/wiki/engineering_singulo_tesla,
/turf/open/water/beach/deep,
/area/ruin/unpowered)
"Ko" = (
/obj/machinery/atmospherics/components/unary/passive_vent{
	dir = 1
	},
/turf/open/floor/engine/airless,
/area/ruin/unpowered)
"Kp" = (
/obj/machinery/door/airlock/command/glass{
	name = "Bridge"
	},
/obj/structure/cable{
	icon_state = "4-8"
	},
/obj/effect/mapping_helpers/airlock/locked,
/turf/open/floor/carpet/nanoweave/orange,
/area/ruin/unpowered)
"KL" = (
/obj/machinery/atmospherics/pipe/simple/yellow/visible,
/obj/effect/turf_decal/weather/sand{
	dir = 1
	},
/turf/open/floor/plating{
	light_range = 2
	},
/area/ruin/unpowered)
"Lo" = (
/obj/machinery/atmospherics/pipe/simple/yellow/visible,
/obj/effect/turf_decal/weather/sand{
	dir = 5
	},
/turf/open/floor/plating{
	light_range = 2
	},
/area/ruin/unpowered)
"Lv" = (
/mob/living/simple_animal/beachcarp/trout{
	desc = "A wild three-eyed trout.";
	name = "ole Three Eyes"
	},
/turf/open/water/beach,
/area/ruin/unpowered)
"LI" = (
/obj/structure/flora/rock,
/turf/open/floor/plating/beach/sand{
	light_range = 2
	},
/area/ruin/unpowered)
"Ms" = (
/obj/effect/turf_decal/weather/sand{
	dir = 10
	},
/obj/effect/turf_decal/weather/sand{
	dir = 6
	},
/turf/open/floor/plating,
/area/ruin/unpowered)
"Na" = (
/obj/item/pickaxe/improvised,
/turf/open/floor/plating/beach/sand{
	light_range = 2
	},
/area/ruin/unpowered)
"Nh" = (
/obj/structure/cable{
	icon_state = "4-9"
	},
/obj/structure/cable{
	icon_state = "4-10"
	},
/obj/structure/cable{
	icon_state = "4-8"
	},
/turf/open/floor/plasteel/dark,
/area/ruin/unpowered)
"Nz" = (
/obj/machinery/portable_atmospherics/canister/toxins,
/obj/item/tank/internals/plasmaman,
/turf/open/floor/plasteel/tech,
/area/ruin/unpowered)
"NZ" = (
/turf/closed/wall/concrete/reinforced,
/area/ruin/unpowered)
"Om" = (
/obj/effect/decal/cleanable/oil,
/turf/open/floor/plating,
/area/ruin/unpowered)
"Ot" = (
/obj/item/geiger_counter,
/turf/open/floor/plating/beach/sand{
	light_range = 2
	},
/area/ruin/unpowered)
"OI" = (
/obj/effect/turf_decal/weather/sand{
	dir = 9
	},
/turf/open/floor/plating{
	light_range = 2
	},
/area/ruin/unpowered)
"Pa" = (
/obj/machinery/power/terminal{
	dir = 8
	},
/obj/structure/cable{
	icon_state = "0-4"
	},
/obj/structure/window/reinforced{
	dir = 4
	},
/turf/open/floor/plating,
/area/ruin/unpowered)
"PK" = (
/obj/structure/flora/tree/jungle/small,
/turf/open/floor/plating/grass/beach{
	light_range = 2
	},
/area/ruin/unpowered)
"PR" = (
/obj/structure/chair/stool/bar{
	dir = 4;
	name = "pilots tactical seat"
	},
/obj/structure/cable{
	icon_state = "2-8"
	},
/turf/open/floor/plating,
/area/ruin/unpowered)
"Qd" = (
/obj/structure/flora/ausbushes/leafybush,
/turf/open/floor/plating/grass/beach{
	light_range = 2
	},
/area/ruin/unpowered)
"Qt" = (
/obj/effect/turf_decal/weather/sand{
	dir = 5
	},
/mob/living/simple_animal/hostile/asteroid/lobstrosity/beach,
/turf/open/floor/plating{
	light_range = 2
	},
/area/ruin/unpowered)
"Qw" = (
/turf/open/floor/plating,
/area/ruin/unpowered)
"QB" = (
/obj/structure/cable{
	icon_state = "4-8"
	},
/obj/structure/cable{
	icon_state = "6-8"
	},
/turf/open/floor/plating/beach/sand{
	light_range = 2
	},
/area/ruin/unpowered)
"QQ" = (
/obj/structure/cable{
	icon_state = "4-8"
	},
/turf/open/floor/plasteel/dark,
/area/ruin/unpowered)
"QV" = (
/obj/effect/turf_decal/weather/sand,
/obj/effect/turf_decal/industrial/warning/corner{
	dir = 4
	},
/turf/open/floor/plating/rust,
/area/ruin/unpowered)
"QY" = (
/obj/effect/turf_decal/weather/sand,
/turf/open/floor/plating{
	light_range = 2
	},
/area/ruin/unpowered)
"Rf" = (
/obj/effect/turf_decal/weather/sand{
	dir = 1
	},
/turf/open/water/beach,
/area/ruin/unpowered)
"Rj" = (
/obj/structure/bed/roller,
/obj/item/bedsheet/orange,
/obj/item/toy/plush/moth{
	name = "Edmund";
	pixel_x = 3
	},
/obj/structure/sign/poster/contraband/power{
	pixel_y = 32
	},
/turf/open/floor/plasteel/tech,
/area/ruin/unpowered)
"Sl" = (
/obj/structure/radioactive/stack,
/turf/open/floor/plating/beach/sand{
	light_range = 2
	},
/area/ruin/unpowered)
"Sx" = (
/obj/structure/cable{
	icon_state = "4-8"
	},
/obj/effect/turf_decal/weather/sand,
/turf/open/floor/plating{
	light_range = 2
	},
/area/ruin/unpowered)
"SE" = (
/obj/structure/barricade/wooden,
/turf/open/floor/plating/beach/sand{
	light_range = 2
	},
/area/ruin/unpowered)
"SF" = (
/obj/structure/cable{
	icon_state = "4-8"
	},
/obj/effect/turf_decal/weather/sand{
	dir = 10
	},
/obj/effect/turf_decal/weather/sand{
	dir = 9
	},
/turf/open/floor/plating{
	light_range = 2
	},
/area/ruin/unpowered)
"SZ" = (
/obj/effect/decal/cleanable/glass,
/obj/effect/turf_decal/weather/sand{
	dir = 5
	},
/turf/open/floor/plating,
/area/ruin/unpowered)
"Ta" = (
/obj/structure/cable{
	icon_state = "5-8"
	},
/turf/open/floor/plating/beach/sand{
	light_range = 2
	},
/area/ruin/unpowered)
"Tf" = (
/obj/structure/cable{
	icon_state = "1-2"
	},
/obj/structure/cable{
	icon_state = "1-4"
	},
/obj/structure/trap/stun,
/obj/effect/decal/cleanable/glass/plasma,
/obj/item/reagent_containers/food/snacks/deadmouse,
/obj/item/stack/cable_coil/cut/orange,
/turf/open/floor/plating,
/area/ruin/unpowered)
"TA" = (
/obj/structure/cable{
	icon_state = "1-2"
	},
/turf/open/floor/plating/beach/sand{
	light_range = 2
	},
/area/ruin/unpowered)
"TB" = (
/obj/effect/spawner/structure/window/hollow/directional{
	dir = 8
	},
/turf/open/floor/plating,
/area/ruin/unpowered)
"TI" = (
/obj/structure/radioactive/waste,
/obj/effect/decal/cleanable/greenglow,
/turf/open/floor/plating/beach/sand{
	light_range = 2
	},
/area/ruin/unpowered)
"Uk" = (
/turf/open/floor/plating/grass/beach{
	light_range = 2
	},
/area/ruin/unpowered)
"Uz" = (
/obj/effect/turf_decal/weather/sand{
	dir = 5
	},
/turf/open/water/beach,
/area/ruin/unpowered)
"UM" = (
/obj/structure/cable{
	icon_state = "6-8"
	},
/turf/open/floor/plasteel/dark,
/area/ruin/unpowered)
"UT" = (
/obj/structure/cable{
	icon_state = "2-8"
	},
/turf/open/floor/plasteel/tech,
/area/ruin/unpowered)
"UU" = (
/obj/structure/cable{
	icon_state = "0-8"
	},
/obj/effect/radiation,
/obj/effect/decal/fakelattice,
/turf/open/floor/plating/rust,
/area/ruin/unpowered)
"Vb" = (
/obj/machinery/atmospherics/components/unary/portables_connector{
	dir = 4
	},
/obj/effect/turf_decal/weather/sand{
	dir = 1
	},
/turf/open/floor/plating{
	light_range = 2
	},
/area/ruin/unpowered)
"Wg" = (
/obj/structure/flora/ausbushes/sparsegrass,
/turf/open/floor/plating/beach/sand{
	light_range = 2
	},
/area/ruin/unpowered)
"Wn" = (
/obj/machinery/computer/arcade/orion_trail{
	dir = 8;
	name = "Advanced Helm Console"
	},
/turf/open/floor/carpet/nanoweave/orange,
/area/ruin/unpowered)
"Wp" = (
/obj/machinery/power/terminal{
	dir = 8
	},
/obj/structure/cable{
	icon_state = "0-4"
	},
/obj/machinery/door/window/brigdoor/eastleft,
/obj/effect/decal/cleanable/oil,
/turf/open/floor/plating,
/area/ruin/unpowered)
"WH" = (
/obj/effect/turf_decal/weather/sand{
	dir = 4
	},
/turf/open/water/beach,
/area/ruin/unpowered)
"Xa" = (
/obj/machinery/atmospherics/components/unary/portables_connector,
/obj/effect/turf_decal/weather/sand{
	dir = 1
	},
/obj/effect/turf_decal/weather/sand,
/obj/effect/turf_decal/weather/sand{
	dir = 4
	},
/obj/effect/turf_decal/weather/sand{
	dir = 8
	},
/turf/open/floor/plating/rust,
/area/ruin/unpowered)
"Xc" = (
/obj/structure/radioactive,
/obj/effect/decal/cleanable/greenglow,
/turf/open/water/beach,
/area/ruin/unpowered)
"Xi" = (
/obj/machinery/atmospherics/components/unary/passive_vent{
	dir = 1
	},
/obj/item/fireaxe{
	name = "rusty fire axe"
	},
/turf/open/floor/engine/airless,
/area/ruin/unpowered)
"Xx" = (
/obj/structure/curtain/cloth/grey,
/obj/effect/turf_decal/weather/sand,
/turf/open/floor/plating,
/area/ruin/unpowered)
"XB" = (
/obj/structure/cable{
	icon_state = "0-10"
	},
/turf/open/floor/plating/beach/sand{
	light_range = 2
	},
/area/ruin/unpowered)
"Yh" = (
/obj/effect/turf_decal/weather/sand{
	dir = 6
	},
/turf/open/water/beach,
/area/ruin/unpowered)
"Yw" = (
/obj/effect/turf_decal/industrial/warning,
/obj/structure/cable{
	icon_state = "1-10"
	},
/obj/structure/cable{
	icon_state = "1-6"
	},
/obj/structure/cable{
	icon_state = "1-2"
	},
/turf/open/floor/plasteel/dark,
/area/ruin/unpowered)
"YD" = (
/obj/structure/closet/secure_closet/engineering_electrical,
/turf/open/floor/plating,
/area/ruin/unpowered)
"ZE" = (
/obj/structure/cable{
	icon_state = "1-10"
	},
/turf/open/floor/plating/beach/sand{
	light_range = 2
	},
/area/ruin/unpowered)
"ZW" = (
/obj/machinery/pipedispenser,
/turf/open/floor/plasteel/dark,
/area/ruin/unpowered)

(1,1,1) = {"
ys
ys
ys
ys
ys
kP
kP
kP
kP
kP
Wg
kP
kP
kP
Uk
fB
Uk
eM
Uk
Uk
Uk
ys
ys
ys
ys
ys
ys
ys
ys
ys
ys
ys
"}
(2,1,1) = {"
ys
ys
ys
kP
kP
DO
kP
Bl
mM
kP
kP
kP
kP
Uk
Uk
Uk
Uk
Uk
Uk
Qd
Uk
Uk
ys
ys
ys
ys
ys
ys
ys
ys
ys
ys
"}
(3,1,1) = {"
ys
ys
kP
Wg
kP
kP
Bl
dX
dX
mM
TI
kP
kP
Uk
Uk
Uk
Uk
Uk
PK
Uk
eM
Uk
Uk
ys
ys
ys
ys
ys
ys
ys
ys
ys
"}
(4,1,1) = {"
ys
ys
kP
kP
kP
Bl
dX
DC
cW
dX
mM
LI
kP
kP
kP
Uk
Uk
Uk
Uk
Qd
Uk
Uk
Uk
ys
ys
ys
ys
ys
ys
ys
ys
ys
"}
(5,1,1) = {"
ys
ys
DO
kP
Bl
dX
DC
DC
DC
dX
Fp
Sl
kP
kP
kP
Wg
kP
kP
Uk
Uk
Uk
fB
Uk
ys
ys
ys
ys
ys
ys
ys
ys
ys
"}
(6,1,1) = {"
ys
ys
kP
kP
Rf
DC
IZ
Kl
DC
dX
Fp
kP
kP
kP
kP
kP
kP
kP
kP
ch
Uk
Uk
Uk
Uk
ys
ys
ys
ys
ys
ys
ys
ys
"}
(7,1,1) = {"
ys
kP
kP
kP
Rf
DC
UU
DC
DC
dX
Fp
DO
kP
kP
kP
mU
Kf
kP
kP
ET
kP
kP
Uk
Uk
ys
ys
ys
ys
ys
ys
ys
ys
"}
(8,1,1) = {"
ys
kP
FN
kP
Rf
dX
DC
DC
Lv
dX
Yh
kP
kP
kP
qD
qD
ij
qD
Gl
qD
qD
kP
kP
kP
ys
ys
ys
ys
ys
ys
ys
ys
"}
(9,1,1) = {"
ys
kP
tB
kP
Uz
Xc
dX
dX
dX
Yh
Ot
kP
kP
Gl
qD
HK
Qw
Qw
Qw
Qw
qD
qD
kP
kP
kP
ys
ys
ys
ys
ys
ys
ys
"}
(10,1,1) = {"
ys
kP
kP
kP
yv
Uz
WH
WH
Yh
kP
kP
Wg
kP
kP
ty
wu
qK
bv
Tf
hM
JW
qD
kP
kP
kP
ys
ys
ys
ys
ys
ys
ys
"}
(11,1,1) = {"
ys
kP
kP
ij
kP
kP
Wg
kP
kP
kP
DO
kP
kP
kP
Qt
kF
Qw
Qw
rW
Qw
Qw
qD
kP
kP
kP
kP
ys
ys
ys
ys
ys
ys
"}
(12,1,1) = {"
ys
kP
kP
kP
Ie
kP
kP
kP
Ie
kP
kP
kP
kP
kP
kP
kK
jP
zh
Qw
FF
Qw
uw
kP
kP
Wg
kP
ys
ys
ys
ys
ys
ys
"}
(13,1,1) = {"
ys
kP
kP
ty
Ie
cO
tB
Kc
Ie
Ie
kP
kP
kP
Ac
At
ty
YD
cr
zc
kP
qD
qD
kP
kP
kP
kP
ys
ys
ys
ys
ys
ys
"}
(14,1,1) = {"
ys
kP
kP
kP
Ie
mH
Bg
fa
Ie
tB
kP
kP
kP
XB
kP
Gl
qD
QB
ye
Ms
qD
kP
kP
kP
kP
kP
kP
kP
ys
ys
ys
ys
"}
(15,1,1) = {"
ys
kP
kP
kP
Ih
Wp
pD
Pa
Ie
kP
kP
kP
kP
kP
kP
kP
kP
Ta
qH
kP
kP
kP
kP
kP
kP
kP
kP
kP
bp
ys
ys
ys
"}
(16,1,1) = {"
ys
kP
kP
kP
SE
UM
QQ
Cp
tB
kP
kP
ts
kP
kP
kP
kP
At
kP
kP
qH
kP
kP
kP
kP
kP
kP
kP
kP
bp
kP
ys
ys
"}
(17,1,1) = {"
ys
kP
kP
kP
wC
ZW
Nh
ug
AT
TA
ZE
kP
kP
kP
lR
CC
kP
kP
Wg
kP
qH
kP
kP
kP
kP
Wg
kP
kP
EP
kP
kP
ys
"}
(18,1,1) = {"
ys
kP
kP
kP
tB
pp
BF
Yw
Xx
kP
kP
kP
kH
kP
sm
kP
kP
kP
kP
kP
kP
DI
DB
kP
kP
kP
kP
kP
bp
kP
kP
ys
"}
(19,1,1) = {"
ys
kP
kP
kP
tB
CW
QQ
ug
cj
kP
kP
vO
kP
kP
SF
kP
kP
kP
kP
Ir
kP
kP
LI
kP
kP
Hp
kP
kP
bp
kP
kP
kP
"}
(20,1,1) = {"
ys
ys
kP
kP
tB
JE
QQ
yA
tB
kP
kP
kP
kP
OI
Sx
kP
kP
kP
kP
kP
kP
kP
kP
kP
DO
kP
qH
kP
bp
kP
kP
kP
"}
(21,1,1) = {"
ys
ys
kP
kP
iZ
fT
Kp
tB
tB
kP
kP
kP
qD
ma
cq
iC
qD
cc
kP
Na
kP
kP
Wg
kP
kP
kP
kP
qH
bp
kP
sB
kP
"}
(22,1,1) = {"
ys
ys
kP
vO
ij
tX
PR
dG
tB
kP
kP
qD
qD
Om
DU
Qw
qD
qD
cc
kP
gH
kP
kP
kP
kP
kP
Wg
kP
An
kP
kP
kP
"}
(23,1,1) = {"
ys
ys
kP
kP
kP
SZ
Wn
Qw
tB
kP
kP
qD
ni
Qw
yf
cy
dO
qD
Fd
QY
kP
kP
kP
kP
kP
kP
kP
kP
um
kP
kP
kP
"}
(24,1,1) = {"
ys
ys
ys
kP
kP
Gj
ye
kR
kP
kP
kP
qD
Rj
JW
Qw
sA
mz
qD
dM
kP
kP
kP
kP
OI
cc
kP
kP
kP
um
kP
kP
kP
"}
(25,1,1) = {"
ys
ys
ys
kP
kP
kP
kP
xV
kP
Wg
kP
qD
Nz
yf
yf
UT
fj
qD
iy
kP
DO
kP
Vb
kA
NZ
NZ
NZ
NZ
um
lk
kP
kP
"}
(26,1,1) = {"
ys
ys
ys
ys
kP
lk
kP
kP
kP
kP
kP
qD
qD
hL
pM
sN
qD
qD
kP
kP
kP
kP
qZ
KL
Ah
Xi
xA
GJ
bh
kP
kP
kP
"}
(27,1,1) = {"
ys
ys
ys
ys
ys
kP
kP
kP
LI
kP
kP
kP
qD
TB
TB
TB
qD
kP
kP
kP
kP
kP
kP
ty
hA
yc
oy
yM
iH
kP
kP
kP
"}
(28,1,1) = {"
ys
ys
ys
ys
ys
ys
kP
kP
kP
kP
kP
kP
kP
kP
kP
kP
kP
kP
kP
kP
kP
Xa
sv
Lo
Ah
Ko
NZ
oV
QV
kP
kP
ys
"}
(29,1,1) = {"
ys
ys
ys
ys
ys
ys
ys
kP
kP
kP
kP
kP
kP
kP
kP
Wg
kP
kP
kP
kP
kP
kP
kP
kP
NZ
NZ
NZ
NZ
oS
kP
kP
ys
"}
(30,1,1) = {"
ys
ys
ys
ys
ys
ys
ys
ys
kP
kP
kP
kP
DO
kP
kP
kP
kP
kP
kP
kP
kP
lk
kP
kP
kP
kP
kP
kP
kP
kP
ys
ys
"}
(31,1,1) = {"
ys
ys
ys
ys
ys
ys
ys
ys
ys
kP
kP
kP
kP
kP
kP
kP
kP
kP
kP
kP
kP
Wg
kP
kP
kP
kP
kP
kP
kP
ys
ys
ys
"}
(32,1,1) = {"
ys
ys
ys
ys
ys
ys
ys
ys
ys
ys
ys
ys
kP
kP
kP
kP
kP
kP
kP
kP
kP
kP
kP
kP
LI
kP
ys
ys
ys
ys
ys
ys
"}
