//MAP CONVERTED BY dmm2tgm.py THIS HEADER COMMENT PREVENTS RECONVERSION, DO NOT REMOVE
"aD" = (
/turf/open/floor/plating/asteroid/sand/lit{
	light_power = 0;
	light_range = 0
	},
/area/ruin/unpowered)
"aI" = (
/obj/structure/closet/cabinet,
/obj/item/clothing/suit/armor/riot/knight/yellow,
/obj/item/clothing/head/helmet/knight/yellow,
/turf/open/floor/plating/asteroid/sand/lit{
	light_power = 0;
	light_range = 0
	},
/area/ruin/unpowered)
"bc" = (
/obj/effect/spawner/lootdrop/prison_contraband,
/obj/structure/sign/poster/contraband/gec{
	pixel_y = -33
	},
/turf/open/floor/plating/asteroid/sand/lit{
	light_power = 0;
	light_range = 0
	},
/area/ruin/unpowered)
"bi" = (
/obj/structure/destructible/tribal_torch/lit{
	break_message = "<span class='warning'>The torch breaks!</span>";
	name = "lit torch"
	},
/turf/open/floor/plating/asteroid/sand/lit{
	light_power = 0;
	light_range = 0
	},
/area/ruin/unpowered)
"bG" = (
/obj/effect/spawner/lootdrop/prison_contraband,
/turf/open/floor/plating/asteroid/sand/lit{
	light_power = 0;
	light_range = 0
	},
/area/ruin/unpowered)
"dc" = (
/obj/structure/flora/rock{
	icon_state = "basalt2"
	},
/turf/open/floor/plating/asteroid/sand/lit,
/area/ruin/unpowered)
"es" = (
/obj/structure/table/wood,
/obj/item/stack/sheet/mineral/sandstone/thirty{
	pixel_y = 8
	},
/obj/item/golem_shell/servant{
	pixel_y = 7
	},
/turf/open/floor/plating/asteroid/sand/lit{
	light_power = 0;
	light_range = 0
	},
/area/ruin/unpowered)
"eI" = (
/obj/structure/rack,
/obj/item/claymore,
/turf/open/floor/plating/asteroid/sand/lit{
	light_power = 0;
	light_range = 0
	},
/area/ruin/unpowered)
"eT" = (
/obj/effect/decal/remains/human{
	pixel_y = -4
	},
/turf/open/floor/plating/asteroid/sand/lit{
	light_power = 0;
	light_range = 0
	},
/area/ruin/unpowered)
"fB" = (
/obj/structure/flora/rock{
	icon_state = "basalt3"
	},
/turf/open/floor/plating/asteroid/sand/lit,
/area/ruin/unpowered)
"fM" = (
/obj/effect/turf_decal/weather/dirt{
	icon_state = "dirt_side_corner";
	dir = 4
	},
/turf/open/floor/plating/asteroid/sand/lit{
	light_power = 0;
	light_range = 0
	},
/area/ruin/unpowered)
"fX" = (
/obj/item/kitchen/knife/combat/bone,
/turf/open/floor/plating/asteroid/sand/lit{
	light_power = 0;
	light_range = 0
	},
/area/ruin/unpowered)
"gw" = (
/obj/effect/mob_spawn/human/corpse/charredskeleton,
/turf/open/floor/plating/asteroid/sand/lit{
	light_power = 0;
	light_range = 0
	},
/area/ruin/unpowered)
"hO" = (
/obj/structure/rack,
/obj/item/restraints/legcuffs/bola/tactical,
/obj/item/restraints/legcuffs/bola,
/obj/item/spear,
/turf/open/floor/plating/asteroid/sand/lit{
	light_power = 0;
	light_range = 0
	},
/area/ruin/unpowered)
"kI" = (
/obj/structure/closet/cabinet,
/obj/item/clothing/suit/armor/riot/knight/blue,
/obj/item/clothing/head/helmet/knight/blue,
/turf/open/floor/plating/asteroid/sand/lit{
	light_power = 0;
	light_range = 0
	},
/area/ruin/unpowered)
"lJ" = (
/obj/item/chisel{
	pixel_y = 6
	},
/turf/open/floor/plating/asteroid/sand/lit{
	light_power = 0;
	light_range = 0
	},
/area/ruin/unpowered)
"mh" = (
/obj/structure/statue/sandstone/venus{
	dir = 1
	},
/turf/open/floor/plating/asteroid/sand/lit,
/area/ruin/unpowered)
"mQ" = (
/obj/effect/turf_decal/weather/sand{
	dir = 5
	},
/turf/open/floor/carpet/red,
/area/ruin/unpowered)
"mX" = (
/obj/structure/flora/ausbushes/sparsegrass,
/turf/open/floor/plating/dirt/dark,
/area/ruin/unpowered)
"nC" = (
/obj/item/restraints/legcuffs/beartrap{
	armed = 1
	},
/turf/open/floor/plating/asteroid/sand/lit{
	light_power = 0;
	light_range = 0
	},
/area/ruin/unpowered)
"nH" = (
/obj/effect/turf_decal/weather/sand{
	dir = 4
	},
/turf/open/floor/carpet/red,
/area/ruin/unpowered)
"og" = (
/obj/effect/decal/cleanable/blood/old{
	icon_state = "bloodyhands_right"
	},
/obj/effect/decal/cleanable/blood/old{
	icon_state = "floor6-old"
	},
/turf/open/floor/plating/asteroid/sand/lit{
	light_power = 0;
	light_range = 0
	},
/area/ruin/unpowered)
"oi" = (
/turf/closed/wall/mineral/sandstone,
/area/ruin/unpowered)
"pA" = (
/obj/effect/turf_decal/weather/sand{
	dir = 9
	},
/turf/open/floor/carpet/red,
/area/ruin/unpowered)
"pE" = (
/obj/machinery/door/poddoor/gates,
/turf/open/floor/plating/asteroid/sand/lit{
	light_power = 0;
	light_range = 0
	},
/area/ruin/unpowered)
"qc" = (
/obj/effect/turf_decal/weather/sand{
	dir = 1
	},
/turf/open/floor/carpet/red,
/area/ruin/unpowered)
"qL" = (
/obj/effect/turf_decal/weather/sand,
/turf/open/floor/carpet/red{
	light_color = "#FAE1AF";
	light_power = 0.8;
	light_range = 2
	},
/area/ruin/unpowered)
"qR" = (
/obj/structure/barricade/wooden,
/turf/open/floor/plating/asteroid/sand/lit{
	light_power = 0;
	light_range = 0
	},
/area/ruin/unpowered)
"qY" = (
/obj/item/clothing/shoes/sandal{
	pixel_x = 13;
	pixel_y = 11
	},
/obj/effect/turf_decal/weather/sand{
	dir = 10
	},
/turf/open/floor/carpet/red{
	light_color = "#FAE1AF";
	light_power = 0.8;
	light_range = 2
	},
/area/ruin/unpowered)
"rb" = (
/obj/structure/mineral_door/sandstone,
/turf/open/floor/plating/asteroid/sand/lit,
/area/ruin/unpowered)
"ru" = (
/obj/effect/turf_decal/weather/dirt{
	dir = 8
	},
/turf/open/floor/plating/asteroid/sand/lit{
	light_power = 0;
	light_range = 0
	},
/area/ruin/unpowered)
"rS" = (
/obj/item/gavelhammer{
	pixel_x = -11;
	pixel_y = 16
	},
/obj/item/clothing/shoes/sandal,
/turf/open/floor/plating/asteroid/sand/lit{
	light_power = 0;
	light_range = 0
	},
/area/ruin/unpowered)
"rV" = (
/obj/effect/turf_decal/weather/dirt{
	icon_state = "dirt_side_corner";
	dir = 1
	},
/turf/open/floor/plating/asteroid/sand/lit{
	light_power = 0;
	light_range = 0
	},
/area/ruin/unpowered)
"sa" = (
/obj/effect/turf_decal/weather/sand{
	dir = 8
	},
/turf/open/floor/carpet/red,
/area/ruin/unpowered)
"sv" = (
/obj/effect/turf_decal/weather/sand{
	dir = 8
	},
/turf/open/floor/carpet/red{
	light_color = "#FAE1AF";
	light_power = 0.8;
	light_range = 2
	},
/area/ruin/unpowered)
"sG" = (
/obj/structure/statue/diamond/captain,
/turf/open/floor/plating/asteroid/sand/lit{
	light_power = 0;
	light_range = 0
	},
/area/ruin/unpowered)
"sH" = (
/obj/item/stack/sheet/mineral/sandstone,
/turf/open/floor/plating/asteroid/sand/lit,
/area/ruin/unpowered)
"tr" = (
/obj/structure/flora/rock{
	icon_state = "lavarocks"
	},
/turf/open/floor/plating/asteroid/sand/lit,
/area/ruin/unpowered)
"tB" = (
/obj/effect/decal/cleanable/blood/old{
	icon_state = "bloodyhands_right"
	},
/turf/open/floor/plating/asteroid/sand/lit{
	light_power = 0;
	light_range = 0
	},
/area/ruin/unpowered)
"tG" = (
/obj/structure/table/wood,
/obj/item/nullrod/staff/blue{
	pixel_y = 2
	},
/obj/item/clothing/head/wizard/black{
	pixel_x = -8;
	pixel_y = 7
	},
/turf/open/floor/plating/asteroid/sand/lit{
	light_power = 0;
	light_range = 0
	},
/area/ruin/unpowered)
"ub" = (
/obj/structure/mineral_door/sandstone,
/turf/open/floor/plating/asteroid/sand/lit{
	light_power = 0;
	light_range = 0
	},
/area/ruin/unpowered)
"uB" = (
/obj/item/chisel,
/turf/open/floor/plating/asteroid/sand/lit{
	light_power = 0;
	light_range = 0
	},
/area/ruin/unpowered)
"vy" = (
/obj/structure/rack,
/obj/item/shield/riot/buckler,
/turf/open/floor/plating/asteroid/sand/lit{
	light_power = 0;
	light_range = 0
	},
/area/ruin/unpowered)
"xK" = (
/obj/item/stack/sheet/mineral/gold,
/turf/open/floor/plating/asteroid/sand/lit{
	light_power = 0;
	light_range = 0
	},
/area/ruin/unpowered)
"yG" = (
/obj/structure/flora/rock{
	icon_state = "lavarocks"
	},
/turf/open/water/beach,
/area/ruin/unpowered)
"ze" = (
/obj/structure/chair/plastic{
	dir = 8
	},
/obj/item/reagent_containers/food/drinks/bottle/sarsaparilla{
	pixel_x = -7;
	pixel_y = 15
	},
/obj/effect/turf_decal/weather/sand{
	dir = 6
	},
/turf/open/floor/carpet/red{
	light_color = "#FAE1AF";
	light_power = 0.8;
	light_range = 2
	},
/area/ruin/unpowered)
"zw" = (
/obj/structure/statue/sandstone/assistant,
/turf/open/floor/plating/asteroid/sand/lit,
/area/ruin/unpowered)
"AD" = (
/turf/open/water/beach,
/area/ruin/unpowered)
"AO" = (
/obj/effect/turf_decal/weather/sand{
	dir = 4
	},
/turf/open/floor/carpet/red{
	light_color = "#FAE1AF";
	light_power = 0.8;
	light_range = 2
	},
/area/ruin/unpowered)
"Bd" = (
/obj/structure/railing{
	dir = 4
	},
/obj/structure/flora/ausbushes/sparsegrass,
/turf/open/floor/plating/dirt/dark,
/area/ruin/unpowered)
"Bs" = (
/obj/effect/turf_decal/weather/sand{
	dir = 5
	},
/turf/open/floor/carpet/red{
	light_color = "#FAE1AF";
	light_power = 0.8;
	light_range = 2
	},
/area/ruin/unpowered)
"BP" = (
/obj/structure/table/wood,
/obj/item/gem/void{
	pixel_y = 4
	},
/turf/open/floor/plating/asteroid/sand/lit{
	light_power = 0;
	light_range = 0
	},
/area/ruin/unpowered)
"BT" = (
/obj/structure/bed,
/obj/item/bedsheet/yellow,
/turf/open/floor/plating/asteroid/sand/lit{
	light_power = 0;
	light_range = 0
	},
/area/ruin/unpowered)
"Ci" = (
/obj/structure/table/wood,
/obj/effect/mob_spawn/human/corpse/charredskeleton,
/turf/open/floor/plating/asteroid/sand/lit{
	light_power = 0;
	light_range = 0
	},
/area/ruin/unpowered)
"Co" = (
/mob/living/simple_animal/hostile/skeleton,
/turf/open/floor/plating/asteroid/sand/lit{
	light_power = 0;
	light_range = 0
	},
/area/ruin/unpowered)
"CM" = (
/obj/effect/decal/remains/human,
/obj/item/reagent_containers/food/snacks/soup/wish{
	pixel_y = -10
	},
/turf/open/floor/plating/asteroid/sand/lit{
	light_power = 0;
	light_range = 0
	},
/area/ruin/unpowered)
"CP" = (
/obj/item/ammo_casing/caseless/arrow{
	pixel_y = -13
	},
/obj/effect/mob_spawn/human/corpse/assistant,
/obj/effect/decal/cleanable/blood/old{
	icon_state = "floor5-old"
	},
/turf/open/floor/plating/asteroid/sand/lit{
	light_power = 0;
	light_range = 0
	},
/area/ruin/unpowered)
"CS" = (
/mob/living/simple_animal/hostile/skeleton/templar,
/obj/effect/turf_decal/weather/sand{
	dir = 6
	},
/turf/open/floor/carpet/red,
/area/ruin/unpowered)
"Dl" = (
/obj/structure/falsewall/sandstone,
/turf/open/floor/plating/asteroid/sand/lit{
	light_power = 0;
	light_range = 0
	},
/area/ruin/unpowered)
"Dy" = (
/obj/effect/turf_decal/weather/sand{
	icon_state = "sand_dug"
	},
/turf/open/floor/plating/asteroid/sand/lit{
	light_power = 0;
	light_range = 0
	},
/area/ruin/unpowered)
"DK" = (
/obj/structure/railing{
	dir = 4
	},
/turf/open/floor/plating/dirt/dark,
/area/ruin/unpowered)
"Eq" = (
/obj/structure/railing{
	icon_state = "railing_corner";
	dir = 4
	},
/obj/structure/railing{
	icon_state = "railing_corner"
	},
/turf/open/floor/plating/dirt/dark,
/area/ruin/unpowered)
"EL" = (
/obj/item/reagent_containers/food/snacks/meat/slab/human/mutant/skeleton,
/turf/open/floor/plating/asteroid/sand/lit{
	light_power = 0;
	light_range = 0
	},
/area/ruin/unpowered)
"EQ" = (
/obj/machinery/door/poddoor/gates/preopen,
/turf/open/floor/plating/asteroid/sand/lit{
	light_power = 0;
	light_range = 0
	},
/area/ruin/unpowered)
"Gh" = (
/obj/structure/rack,
/obj/item/clothing/under/rank/prisoner,
/obj/item/reagent_containers/food/snacks/candy_corn/prison,
/turf/open/floor/plating/asteroid/sand/lit{
	light_power = 0;
	light_range = 0
	},
/area/ruin/unpowered)
"Gq" = (
/obj/structure/rack,
/obj/item/restraints/handcuffs/cable/yellow,
/obj/item/restraints/handcuffs/cable/yellow,
/obj/item/restraints/handcuffs,
/turf/open/floor/plating/asteroid/sand/lit{
	light_power = 0;
	light_range = 0
	},
/area/ruin/unpowered)
"Gs" = (
/obj/structure/table/wood,
/obj/item/ammo_casing/caseless/arrow,
/obj/item/ammo_casing/caseless/arrow,
/obj/item/ammo_casing/caseless/arrow,
/obj/item/ammo_casing/caseless/arrow,
/obj/item/ammo_casing/caseless/arrow,
/turf/open/floor/plating/asteroid/sand/lit{
	light_power = 0;
	light_range = 0
	},
/area/ruin/unpowered)
"Hl" = (
/turf/open/floor/plating/dirt/dark,
/area/ruin/unpowered)
"Ib" = (
/obj/item/stack/sheet/sandblock/five,
/turf/open/floor/plating/asteroid/sand/lit,
/area/ruin/unpowered)
"Ju" = (
/obj/effect/turf_decal/weather/sand,
/turf/open/floor/carpet/red,
/area/ruin/unpowered)
"JB" = (
/obj/structure/trap/stun,
/turf/open/floor/plating/asteroid/sand/lit{
	light_power = 0;
	light_range = 0
	},
/area/ruin/unpowered)
"JJ" = (
/mob/living/simple_animal/hostile/skeleton/templar,
/obj/effect/turf_decal/weather/sand{
	dir = 10
	},
/turf/open/floor/carpet/red,
/area/ruin/unpowered)
"JO" = (
/obj/item/stack/ore/glass/beach,
/turf/open/floor/plating/asteroid/sand/lit,
/area/ruin/unpowered)
"JT" = (
/obj/structure/trap/damage,
/turf/open/floor/plating/asteroid/sand/lit{
	light_power = 0;
	light_range = 0
	},
/area/ruin/unpowered)
"Kz" = (
/obj/effect/turf_decal/weather/sand{
	icon_state = "sand_dug"
	},
/turf/open/floor/plating/asteroid/sand/lit,
/area/ruin/unpowered)
"MD" = (
/mob/living/simple_animal/hostile/skeleton/templar,
/turf/open/floor/plating/asteroid/sand/lit{
	light_power = 0;
	light_range = 0
	},
/area/ruin/unpowered)
"Nn" = (
/obj/structure/rack,
/obj/item/reagent_containers/food/drinks/bottle/holywater,
/turf/open/floor/plating/asteroid/sand/lit{
	light_power = 0;
	light_range = 0
	},
/area/ruin/unpowered)
"No" = (
/obj/effect/turf_decal/weather/sand{
	dir = 1
	},
/turf/open/floor/carpet/red{
	light_color = "#FAE1AF";
	light_power = 0.8;
	light_range = 2
	},
/area/ruin/unpowered)
"Oy" = (
/obj/item/clothing/shoes/sandal{
	pixel_x = 9;
	pixel_y = -9
	},
/obj/effect/turf_decal/weather/sand,
/turf/open/floor/carpet/red{
	light_color = "#FAE1AF";
	light_power = 0.8;
	light_range = 2
	},
/area/ruin/unpowered)
"OV" = (
/obj/structure/chair/plastic{
	dir = 4
	},
/obj/item/reagent_containers/food/snacks/sandwich{
	pixel_x = 20;
	pixel_y = -10
	},
/obj/effect/turf_decal/weather/sand{
	dir = 9
	},
/turf/open/floor/carpet/red{
	light_color = "#FAE1AF";
	light_power = 0.8;
	light_range = 2
	},
/area/ruin/unpowered)
"PA" = (
/obj/structure/closet/cabinet,
/obj/item/clothing/suit/armor/riot/knight,
/obj/item/clothing/head/helmet/knight,
/turf/open/floor/plating/asteroid/sand/lit{
	light_power = 0;
	light_range = 0
	},
/area/ruin/unpowered)
"Qc" = (
/obj/effect/turf_decal/weather/sand{
	dir = 10
	},
/turf/open/floor/carpet/red,
/area/ruin/unpowered)
"QI" = (
/obj/structure/statue/sandstone/venus,
/turf/open/floor/plating/asteroid/sand/lit,
/area/ruin/unpowered)
"Rj" = (
/turf/template_noop,
/area/template_noop)
"Tw" = (
/obj/structure/flora/rock,
/turf/open/floor/plating/asteroid/sand/lit,
/area/ruin/unpowered)
"TM" = (
/obj/item/stack/sheet/mineral/sandstone,
/turf/open/floor/plating/asteroid/sand/lit{
	light_power = 0;
	light_range = 0
	},
/area/ruin/unpowered)
"UO" = (
/obj/structure/table/wood,
/obj/item/gun/ballistic/bow,
/turf/open/floor/plating/asteroid/sand/lit{
	light_power = 0;
	light_range = 0
	},
/area/ruin/unpowered)
"VN" = (
/obj/item/toy/plush/among,
/turf/open/floor/plating/asteroid/sand/lit{
	light_power = 0;
	light_range = 0
	},
/area/ruin/unpowered)
"VO" = (
/obj/structure/table/wood,
/obj/item/shield/riot/buckler,
/turf/open/floor/plating/asteroid/sand/lit{
	light_power = 0;
	light_range = 0
	},
/area/ruin/unpowered)
"Ws" = (
/obj/item/stack/sheet/mineral/diamond,
/turf/open/floor/plating/asteroid/sand/lit{
	light_power = 0;
	light_range = 0
	},
/area/ruin/unpowered)
"Wt" = (
/obj/effect/decal/remains/human{
	pixel_y = 6
	},
/turf/open/floor/plating/asteroid/sand/lit{
	light_power = 0;
	light_range = 0
	},
/area/ruin/unpowered)
"Ww" = (
/obj/structure/flora/rock,
/turf/open/water/beach,
/area/ruin/unpowered)
"WR" = (
/obj/structure/rack,
/obj/item/claymore/weak,
/turf/open/floor/plating/asteroid/sand/lit{
	light_power = 0;
	light_range = 0
	},
/area/ruin/unpowered)
"Xk" = (
/obj/structure/table/wood,
/turf/open/floor/plating/asteroid/sand/lit{
	light_power = 0;
	light_range = 0
	},
/area/ruin/unpowered)
"XM" = (
/obj/structure/bed,
/obj/item/bedsheet/mime,
/obj/item/kitchen/knife/shiv,
/obj/effect/spawner/lootdrop/prison_contraband,
/turf/open/floor/plating/asteroid/sand/lit{
	light_power = 0;
	light_range = 0
	},
/area/ruin/unpowered)
"Yw" = (
/turf/open/floor/plating/asteroid/sand/lit,
/area/ruin/unpowered)
"YF" = (
/obj/structure/bed,
/obj/item/bedsheet/black,
/obj/effect/decal/cleanable/blood/old{
	icon_state = "floor4-old"
	},
/turf/open/floor/plating/asteroid/sand/lit{
	light_power = 0;
	light_range = 0
	},
/area/ruin/unpowered)
"Zf" = (
/obj/item/melee/classic_baton,
/obj/effect/decal/cleanable/blood/old{
	icon_state = "bloodyhands_right"
	},
/turf/open/floor/plating/asteroid/sand/lit{
	light_power = 0;
	light_range = 0
	},
/area/ruin/unpowered)
"Zt" = (
/obj/structure/flora/ash/cacti,
/turf/open/floor/plating/dirt/dark,
/area/ruin/unpowered)
"ZF" = (
/obj/effect/turf_decal/weather/sand{
	dir = 6
	},
/turf/open/floor/carpet/red,
/area/ruin/unpowered)
"ZK" = (
/obj/structure/closet/cabinet,
/obj/item/clothing/suit/armor/riot/knight/red,
/obj/item/clothing/head/helmet/knight/red,
/turf/open/floor/plating/asteroid/sand/lit{
	light_power = 0;
	light_range = 0
	},
/area/ruin/unpowered)
"ZR" = (
/turf/open/floor/carpet/red{
	light_color = "#FAE1AF";
	light_power = 0.8;
	light_range = 2
	},
/area/ruin/unpowered)

(1,1,1) = {"
Rj
Rj
Rj
Rj
Rj
Rj
Rj
Rj
Rj
Rj
Rj
Rj
Rj
AD
AD
AD
AD
Rj
Rj
Rj
Rj
Rj
Rj
Rj
Rj
Rj
AD
AD
AD
AD
AD
AD
Rj
Rj
Rj
Rj
Rj
AD
AD
AD
AD
Rj
Rj
Rj
Rj
Rj
Rj
Rj
Rj
Rj
"}
(2,1,1) = {"
Rj
AD
AD
Rj
Rj
Rj
Rj
Rj
Rj
AD
AD
AD
AD
AD
AD
Ww
AD
AD
AD
AD
Rj
Rj
Rj
AD
AD
AD
AD
AD
AD
AD
AD
AD
AD
AD
AD
AD
AD
AD
Ww
AD
AD
AD
AD
AD
AD
AD
Rj
Rj
Rj
Rj
"}
(3,1,1) = {"
Rj
AD
AD
AD
AD
AD
AD
AD
AD
AD
AD
AD
AD
yG
AD
AD
AD
AD
AD
AD
AD
AD
AD
AD
AD
AD
AD
yG
AD
AD
AD
AD
AD
AD
AD
AD
AD
AD
AD
AD
AD
AD
yG
AD
AD
AD
AD
AD
Rj
Rj
"}
(4,1,1) = {"
Rj
AD
AD
Ww
AD
AD
AD
AD
AD
AD
AD
AD
AD
AD
AD
AD
AD
AD
AD
AD
AD
AD
Ww
AD
AD
AD
AD
AD
AD
AD
AD
AD
AD
AD
AD
AD
AD
AD
AD
AD
AD
AD
AD
AD
Ww
AD
AD
AD
AD
Rj
"}
(5,1,1) = {"
Rj
AD
AD
AD
AD
AD
AD
AD
Yw
Yw
Yw
Yw
Yw
Yw
Yw
Yw
Yw
Yw
AD
AD
AD
AD
AD
AD
AD
Yw
Yw
Yw
Yw
Yw
Yw
AD
AD
AD
AD
AD
AD
AD
Yw
Yw
Yw
Yw
Yw
AD
AD
AD
AD
AD
AD
AD
"}
(6,1,1) = {"
AD
AD
yG
AD
AD
Yw
Yw
Yw
Yw
Yw
Yw
Yw
Yw
Yw
Yw
JO
Yw
Yw
Yw
Yw
Yw
Yw
Yw
Yw
Yw
Yw
Yw
tr
Yw
Yw
Yw
Yw
Yw
Yw
Yw
Yw
Yw
Yw
JO
Yw
Yw
Yw
Yw
Yw
Yw
Yw
AD
Ww
AD
AD
"}
(7,1,1) = {"
AD
AD
AD
AD
AD
Yw
Tw
JO
sH
Yw
JO
oi
oi
oi
oi
oi
JO
Yw
Yw
Yw
Yw
Yw
Yw
Yw
Yw
Yw
Yw
Yw
Yw
Tw
Yw
Yw
Yw
JO
oi
oi
oi
oi
oi
Yw
sH
Yw
dc
Yw
Yw
Yw
AD
AD
AD
AD
"}
(8,1,1) = {"
Rj
AD
AD
AD
AD
Yw
Yw
Yw
Yw
oi
oi
oi
aD
TM
uB
oi
oi
oi
Yw
Yw
Yw
Yw
dc
Yw
Yw
sH
Yw
Yw
JO
Yw
sH
Yw
oi
oi
oi
mX
Hl
Zt
oi
oi
oi
JO
Yw
sH
Yw
Yw
AD
AD
AD
AD
"}
(9,1,1) = {"
Rj
AD
AD
AD
AD
Yw
JO
Yw
oi
oi
aD
aD
Dy
Wt
TM
qR
aD
oi
oi
Yw
JO
Yw
JO
Yw
Yw
Yw
Yw
Yw
Yw
Yw
Yw
oi
oi
Gh
oi
Zt
Hl
mX
oi
Gh
oi
oi
Yw
Yw
Yw
AD
AD
AD
AD
Rj
"}
(10,1,1) = {"
Rj
Rj
AD
AD
Yw
Yw
JO
oi
oi
aD
TM
qR
aD
aD
qR
aD
aD
aD
oi
oi
Yw
Yw
sH
Yw
Yw
Yw
fB
Yw
Yw
Yw
oi
oi
CP
tB
oi
Hl
Hl
Zt
oi
aD
aD
oi
oi
JO
Yw
AD
AD
AD
Rj
Rj
"}
(11,1,1) = {"
Rj
Rj
AD
AD
Yw
sH
Yw
oi
aD
EL
aD
qR
aD
aD
aD
aD
TM
aD
aD
oi
Yw
Yw
Yw
Yw
Yw
JO
Yw
sH
Yw
Yw
oi
og
Zf
YF
oi
Bd
Eq
DK
oi
BT
aD
aD
oi
JO
Yw
AD
yG
AD
Rj
Rj
"}
(12,1,1) = {"
Rj
AD
AD
AD
Yw
Yw
oi
oi
lJ
TM
Dy
aD
aD
aD
aD
aD
aD
Dy
aD
oi
oi
Yw
Yw
Yw
Yw
Yw
Yw
Yw
Yw
oi
oi
oi
EQ
oi
fM
ru
ru
ru
rV
oi
EQ
oi
oi
oi
Yw
AD
AD
AD
Rj
Rj
"}
(13,1,1) = {"
Rj
AD
AD
AD
Yw
Yw
oi
aD
Wt
rS
aD
aD
bi
oi
bi
aD
aD
aD
qR
aD
oi
oi
oi
oi
oi
oi
oi
oi
oi
oi
oi
aD
aD
aD
aD
bi
oi
bi
aD
aD
aD
aD
aD
oi
Yw
AD
AD
AD
AD
Rj
"}
(14,1,1) = {"
Rj
AD
AD
AD
Yw
JO
oi
aD
TM
aD
aD
aD
oi
oi
oi
qR
aD
aD
qR
aD
oi
aD
aD
bi
aD
aD
bi
aD
aD
aD
oi
aD
aD
aD
aD
oi
oi
oi
aD
aD
aD
aD
aD
oi
Yw
AD
AD
AD
AD
Rj
"}
(15,1,1) = {"
AD
AD
AD
AD
Yw
Yw
oi
aD
qR
qR
aD
aD
bi
oi
bi
aD
aD
aD
aD
aD
ub
pA
sa
sa
sa
sa
sa
sa
sa
Qc
ub
aD
aD
Co
aD
bi
oi
bi
aD
aD
aD
aD
aD
oi
Yw
Yw
AD
AD
AD
AD
"}
(16,1,1) = {"
AD
AD
AD
AD
Yw
Yw
oi
oi
fX
TM
aD
Dy
aD
aD
aD
aD
aD
aD
aD
aD
ub
mQ
nH
nH
nH
nH
nH
nH
nH
ZF
ub
aD
aD
aD
aD
aD
aD
aD
aD
oi
pE
oi
oi
oi
JO
Yw
AD
AD
AD
AD
"}
(17,1,1) = {"
AD
Ww
AD
AD
Yw
Yw
Yw
oi
aD
Wt
aD
aD
TM
aD
aD
TM
aD
qR
aD
aD
oi
aD
aD
bi
aD
aD
bi
aD
aD
aD
oi
aD
aD
aD
aD
aD
aD
Co
oi
XM
aD
bc
Dl
Yw
Yw
Yw
AD
AD
AD
AD
"}
(18,1,1) = {"
AD
AD
AD
AD
Yw
Yw
JO
oi
oi
uB
aD
qR
aD
aD
aD
aD
aD
aD
oi
oi
oi
oi
oi
oi
oi
oi
oi
oi
oi
oi
oi
oi
Gq
aD
MD
aD
aD
aD
oi
bG
eT
oi
oi
sH
Yw
Yw
AD
Ww
AD
AD
"}
(19,1,1) = {"
AD
AD
AD
AD
Yw
Yw
Yw
Yw
oi
oi
aD
aD
aD
aD
aD
aD
aD
oi
oi
Yw
zw
Yw
JO
Yw
Yw
Yw
Yw
Yw
Yw
JO
Yw
oi
oi
hO
aD
aD
aD
aD
oi
Gh
oi
oi
Yw
Yw
tr
Yw
AD
AD
AD
AD
"}
(20,1,1) = {"
AD
AD
AD
AD
Yw
fB
Yw
Yw
Yw
oi
oi
oi
aD
aD
aD
aD
aD
oi
Yw
Yw
Yw
Yw
Yw
Ib
Yw
QI
JO
Yw
zw
Yw
Ib
Kz
oi
oi
oi
aD
aD
aD
oi
oi
oi
Yw
Yw
Yw
Yw
Yw
AD
AD
AD
AD
"}
(21,1,1) = {"
Rj
AD
AD
AD
Yw
Yw
Yw
Yw
Yw
Yw
Yw
oi
oi
oi
ub
ub
oi
oi
Kz
Ib
Yw
JO
Yw
Yw
Yw
Yw
Ib
Yw
Yw
Yw
JO
Yw
Yw
Yw
oi
oi
oi
oi
oi
Yw
Yw
Yw
JO
tr
Kz
Yw
AD
AD
AD
AD
"}
(22,1,1) = {"
Rj
AD
AD
AD
Yw
Yw
Yw
JO
Yw
sH
Yw
Yw
oi
aD
pA
Qc
aD
oi
Yw
JO
Yw
Ib
Yw
JO
zw
Yw
Kz
Yw
Yw
Yw
Yw
mh
JO
Yw
Yw
oi
CM
oi
sH
Yw
Kz
Yw
Yw
sH
Yw
Yw
AD
AD
AD
AD
"}
(23,1,1) = {"
Rj
AD
AD
AD
AD
Yw
Yw
Yw
Yw
Yw
Yw
sH
oi
aD
qc
Ju
aD
oi
Yw
Yw
Yw
Yw
Yw
Yw
Yw
Yw
JO
Yw
JO
Yw
Yw
Yw
Yw
Kz
Yw
oi
oi
oi
Yw
JO
Yw
oi
Yw
Yw
JO
Yw
AD
AD
AD
AD
"}
(24,1,1) = {"
Rj
AD
AD
AD
AD
Yw
Yw
tr
Yw
Tw
Yw
JO
oi
bi
qc
Ju
bi
oi
Yw
Yw
JO
Yw
aD
OV
sv
qY
Yw
Yw
Ib
Yw
Yw
Yw
Yw
Yw
Yw
Yw
oi
oi
Yw
Yw
Yw
Yw
Yw
dc
Yw
Yw
AD
AD
AD
Rj
"}
(25,1,1) = {"
Rj
Rj
AD
AD
AD
Yw
Yw
Yw
Yw
Yw
Yw
Yw
oi
aD
qc
Ju
aD
ub
Yw
Yw
Yw
Yw
Yw
No
ZR
qL
Yw
Yw
Yw
Yw
Yw
Yw
Yw
Yw
Yw
Yw
Yw
rb
Yw
Yw
Yw
Yw
Yw
Yw
Yw
AD
AD
AD
AD
Rj
"}
(26,1,1) = {"
Rj
Rj
AD
AD
AD
Yw
Yw
Yw
Yw
JO
Yw
Yw
oi
aD
qc
Ju
aD
ub
Yw
Yw
Yw
Yw
Yw
No
ZR
Oy
Yw
Yw
Yw
Yw
Yw
Yw
Yw
Yw
Yw
Yw
Yw
rb
Yw
Yw
Yw
Yw
Yw
JO
Yw
AD
AD
AD
Rj
Rj
"}
(27,1,1) = {"
Rj
Rj
AD
yG
AD
Yw
Yw
sH
Yw
Yw
Yw
Yw
oi
bi
qc
Ju
bi
oi
Yw
Yw
Yw
Yw
Yw
Bs
AO
ze
Yw
Yw
Yw
Yw
Yw
Yw
Yw
Yw
Kz
Yw
oi
oi
Yw
Yw
Yw
Yw
Yw
Yw
Yw
AD
yG
AD
Rj
Rj
"}
(28,1,1) = {"
Rj
Rj
AD
AD
AD
Yw
Yw
Yw
Yw
Yw
Yw
sH
oi
aD
qc
Ju
aD
oi
Yw
JO
Yw
Kz
Ib
Yw
Yw
JO
Yw
Kz
Yw
Yw
Yw
QI
Yw
Yw
Yw
oi
oi
oi
JO
sH
Yw
oi
Yw
Yw
Yw
AD
AD
AD
Rj
Rj
"}
(29,1,1) = {"
Rj
Rj
AD
AD
AD
Yw
Yw
dc
Yw
JO
Yw
Yw
oi
aD
mQ
ZF
aD
oi
Yw
zw
Yw
Yw
Yw
JO
Yw
Ib
Yw
Yw
Yw
zw
Yw
Yw
JO
Yw
Yw
oi
VN
oi
Yw
Kz
Yw
JO
Yw
Kz
Yw
AD
AD
AD
AD
Rj
"}
(30,1,1) = {"
Rj
AD
AD
AD
AD
Yw
Yw
Yw
sH
Yw
Yw
oi
oi
oi
ub
ub
oi
oi
Yw
Yw
Ib
JO
Yw
Yw
Yw
Yw
Yw
Yw
Yw
Yw
Ib
Yw
Yw
Yw
oi
oi
oi
oi
oi
Yw
Yw
Yw
sH
tr
Yw
Yw
AD
AD
AD
Rj
"}
(31,1,1) = {"
Rj
AD
AD
AD
AD
Yw
Yw
Yw
Yw
oi
oi
oi
aD
aD
aD
aD
aD
oi
Yw
Yw
Yw
Yw
Yw
mh
Yw
Yw
zw
Ib
JO
Yw
Yw
Yw
oi
oi
oi
oi
oi
oi
oi
oi
oi
Yw
Yw
Yw
JO
Yw
AD
Ww
AD
AD
"}
(32,1,1) = {"
Rj
AD
AD
AD
Yw
Yw
Yw
Yw
oi
oi
Nn
aD
aD
aD
aD
aD
aD
oi
oi
Yw
Yw
Yw
Yw
Yw
Yw
Yw
Yw
Yw
Yw
Yw
Yw
oi
oi
aD
aD
JT
aD
aD
JB
aD
oi
oi
Yw
Yw
Yw
Yw
AD
AD
AD
AD
"}
(33,1,1) = {"
Rj
AD
Ww
AD
Yw
Yw
Yw
oi
oi
oi
vy
aD
aD
aD
aD
aD
aD
aD
oi
oi
oi
oi
oi
oi
oi
oi
oi
oi
oi
oi
oi
oi
aD
nC
aD
aD
nC
aD
aD
aD
aD
oi
oi
Yw
Tw
Yw
AD
AD
AD
AD
"}
(34,1,1) = {"
Rj
AD
AD
AD
Yw
Yw
Yw
oi
UO
Gs
oi
aD
Co
aD
aD
aD
aD
aD
aD
aD
oi
aD
aD
bi
aD
aD
bi
aD
aD
aD
oi
aD
aD
aD
aD
aD
aD
JT
aD
JT
aD
JB
oi
JO
Yw
Yw
AD
AD
AD
AD
"}
(35,1,1) = {"
AD
AD
AD
AD
Yw
Yw
oi
oi
aD
aD
gw
aD
aD
aD
aD
aD
aD
aD
aD
aD
ub
pA
sa
sa
sa
sa
sa
sa
sa
JJ
ub
nC
aD
aD
aD
nC
aD
aD
aD
aD
aD
aD
oi
oi
sH
Yw
AD
AD
AD
AD
"}
(36,1,1) = {"
AD
AD
AD
AD
Yw
JO
oi
WR
aD
aD
aD
aD
bi
oi
bi
aD
aD
aD
aD
aD
ub
mQ
nH
nH
nH
nH
nH
nH
nH
CS
ub
aD
aD
nC
aD
aD
oi
aD
JB
aD
aD
JT
oi
oi
Yw
Yw
AD
AD
AD
AD
"}
(37,1,1) = {"
AD
AD
yG
AD
Yw
Yw
oi
VO
aD
Co
aD
aD
oi
oi
oi
aD
aD
aD
aD
aD
oi
aD
aD
bi
aD
aD
bi
aD
aD
aD
oi
aD
aD
oi
oi
oi
oi
oi
aD
aD
JB
aD
oi
oi
Yw
Yw
AD
AD
AD
AD
"}
(38,1,1) = {"
AD
AD
AD
AD
Yw
Yw
oi
WR
aD
aD
aD
aD
bi
oi
bi
aD
aD
aD
aD
aD
oi
oi
oi
oi
oi
oi
oi
oi
oi
oi
oi
oi
oi
oi
sG
xK
oi
JT
aD
aD
aD
aD
oi
oi
Yw
Yw
AD
AD
AD
AD
"}
(39,1,1) = {"
Rj
AD
AD
AD
Yw
Yw
oi
oi
aD
aD
aD
aD
aD
aD
aD
aD
aD
aD
aD
oi
oi
Yw
Yw
Yw
Yw
sH
Yw
Yw
Yw
oi
oi
es
Ws
aD
Ws
aD
aD
aD
aD
aD
JB
aD
oi
oi
JO
Yw
AD
yG
AD
AD
"}
(40,1,1) = {"
Rj
AD
AD
AD
AD
Yw
Yw
oi
aI
ZK
oi
gw
aD
aD
aD
aD
oi
Ci
Xk
oi
Yw
Yw
JO
Yw
Yw
Yw
Yw
dc
JO
Yw
oi
BP
xK
aD
aD
aD
JB
aD
JT
aD
aD
aD
oi
Yw
Yw
Yw
AD
AD
AD
Rj
"}
(41,1,1) = {"
Rj
Rj
AD
AD
AD
Yw
Yw
oi
oi
oi
PA
aD
aD
Co
aD
aD
Gs
oi
oi
oi
Yw
Yw
sH
Yw
tr
Yw
Yw
Yw
Yw
sH
oi
oi
tG
Ws
aD
aD
aD
aD
aD
aD
JT
oi
oi
JO
Yw
Yw
AD
AD
AD
Rj
"}
(42,1,1) = {"
Rj
Rj
AD
Ww
AD
Yw
Yw
JO
oi
oi
kI
aD
aD
aD
aD
aD
UO
oi
oi
Yw
JO
Yw
Yw
Yw
Yw
sH
Yw
Yw
Yw
Yw
Yw
oi
oi
aD
xK
aD
JB
aD
aD
aD
oi
oi
Yw
JO
Yw
AD
AD
AD
AD
Rj
"}
(43,1,1) = {"
Rj
Rj
AD
AD
AD
Yw
Tw
Yw
Yw
oi
oi
oi
WR
VO
eI
oi
oi
oi
Yw
Yw
sH
Yw
fB
Yw
Yw
Yw
Yw
sH
Yw
Yw
JO
Yw
oi
oi
oi
oi
oi
oi
oi
oi
oi
Yw
Yw
Yw
Yw
AD
AD
AD
AD
Rj
"}
(44,1,1) = {"
Rj
Rj
AD
AD
AD
Yw
JO
Yw
sH
Yw
Yw
oi
oi
oi
oi
oi
Yw
JO
Yw
Tw
Yw
Yw
Yw
Yw
Yw
Yw
Yw
tr
Yw
Yw
Yw
Yw
Yw
sH
oi
oi
oi
oi
oi
Yw
sH
Yw
Yw
tr
Yw
AD
AD
Ww
AD
Rj
"}
(45,1,1) = {"
Rj
AD
AD
AD
AD
Yw
Yw
Yw
Yw
Yw
Yw
JO
Yw
Yw
Yw
Yw
Yw
Yw
Yw
Yw
Yw
Yw
Yw
Yw
Yw
Yw
Yw
Yw
Yw
Yw
Yw
Yw
Yw
Yw
Yw
Yw
Yw
JO
Yw
Yw
Yw
Yw
Yw
Yw
Yw
AD
AD
AD
AD
Rj
"}
(46,1,1) = {"
Rj
AD
AD
AD
AD
AD
AD
AD
AD
AD
Yw
Yw
Yw
Yw
AD
AD
AD
AD
AD
Yw
Yw
Yw
Yw
Yw
Yw
Yw
AD
AD
AD
AD
AD
AD
Yw
Yw
Yw
Yw
Yw
Yw
Yw
Yw
AD
AD
AD
AD
AD
AD
AD
AD
Rj
Rj
"}
(47,1,1) = {"
Rj
AD
AD
AD
yG
AD
AD
AD
AD
AD
AD
AD
AD
AD
AD
AD
yG
AD
AD
AD
AD
AD
AD
AD
AD
AD
AD
AD
AD
AD
AD
AD
AD
AD
AD
AD
AD
AD
AD
AD
AD
AD
AD
yG
AD
AD
AD
AD
Rj
Rj
"}
(48,1,1) = {"
Rj
Rj
AD
AD
AD
AD
AD
AD
AD
AD
AD
AD
Ww
AD
AD
AD
AD
AD
AD
AD
AD
AD
AD
AD
yG
AD
AD
AD
AD
AD
AD
AD
Ww
AD
AD
AD
AD
AD
AD
AD
Ww
AD
AD
AD
AD
AD
AD
AD
Rj
Rj
"}
(49,1,1) = {"
Rj
Rj
Rj
AD
AD
AD
Rj
Rj
Rj
AD
AD
AD
AD
AD
AD
Rj
Rj
Rj
AD
AD
AD
Ww
AD
AD
AD
AD
AD
Rj
Rj
Rj
Rj
AD
AD
AD
AD
AD
yG
AD
AD
AD
AD
AD
AD
AD
AD
AD
Rj
Rj
Rj
Rj
"}
(50,1,1) = {"
Rj
Rj
Rj
Rj
Rj
Rj
Rj
Rj
Rj
Rj
Rj
AD
AD
Rj
Rj
Rj
Rj
Rj
Rj
Rj
AD
AD
AD
AD
AD
Rj
Rj
Rj
Rj
Rj
Rj
Rj
Rj
Rj
Rj
AD
AD
AD
AD
Rj
Rj
Rj
Rj
Rj
Rj
Rj
Rj
Rj
Rj
Rj
"}
