//MAP CONVERTED BY dmm2tgm.py THIS HEADER COMMENT PREVENTS RECONVERSION, DO NOT REMOVE
"ag" = (
/obj/effect/overlay/palmtree_l,
/turf/open/floor/plating/asteroid/sand/lit,
/area/ruin/unpowered)
"aW" = (
/obj/item/instrument/guitar,
/turf/open/floor/carpet/blue{
	light_range = 2
	},
/area/ruin/unpowered)
"bt" = (
/obj/structure/flora/ausbushes/leafybush,
/turf/open/floor/plating/grass/beach/lit,
/area/ruin/unpowered)
"bO" = (
/turf/closed/wall/mineral/sandstone,
/area/ruin/unpowered)
"cr" = (
/obj/item/reagent_containers/food/snacks/kebab/rat/double,
/turf/open/floor/plating/grass/beach/lit,
/area/ruin/unpowered)
"cC" = (
/obj/structure/flora/ausbushes/brflowers,
/turf/open/floor/plating/grass/beach/lit,
/area/ruin/unpowered)
"cS" = (
/obj/structure/flora/ausbushes/fernybush,
/turf/open/floor/plating/grass/beach/lit,
/area/ruin/unpowered)
"dE" = (
/obj/item/seeds/cocoapod,
/turf/open/floor/plating/dirt/jungle{
	light_range = 2
	},
/area/ruin/unpowered)
"dH" = (
/obj/structure/fence{
	icon_state = "corner"
	},
/turf/open/floor/plating/grass/beach/lit,
/area/ruin/unpowered)
"fd" = (
/obj/item/cultivator/rake,
/turf/open/floor/plating/dirt/jungle{
	light_range = 2
	},
/area/ruin/unpowered)
"fj" = (
/obj/item/storage/cans/sixbeer,
/turf/open/floor/carpet/orange{
	light_range = 2
	},
/area/ruin/unpowered)
"fC" = (
/obj/structure/flora/tree/palm,
/turf/open/floor/plating/asteroid/sand/lit,
/area/ruin/unpowered)
"gn" = (
/obj/structure/flora/ausbushes/sparsegrass,
/turf/open/floor/plating/grass/beach/lit,
/area/ruin/unpowered)
"gv" = (
/obj/structure/fluff/beach_umbrella/cap,
/turf/open/floor/plating/asteroid/sand/lit,
/area/ruin/unpowered)
"hh" = (
/obj/structure/barricade/sandbags,
/turf/open/floor/plating/asteroid/sand/lit,
/area/ruin/unpowered)
"hQ" = (
/obj/structure/fence{
	dir = 5;
	icon_state = "corner"
	},
/turf/open/floor/plating/grass/beach/lit,
/area/ruin/unpowered)
"iJ" = (
/obj/structure/railing{
	dir = 1
	},
/obj/item/melee/roastingstick,
/turf/open/floor/plating/grass/beach/lit,
/area/ruin/unpowered)
"kd" = (
/obj/effect/mob_spawn/human/corpse/pirate,
/turf/open/floor/plating/grass/beach/lit,
/area/ruin/unpowered)
"kV" = (
/obj/effect/decal/cleanable/crayon{
	icon_state = "carp"
	},
/turf/open/floor/concrete{
	light_range = 2
	},
/area/ruin/unpowered)
"lr" = (
/obj/item/toy/beach_ball,
/turf/open/floor/plating/asteroid/sand/lit,
/area/ruin/unpowered)
"lD" = (
/obj/structure/fence,
/turf/open/floor/plating/grass/beach/lit,
/area/ruin/unpowered)
"mt" = (
/turf/open/floor/wood,
/area/ruin/unpowered)
"mI" = (
/obj/structure/toilet{
	dir = 4;
	pixel_y = 3
	},
/obj/structure/sink/kitchen{
	dir = 8;
	pixel_x = 15
	},
/turf/open/floor/wood,
/area/ruin/unpowered)
"nl" = (
/obj/item/shovel/spade,
/turf/open/floor/plating/asteroid/sand/lit,
/area/ruin/unpowered)
"ns" = (
/obj/structure/fence{
	icon_state = "door_closed"
	},
/turf/open/floor/plating/grass/beach/lit,
/area/ruin/unpowered)
"nB" = (
/obj/structure/flora/ausbushes/ppflowers,
/turf/open/floor/plating/grass/beach/lit,
/area/ruin/unpowered)
"on" = (
/obj/structure/table/wood,
/obj/item/clothing/glasses/sunglasses/garb{
	pixel_y = -5
	},
/obj/item/clothing/glasses/sunglasses/big{
	pixel_y = 9
	},
/turf/open/floor/wood,
/area/ruin/unpowered)
"pp" = (
/obj/structure/chair/plastic{
	dir = 4
	},
/turf/open/floor/plating/grass/beach/lit,
/area/ruin/unpowered)
"pv" = (
/turf/open/floor/plating/asteroid/sand/lit{
	icon_state = "sand_dug"
	},
/area/ruin/unpowered)
"pN" = (
/turf/open/floor/concrete{
	light_range = 2
	},
/area/ruin/unpowered)
"pU" = (
/obj/structure/fluff/fokoff_sign,
/turf/open/floor/plating/grass/beach/lit,
/area/ruin/unpowered)
"pY" = (
/obj/structure/bonfire/prelit,
/turf/open/floor/plating/grass/beach/lit,
/area/ruin/unpowered)
"qq" = (
/obj/effect/overlay/coconut,
/turf/open/floor/plating/asteroid/sand/lit,
/area/ruin/unpowered)
"qG" = (
/obj/item/clothing/suit/space/hardsuit/carp/old,
/turf/open/floor/plating/grass/beach/lit,
/area/ruin/unpowered)
"qP" = (
/obj/structure/window/reinforced{
	dir = 8
	},
/obj/structure/window/reinforced,
/obj/item/storage/firstaid/o2,
/turf/open/floor/wood{
	light_range = 2
	},
/area/ruin/unpowered)
"rD" = (
/obj/structure/bed,
/obj/item/bedsheet/dorms,
/turf/open/floor/wood,
/area/ruin/unpowered)
"ta" = (
/turf/open/floor/carpet/blue{
	light_range = 2
	},
/area/ruin/unpowered)
"ug" = (
/obj/structure/closet/crate/freezer{
	name = "Cooler"
	},
/obj/item/reagent_containers/food/drinks/ice,
/obj/item/reagent_containers/food/drinks/colocup,
/obj/item/reagent_containers/food/drinks/colocup,
/obj/item/reagent_containers/food/drinks/beer{
	desc = "Beer advertised to be the best in space.";
	name = "Masterbrand Beer"
	},
/obj/item/reagent_containers/food/drinks/beer{
	desc = "Beer advertised to be the best in space.";
	name = "Masterbrand Beer"
	},
/obj/item/reagent_containers/food/drinks/beer{
	desc = "Beer advertised to be the best in space.";
	name = "Masterbrand Beer"
	},
/obj/item/reagent_containers/food/drinks/beer/light,
/obj/item/reagent_containers/food/drinks/beer/light,
/obj/item/reagent_containers/food/drinks/beer/light,
/turf/open/floor/plating/asteroid/sand/lit,
/area/ruin/unpowered)
"uw" = (
/obj/structure/flora/rock/beach,
/turf/open/floor/plating/asteroid/sand/lit,
/area/ruin/unpowered)
"vG" = (
/obj/effect/mob_spawn/human/corpse/charredskeleton,
/turf/open/floor/carpet/purple{
	light_range = 2
	},
/area/ruin/unpowered)
"wb" = (
/obj/structure/window/reinforced{
	dir = 1
	},
/obj/structure/window/reinforced{
	dir = 8
	},
/obj/structure/table/wood,
/obj/item/megaphone,
/turf/open/floor/wood{
	light_range = 2
	},
/area/ruin/unpowered)
"wf" = (
/obj/effect/spawner/structure/window/reinforced,
/obj/structure/grille,
/obj/structure/curtain,
/turf/open/floor/wood,
/area/ruin/unpowered)
"xK" = (
/obj/structure/chair/plastic,
/turf/open/floor/plating/grass/beach/lit,
/area/ruin/unpowered)
"xT" = (
/obj/item/stack/sheet/sandblock,
/turf/open/floor/plating/asteroid/sand/lit,
/area/ruin/unpowered)
"Ap" = (
/obj/structure/fluff/beach_umbrella/security,
/turf/open/floor/plating/asteroid/sand/lit,
/area/ruin/unpowered)
"AV" = (
/obj/item/storage/crayons,
/turf/open/floor/concrete{
	light_range = 2
	},
/area/ruin/unpowered)
"CR" = (
/obj/structure/window/reinforced{
	dir = 4
	},
/obj/structure/window/reinforced{
	dir = 1;
	layer = 2.9
	},
/obj/structure/chair/stool,
/obj/item/storage/backpack/duffelbag,
/obj/item/clothing/under/shorts/red,
/obj/item/clothing/glasses/sunglasses,
/turf/open/floor/wood{
	light_range = 2
	},
/area/ruin/unpowered)
"Dx" = (
/obj/item/toy/crayon/spraycan{
	pixel_x = -5;
	pixel_y = 6
	},
/obj/item/toy/crayon/spraycan{
	pixel_x = 6;
	pixel_y = 3
	},
/turf/open/floor/concrete{
	light_range = 2
	},
/area/ruin/unpowered)
"EB" = (
/obj/structure/fence{
	dir = 4
	},
/obj/structure/fence{
	dir = 4
	},
/turf/open/floor/plating/grass/beach/lit,
/area/ruin/unpowered)
"EC" = (
/obj/item/toy/beach_ball/holoball/dodgeball,
/turf/open/floor/plating/asteroid/sand/lit,
/area/ruin/unpowered)
"Fm" = (
/obj/structure/catwalk/over/plated_catwalk,
/turf/open/floor/plating/asteroid/sand/lit,
/area/ruin/unpowered)
"FV" = (
/obj/effect/overlay/palmtree_r,
/turf/open/floor/plating/asteroid/sand/lit,
/area/ruin/unpowered)
"FW" = (
/mob/living/simple_animal/hostile/carp,
/turf/open/floor/plating/grass/beach/lit,
/area/ruin/unpowered)
"Gh" = (
/obj/structure/fence{
	dir = 9;
	icon_state = "corner"
	},
/turf/open/floor/plating/grass/beach/lit,
/area/ruin/unpowered)
"Hg" = (
/obj/machinery/hydroponics/soil,
/turf/open/floor/plating/dirt/jungle{
	light_range = 2
	},
/area/ruin/unpowered)
"IV" = (
/obj/item/stack/ore/glass/beach,
/turf/open/floor/plating/asteroid/sand/lit,
/area/ruin/unpowered)
"Ja" = (
/obj/structure/flora/tree/jungle/small,
/turf/open/floor/plating/grass/beach/lit,
/area/ruin/unpowered)
"Jb" = (
/obj/item/seeds/cocoapod/vanillapod,
/turf/open/floor/plating/dirt/jungle{
	light_range = 2
	},
/area/ruin/unpowered)
"JX" = (
/obj/machinery/door/airlock/sandstone,
/turf/open/floor/wood,
/area/ruin/unpowered)
"KA" = (
/turf/open/floor/plating/dirt/jungle{
	light_range = 2
	},
/area/ruin/unpowered)
"KM" = (
/turf/template_noop,
/area/template_noop)
"Ld" = (
/obj/structure/fluff/beach_umbrella/science,
/turf/open/floor/plating/asteroid/sand/lit,
/area/ruin/unpowered)
"Li" = (
/turf/open/water/beach/deep,
/area/ruin/unpowered)
"Lz" = (
/obj/structure/fluff/beach_umbrella/engine,
/turf/open/floor/plating/asteroid/sand/lit,
/area/ruin/unpowered)
"ML" = (
/obj/item/reagent_containers/glass/bucket/wooden,
/turf/open/floor/plating/dirt/jungle{
	light_range = 2
	},
/area/ruin/unpowered)
"Nl" = (
/obj/item/toy/seashell,
/turf/open/floor/plating/asteroid/sand/lit,
/area/ruin/unpowered)
"Nz" = (
/turf/open/floor/plasteel/stairs/old{
	light_range = 2
	},
/area/ruin/unpowered)
"NG" = (
/obj/item/gun/ballistic/automatic/pistol/m1911/no_mag{
	pixel_x = 13
	},
/obj/item/toy/plush/carpplushie{
	desc = "An adorable stuffed toy that resembles a space carp with a gun.";
	name = "glock-ness monster plushie"
	},
/turf/open/water/beach/deep,
/area/ruin/unpowered)
"NL" = (
/obj/structure/closet/cabinet,
/obj/item/storage/backpack/duffelbag,
/obj/item/clothing/under/shorts/purple,
/obj/item/clothing/shoes/cookflops{
	desc = "A very fashionable pair of flip flops.";
	name = "flip-flops"
	},
/obj/item/clothing/neck/beads,
/obj/item/clothing/under/color/red,
/obj/item/clothing/under/color/white,
/turf/open/floor/wood,
/area/ruin/unpowered)
"Oa" = (
/obj/item/melee/skateboard/pro,
/turf/open/floor/wood,
/area/ruin/unpowered)
"Om" = (
/obj/structure/fence{
	dir = 10;
	icon_state = "corner"
	},
/turf/open/floor/plating/grass/beach/lit,
/area/ruin/unpowered)
"Pd" = (
/obj/item/grown/log/tree,
/obj/item/grown/log/tree,
/obj/item/grown/log/tree,
/turf/open/floor/plating/grass/beach/lit,
/area/ruin/unpowered)
"Px" = (
/obj/structure/chair/plastic{
	dir = 1
	},
/turf/open/floor/plating/grass/beach/lit,
/area/ruin/unpowered)
"Qf" = (
/turf/open/floor/concrete/slab_1{
	light_range = 2
	},
/area/ruin/unpowered)
"RK" = (
/obj/item/toy/beach_ball/holoball/dodgeball,
/obj/item/melee/skateboard/hoverboard,
/turf/open/floor/plating/asteroid/sand/lit,
/area/ruin/unpowered)
"RM" = (
/obj/structure/sink/puddle,
/turf/open/floor/plating/dirt/jungle{
	light_range = 2
	},
/area/ruin/unpowered)
"RV" = (
/obj/structure/chair/plastic{
	dir = 8
	},
/turf/open/floor/plating/grass/beach/lit,
/area/ruin/unpowered)
"SS" = (
/turf/open/floor/carpet/red{
	light_range = 2
	},
/area/ruin/unpowered)
"Te" = (
/obj/structure/railing,
/turf/open/floor/plating/grass/beach/lit,
/area/ruin/unpowered)
"Tr" = (
/obj/item/reagent_containers/food/drinks/colocup{
	pixel_x = -7;
	pixel_y = -2
	},
/obj/item/reagent_containers/food/drinks/colocup{
	pixel_x = 5;
	pixel_y = 6
	},
/obj/item/reagent_containers/food/drinks/bottle/rum{
	pixel_x = 4;
	pixel_y = -3
	},
/turf/open/floor/carpet/red{
	light_range = 2
	},
/area/ruin/unpowered)
"TW" = (
/obj/structure/fence{
	dir = 4
	},
/turf/open/floor/plating/grass/beach/lit,
/area/ruin/unpowered)
"TZ" = (
/turf/open/floor/carpet/purple{
	light_range = 2
	},
/area/ruin/unpowered)
"US" = (
/turf/open/water/beach,
/area/ruin/unpowered)
"Vn" = (
/turf/open/floor/plating/grass/beach{
	light_range = 2
	},
/area/ruin/unpowered)
"Vx" = (
/obj/structure/table/rolling,
/obj/item/reagent_containers/food/snacks/kebab/fiesta,
/obj/item/reagent_containers/food/snacks/kebab/fiesta{
	pixel_y = 7
	},
/obj/item/reagent_containers/food/snacks/kebab/fiesta{
	pixel_y = 13
	},
/turf/open/floor/plating/grass/beach/lit,
/area/ruin/unpowered)
"VG" = (
/obj/item/reagent_containers/spray/cleaner,
/turf/open/floor/concrete{
	light_range = 2
	},
/area/ruin/unpowered)
"VX" = (
/obj/structure/railing{
	dir = 8
	},
/turf/open/floor/plating/grass/beach/lit,
/area/ruin/unpowered)
"Wq" = (
/turf/open/floor/plating/grass/beach/lit,
/area/ruin/unpowered)
"Ww" = (
/obj/item/melee/roastingstick,
/turf/open/floor/plating/grass/beach/lit,
/area/ruin/unpowered)
"Xd" = (
/obj/structure/railing{
	dir = 4
	},
/turf/open/floor/plating/grass/beach/lit,
/area/ruin/unpowered)
"Xe" = (
/obj/item/storage/cans/sixbeer,
/turf/open/floor/plating/grass/beach/lit,
/area/ruin/unpowered)
"Xh" = (
/obj/item/reagent_containers/glass/bucket,
/turf/open/floor/plating/asteroid/sand/lit,
/area/ruin/unpowered)
"Xo" = (
/obj/structure/statue/sandstone/assistant,
/turf/open/floor/plating/asteroid/sand/lit,
/area/ruin/unpowered)
"Xr" = (
/obj/structure/flora/ausbushes/sparsegrass,
/turf/open/floor/plating/asteroid/sand/lit,
/area/ruin/unpowered)
"Xz" = (
/obj/structure/window/reinforced{
	dir = 4
	},
/turf/open/floor/wood{
	light_range = 2
	},
/area/ruin/unpowered)
"Yi" = (
/obj/item/toy/plush/lizardplushie{
	name = "Soaks-The-Rays"
	},
/turf/open/floor/carpet/orange{
	light_range = 2
	},
/area/ruin/unpowered)
"Yq" = (
/obj/effect/decal/cleanable/crayon{
	icon_state = "#"
	},
/turf/open/floor/concrete{
	light_range = 2
	},
/area/ruin/unpowered)
"Zz" = (
/obj/structure/flora/ausbushes/grassybush,
/turf/open/floor/plating/asteroid/sand/lit,
/area/ruin/unpowered)
"ZA" = (
/obj/structure/flora/junglebush/large,
/turf/open/floor/plating/grass/beach/lit,
/area/ruin/unpowered)
"ZI" = (
/turf/open/floor/plating/asteroid/sand/lit,
/area/ruin/unpowered)

(1,1,1) = {"
KM
KM
KM
KM
KM
KM
Wq
Wq
Wq
Wq
Wq
Wq
Vn
Wq
Wq
Wq
Wq
Wq
Wq
KM
KM
KM
KM
KM
KM
KM
KM
KM
KM
KM
"}
(2,1,1) = {"
KM
KM
bO
bO
bO
bO
bO
bO
bO
Wq
cC
Wq
Hg
Hg
dE
Jb
Hg
Hg
Wq
Wq
gn
nB
Wq
Wq
KM
KM
KM
KM
KM
KM
"}
(3,1,1) = {"
KM
KM
bO
NL
mt
Oa
bO
mI
JX
Wq
Wq
Hg
KA
KA
ML
RM
KA
KA
Hg
Wq
Wq
Wq
Wq
ZA
Wq
Wq
Wq
Ja
KM
KM
"}
(4,1,1) = {"
KM
bO
bO
mt
mt
bO
bO
bO
bO
Wq
Wq
Wq
Hg
Hg
KA
fd
Hg
Hg
Wq
Wq
Wq
cS
Wq
Wq
Wq
Wq
Wq
Wq
Wq
KM
"}
(5,1,1) = {"
KM
bO
mt
mt
mt
JX
Wq
Wq
Wq
Wq
gn
Wq
Wq
Wq
Wq
Wq
Wq
Wq
Wq
Wq
bt
Wq
gn
Wq
Xe
pp
Wq
cr
Wq
KM
"}
(6,1,1) = {"
KM
bO
rD
on
rD
bO
Wq
cC
Wq
bt
Wq
ZI
Xr
ZI
ZI
ZI
Wq
Wq
Wq
Wq
Wq
Wq
Wq
Wq
Wq
Xd
Wq
Px
Wq
KM
"}
(7,1,1) = {"
KM
bO
bO
wf
bO
bO
Wq
Wq
Wq
ZI
ZI
ZI
ZI
ZI
ZI
ZI
ZI
ZI
ZI
Wq
Wq
Wq
gn
xK
Te
pY
iJ
Pd
Wq
KM
"}
(8,1,1) = {"
KM
ZA
Wq
Wq
Wq
Wq
ZI
Zz
ZI
ZI
ZI
ZI
ZI
ZI
ZI
ZI
ZI
Xr
ZI
ZI
Wq
Wq
Wq
Wq
Ww
VX
Wq
Px
Wq
KM
"}
(9,1,1) = {"
Wq
Wq
Wq
Wq
ZI
ZI
ZI
ZI
ZI
ZI
qq
ZI
ZI
ZI
fC
Zz
ZI
ZI
ZI
ZI
Zz
ZI
Vn
Vn
RV
Wq
Vx
Wq
Wq
KM
"}
(10,1,1) = {"
Wq
cS
Wq
ZI
ZI
ZI
ZI
ZI
RK
ZI
ZI
ZI
Xr
ZI
ZI
ZI
ZI
Xr
ZI
ZI
ZI
Xr
Vn
Vn
Wq
Wq
Wq
gn
Wq
KM
"}
(11,1,1) = {"
Ja
Wq
Wq
ZI
ZI
ZI
Zz
ZI
ZI
ZI
ZI
ZI
ZI
ZI
ZI
ZI
ZI
ZI
ZI
ZI
ZI
ZI
Wq
Wq
cC
Gh
lD
lD
Om
Wq
"}
(12,1,1) = {"
Wq
Wq
gn
Zz
ZI
ZI
ZI
ZI
ZI
ZI
Xr
ZI
ZI
uw
US
US
ZI
ZI
Zz
ZI
ZI
ZI
Wq
Wq
Wq
TW
FW
cS
TW
Wq
"}
(13,1,1) = {"
Wq
Wq
ZI
ZI
ZI
ZI
fC
ZI
Ap
ZI
ZI
ZI
ZI
US
US
US
US
ZI
ZI
pv
IV
ZI
Wq
Wq
Wq
TW
Wq
FW
TW
pU
"}
(14,1,1) = {"
ZA
Wq
ZI
ZI
ZI
ZI
ZI
ZI
Tr
SS
ZI
ZI
US
US
US
US
US
ZI
ZI
Xh
nl
pv
ZI
Wq
Wq
TW
qG
Wq
ns
Wq
"}
(15,1,1) = {"
cS
Wq
Zz
ZI
ZI
Xr
ZI
ZI
ZI
ZI
ZI
ZI
US
US
US
US
US
ZI
ZI
xT
pv
IV
ZI
nB
Wq
TW
Wq
cC
TW
Wq
"}
(16,1,1) = {"
Wq
Wq
ZI
ZI
ZI
ZI
ZI
ZI
ug
Nl
ZI
US
US
US
Li
US
US
US
ZI
Xo
xT
ZI
ZI
Xr
Wq
TW
FW
kd
EB
ZA
"}
(17,1,1) = {"
Wq
Wq
Zz
ZI
ZI
fC
ZI
Ld
ZI
ZI
ZI
US
US
US
Li
Li
US
US
ZI
ZI
ZI
lr
ZI
ZI
Wq
hQ
lD
lD
dH
Wq
"}
(18,1,1) = {"
Wq
ZI
ZI
ZI
ZI
ZI
ZI
vG
TZ
ZI
ZI
US
US
Li
Li
Li
US
US
ZI
Xr
EC
ZI
ZI
ZI
gn
Wq
Wq
Wq
Wq
Wq
"}
(19,1,1) = {"
Xr
ZI
ZI
ZI
Zz
ZI
ZI
lr
ZI
ZI
ZI
US
US
Li
Li
Li
US
US
ZI
ZI
ZI
ZI
EC
ZI
Wq
bt
Wq
Wq
Wq
Wq
"}
(20,1,1) = {"
ZI
ZI
fC
ZI
Xr
ZI
ZI
ZI
ZI
ZI
ZI
US
US
Li
NG
Li
US
US
ZI
ZI
ZI
ZI
ZI
ZI
Wq
Wq
Wq
Wq
Wq
Wq
"}
(21,1,1) = {"
ZI
ZI
ZI
qq
ZI
ZI
ZI
gv
ZI
ZI
ZI
US
US
Li
Li
Li
US
US
ZI
ZI
hh
hh
hh
ZI
Wq
Wq
Ja
Wq
cS
Wq
"}
(22,1,1) = {"
KM
ZI
ZI
ZI
ZI
ZI
ZI
ta
aW
ZI
ZI
US
US
US
Li
Li
US
US
ZI
ZI
ZI
ZI
ZI
ZI
Qf
Qf
Qf
Qf
Qf
KM
"}
(23,1,1) = {"
KM
Zz
ZI
ZI
ZI
ZI
Xr
ZI
ZI
ZI
Zz
ZI
US
US
Li
US
US
US
ZI
ZI
EC
ZI
ZI
ZI
Qf
AV
pN
Yq
Qf
KM
"}
(24,1,1) = {"
KM
ZI
ZI
ZI
Lz
ZI
ZI
ZI
ZI
ZI
ZI
ZI
US
US
US
US
US
US
ZI
ZI
ZI
Zz
ZI
ZI
Qf
pN
pN
pN
Qf
KM
"}
(25,1,1) = {"
KM
ZI
ZI
ag
Yi
ZI
ZI
wb
qP
Fm
ZI
ZI
US
US
US
US
US
uw
ZI
ZI
ZI
ZI
ZI
ZI
Qf
Dx
kV
VG
Qf
KM
"}
(26,1,1) = {"
KM
ZI
ZI
FV
fj
ZI
ZI
CR
Xz
Nz
ZI
ZI
uw
US
US
US
ZI
ZI
ZI
fC
qq
ZI
ZI
Wq
Qf
Qf
Qf
Qf
Qf
KM
"}
(27,1,1) = {"
KM
ZI
ZI
ZI
Xr
ZI
ZI
ZI
ZI
ZI
ZI
ZI
ZI
ZI
ZI
ZI
ZI
Xr
ZI
ZI
ZI
ZI
ZI
Wq
cC
Wq
Wq
Wq
KM
KM
"}
(28,1,1) = {"
KM
KM
ZI
ZI
ZI
ZI
ZI
ZI
Xr
ZI
ZI
ZI
ZI
Xr
ZI
ZI
ZI
ZI
ZI
ZI
ZI
ZI
Wq
Wq
Wq
Wq
Wq
ZA
KM
KM
"}
(29,1,1) = {"
KM
KM
KM
KM
KM
ZI
Zz
ZI
ZI
ZI
ZI
ZI
ZI
ZI
ZI
ZI
ZI
Zz
ZI
ZI
ZI
Xr
Wq
Wq
Wq
Wq
Wq
KM
KM
KM
"}
(30,1,1) = {"
KM
KM
KM
KM
KM
KM
KM
KM
ZI
ZI
ZI
ZI
Zz
ZI
ZI
ZI
ZI
ZI
ZI
ZI
Wq
Wq
Wq
gn
KM
KM
KM
KM
KM
KM
"}
