//MAP CONVERTED BY dmm2tgm.py THIS HEADER COMMENT PREVENTS RECONVERSION, DO NOT REMOVE
"bA" = (
/obj/structure/cable{
	icon_state = "6-8"
	},
/turf/open/floor/concrete/pavement/beachplanet/lit,
/area/space)
"bJ" = (
/obj/structure/fence{
	dir = 4
	},
/turf/open/floor/plating/dirt/beach/lit,
/area/space)
"bS" = (
/obj/structure/cable{
	icon_state = "4-9"
	},
/turf/open/floor/plating/dirt/beach/lit,
/area/space)
"ci" = (
/turf/open/floor/plating/dirt/beach/lit,
/area/space)
"cx" = (
/obj/structure/cable{
	icon_state = "1-9"
	},
/turf/open/floor/concrete/pavement/beachplanet/lit,
/area/space)
"cE" = (
/obj/structure/cable{
	icon_state = "5-9"
	},
/turf/open/floor/plating/dirt/beach/lit,
/area/space)
"db" = (
/obj/effect/turf_decal/road,
/obj/structure/cable{
	icon_state = "2-5"
	},
/turf/open/floor/concrete/pavement/beachplanet/lit,
/area/space)
"de" = (
/obj/structure/fence{
	dir = 4
	},
/turf/open/floor/plating/asteroid/sand/lit,
/area/space)
"dk" = (
/turf/open/floor/plating/grass/beach,
/area/space)
"do" = (
/obj/structure/fence{
	dir = 4
	},
/turf/open/floor/plating/grass/beach/lit,
/area/space)
"dF" = (
/obj/structure/fence{
	dir = 1
	},
/turf/open/floor/plating/dirt/beach/lit,
/area/space)
"ei" = (
/obj/effect/turf_decal/road,
/obj/structure/cable{
	icon_state = "4-5"
	},
/turf/open/floor/concrete/pavement/beachplanet/lit,
/area/space)
"eo" = (
/obj/structure/cable{
	icon_state = "4-9"
	},
/turf/open/floor/plating/asteroid/sand/lit,
/area/space)
"ez" = (
/turf/closed/wall/concrete,
/area/space)
"fc" = (
/obj/structure/chair/plastic{
	dir = 2
	},
/turf/open/floor/plating/dirt/beach/lit,
/area/space)
"fZ" = (
/obj/structure/cable{
	icon_state = "0-10"
	},
/turf/open/floor/concrete/slab_1,
/area/space)
"gS" = (
/obj/structure/cable{
	icon_state = "2-10"
	},
/turf/open/floor/plating/grass/beach/lit,
/area/space)
"hM" = (
/obj/effect/turf_decal/road{
	dir = 1
	},
/obj/structure/cable{
	icon_state = "5-10"
	},
/turf/open/floor/concrete/pavement/beachplanet/lit,
/area/space)
"ik" = (
/obj/item/pickaxe/improvised{
	pixel_x = 6;
	pixel_y = -7
	},
/turf/open/floor/plating/dirt/beach,
/area/space)
"ix" = (
/mob/living/simple_animal/hostile/human/frontier/ranged/mosin{
	environment_smash = 0;
	wander = 0
	},
/turf/open/floor/plating/grass/beach/lit,
/area/space)
"ja" = (
/obj/structure/cable{
	icon_state = "4-10"
	},
/turf/open/floor/concrete/pavement/beachplanet/lit,
/area/space)
"je" = (
/obj/structure/cable{
	icon_state = "5-9"
	},
/turf/open/floor/concrete/pavement/beachplanet/lit,
/area/space)
"jQ" = (
/obj/structure/table,
/obj/item/binoculars{
	pixel_y = 7;
	pixel_x = -6
	},
/obj/item/attachment/scope{
	pixel_y = 8;
	pixel_x = 9
	},
/obj/item/ammo_box/magazine/illestren_a850r{
	pixel_y = -5;
	pixel_x = -8
	},
/obj/item/ammo_box/magazine/illestren_a850r{
	pixel_y = -5
	},
/obj/item/ammo_box/magazine/illestren_a850r{
	pixel_y = -5;
	pixel_x = 8
	},
/turf/open/floor/plating/dirt/beach/lit,
/area/space)
"jS" = (
/turf/closed/wall/concrete/reinforced,
/area/space)
"kl" = (
/obj/effect/turf_decal/road/stripes{
	dir = 4
	},
/obj/structure/cable{
	icon_state = "5-9"
	},
/turf/open/floor/concrete/pavement/beachplanet/lit,
/area/space)
"ky" = (
/obj/structure/cable{
	icon_state = "6-8"
	},
/turf/open/floor/plating/grass/beach/lit,
/area/space)
"kL" = (
/turf/open/floor/concrete/tiles,
/area/space)
"lC" = (
/obj/structure/cable{
	icon_state = "4-5"
	},
/turf/open/floor/concrete/slab_2,
/area/space)
"lY" = (
/obj/structure/barricade/sandbags,
/turf/open/floor/plating/asteroid/sand/lit,
/area/space)
"mn" = (
/turf/open/floor/plasteel,
/area/space)
"mC" = (
/obj/structure/cable{
	icon_state = "9-10"
	},
/obj/structure/cable{
	icon_state = "4-10"
	},
/turf/open/floor/concrete/pavement/beachplanet/lit,
/area/space)
"mY" = (
/obj/effect/turf_decal/road,
/obj/structure/cable{
	icon_state = "5-10"
	},
/turf/open/floor/concrete/pavement/beachplanet/lit,
/area/space)
"nf" = (
/obj/structure/cable{
	icon_state = "9-10"
	},
/turf/open/floor/plating/dirt/beach/lit,
/area/space)
"ni" = (
/obj/effect/turf_decal/road,
/obj/structure/cable{
	icon_state = "1-2"
	},
/turf/open/floor/concrete/pavement/beachplanet/lit,
/area/space)
"nr" = (
/turf/closed/mineral/random/beach,
/area/space)
"os" = (
/obj/structure/cable{
	icon_state = "0-9"
	},
/turf/open/floor/concrete/slab_1,
/area/space)
"oR" = (
/obj/effect/turf_decal/road{
	dir = 1
	},
/obj/structure/cable{
	icon_state = "2-9"
	},
/turf/open/floor/concrete/pavement/beachplanet/lit,
/area/space)
"pE" = (
/mob/living/simple_animal/hostile/human/frontier/ranged/mosin{
	environment_smash = 0;
	wander = 0
	},
/turf/open/floor/plating/dirt/beach/lit,
/area/space)
"pM" = (
/obj/structure/cable{
	icon_state = "5-8"
	},
/turf/open/floor/concrete/slab_2,
/area/space)
"pT" = (
/obj/structure/crate_shelf,
/turf/open/floor/concrete/reinforced,
/area/space)
"ql" = (
/obj/effect/turf_decal/solarpanel,
/obj/machinery/power/solar,
/obj/structure/cable{
	icon_state = "0-2"
	},
/turf/open/floor/plasteel,
/area/space)
"qH" = (
/obj/structure/cable{
	icon_state = "6-10"
	},
/turf/open/floor/concrete/slab_1,
/area/space)
"qN" = (
/obj/structure/cable{
	icon_state = "1-8"
	},
/obj/structure/cable{
	icon_state = "4-8"
	},
/obj/structure/catwalk/over/plated_catwalk,
/turf/open/floor/plating/dirt/beach/lit,
/area/space)
"rh" = (
/obj/structure/cable{
	icon_state = "4-8"
	},
/turf/open/floor/concrete/pavement/beachplanet/lit,
/area/space)
"rE" = (
/turf/open/floor/concrete,
/area/space)
"rG" = (
/obj/effect/turf_decal/road{
	dir = 1
	},
/obj/structure/cable{
	icon_state = "6-9"
	},
/turf/open/floor/concrete/pavement/beachplanet/lit,
/area/space)
"rJ" = (
/obj/structure/cable{
	icon_state = "5-10"
	},
/turf/open/floor/plating/grass/beach/lit,
/area/space)
"rK" = (
/obj/structure/cable{
	icon_state = "1-2"
	},
/turf/open/floor/concrete/slab_1,
/area/space)
"sT" = (
/obj/effect/turf_decal/road{
	dir = 1
	},
/turf/open/floor/concrete/pavement/beachplanet/lit,
/area/space)
"tc" = (
/obj/structure/cable{
	icon_state = "4-9"
	},
/turf/open/floor/concrete/pavement/beachplanet/lit,
/area/space)
"tH" = (
/obj/structure/cable{
	icon_state = "4-5"
	},
/obj/structure/cable{
	icon_state = "8-9"
	},
/turf/open/floor/plating/dirt/beach/lit,
/area/space)
"tR" = (
/obj/structure/cable{
	icon_state = "6-9"
	},
/turf/open/floor/plating/grass/beach/lit,
/area/space)
"tV" = (
/obj/structure/cable{
	icon_state = "1-4"
	},
/turf/open/floor/plating/dirt/beach/lit,
/area/space)
"uO" = (
/obj/structure/cable{
	icon_state = "6-9"
	},
/turf/open/floor/concrete/pavement/beachplanet/lit,
/area/space)
"uT" = (
/obj/effect/turf_decal/road,
/obj/structure/cable{
	icon_state = "1-4"
	},
/turf/open/floor/concrete/pavement/beachplanet/lit,
/area/space)
"vp" = (
/obj/structure/cable{
	icon_state = "1-8"
	},
/obj/structure/catwalk/over/plated_catwalk,
/turf/open/floor/plating/dirt/beach/lit,
/area/space)
"vN" = (
/obj/effect/turf_decal/road/slow{
	dir = 4
	},
/turf/open/floor/concrete/pavement/beachplanet/lit,
/area/space)
"vX" = (
/obj/structure/cable{
	icon_state = "6-10"
	},
/turf/open/floor/plating/dirt/beach/lit,
/area/space)
"wk" = (
/obj/effect/turf_decal/road/stripes{
	dir = 4
	},
/turf/open/floor/concrete/pavement/beachplanet/lit,
/area/space)
"wy" = (
/obj/machinery/power/solar_control{
	dir = 8
	},
/obj/structure/cable{
	icon_state = "0-8"
	},
/turf/open/floor/concrete/slab_1,
/area/space)
"wW" = (
/obj/effect/turf_decal/industrial/warning/full,
/turf/open/floor/concrete,
/area/space)
"xr" = (
/obj/structure/catwalk/over/plated_catwalk,
/obj/structure/cable{
	icon_state = "1-4"
	},
/obj/structure/cable{
	icon_state = "1-2"
	},
/turf/open/floor/plating/dirt/beach/lit,
/area/space)
"xF" = (
/obj/structure/cable{
	icon_state = "1-8"
	},
/obj/structure/cable{
	icon_state = "4-8"
	},
/turf/open/floor/plating/asteroid/sand/dense/lit,
/area/space)
"xZ" = (
/obj/structure/cable{
	icon_state = "1-8"
	},
/turf/open/floor/plating/asteroid/sand/dense/lit,
/area/space)
"yl" = (
/obj/effect/turf_decal/road,
/obj/structure/cable{
	icon_state = "2-4"
	},
/turf/open/floor/concrete/pavement/beachplanet/lit,
/area/space)
"yp" = (
/obj/effect/turf_decal/road{
	dir = 1
	},
/obj/structure/cable{
	icon_state = "1-10"
	},
/turf/open/floor/concrete/pavement/beachplanet/lit,
/area/space)
"yM" = (
/obj/structure/cable{
	icon_state = "5-8"
	},
/turf/open/floor/plating/asteroid/sand/lit,
/area/space)
"yX" = (
/obj/structure/cable{
	icon_state = "1-2"
	},
/obj/structure/cable{
	icon_state = "2-4"
	},
/turf/open/floor/plating/dirt/beach/lit,
/area/space)
"zK" = (
/obj/effect/turf_decal/industrial/warning{
	dir = 1
	},
/turf/open/floor/concrete,
/area/space)
"zW" = (
/turf/open/floor/plating/dirt/beach,
/area/space)
"Ax" = (
/obj/structure/cable{
	icon_state = "1-6"
	},
/obj/structure/cable{
	icon_state = "5-8"
	},
/turf/open/floor/plating/grass/beach/lit,
/area/space)
"AO" = (
/obj/structure/cable{
	icon_state = "1-10"
	},
/turf/open/floor/plating/asteroid/sand/lit,
/area/space)
"AZ" = (
/obj/structure/cable{
	icon_state = "1-6"
	},
/turf/open/floor/plating/grass/beach/lit,
/area/space)
"Bl" = (
/obj/structure/cable{
	icon_state = "4-5"
	},
/turf/open/floor/concrete/pavement/beachplanet/lit,
/area/space)
"BK" = (
/turf/open/floor/concrete/slab_1,
/area/space)
"BL" = (
/obj/structure/cable{
	icon_state = "1-8"
	},
/obj/structure/cable{
	icon_state = "6-8"
	},
/obj/structure/cable{
	icon_state = "4-6"
	},
/turf/open/floor/plating/asteroid/sand/dense/lit,
/area/space)
"Cb" = (
/obj/effect/turf_decal/road{
	dir = 1
	},
/obj/structure/cable{
	icon_state = "9-10"
	},
/turf/open/floor/concrete/pavement/beachplanet/lit,
/area/space)
"CB" = (
/obj/structure/barricade/sandbags,
/turf/open/floor/plating/dirt/beach/lit,
/area/space)
"CK" = (
/obj/structure/cable{
	icon_state = "6-9"
	},
/turf/open/floor/plating/dirt/beach/lit,
/area/space)
"CP" = (
/obj/structure/cable{
	icon_state = "5-6"
	},
/obj/structure/cable{
	icon_state = "2-4"
	},
/turf/open/floor/plating/grass/beach/lit,
/area/space)
"CR" = (
/obj/effect/turf_decal/road,
/obj/structure/cable{
	icon_state = "5-6"
	},
/turf/open/floor/concrete/pavement/beachplanet/lit,
/area/space)
"DL" = (
/obj/structure/cable{
	icon_state = "2-9"
	},
/turf/open/floor/concrete/pavement/beachplanet/lit,
/area/space)
"DN" = (
/obj/effect/turf_decal/industrial/warning,
/turf/open/floor/concrete,
/area/space)
"Er" = (
/obj/effect/turf_decal/road{
	dir = 1
	},
/obj/structure/cable{
	icon_state = "2-5"
	},
/turf/open/floor/concrete/pavement/beachplanet/lit,
/area/space)
"EC" = (
/obj/effect/turf_decal/road{
	dir = 1
	},
/obj/structure/cable{
	icon_state = "1-8"
	},
/turf/open/floor/concrete/pavement/beachplanet/lit,
/area/space)
"ER" = (
/turf/open/floor/concrete/slab_2,
/area/space)
"FW" = (
/turf/open/floor/concrete/reinforced,
/area/space)
"Gx" = (
/obj/structure/closet/secure_closet/engineering_electrical,
/turf/open/floor/concrete/slab_1,
/area/space)
"GA" = (
/obj/structure/catwalk/over/plated_catwalk,
/obj/structure/cable{
	icon_state = "1-8"
	},
/turf/open/floor/plating/dirt/beach/lit,
/area/space)
"GK" = (
/obj/effect/turf_decal/solarpanel,
/obj/machinery/power/tracker,
/obj/structure/cable{
	icon_state = "0-2"
	},
/turf/open/floor/plasteel,
/area/space)
"GS" = (
/obj/machinery/power/terminal{
	dir = 1
	},
/obj/structure/cable{
	icon_state = "0-4"
	},
/turf/open/floor/concrete/slab_1,
/area/space)
"GT" = (
/obj/vehicle/ridden/atv,
/turf/open/floor/concrete/pavement/beachplanet/lit,
/area/space)
"GU" = (
/obj/structure/catwalk/over/plated_catwalk,
/obj/structure/cable{
	icon_state = "1-2"
	},
/turf/open/floor/plating/dirt/beach/lit,
/area/space)
"GW" = (
/obj/effect/turf_decal/road/slow{
	dir = 8
	},
/obj/structure/cable{
	icon_state = "4-8"
	},
/turf/open/floor/concrete/pavement/beachplanet/lit,
/area/space)
"GX" = (
/obj/effect/turf_decal/road{
	dir = 1
	},
/obj/structure/cable{
	icon_state = "8-10"
	},
/turf/open/floor/concrete/pavement/beachplanet/lit,
/area/space)
"HF" = (
/turf/open/floor/concrete/slab_4,
/area/space)
"Ip" = (
/obj/effect/turf_decal/road,
/turf/open/floor/concrete/pavement/beachplanet/lit,
/area/space)
"Jo" = (
/obj/effect/turf_decal/road{
	dir = 1
	},
/obj/structure/cable{
	icon_state = "1-8"
	},
/obj/structure/cable{
	icon_state = "8-10"
	},
/turf/open/floor/concrete/pavement/beachplanet/lit,
/area/space)
"Jq" = (
/obj/effect/turf_decal/road{
	dir = 1
	},
/obj/structure/cable{
	icon_state = "1-2"
	},
/turf/open/floor/concrete/pavement/beachplanet/lit,
/area/space)
"Ju" = (
/obj/structure/cable{
	icon_state = "2-10"
	},
/turf/open/floor/concrete/pavement/beachplanet/lit,
/area/space)
"JX" = (
/obj/effect/turf_decal/road{
	dir = 1
	},
/obj/structure/cable{
	icon_state = "1-6"
	},
/obj/structure/cable{
	icon_state = "1-10"
	},
/obj/structure/cable{
	icon_state = "6-10"
	},
/turf/open/floor/concrete/pavement/beachplanet/lit,
/area/space)
"Kx" = (
/obj/structure/fluff/beach_umbrella{
	pixel_x = 7;
	pixel_y = -18
	},
/turf/open/floor/plating/dirt/beach,
/area/space)
"KH" = (
/obj/structure/fence,
/turf/open/floor/plating/dirt/beach/lit,
/area/space)
"KN" = (
/obj/structure/cable{
	icon_state = "4-6"
	},
/turf/open/floor/concrete/pavement/beachplanet/lit,
/area/space)
"KV" = (
/obj/effect/turf_decal/road{
	dir = 1
	},
/obj/structure/cable{
	icon_state = "2-8"
	},
/turf/open/floor/concrete/pavement/beachplanet/lit,
/area/space)
"Lr" = (
/mob/living/simple_animal/hostile/human/frontier/ranged/mosin{
	environment_smash = 0;
	wander = 0;
	stop_automated_movement = 1
	},
/obj/structure/chair/plastic{
	dir = 2
	},
/turf/open/floor/plating/dirt/beach/lit,
/area/space)
"LP" = (
/mob/living/simple_animal/hostile/human/frontier/ranged/trooper/rifle{
	wander = 0;
	environment_smash = 0
	},
/turf/open/floor/concrete/pavement/beachplanet/lit,
/area/space)
"LS" = (
/obj/structure/cable{
	icon_state = "5-8"
	},
/turf/open/floor/concrete/pavement/beachplanet/lit,
/area/space)
"Mk" = (
/obj/effect/turf_decal/road{
	dir = 1
	},
/obj/structure/cable{
	icon_state = "1-6"
	},
/turf/open/floor/concrete/pavement/beachplanet/lit,
/area/space)
"MF" = (
/obj/structure/cable{
	icon_state = "5-9"
	},
/mob/living/simple_animal/hostile/human/frontier/ranged,
/turf/open/floor/concrete/pavement/beachplanet/lit,
/area/space)
"Ns" = (
/turf/open/floor/plating/asteroid/sand/dense/lit,
/area/space)
"OE" = (
/obj/structure/cable{
	icon_state = "6-8"
	},
/turf/open/floor/concrete/slab_2,
/area/space)
"OU" = (
/obj/structure/rack,
/turf/open/floor/concrete/reinforced,
/area/space)
"Pu" = (
/obj/structure/cable{
	icon_state = "1-4"
	},
/turf/open/floor/concrete/pavement/beachplanet/lit,
/area/space)
"PM" = (
/obj/structure/fence,
/turf/open/floor/plating/asteroid/sand/lit,
/area/space)
"Qd" = (
/obj/structure/cable{
	icon_state = "4-10"
	},
/turf/open/floor/plating/dirt/beach/lit,
/area/space)
"Qm" = (
/obj/effect/turf_decal/road,
/obj/structure/cable{
	icon_state = "4-6"
	},
/turf/open/floor/concrete/pavement/beachplanet/lit,
/area/space)
"QN" = (
/obj/machinery/power/smes/engineering,
/obj/structure/cable,
/turf/open/floor/concrete/slab_1,
/area/space)
"QX" = (
/obj/effect/turf_decal/industrial/warning{
	dir = 4
	},
/turf/open/floor/concrete,
/area/space)
"RH" = (
/obj/effect/turf_decal/road,
/obj/structure/cable{
	icon_state = "1-6"
	},
/turf/open/floor/concrete/pavement/beachplanet/lit,
/area/space)
"RW" = (
/obj/structure/cable{
	icon_state = "8-9"
	},
/turf/open/floor/plating/dirt/beach/lit,
/area/space)
"SX" = (
/obj/effect/turf_decal/industrial/warning{
	dir = 8
	},
/turf/open/floor/concrete,
/area/space)
"TV" = (
/obj/effect/turf_decal/road/stripes{
	dir = 8
	},
/turf/open/floor/concrete/pavement/beachplanet/lit,
/area/space)
"Ur" = (
/obj/structure/cable{
	icon_state = "5-8"
	},
/turf/open/floor/plating/dirt/beach/lit,
/area/space)
"UT" = (
/turf/open/floor/plating/asteroid/sand/lit,
/area/space)
"Vi" = (
/turf/open/floor/plating/grass/beach/lit,
/area/space)
"Vr" = (
/turf/open/space/basic,
/area/space)
"Wr" = (
/turf/open/floor/concrete/pavement/beachplanet/lit,
/area/space)
"WO" = (
/obj/structure/cable{
	icon_state = "2-5"
	},
/obj/structure/cable{
	icon_state = "2-6"
	},
/turf/open/floor/plating/grass/beach/lit,
/area/space)
"WZ" = (
/obj/structure/cable{
	icon_state = "6-10"
	},
/turf/open/floor/concrete/pavement/beachplanet/lit,
/area/space)
"Xn" = (
/obj/effect/turf_decal/road,
/obj/structure/cable{
	icon_state = "4-8"
	},
/turf/open/floor/concrete/pavement/beachplanet/lit,
/area/space)
"Xt" = (
/obj/effect/turf_decal/road{
	dir = 1
	},
/obj/structure/cable{
	icon_state = "8-9"
	},
/turf/open/floor/concrete/pavement/beachplanet/lit,
/area/space)
"Xu" = (
/obj/structure/cable{
	icon_state = "2-9"
	},
/turf/open/floor/plating/dirt/beach/lit,
/area/space)
"Zr" = (
/obj/structure/fence,
/turf/open/floor/plating/asteroid/sand/dense/lit,
/area/space)

(1,1,1) = {"
Vr
Vr
Vr
jS
rE
Vr
FW
kL
mn
Vr
Vr
Vr
Vr
Vr
Vr
Vr
Vr
Vr
Vr
Vr
nr
nr
nr
Vr
Vr
Vr
Vr
Vr
Vr
Vr
Vr
Vr
Vr
Vr
Vr
Vr
Vr
Vr
Vr
Vr
UT
UT
UT
Vr
Vr
Vr
Vr
Vr
Vr
Vr
Vr
Vr
Vr
"}
(2,1,1) = {"
Vr
Vr
Vr
Vr
Vr
Vr
Vr
Vr
Vr
Vr
Vr
Vr
Vr
Vr
Vr
Vr
Vr
Vr
nr
nr
nr
nr
nr
nr
Vr
Vr
Vr
Vr
Vr
Vr
Vr
Vr
Vr
Vr
Vr
Vr
Vr
Vr
Vr
UT
UT
UT
UT
UT
Vr
Vr
Vr
Vr
Vr
Vr
Vr
Vr
Vr
"}
(3,1,1) = {"
Vr
Vr
Vr
Vr
Vr
Vr
Vr
Vr
Vr
Vr
Vr
Vr
Vr
Vr
Vr
Vr
Vr
nr
nr
nr
nr
nr
nr
nr
nr
nr
Vr
Vr
Vr
Vr
Vr
Vr
Vr
Vr
Vr
Vr
nr
nr
nr
nr
UT
UT
UT
UT
UT
Vr
Vr
Vr
Vr
Vr
Vr
Vr
Vr
"}
(4,1,1) = {"
Vr
Vr
Vr
Vr
Vr
Vr
Vr
Vr
Vr
Vr
Vr
Vr
Vr
Vr
Vr
Vr
nr
nr
nr
nr
nr
nr
nr
nr
nr
nr
nr
Vr
Vr
Vr
Vr
Vr
Vr
Vr
Vr
nr
nr
nr
nr
nr
CB
CB
UT
UT
UT
UT
Vr
Vr
Vr
Vr
Vr
Vr
Vr
"}
(5,1,1) = {"
Vr
Vr
Vr
Vr
Vr
Vr
Vr
Vr
Vr
Vr
Vr
Vr
Vr
Vr
nr
nr
nr
nr
nr
nr
nr
nr
nr
nr
nr
nr
nr
nr
nr
nr
nr
nr
nr
nr
nr
nr
nr
nr
zW
zW
pE
CB
lY
UT
UT
UT
Vr
Vr
Vr
Vr
Vr
Vr
Vr
"}
(6,1,1) = {"
Vr
Vr
Vr
Vr
Vr
Vr
Vr
Vr
Vr
Vr
Vr
Vr
nr
nr
nr
nr
nr
nr
nr
nr
nr
nr
nr
nr
nr
nr
nr
nr
nr
nr
nr
nr
nr
nr
nr
nr
nr
zW
zW
zW
zW
ci
CB
nr
UT
UT
UT
UT
UT
Vr
Vr
Vr
Vr
"}
(7,1,1) = {"
Vr
Vr
Vr
Vr
Vr
Vr
Vr
Vr
Vr
Vr
nr
nr
nr
nr
nr
nr
ez
ez
ez
ez
ez
nr
nr
nr
nr
nr
nr
nr
nr
nr
nr
nr
nr
nr
nr
nr
nr
nr
zW
zW
zW
zW
zW
nr
nr
nr
UT
UT
UT
UT
Vr
Vr
Vr
"}
(8,1,1) = {"
Vr
Vr
Vr
Vr
Vr
Vr
Vr
Vr
nr
nr
nr
nr
nr
nr
nr
ez
ez
pT
pT
pT
ez
ez
zW
zW
nr
nr
nr
nr
nr
nr
nr
nr
nr
zW
zW
zW
nr
nr
nr
zW
zW
nr
nr
nr
nr
nr
nr
UT
UT
UT
UT
Vr
Vr
"}
(9,1,1) = {"
Vr
Vr
Vr
Vr
Vr
Vr
nr
nr
nr
nr
nr
nr
nr
nr
zW
ez
OU
BK
BK
BK
OU
ez
zW
zW
zW
nr
nr
nr
nr
nr
nr
zW
zW
zW
zW
zW
nr
nr
nr
zW
zW
nr
nr
nr
nr
nr
nr
nr
UT
UT
UT
Vr
Vr
"}
(10,1,1) = {"
Vr
Vr
Vr
Vr
Vr
nr
nr
nr
nr
nr
nr
nr
nr
zW
zW
ez
OU
BK
lC
BK
OU
ez
zW
zW
zW
zW
nr
nr
nr
nr
nr
nr
zW
zW
zW
zW
zW
zW
ik
zW
zW
zW
zW
nr
nr
nr
nr
nr
nr
UT
UT
Vr
Vr
"}
(11,1,1) = {"
Vr
Vr
Vr
Vr
nr
nr
nr
nr
nr
nr
nr
nr
zW
zW
zW
ez
ez
fZ
pM
BK
ez
ez
zW
zW
zW
zW
nr
nr
nr
nr
nr
nr
zW
zW
zW
zW
zW
zW
zW
zW
zW
zW
zW
zW
zW
zW
ci
CB
CB
UT
UT
UT
Vr
"}
(12,1,1) = {"
Vr
Vr
Vr
Vr
nr
nr
nr
nr
nr
nr
nr
nr
zW
zW
ci
ci
ez
qH
ER
BK
ez
ci
ci
zW
zW
zW
zW
nr
nr
nr
nr
nr
nr
zW
zW
zW
zW
zW
zW
ci
ci
ci
zW
zW
zW
zW
Kx
Lr
CB
UT
UT
UT
Vr
"}
(13,1,1) = {"
Vr
Vr
Vr
nr
nr
nr
nr
nr
nr
nr
nr
nr
zW
ci
ci
ci
ci
Wr
tc
Wr
ci
ci
ci
ez
ez
ez
ez
ez
ez
ez
ez
ez
nr
nr
nr
zW
zW
ci
ci
ci
ci
ci
ci
ci
zW
zW
zW
jQ
CB
UT
UT
UT
Vr
"}
(14,1,1) = {"
Vr
Vr
nr
nr
nr
nr
nr
nr
nr
nr
ez
ez
ez
ez
ci
ci
ci
Wr
bA
Wr
ci
ci
ez
ez
OU
OU
ez
ez
GT
Wr
Wr
ez
nr
nr
nr
zW
ci
ci
Vi
Vi
Vi
Vi
Vi
ci
ci
zW
zW
fc
CB
UT
UT
Vr
Vr
"}
(15,1,1) = {"
Vr
Vr
nr
nr
nr
nr
nr
nr
nr
ez
ez
OU
OU
ez
ez
ci
ci
Wr
Wr
MF
ci
Wr
HF
HF
HF
HF
OU
ez
Wr
Wr
Wr
ez
nr
nr
nr
ci
ci
Vi
Vi
Vi
Vi
Vi
Vi
Vi
ci
ci
zW
CB
CB
UT
UT
Vr
Vr
"}
(16,1,1) = {"
Vr
Vr
nr
nr
nr
nr
nr
nr
nr
ez
OU
HF
HF
HF
HF
Wr
ci
Wr
Ju
Pu
Wr
Wr
HF
HF
HF
HF
OU
ez
GT
Wr
Wr
ez
nr
nr
nr
Vi
Vi
Vi
Vi
Vi
Vi
Vi
Vi
Vi
Vi
ci
nr
nr
nr
nr
UT
Vr
Vr
"}
(17,1,1) = {"
Vr
Vr
nr
nr
nr
nr
nr
nr
nr
ez
OU
HF
HF
HF
HF
Wr
Wr
Wr
Wr
LS
ci
ci
ez
ez
OU
OU
ez
ez
ez
Wr
Wr
ez
nr
nr
nr
Vi
Vi
Vi
Vi
Vi
Vi
ci
Vi
Vi
Vi
Vi
nr
nr
nr
nr
Vr
Vr
Vr
"}
(18,1,1) = {"
Vr
nr
nr
nr
nr
nr
nr
nr
nr
ez
ez
OU
OU
ez
ez
ci
ci
ci
ja
Wr
ci
ci
ci
ez
ez
ez
ez
ci
ci
Wr
Wr
ci
ci
jS
Vi
Vi
Vi
Vi
Vi
Vi
ci
ci
Vi
Vi
Vi
Vi
Vi
nr
nr
jS
Vr
Vr
Vr
"}
(19,1,1) = {"
Vr
nr
nr
nr
nr
nr
nr
nr
nr
nr
ez
ez
ez
ez
Vi
ci
ci
ci
rh
Wr
ci
ci
ci
Vi
Vi
Vi
bJ
ci
ci
Wr
Wr
ci
ci
do
Vi
Vi
Vi
Vi
ci
ci
ci
ci
ci
ci
Vi
Vi
Vi
ci
ci
bJ
Vr
Vr
Vr
"}
(20,1,1) = {"
Vr
nr
nr
ez
ez
ez
ez
ez
ez
ci
ci
ci
Vi
Vi
Vi
Vi
ci
ci
LS
Wr
ci
ci
Vi
Vi
Vi
Vi
bJ
ci
ci
Wr
Wr
ci
Vi
do
Vi
Vi
Vi
Vi
ci
wW
QX
QX
ci
ci
QX
QX
wW
ci
ci
bJ
Vr
Vr
Vr
"}
(21,1,1) = {"
nr
nr
nr
ez
Vr
Vr
Vr
Vr
ez
ci
ci
ci
ci
ci
Vi
Vi
ci
WZ
Wr
Wr
ci
ci
Vi
Vi
Vi
Vi
bJ
ci
Vi
Wr
Wr
ci
Vi
do
Vi
Vi
Vi
ci
ci
DN
rE
rE
rE
rE
rE
rE
zK
ci
ci
bJ
Vr
Vr
Vr
"}
(22,1,1) = {"
nr
nr
nr
ez
Vr
Vr
Vr
Vr
ez
ci
ci
ci
ci
ci
ci
Vi
ci
Wr
uO
Wr
ci
ci
ci
Vi
Vi
ci
bJ
ci
Vi
Wr
Wr
ci
Vi
do
Vi
Vi
ci
ci
ci
DN
rE
rE
rE
rE
rE
rE
zK
ci
ci
bJ
Vr
Vr
Vr
"}
(23,1,1) = {"
nr
nr
nr
ez
Vr
Vr
Vr
Vr
ez
ez
dF
dF
dF
dF
dF
dF
jS
wk
vN
kl
jS
dF
dF
dF
dF
dF
jS
ci
ci
Wr
Wr
ci
ci
jS
ci
ci
ci
ci
ci
DN
rE
rE
rE
rE
rE
rE
ci
ci
ci
bJ
Vr
Vr
Vr
"}
(24,1,1) = {"
nr
nr
nr
ez
Vr
Vr
Vr
Vr
ez
Wr
Wr
Wr
Wr
Wr
Wr
Wr
Wr
Wr
ja
Wr
Wr
Wr
Wr
Wr
Wr
Wr
ci
ci
Wr
Wr
Wr
Wr
Wr
Wr
Wr
Wr
Wr
Bl
Wr
DN
rE
rE
rE
rE
rE
rE
ci
ci
ci
bJ
Vr
Vr
Vr
"}
(25,1,1) = {"
nr
nr
nr
ez
Vr
Vr
Vr
Vr
BK
Qm
yl
ni
RH
Ip
Ip
Ip
Ip
Ip
Xn
CR
Ip
db
RH
Ip
Ip
CR
Ip
CR
Ip
Ip
Ip
ei
Ip
db
ni
uT
mY
Xn
db
DN
rE
rE
rE
rE
rE
rE
ci
ci
ci
bJ
Vr
Vr
Vr
"}
(26,1,1) = {"
nr
nr
nr
ez
Vr
Vr
Vr
Vr
BK
EC
Xt
sT
sT
oR
Mk
sT
Er
Jq
Jo
sT
Cb
sT
sT
oR
JX
sT
Cb
sT
rG
sT
hM
KV
yp
sT
sT
GX
sT
GX
sT
DN
rE
rE
rE
rE
rE
rE
ci
ci
ci
bJ
Vr
Vr
Vr
"}
(27,1,1) = {"
nr
nr
nr
ez
Vr
Vr
Vr
Vr
ez
Wr
Wr
Wr
Wr
Wr
Wr
mC
Wr
Wr
Wr
Wr
Wr
Wr
Wr
Wr
ci
CK
ci
Wr
Wr
nf
ci
Wr
Wr
Wr
ci
ci
Wr
Wr
Wr
DN
rE
rE
rE
rE
rE
rE
ci
ci
ci
bJ
Vr
Vr
Vr
"}
(28,1,1) = {"
nr
nr
nr
ez
Vr
Vr
Vr
Vr
ez
ez
dF
dF
dF
jS
TV
GW
TV
jS
dF
dF
dF
jS
ci
ci
ci
ci
Xu
tV
ci
ci
ci
ci
ci
jS
ci
ci
Wr
LP
ci
ci
rE
rE
rE
rE
rE
rE
zK
ci
ci
bJ
Vr
Vr
Vr
"}
(29,1,1) = {"
nr
nr
nr
ez
Vr
Vr
Vr
Vr
ez
ci
ci
dk
ci
ci
Wr
LS
Wr
ci
dk
ci
ci
bJ
ci
ci
Vi
Vi
Vi
Ur
Vi
Vi
ci
ci
ci
do
Vi
Wr
Wr
Wr
ci
ci
rE
rE
rE
rE
rE
rE
zK
ci
ci
bJ
Vr
Vr
Vr
"}
(30,1,1) = {"
nr
nr
nr
ez
ez
Vr
Vr
Vr
ez
ci
dk
dk
dk
ci
WZ
Wr
Wr
ci
dk
dk
dk
bJ
ci
ci
ci
ci
rJ
Vi
Vi
Vi
ci
ci
Vi
do
Vi
Wr
Wr
Wr
ci
DN
rE
rE
rE
rE
rE
rE
zK
ci
ci
bJ
Vr
Vr
Vr
"}
(31,1,1) = {"
nr
nr
nr
nr
ez
Vr
Vr
Vr
ez
ci
dk
dk
dk
ci
Wr
tc
ci
ci
dk
dk
ez
ez
ez
ez
ci
vX
Vi
Vi
Vi
Vi
Vi
ci
Vi
do
Vi
Wr
Wr
Wr
ci
ci
SX
SX
ci
SX
SX
SX
wW
ci
ci
bJ
Vr
Vr
Vr
"}
(32,1,1) = {"
nr
nr
nr
ez
ez
BK
ez
ez
ez
ez
ez
dk
dk
ci
ci
rh
ci
ci
ci
ez
ez
OU
OU
ez
ez
ci
cE
ci
ci
Vi
ci
ci
Vi
do
Vi
Wr
Wr
Wr
Vi
ci
ci
ci
ci
ci
Vi
ci
ci
Vi
Vi
bJ
Vr
Vr
Vr
"}
(33,1,1) = {"
nr
nr
ez
ez
Vr
Vr
Vr
ez
ez
Vr
ez
ez
dk
ci
ci
bA
Wr
Wr
Wr
HF
HF
HF
HF
OU
ez
Qd
ci
ci
ci
ci
ci
ci
ci
do
Vi
Wr
Wr
Wr
Wr
Wr
Wr
Wr
ci
ci
Vi
Vi
Vi
Vi
Vi
bJ
Vr
Vr
Vr
"}
(34,1,1) = {"
nr
nr
ez
Vr
Vr
Vr
Vr
ez
Vr
Vr
Vr
ez
ci
ci
Wr
Wr
je
Wr
Wr
HF
HF
HF
HF
OU
ez
ky
ci
ci
ci
ci
ci
ci
ci
do
ci
ci
Wr
Wr
Wr
Wr
Wr
Wr
Wr
ci
ci
Vi
Vi
Vi
ci
bJ
Vr
Vr
Vr
"}
(35,1,1) = {"
nr
nr
ez
Vr
Vr
Vr
Vr
BK
Vr
Vr
Vr
ez
ci
ci
KN
WZ
Wr
ci
ci
ez
ez
OU
OU
ez
ez
Vi
tR
ci
ez
ez
ez
ez
ci
do
ci
ci
Wr
Wr
ci
ci
Wr
Wr
Wr
ci
Vi
Vi
ci
ci
nr
jS
nr
Vr
Vr
"}
(36,1,1) = {"
nr
nr
ez
Vr
Vr
Vr
Vr
ez
Vr
Vr
Vr
ez
ci
ci
bA
DL
cx
ci
ci
ci
ez
ez
ez
ez
Vi
Vi
Vi
Xu
rK
QN
GS
ez
ez
jS
Vi
ci
Vi
Vi
Vi
ci
Wr
Wr
Wr
ci
ci
ci
ci
nr
nr
nr
nr
nr
Vr
"}
(37,1,1) = {"
nr
nr
ez
Vr
Vr
Vr
Vr
ez
ez
Vr
ez
ez
ci
ci
Wr
tc
Wr
ci
ci
ci
ci
ci
ci
Vi
Vi
Vi
CP
yX
GU
xr
GA
ez
nr
nr
nr
ci
Vi
ci
ci
ci
Wr
Wr
Wr
ci
ci
ci
ci
nr
nr
nr
nr
nr
Vr
"}
(38,1,1) = {"
nr
nr
ez
Vr
Vr
Vr
Vr
ez
ez
ez
ez
ci
ci
ez
BK
OE
BK
ez
ci
ci
ci
ci
ci
WO
AZ
gS
Ax
tH
BK
wy
Gx
ez
nr
nr
nr
nr
jS
KH
KH
jS
Wr
Wr
Wr
jS
KH
KH
jS
nr
nr
nr
nr
nr
nr
"}
(39,1,1) = {"
nr
nr
ez
Vr
Vr
Vr
Vr
ez
zW
zW
zW
ci
ez
ez
BK
ER
os
ez
ez
ci
ci
ci
Qd
ci
bS
nf
Qd
RW
ez
ez
ez
ez
nr
nr
nr
nr
nr
ci
Vi
ci
Wr
Wr
Wr
ci
ci
ci
ci
nr
nr
nr
ci
Vr
Vr
"}
(40,1,1) = {"
nr
nr
ez
ez
ez
Vr
ez
ez
nr
zW
zW
zW
ez
OU
BK
ER
BK
OU
ez
ci
ci
ql
qN
ql
qN
ql
xF
Ns
jS
nr
nr
nr
nr
nr
nr
nr
nr
Vi
ci
ci
ci
Wr
ci
ci
Vi
Vi
Vi
Vi
Vi
ci
ci
Vr
Vr
"}
(41,1,1) = {"
nr
nr
nr
nr
ez
Vr
Vr
ez
nr
nr
zW
zW
ez
OU
BK
BK
BK
OU
ez
ci
Vi
ql
qN
ql
qN
ql
BL
Ns
de
UT
Ns
Ns
Ns
nr
nr
ci
ci
ci
ci
ci
ci
Wr
ci
ci
Vi
Vi
Vi
Vi
ci
ci
ci
Vr
Vr
"}
(42,1,1) = {"
nr
nr
nr
nr
ez
Vr
Vr
ez
nr
nr
nr
zW
ez
ez
pT
pT
pT
ez
ez
Vi
Vi
ql
qN
ql
qN
ql
xF
eo
de
UT
Ns
Ns
Ns
Ns
Ns
ci
ci
ci
Vi
ci
Wr
Wr
Wr
ci
Vi
Vi
Vi
Vi
CB
ci
ci
Vr
Vr
"}
(43,1,1) = {"
Vr
Vr
Vr
nr
ez
ez
ez
ez
nr
nr
nr
zW
nr
ez
ez
ez
ez
ez
ci
Vi
Vi
ql
qN
ql
qN
ql
xZ
yM
de
UT
UT
Ns
Ns
Ns
ci
CB
ci
Vi
Vi
ci
Wr
Wr
Wr
ci
Vi
Vi
pE
CB
CB
ci
Vr
Vr
Vr
"}
(44,1,1) = {"
Vr
Vr
Vr
Vr
Vr
nr
nr
nr
nr
nr
nr
nr
nr
nr
UT
UT
UT
UT
Vi
ci
ci
ql
vp
GK
vp
ql
AO
UT
de
UT
UT
Ns
Ns
Ns
ci
CB
CB
ix
Vi
ci
Wr
Wr
ci
ci
Vi
Vi
CB
CB
ci
ci
Vr
Vr
Vr
"}
(45,1,1) = {"
Vr
Vr
Vr
Vr
Vr
nr
nr
nr
nr
nr
nr
nr
nr
nr
UT
UT
UT
UT
ci
UT
UT
UT
Ns
Ns
Ns
Ns
UT
UT
de
UT
UT
UT
UT
UT
ci
ci
CB
CB
Vi
ci
Wr
Wr
ci
ci
Vi
Vi
Vi
Vi
ci
Vr
Vr
Vr
Vr
"}
(46,1,1) = {"
Vr
Vr
Vr
Vr
Vr
Vr
Vr
nr
nr
nr
nr
nr
nr
nr
nr
UT
UT
UT
Ns
Ns
UT
UT
UT
Ns
Ns
Ns
UT
UT
de
UT
UT
UT
UT
UT
UT
Vi
Vi
Vi
Vi
ci
Wr
Wr
Wr
ci
ci
Vi
Vi
Vi
Vr
Vr
Vr
Vr
Vr
"}
(47,1,1) = {"
Vr
Vr
Vr
Vr
Vr
Vr
Vr
Vr
Vr
Vr
Vr
Vr
nr
nr
nr
jS
Zr
Zr
Zr
Zr
Zr
jS
PM
PM
PM
PM
PM
PM
jS
UT
UT
UT
UT
UT
Vr
Vr
Vi
Vi
Vi
ci
ci
Wr
Wr
ci
ci
Vi
Vi
Vr
Vr
Vr
Vr
Vr
Vr
"}
(48,1,1) = {"
Vr
Vr
Vr
Vr
Vr
Vr
Vr
Vr
Vr
Vr
Vr
Vr
Vr
nr
nr
nr
UT
Ns
Ns
UT
UT
UT
UT
Vr
Vr
Vr
Vr
Vr
Vr
Vr
Vr
Vr
Vr
Vr
Vr
Vr
Vr
Vi
Vi
Vi
ci
Wr
ci
ci
ci
Vi
Vi
Vi
Vr
Vr
Vr
Vr
Vr
"}
(49,1,1) = {"
Vr
Vr
Vr
Vr
Vr
Vr
Vr
Vr
Vr
Vr
Vr
Vr
Vr
Vr
Vr
Vr
Vr
Vr
Vr
Vr
Vr
Vr
Vr
Vr
Vr
Vr
Vr
Vr
Vr
Vr
Vr
Vr
Vr
Vr
Vr
Vr
Vr
Vr
Vi
Vi
ci
ci
ci
ci
Vi
Vi
Vi
Vr
Vr
Vr
Vr
Vr
Vr
"}
(50,1,1) = {"
Vr
Vr
Vr
Vr
Vr
Vr
Vr
Vr
Vr
Vr
Vr
Vr
Vr
Vr
Vr
Vr
Vr
Vr
Vr
Vr
Vr
Vr
Vr
Vr
Vr
Vr
Vr
Vr
Vr
Vr
Vr
Vr
Vr
Vr
Vr
Vr
Vr
Vr
Vr
Vi
Vi
Vi
Vi
Vi
Vi
Vi
Vr
Vr
Vr
Vr
Vr
Vr
Vr
"}
