//MAP CONVERTED BY dmm2tgm.py THIS HEADER COMMENT PREVENTS RECONVERSION, DO NOT REMOVE
"a" = (
/turf/template_noop,
/area/template_noop)
"b" = (
/obj/structure/lattice/clockwork,
/turf/template_noop,
/area/template_noop)
"d" = (
/obj/structure/table/bronze,
/obj/item/radio/intercom,
/turf/open/floor/bronze,
/area/reebe/city_of_cogs)
"e" = (
/turf/open/floor/bronze,
/area/reebe/city_of_cogs)
"f" = (
/obj/item/nullrod/spear,
/turf/open/floor/bronze,
/area/reebe/city_of_cogs)
"h" = (
/obj/structure/chair/bronze{
	dir = 1
	},
/turf/open/floor/bronze,
/area/reebe/city_of_cogs)
"i" = (
/obj/structure/grille,
/obj/structure/window/bronze/fulltile,
/turf/template_noop,
/area/reebe/city_of_cogs)
"k" = (
/obj/structure/table/bronze,
/turf/open/floor/bronze,
/area/reebe/city_of_cogs)
"l" = (
/obj/machinery/computer{
	icon_keyboard = "ratvar_key1";
	name = "abandoned computer"
	},
/turf/open/floor/bronze,
/area/reebe/city_of_cogs)
"n" = (
/obj/structure/mirror/magic/lesser{
	pixel_x = 32
	},
/turf/open/floor/bronze,
/area/reebe/city_of_cogs)
"o" = (
/turf/closed/wall/mineral/bronze,
/area/reebe/city_of_cogs)
"p" = (
/obj/structure/table/bronze,
/obj/item/storage/firstaid/regular,
/turf/open/floor/bronze,
/area/reebe/city_of_cogs)
"q" = (
/obj/structure/grille,
/turf/open/floor/bronze,
/area/reebe/city_of_cogs)
"r" = (
/obj/structure/chair/bronze{
	dir = 8
	},
/turf/open/floor/bronze,
/area/reebe/city_of_cogs)
"s" = (
/obj/machinery/door/airlock/bronze/seethru{
	name = "Summoning Chamber"
	},
/turf/open/floor/bronze,
/area/reebe/city_of_cogs)
"t" = (
/obj/machinery/door/airlock/bronze/seethru{
	name = "Ark Chamber"
	},
/turf/open/floor/bronze,
/area/reebe/city_of_cogs)
"z" = (
/obj/machinery/sleeper{
	dir = 4
	},
/turf/open/floor/bronze,
/area/reebe/city_of_cogs)
"A" = (
/obj/machinery/sleeper,
/turf/open/floor/bronze,
/area/reebe/city_of_cogs)
"B" = (
/obj/structure/grille,
/obj/structure/window/bronze/fulltile,
/turf/open/floor/bronze,
/area/reebe/city_of_cogs)
"C" = (
/obj/structure/lattice/catwalk/clockwork,
/turf/open/chasm/reebe_void,
/area/reebe/city_of_cogs)
"D" = (
/obj/machinery/door/airlock/bronze/seethru,
/turf/open/floor/bronze,
/area/reebe/city_of_cogs)
"E" = (
/obj/structure/lattice/clockwork,
/obj/structure/lattice/clockwork,
/turf/template_noop,
/area/template_noop)
"F" = (
/obj/machinery/door/airlock/bronze/seethru{
	name = "Infirmary"
	},
/turf/open/floor/bronze,
/area/reebe/city_of_cogs)
"G" = (
/obj/structure/chair/bronze{
	dir = 4
	},
/turf/open/floor/bronze,
/area/reebe/city_of_cogs)
"H" = (
/obj/structure/table/bronze,
/obj/item/toy/plush/plushvar,
/turf/open/floor/bronze,
/area/reebe/city_of_cogs)
"I" = (
/turf/open/chasm/reebe_void,
/area/reebe/city_of_cogs)
"J" = (
/obj/structure/dresser,
/turf/open/floor/bronze,
/area/reebe/city_of_cogs)
"K" = (
/obj/item/spear,
/obj/item/grenade/c4,
/turf/open/floor/bronze,
/area/reebe/city_of_cogs)
"L" = (
/obj/machinery/door/airlock/bronze/seethru{
	name = "Observation Room"
	},
/turf/open/floor/bronze,
/area/reebe/city_of_cogs)
"N" = (
/obj/machinery/computer{
	dir = 8
	},
/turf/open/floor/bronze,
/area/reebe/city_of_cogs)
"Q" = (
/obj/machinery/door/airlock/bronze/seethru{
	name = "Listening Station"
	},
/turf/open/floor/bronze,
/area/reebe/city_of_cogs)
"R" = (
/obj/structure/window/bronze/fulltile,
/obj/structure/grille,
/turf/open/floor/bronze,
/area/reebe/city_of_cogs)
"T" = (
/obj/effect/decal/remains/human,
/turf/open/floor/bronze,
/area/reebe/city_of_cogs)
"U" = (
/obj/structure/chair/bronze,
/turf/open/floor/bronze,
/area/reebe/city_of_cogs)
"W" = (
/obj/machinery/computer,
/turf/open/floor/bronze,
/area/reebe/city_of_cogs)
"Y" = (
/obj/machinery/computer{
	dir = 4
	},
/turf/open/floor/bronze,
/area/reebe/city_of_cogs)
"Z" = (
/obj/structure/lattice/catwalk/clockwork,
/turf/template_noop,
/area/template_noop)

(1,1,1) = {"
a
a
a
a
a
a
a
a
a
a
a
a
a
a
a
a
a
a
a
a
B
B
B
B
B
a
a
a
a
a
a
a
a
a
a
a
a
a
a
a
a
a
a
a
a
a
a
a
a
a
a
a
a
a
a
a
a
a
a
a
"}
(2,1,1) = {"
a
a
a
a
a
a
a
a
a
a
a
a
a
a
a
a
a
a
a
B
B
e
e
e
B
i
a
a
a
a
a
a
a
a
a
a
a
a
a
a
a
a
a
a
a
a
a
a
a
a
a
a
a
a
a
a
a
a
a
a
"}
(3,1,1) = {"
a
a
a
a
a
a
a
a
a
a
a
a
a
a
a
a
a
a
B
B
e
e
e
e
e
B
B
a
a
a
a
a
a
a
a
a
a
a
a
a
a
a
a
a
a
a
a
a
a
a
a
a
a
a
a
a
a
a
a
a
"}
(4,1,1) = {"
a
a
a
a
a
a
a
a
a
a
a
a
a
a
a
a
a
b
e
e
e
e
e
e
e
e
e
b
a
a
a
a
a
a
a
a
a
a
a
a
a
a
a
a
a
a
a
a
a
a
a
a
a
a
a
a
a
a
a
a
"}
(5,1,1) = {"
a
a
a
a
a
a
a
a
Z
b
b
b
b
b
b
b
b
b
e
e
e
e
e
e
e
e
e
b
b
b
b
b
b
b
b
b
Z
a
a
a
a
a
a
a
a
a
a
a
a
a
a
a
a
a
a
a
a
a
a
a
"}
(6,1,1) = {"
a
a
a
a
a
a
a
a
a
a
a
a
a
a
a
a
a
b
e
e
e
e
e
e
e
e
e
b
a
a
a
a
a
a
a
a
a
a
a
a
a
a
a
a
a
a
a
a
a
a
a
a
a
a
a
a
a
a
a
a
"}
(7,1,1) = {"
a
a
a
a
a
a
a
a
a
a
a
a
a
a
a
a
a
a
B
B
e
e
e
e
e
B
B
a
a
a
a
a
a
a
a
a
a
a
a
a
a
a
a
a
a
a
a
a
a
a
a
a
a
a
a
a
a
a
a
a
"}
(8,1,1) = {"
a
a
a
a
a
a
a
a
a
a
a
a
a
a
a
a
a
a
a
B
B
e
e
e
B
B
a
a
a
a
a
a
a
a
a
a
a
a
a
a
a
a
a
a
a
a
a
a
a
a
a
a
a
a
a
a
a
a
a
a
"}
(9,1,1) = {"
a
a
a
a
a
a
a
a
a
a
a
a
a
a
a
a
a
a
a
a
B
R
D
R
B
a
a
a
a
a
a
a
a
a
a
a
a
a
a
a
a
a
a
a
a
a
a
a
a
a
a
a
a
a
a
a
a
a
a
a
"}
(10,1,1) = {"
a
a
a
a
a
a
a
a
a
a
a
a
a
a
a
a
a
a
a
a
B
e
e
e
B
a
a
a
a
a
a
a
a
a
a
a
a
a
a
a
a
a
a
a
a
a
a
a
a
a
a
a
a
a
a
a
a
a
a
a
"}
(11,1,1) = {"
a
a
a
a
a
a
a
a
a
a
a
a
a
a
a
a
a
a
a
a
B
e
e
e
B
a
a
a
a
a
a
a
a
a
a
a
a
a
a
a
a
a
a
a
a
a
a
a
a
a
a
a
a
a
a
a
a
a
a
a
"}
(12,1,1) = {"
a
a
a
a
a
a
a
a
a
a
a
a
a
a
a
a
a
a
a
a
B
e
e
e
B
a
a
a
a
a
a
a
a
a
a
a
a
a
a
a
a
a
a
a
a
a
a
a
a
a
a
a
a
a
a
a
a
a
a
a
"}
(13,1,1) = {"
a
a
a
a
a
a
a
a
a
a
a
a
a
a
a
a
a
a
a
a
B
e
e
e
B
a
a
a
a
a
a
a
a
a
a
a
a
a
a
a
a
a
a
a
a
a
a
a
a
a
a
a
a
a
a
a
a
a
a
a
"}
(14,1,1) = {"
a
a
a
a
a
a
a
a
a
a
a
a
a
a
a
a
a
a
a
B
B
e
e
e
B
B
B
B
B
B
a
a
a
a
a
a
a
a
a
a
a
a
a
a
a
a
a
a
a
a
a
a
a
a
a
a
a
a
a
a
"}
(15,1,1) = {"
a
a
a
a
a
a
a
a
a
a
a
a
a
a
a
a
a
a
a
B
e
e
e
e
e
e
e
e
e
B
B
B
B
a
a
a
a
a
a
a
a
a
a
a
a
a
a
a
a
a
a
a
a
a
a
a
a
a
a
a
"}
(16,1,1) = {"
a
a
a
a
a
a
a
a
a
a
a
a
a
a
a
a
a
a
a
B
e
e
e
e
e
e
e
e
e
e
e
e
B
B
B
B
a
a
a
a
a
a
a
a
a
a
a
a
a
a
a
a
a
a
a
a
a
a
a
a
"}
(17,1,1) = {"
a
a
a
a
a
a
a
a
a
a
a
a
a
a
a
a
a
a
a
o
o
o
D
o
o
o
o
e
e
e
e
e
e
e
e
B
B
B
a
a
a
a
a
a
a
a
a
a
a
a
a
a
a
a
a
a
a
a
a
a
"}
(18,1,1) = {"
a
a
a
a
a
a
a
a
a
a
a
a
a
a
a
a
a
a
a
o
e
e
e
e
e
e
o
o
o
o
e
e
e
e
e
e
e
B
B
B
a
a
a
a
a
a
a
a
a
a
a
a
a
a
a
a
a
a
a
a
"}
(19,1,1) = {"
a
a
a
a
a
a
a
a
a
a
a
a
a
a
a
a
a
a
a
o
e
e
e
e
e
e
e
e
e
o
o
o
o
e
e
e
e
e
e
B
B
a
a
a
a
a
a
a
a
a
a
a
a
a
a
a
a
a
a
a
"}
(20,1,1) = {"
a
a
a
a
a
a
a
a
a
a
a
a
a
a
a
a
a
a
a
o
e
e
e
e
e
e
e
e
e
e
e
e
o
o
o
o
e
e
e
e
B
B
a
a
a
a
a
a
a
a
a
a
a
a
a
a
a
a
a
a
"}
(21,1,1) = {"
a
a
a
a
a
a
a
a
a
a
a
a
a
a
a
a
a
a
a
o
C
C
C
C
C
C
e
e
e
e
e
e
e
e
e
o
o
e
e
e
e
B
B
a
a
a
a
a
a
a
a
a
a
a
a
a
a
a
a
a
"}
(22,1,1) = {"
a
a
a
a
a
a
a
a
a
a
a
a
a
a
a
a
a
a
a
o
e
e
e
e
e
C
C
C
C
e
e
e
e
e
e
e
o
o
e
e
e
e
B
a
a
a
a
a
a
a
a
a
a
a
a
a
a
a
a
a
"}
(23,1,1) = {"
a
a
a
a
a
a
a
a
a
a
a
a
a
a
a
a
a
a
a
B
e
e
e
e
e
e
e
e
C
C
C
C
e
e
e
e
e
o
o
e
e
e
B
B
a
a
a
a
a
a
a
a
a
a
a
a
a
a
a
a
"}
(24,1,1) = {"
a
a
a
a
a
a
a
a
a
a
a
a
a
a
a
a
a
a
a
B
e
e
e
e
e
e
e
e
e
e
e
C
C
C
e
e
e
e
o
o
e
e
e
B
a
a
a
a
a
a
a
a
a
a
a
a
a
a
a
a
"}
(25,1,1) = {"
a
a
a
a
a
a
a
a
a
a
a
a
a
a
a
a
a
a
a
B
e
e
e
e
e
e
e
e
e
e
e
e
e
C
C
e
e
e
e
o
o
e
e
B
B
a
a
a
a
a
a
a
a
a
a
a
a
a
a
a
"}
(26,1,1) = {"
a
a
a
a
a
a
a
a
a
a
a
a
a
a
a
a
a
a
a
B
e
e
e
e
e
e
e
e
e
e
e
e
e
e
C
C
e
e
e
e
o
e
e
e
B
a
a
a
a
a
a
a
a
a
a
Z
a
a
a
a
"}
(27,1,1) = {"
a
a
a
a
a
a
a
a
a
a
a
a
a
a
a
a
a
a
a
B
e
e
e
e
e
e
e
e
e
e
e
e
e
e
e
C
C
e
e
e
o
e
e
e
B
a
a
a
a
a
a
a
a
a
a
b
a
a
a
a
"}
(28,1,1) = {"
a
a
a
a
a
a
a
a
a
a
a
a
a
a
a
a
a
a
a
B
e
e
e
e
e
e
e
e
e
e
e
e
e
e
e
e
C
e
e
e
o
o
e
e
B
B
a
a
a
a
a
a
a
a
a
b
a
a
a
a
"}
(29,1,1) = {"
a
a
a
a
a
a
a
a
a
a
a
a
a
a
a
a
a
a
a
o
e
e
e
e
e
e
e
e
e
e
e
e
e
e
e
e
C
C
e
e
e
o
e
e
e
B
a
a
a
a
a
a
a
a
a
b
a
a
a
a
"}
(30,1,1) = {"
a
a
a
a
a
a
a
a
o
B
B
o
o
o
o
B
B
o
o
o
e
e
e
e
e
e
e
e
e
e
e
e
e
e
e
e
e
C
e
e
e
o
e
e
e
B
a
a
a
a
a
a
a
a
a
b
a
a
a
a
"}
(31,1,1) = {"
a
a
a
a
a
a
a
o
o
A
e
k
p
o
d
e
e
d
o
o
e
e
e
e
e
e
e
e
e
e
e
e
e
e
e
e
e
C
e
e
e
o
o
e
e
B
B
a
a
a
a
a
a
a
a
b
a
a
a
a
"}
(32,1,1) = {"
a
a
a
a
a
a
o
o
k
A
e
e
e
B
r
e
e
r
d
o
o
e
e
e
e
e
e
e
e
e
e
e
e
e
e
e
e
C
C
e
e
e
o
e
e
e
B
a
a
a
a
a
a
a
a
b
a
a
a
a
"}
(33,1,1) = {"
a
a
a
a
a
a
B
z
z
e
e
e
e
F
e
e
e
e
U
d
o
e
e
e
e
e
e
e
e
e
e
e
e
e
e
e
e
e
C
e
e
e
o
e
e
e
B
a
a
a
a
a
a
a
a
b
a
a
a
a
"}
(34,1,1) = {"
a
a
a
a
a
a
B
e
e
e
e
e
e
B
G
e
G
e
e
e
o
e
e
e
e
e
e
e
e
e
e
e
e
e
e
e
e
e
C
e
e
e
o
o
e
e
B
a
a
a
a
a
a
a
a
b
a
a
a
a
"}
(35,1,1) = {"
a
a
a
a
a
a
o
n
e
e
e
J
p
o
d
e
d
e
e
e
o
e
e
e
e
e
e
e
e
e
e
e
e
e
e
e
e
e
C
C
e
e
e
o
e
e
B
a
a
a
a
a
a
a
E
E
E
a
a
a
"}
(36,1,1) = {"
a
a
a
a
a
a
o
o
B
F
B
o
o
o
o
o
o
B
Q
B
o
e
e
e
e
e
e
e
e
e
e
e
e
e
e
e
e
e
e
C
e
e
e
o
e
e
B
a
a
a
a
a
a
B
e
e
e
B
a
a
"}
(37,1,1) = {"
o
o
e
q
B
o
o
e
e
e
e
e
e
e
e
e
o
k
e
e
e
e
e
e
e
e
e
e
e
e
e
e
e
e
e
e
e
e
e
C
e
e
e
o
e
e
B
a
a
a
a
a
B
B
e
e
e
B
B
a
"}
(38,1,1) = {"
e
e
I
I
I
e
o
e
e
f
h
e
h
e
h
e
B
k
e
e
e
e
e
e
e
e
e
e
e
e
e
e
e
e
e
e
e
e
e
C
e
e
e
o
e
e
B
B
B
B
B
B
B
e
e
e
e
e
B
B
"}
(39,1,1) = {"
B
e
I
I
T
e
B
e
k
e
h
e
h
e
h
e
B
e
e
e
e
e
e
e
e
e
e
e
e
e
e
e
e
e
e
e
e
e
e
C
e
e
e
o
e
e
e
e
e
e
e
B
e
e
e
e
e
e
e
B
"}
(40,1,1) = {"
B
I
I
I
I
e
s
e
H
e
e
e
e
e
e
e
t
e
e
e
e
e
e
e
e
e
e
e
e
e
e
e
e
e
e
e
e
e
e
C
e
e
e
D
e
e
e
e
e
e
e
D
e
e
e
e
e
e
e
B
"}
(41,1,1) = {"
q
T
I
I
I
e
B
e
e
e
h
e
h
e
h
e
B
e
e
e
e
e
e
e
e
e
e
e
e
e
e
e
e
e
e
e
e
e
e
C
e
e
e
o
e
e
e
e
e
e
e
B
e
e
e
e
e
e
e
B
"}
(42,1,1) = {"
o
e
e
K
e
e
o
e
e
e
h
e
h
e
h
e
B
k
e
e
e
e
e
e
e
e
e
e
e
e
e
e
e
e
e
e
e
e
e
C
e
e
e
o
e
e
B
B
B
B
B
B
B
e
e
e
e
e
B
B
"}
(43,1,1) = {"
e
o
q
B
B
o
o
e
e
e
e
e
e
e
e
e
o
k
e
e
e
e
e
e
e
e
e
e
e
e
e
e
e
e
e
e
e
e
e
C
e
e
e
o
e
e
B
a
a
a
a
a
B
B
e
e
e
B
B
a
"}
(44,1,1) = {"
a
a
a
a
a
a
o
o
B
L
B
o
o
o
o
o
o
B
t
B
o
e
e
e
e
e
e
e
e
e
e
e
e
e
e
e
e
e
e
C
e
e
e
o
e
e
B
a
a
a
a
a
a
B
e
e
e
B
a
a
"}
(45,1,1) = {"
a
a
a
a
a
a
o
l
h
e
e
Y
k
o
k
k
k
e
e
e
o
e
e
e
e
e
e
e
e
e
e
e
e
e
e
e
e
e
C
C
e
e
e
o
e
e
B
a
a
a
a
a
a
a
E
E
E
a
a
a
"}
(46,1,1) = {"
a
a
a
a
a
a
B
k
e
e
e
r
e
B
e
e
e
e
e
e
o
e
e
e
e
e
e
e
e
e
e
e
e
e
e
e
e
e
C
e
e
e
o
o
e
e
B
a
a
a
a
a
a
a
a
b
a
a
a
a
"}
(47,1,1) = {"
a
a
a
a
a
a
B
W
h
e
e
e
e
L
e
e
e
e
e
k
o
e
e
e
e
e
e
e
e
e
e
e
e
e
e
e
e
e
C
e
e
e
o
e
e
e
B
a
a
a
a
a
a
a
a
b
a
a
a
a
"}
(48,1,1) = {"
a
a
a
a
a
a
o
o
k
G
e
G
e
B
e
e
e
e
k
o
o
e
e
e
e
e
e
e
e
e
e
e
e
e
e
e
e
C
C
e
e
e
o
e
e
e
B
a
a
a
a
a
a
a
a
b
a
a
a
a
"}
(49,1,1) = {"
a
a
a
a
a
a
a
o
o
N
k
N
k
o
k
e
e
k
o
o
e
e
e
e
e
e
e
e
e
e
e
e
e
e
e
e
e
C
e
e
e
o
o
e
e
B
B
a
a
a
a
a
a
a
a
b
a
a
a
a
"}
(50,1,1) = {"
a
a
a
a
a
a
a
a
o
B
B
o
o
o
o
B
B
o
o
o
e
e
e
e
e
e
e
e
e
e
e
e
e
e
e
e
e
C
e
e
e
o
e
e
e
B
a
a
a
a
a
a
a
a
a
b
a
a
a
a
"}
(51,1,1) = {"
a
a
a
a
a
a
a
a
a
a
a
a
a
a
a
a
a
a
a
o
e
e
e
e
e
e
e
e
e
e
e
e
e
e
e
e
C
C
e
e
e
o
e
e
e
B
a
a
a
a
a
a
a
a
a
b
a
a
a
a
"}
(52,1,1) = {"
a
a
a
a
a
a
a
a
a
a
a
a
a
a
a
a
a
a
a
B
e
e
e
e
e
e
e
e
e
e
e
e
e
e
e
e
C
e
e
e
o
o
e
e
B
B
a
a
a
a
a
a
a
a
a
b
a
a
a
a
"}
(53,1,1) = {"
a
a
a
a
a
a
a
a
a
a
a
a
a
a
a
a
a
a
a
B
e
e
e
e
e
e
e
e
e
e
e
e
e
e
e
C
C
e
e
e
o
e
e
e
B
a
a
a
a
a
a
a
a
a
a
b
a
a
a
a
"}
(54,1,1) = {"
a
a
a
a
a
a
a
a
a
a
a
a
a
a
a
a
a
a
a
B
e
e
e
e
e
e
e
e
e
e
e
e
e
e
C
C
e
e
e
e
o
e
e
e
B
a
a
a
a
a
a
a
a
a
a
Z
a
a
a
a
"}
(55,1,1) = {"
a
a
a
a
a
a
a
a
a
a
a
a
a
a
a
a
a
a
a
B
e
e
e
e
e
e
e
e
e
e
e
e
e
C
C
e
e
e
e
o
o
e
e
B
B
a
a
a
a
a
a
a
a
a
a
a
a
a
a
a
"}
(56,1,1) = {"
a
a
a
a
a
a
a
a
a
a
a
a
a
a
a
a
a
a
a
B
e
e
e
e
e
e
e
e
e
e
e
C
C
C
e
e
e
e
o
o
e
e
e
B
a
a
a
a
a
a
a
a
a
a
a
a
a
a
a
a
"}
(57,1,1) = {"
a
a
a
a
a
a
a
a
a
a
a
a
a
a
a
a
a
a
a
B
e
e
e
e
e
e
e
e
C
C
C
C
e
e
e
e
e
o
o
e
e
e
B
B
a
a
a
a
a
a
a
a
a
a
a
a
a
a
a
a
"}
(58,1,1) = {"
a
a
a
a
a
a
a
a
a
a
a
a
a
a
a
a
a
a
a
o
e
e
e
e
e
C
C
C
C
e
e
e
e
e
e
e
o
o
e
e
e
e
B
a
a
a
a
a
a
a
a
a
a
a
a
a
a
a
a
a
"}
(59,1,1) = {"
a
a
a
a
a
a
a
a
a
a
a
a
a
a
a
a
a
a
a
o
C
C
C
C
C
C
e
e
e
e
e
e
e
e
e
o
o
e
e
e
e
B
B
a
a
a
a
a
a
a
a
a
a
a
a
a
a
a
a
a
"}
(60,1,1) = {"
a
a
a
a
a
a
a
a
a
a
a
a
a
a
a
a
a
a
a
o
e
e
e
e
e
e
e
e
e
e
e
e
o
o
o
o
e
e
e
e
B
B
a
a
a
a
a
a
a
a
a
a
a
a
a
a
a
a
a
a
"}
(61,1,1) = {"
a
a
a
a
a
a
a
a
a
a
a
a
a
a
a
a
a
a
a
o
e
e
e
e
e
e
e
e
e
o
o
o
o
e
e
e
e
e
e
B
B
a
a
a
a
a
a
a
a
a
a
a
a
a
a
a
a
a
a
a
"}
(62,1,1) = {"
a
a
a
a
a
a
a
a
a
a
a
a
a
a
a
a
a
a
a
o
e
e
e
e
e
e
o
o
o
o
e
e
e
e
e
e
e
B
B
B
a
a
a
a
a
a
a
a
a
a
a
a
a
a
a
a
a
a
a
a
"}
(63,1,1) = {"
a
a
a
a
a
a
a
a
a
a
a
a
a
a
a
a
a
a
a
o
o
o
D
o
o
o
o
e
e
e
e
e
e
e
e
B
B
B
a
a
a
a
a
a
a
a
a
a
a
a
a
a
a
a
a
a
a
a
a
a
"}
(64,1,1) = {"
a
a
a
a
a
a
a
a
a
a
a
a
a
a
a
a
a
a
a
B
e
e
e
e
e
e
e
e
e
e
e
e
B
B
B
B
a
a
a
a
a
a
a
a
a
a
a
a
a
a
a
a
a
a
a
a
a
a
a
a
"}
(65,1,1) = {"
a
a
a
a
a
a
a
a
a
a
a
a
a
a
a
a
a
a
a
B
e
e
e
e
e
e
e
e
e
B
B
B
B
a
a
a
a
a
a
a
a
a
a
a
a
a
a
a
a
a
a
a
a
a
a
a
a
a
a
a
"}
(66,1,1) = {"
a
a
a
a
a
a
a
a
a
a
a
a
a
a
a
a
a
a
a
B
B
e
e
e
B
B
B
B
B
B
a
a
a
a
a
a
a
a
a
a
a
a
a
a
a
a
a
a
a
a
a
a
a
a
a
a
a
a
a
a
"}
(67,1,1) = {"
a
a
a
a
a
a
a
a
a
a
a
a
a
a
a
a
a
a
a
a
B
e
e
e
B
a
a
a
a
a
a
a
a
a
a
a
a
a
a
a
a
a
a
a
a
a
a
a
a
a
a
a
a
a
a
a
a
a
a
a
"}
(68,1,1) = {"
a
a
a
a
a
a
a
a
a
a
a
a
a
a
a
a
a
a
a
a
B
e
e
e
B
a
a
a
a
a
a
a
a
a
a
a
a
a
a
a
a
a
a
a
a
a
a
a
a
a
a
a
a
a
a
a
a
a
a
a
"}
(69,1,1) = {"
a
a
a
a
a
a
a
a
a
a
a
a
a
a
a
a
a
a
a
a
B
e
e
e
B
a
a
a
a
a
a
a
a
a
a
a
a
a
a
a
a
a
a
a
a
a
a
a
a
a
a
a
a
a
a
a
a
a
a
a
"}
(70,1,1) = {"
a
a
a
a
a
a
a
a
a
a
a
a
a
a
a
a
a
a
a
a
B
e
e
e
B
a
a
a
a
a
a
a
a
a
a
a
a
a
a
a
a
a
a
a
a
a
a
a
a
a
a
a
a
a
a
a
a
a
a
a
"}
(71,1,1) = {"
a
a
a
a
a
a
a
a
a
a
a
a
a
a
a
a
a
a
a
a
B
R
D
R
B
a
a
a
a
a
a
a
a
a
a
a
a
a
a
a
a
a
a
a
a
a
a
a
a
a
a
a
a
a
a
a
a
a
a
a
"}
(72,1,1) = {"
a
a
a
a
a
a
a
a
a
a
a
a
a
a
a
a
a
a
a
B
B
e
e
e
B
B
a
a
a
a
a
a
a
a
a
a
a
a
a
a
a
a
a
a
a
a
a
a
a
a
a
a
a
a
a
a
a
a
a
a
"}
(73,1,1) = {"
a
a
a
a
a
a
a
a
a
a
a
a
a
a
a
a
a
a
B
B
e
e
e
e
e
B
B
a
a
a
a
a
a
a
a
a
a
a
a
a
a
a
a
a
a
a
a
a
a
a
a
a
a
a
a
a
a
a
a
a
"}
(74,1,1) = {"
a
a
a
a
a
a
a
a
a
a
a
a
a
a
a
a
a
b
e
e
e
e
e
e
e
e
e
b
a
a
a
a
a
a
a
a
a
a
a
a
a
a
a
a
a
a
a
a
a
a
a
a
a
a
a
a
a
a
a
a
"}
(75,1,1) = {"
a
a
a
a
a
a
a
a
Z
b
b
b
b
b
b
b
b
b
e
e
e
e
e
e
e
e
e
b
b
b
b
b
b
b
b
b
Z
a
a
a
a
a
a
a
a
a
a
a
a
a
a
a
a
a
a
a
a
a
a
a
"}
(76,1,1) = {"
a
a
a
a
a
a
a
a
a
a
a
a
a
a
a
a
a
b
e
e
e
e
e
e
e
e
e
b
a
a
a
a
a
a
a
a
a
a
a
a
a
a
a
a
a
a
a
a
a
a
a
a
a
a
a
a
a
a
a
a
"}
(77,1,1) = {"
a
a
a
a
a
a
a
a
a
a
a
a
a
a
a
a
a
a
B
B
e
e
e
e
e
B
B
a
a
a
a
a
a
a
a
a
a
a
a
a
a
a
a
a
a
a
a
a
a
a
a
a
a
a
a
a
a
a
a
a
"}
(78,1,1) = {"
a
a
a
a
a
a
a
a
a
a
a
a
a
a
a
a
a
a
a
B
B
e
e
e
B
B
a
a
a
a
a
a
a
a
a
a
a
a
a
a
a
a
a
a
a
a
a
a
a
a
a
a
a
a
a
a
a
a
a
a
"}
(79,1,1) = {"
a
a
a
a
a
a
a
a
a
a
a
a
a
a
a
a
a
a
a
a
B
B
B
B
B
a
a
a
a
a
a
a
a
a
a
a
a
a
a
a
a
a
a
a
a
a
a
a
a
a
a
a
a
a
a
a
a
a
a
a
"}
