//MAP CONVERTED BY dmm2tgm.py THIS HEADER COMMENT PREVENTS RECONVERSION, DO NOT REMOVE
"a" = (
)
"b" = (
/obj/machinery/door/airlock/highsecurity{
	hackProof = 1;
	name = "secure airlock"
	},
/turf/open/floor/mineral/plastitanium{
	name = "base floor"
	},
/area/ruin/unpowered/syndicate_lava_base/main{
	name = "Syndicate Comm Outpost"
	})
"d" = (
/obj/machinery/telecomms/broadcaster,
/turf/open/floor/mineral/plastitanium/airless{
	name = "telecomms floor"
	},
/area/ruin/unpowered/syndicate_lava_base/main{
	name = "Syndicate Comm Outpost"
	})
"e" = (
/obj/item/storage/toolbox/syndicate,
/obj/structure/table/reinforced,
/turf/open/floor/mineral/plastitanium/red{
	name = "base floor"
	},
/area/ruin/unpowered/syndicate_lava_base/main{
	name = "Syndicate Comm Outpost"
	})
"f" = (
/obj/structure/chair/comfy/black{
	dir = 8
	},
/turf/open/floor/mineral/plastitanium/red{
	name = "base floor"
	},
/area/ruin/unpowered/syndicate_lava_base/main{
	name = "Syndicate Comm Outpost"
	})
"g" = (
/obj/machinery/vending/cigarette/syndicate,
/turf/open/floor/carpet/black,
/area/ruin/unpowered/syndicate_lava_base/main{
	name = "Syndicate Comm Outpost"
	})
"i" = (
/obj/machinery/computer/telecomms{
	dir = 8
	},
/turf/open/floor/mineral/plastitanium/red{
	name = "base floor"
	},
/area/ruin/unpowered/syndicate_lava_base/main{
	name = "Syndicate Comm Outpost"
	})
"j" = (
/obj/effect/spawner/structure/window/plasma/reinforced/plastitanium,
/turf/open/floor/plating,
/area/ruin/unpowered/syndicate_lava_base/main{
	name = "Syndicate Comm Outpost"
	})
"k" = (
/obj/machinery/door/airlock/hatch,
/turf/open/floor/mineral/plastitanium/red{
	name = "base floor"
	},
/area/ruin/unpowered/syndicate_lava_base/main{
	name = "Syndicate Comm Outpost"
	})
"l" = (
/obj/machinery/door/window,
/turf/open/floor/mineral/plastitanium/red{
	name = "base floor"
	},
/area/ruin/unpowered/syndicate_lava_base/main{
	name = "Syndicate Comm Outpost"
	})
"n" = (
/turf/closed/wall/mineral/plastitanium/interior,
/area/ruin/unpowered/syndicate_lava_base/main{
	name = "Syndicate Comm Outpost"
	})
"o" = (
/obj/effect/mapping_helpers/no_lava,
/turf/open/floor/plating/asteroid/basalt/lava_land_surface,
/area/ruin/unpowered/syndicate_lava_base/main{
	name = "Syndicate Comm Outpost"
	})
"p" = (
/obj/machinery/vending/sustenance,
/turf/open/floor/carpet/black,
/area/ruin/unpowered/syndicate_lava_base/main{
	name = "Syndicate Comm Outpost"
	})
"q" = (
/turf/open/floor/carpet,
/area/ruin/unpowered/syndicate_lava_base/main{
	name = "Syndicate Comm Outpost"
	})
"s" = (
/turf/template_noop,
/area/template_noop)
"t" = (
/obj/structure/window/reinforced/survival_pod{
	dir = 1;
	name = "Window"
	},
/turf/open/floor/mineral/plastitanium/airless{
	name = "telecomms floor"
	},
/area/ruin/unpowered/syndicate_lava_base/main{
	name = "Syndicate Comm Outpost"
	})
"u" = (
/obj/machinery/portable_atmospherics/canister/air,
/turf/open/floor/mineral/plastitanium/red{
	name = "base floor"
	},
/area/ruin/unpowered/syndicate_lava_base/main{
	name = "Syndicate Comm Outpost"
	})
"w" = (
/obj/structure/bed/dogbed{
	desc = "A well worn dog bed, wait... are dog beds supposed to have burn marks?."
	},
/mob/living/simple_animal/hostile/asteroid/basilisk/watcher/magmawing{
	desc = "A domesticated Magmawing watcher, you weren't aware that was even possible. Unfortunately though, it's been domesticated by the Syndicate..";
	dir = 4;
	faction = list("Syndicate");
	movement_type = 1
	},
/turf/open/floor/mineral/plastitanium{
	name = "base floor"
	},
/area/ruin/unpowered/syndicate_lava_base/main{
	name = "Syndicate Comm Outpost"
	})
"x" = (
/obj/structure/table/reinforced,
/obj/item/paper/crumpled/awaymissions/moonoutpost19/hastey_note{
	desc = It seems like it was written in a hurry;
	info = "<i>Hey, you're probably reading this after having killed me, but that's alright. I probably shot first. Names' Yuto, Syndicate Radio Operator, there used to be another op here, a nice one too. Had syndicate command not forgotten about this post, we'd of probably been executed for sentinmental attachments on the job. Although she didn't have to worry about that, the local fauna got her first. I guess this note is my way of saying sorry. Take what you want from this station and my body, you need it more than I do now. Good luck out there, whoever you are. - Syndicate Radio</i><br><br><i>e f.</i>";
	pixel_x = -3;
	pixel_y = 2
	},
/obj/item/candle{
	pixel_x = 8;
	pixel_y = 5
	},
/turf/open/floor/carpet,
/area/ruin/unpowered/syndicate_lava_base/main{
	name = "Syndicate Comm Outpost"
	})
"y" = (
/obj/structure/closet/crate/grave,
/obj/effect/mapping_helpers/no_lava,
/turf/open/floor/plating/asteroid/basalt/lava_land_surface,
/area/ruin/unpowered/syndicate_lava_base/main{
	name = "Syndicate Comm Outpost"
	})
"A" = (
/obj/structure/chair/comfy/black{
	desc = "It looks like it hasn't been used in a long time.";
	dir = 1
	},
/turf/open/floor/carpet/black,
/area/ruin/unpowered/syndicate_lava_base/main{
	name = "Syndicate Comm Outpost"
	})
"B" = (
/obj/machinery/light/dim{
	dir = 8
	},
/turf/open/floor/mineral/plastitanium/red{
	name = "base floor"
	},
/area/ruin/unpowered/syndicate_lava_base/main{
	name = "Syndicate Comm Outpost"
	})
"C" = (
/obj/machinery/computer/telecomms/monitor,
/turf/open/floor/mineral/plastitanium/red{
	name = "base floor"
	},
/area/ruin/unpowered/syndicate_lava_base/main{
	name = "Syndicate Comm Outpost"
	})
"D" = (
/turf/closed/wall/mineral/plastitanium,
/area/ruin/unpowered/syndicate_lava_base/main{
	name = "Syndicate Comm Outpost"
	})
"F" = (
/obj/machinery/light/dim,
/turf/open/floor/mineral/plastitanium{
	name = "base floor"
	},
/area/ruin/unpowered/syndicate_lava_base/main{
	name = "Syndicate Comm Outpost"
	})
"G" = (
/obj/structure/table/reinforced,
/obj/item/trash/syndi_cakes{
	pixel_y = 13
	},
/turf/open/floor/mineral/plastitanium/red{
	name = "base floor"
	},
/area/ruin/unpowered/syndicate_lava_base/main{
	name = "Syndicate Comm Outpost"
	})
"H" = (
/turf/open/floor/mineral/plastitanium{
	name = "base floor"
	},
/area/ruin/unpowered/syndicate_lava_base/main{
	name = "Syndicate Comm Outpost"
	})
"J" = (
/obj/structure/table/reinforced,
/obj/item/radio/intercom/wideband,
/turf/open/floor/mineral/plastitanium/red{
	name = "base floor"
	},
/area/ruin/unpowered/syndicate_lava_base/main{
	name = "Syndicate Comm Outpost"
	})
"K" = (
/turf/open/floor/carpet/black,
/area/ruin/unpowered/syndicate_lava_base/main{
	name = "Syndicate Comm Outpost"
	})
"L" = (
/obj/structure/window/reinforced/survival_pod{
	dir = 1;
	name = "window"
	},
/turf/open/floor/mineral/plastitanium/airless{
	name = "telecomms floor"
	},
/area/ruin/unpowered/syndicate_lava_base/main{
	name = "Syndicate Comm Outpost"
	})
"M" = (
/obj/structure/chair/comfy/black,
/turf/open/floor/carpet,
/area/ruin/unpowered/syndicate_lava_base/main{
	name = "Syndicate Comm Outpost"
	})
"N" = (
/turf/open/floor/plating/asteroid/basalt/lava_land_surface,
/area/ruin/unpowered/syndicate_lava_base/main{
	name = "Syndicate Comm Outpost"
	})
"O" = (
/obj/structure/closet/crate,
/obj/item/clothing/gloves/combat,
/obj/item/gun/ballistic/automatic/pistol,
/obj/item/ammo_box/magazine/pistolm9mm,
/obj/item/ammo_box/magazine/pistolm9mm,
/obj/item/ammo_box/magazine/pistolm9mm,
/turf/open/floor/carpet/black,
/area/ruin/unpowered/syndicate_lava_base/main{
	name = "Syndicate Comm Outpost"
	})
"P" = (
/obj/machinery/door/window/survival_pod{
	dir = 1
	},
/turf/open/floor/mineral/plastitanium/airless{
	name = "telecomms floor"
	},
/area/ruin/unpowered/syndicate_lava_base/main{
	name = "Syndicate Comm Outpost"
	})
"Q" = (
/obj/item/trash/sosjerky{
	pixel_x = -9;
	pixel_y = 16
	},
/turf/open/floor/mineral/plastitanium{
	name = "base floor"
	},
/area/ruin/unpowered/syndicate_lava_base/main{
	name = "Syndicate Comm Outpost"
	})
"R" = (
/obj/machinery/light/dim{
	dir = 8
	},
/turf/open/floor/mineral/plastitanium{
	name = "base floor"
	},
/area/ruin/unpowered/syndicate_lava_base/main{
	name = "Syndicate Comm Outpost"
	})
"S" = (
/obj/structure/table/reinforced,
/obj/item/flashlight/lantern/lanternbang,
/turf/open/floor/mineral/plastitanium/red{
	name = "base floor"
	},
/area/ruin/unpowered/syndicate_lava_base/main{
	name = "Syndicate Comm Outpost"
	})
"T" = (
/mob/living/simple_animal/hostile/syndicate/ranged{
	dir = 8;
	health = 125;
	name = "Syndicate Radio Operative"
	},
/turf/open/floor/mineral/plastitanium/red{
	name = "base floor"
	},
/area/ruin/unpowered/syndicate_lava_base/main{
	name = "Syndicate Comm Outpost"
	})
"U" = (
/obj/machinery/telecomms/receiver,
/turf/open/floor/mineral/plastitanium/airless{
	name = "telecomms floor"
	},
/area/ruin/unpowered/syndicate_lava_base/main{
	name = "Syndicate Comm Outpost"
	})
"V" = (
/obj/structure/table/reinforced,
/turf/open/floor/mineral/plastitanium/red{
	name = "base floor"
	},
/area/ruin/unpowered/syndicate_lava_base/main{
	name = "Syndicate Comm Outpost"
	})
"W" = (
/turf/open/floor/mineral/plastitanium/red{
	name = "base floor"
	},
/area/ruin/unpowered/syndicate_lava_base/main{
	name = "Syndicate Comm Outpost"
	})
"X" = (
/obj/machinery/door/airlock/hatch,
/turf/open/floor/mineral/plastitanium{
	name = "base floor"
	},
/area/ruin/unpowered/syndicate_lava_base/main{
	name = "Syndicate Comm Outpost"
	})
"Y" = (
/obj/machinery/telecomms/bus,
/turf/open/floor/mineral/plastitanium/airless{
	name = "telecomms floor"
	},
/area/ruin/unpowered/syndicate_lava_base/main{
	name = "Syndicate Comm Outpost"
	})
"Z" = (
/obj/machinery/light/dim{
	dir = 1
	},
/turf/open/floor/carpet,
/area/ruin/unpowered/syndicate_lava_base/main{
	name = "Syndicate Comm Outpost"
	})

(1,1,1) = {"
s
s
s
s
s
s
s
s
s
s
s
s
s
s
s
s
s
s
s
a
"}
(2,1,1) = {"
s
s
s
s
s
s
s
s
s
s
s
s
s
s
s
s
s
s
s
s
"}
(3,1,1) = {"
s
s
s
s
s
s
s
s
s
s
s
s
s
s
s
s
s
s
s
s
"}
(4,1,1) = {"
s
s
s
s
s
s
s
s
s
s
s
s
s
s
s
s
s
s
s
s
"}
(5,1,1) = {"
s
s
s
o
o
o
o
o
o
o
o
s
s
s
s
s
s
s
s
s
"}
(6,1,1) = {"
s
s
s
o
D
D
D
b
D
D
o
N
s
s
s
s
s
s
s
s
"}
(7,1,1) = {"
s
s
s
o
D
w
R
H
H
D
D
N
N
N
N
N
s
s
s
s
"}
(8,1,1) = {"
s
s
s
o
j
H
Q
H
H
H
D
D
D
D
D
N
N
s
s
s
"}
(9,1,1) = {"
s
s
s
o
j
G
J
V
V
H
H
n
g
p
D
D
N
s
s
s
"}
(10,1,1) = {"
s
s
s
o
j
W
f
W
S
H
H
X
q
K
O
D
N
s
s
s
"}
(11,1,1) = {"
s
s
s
o
D
W
T
W
l
H
F
n
Z
q
K
D
N
s
s
s
"}
(12,1,1) = {"
s
s
s
o
D
n
n
k
n
n
n
n
M
x
A
D
N
s
s
s
"}
(13,1,1) = {"
s
s
s
o
D
C
B
W
W
L
d
n
j
j
j
D
N
s
s
s
"}
(14,1,1) = {"
s
s
s
N
D
D
i
W
W
P
Y
D
o
o
o
o
N
s
s
s
"}
(15,1,1) = {"
s
s
s
N
N
D
D
e
u
t
U
D
y
o
o
o
s
s
s
s
"}
(16,1,1) = {"
s
s
s
s
N
N
D
D
D
D
D
D
o
o
o
o
s
s
s
s
"}
(17,1,1) = {"
s
s
s
s
s
N
N
N
N
N
N
N
o
o
o
s
s
s
s
s
"}
(18,1,1) = {"
s
s
s
s
s
s
s
s
s
s
s
s
s
s
s
s
s
s
s
s
"}
(19,1,1) = {"
s
s
s
s
s
s
s
s
s
s
s
s
s
s
s
s
s
s
s
s
"}
(20,1,1) = {"
s
s
s
s
s
s
s
s
s
s
s
s
s
s
s
s
s
s
s
s
"}
