//MAP CONVERTED BY dmm2tgm.py THIS HEADER COMMENT PREVENTS RECONVERSION, DO NOT REMOVE
"bP" = (
/obj/effect/decal/cleanable/blood/old{
	icon_state = "floor3-old"
	},
/turf/open/floor/plating/asteroid/basalt,
/area/lavaland/surface/outdoors)
"fr" = (
/obj/structure/closet/cabinet,
/obj/item/instrument/banjo,
/obj/item/instrument/trombone,
/turf/open/floor/plating/asteroid/basalt,
/area/ruin/unpowered)
"gB" = (
/mob/living/simple_animal/hostile/asteroid/hivelord/legion{
	name = "tall dwarf legion"
	},
/turf/open/floor/plating/asteroid/basalt,
/area/ruin/unpowered)
"if" = (
/obj/structure/table/wood,
/obj/item/reagent_containers/food/drinks/drinkingglass{
	list_reagents = list(/datum/reagent/consumable/ethanol/fetching_fizz= 30)
	},
/turf/open/floor/plating/asteroid/basalt,
/area/ruin/unpowered)
"iI" = (
/obj/structure/sign/poster/contraband/eat,
/turf/closed/wall/mineral/wood,
/area/ruin/unpowered)
"iM" = (
/obj/structure/table/wood,
/obj/item/hatchet/wooden,
/obj/item/hatchet/wooden,
/turf/open/floor/plating/asteroid/basalt,
/area/ruin/unpowered)
"jL" = (
/turf/open/floor/plating/asteroid/basalt,
/area/ruin/unpowered)
"ks" = (
/obj/structure/mineral_door/iron,
/turf/open/floor/plating/asteroid/basalt,
/area/ruin/unpowered)
"lt" = (
/obj/structure/table/wood,
/obj/item/reagent_containers/food/drinks/drinkingglass{
	list_reagents = list(/datum/reagent/consumable/ethanol/quintuple_sec = 20)
	},
/turf/open/floor/plating/asteroid/basalt,
/area/ruin/unpowered)
"lV" = (
/obj/structure/chair/wood/wings{
	dir = 8
	},
/mob/living/simple_animal/hostile/asteroid/hivelord/legion/dwarf,
/turf/open/floor/plating/asteroid/basalt,
/area/ruin/unpowered)
"mO" = (
/obj/item/chair/wood/wings,
/turf/open/floor/plating/asteroid/basalt,
/area/ruin/unpowered)
"qj" = (
/mob/living/simple_animal/hostile/asteroid/hivelord/legion/dwarf,
/obj/effect/decal/cleanable/blood/old,
/turf/open/floor/plating/asteroid/basalt,
/area/ruin/unpowered)
"rP" = (
/obj/effect/decal/cleanable/blood/old{
	icon_state = "floor2-old"
	},
/turf/open/floor/plating/asteroid/basalt,
/area/ruin/unpowered)
"se" = (
/obj/structure/chair/stool/bar,
/mob/living/simple_animal/hostile/asteroid/hivelord/legion/dwarf,
/turf/open/floor/plating/asteroid/basalt,
/area/ruin/unpowered)
"sz" = (
/obj/structure/spawner/lavaland/legion,
/turf/open/floor/plating/asteroid/basalt,
/area/lavaland/surface/outdoors)
"sR" = (
/obj/structure/fermenting_barrel,
/turf/open/floor/plating/asteroid/basalt,
/area/ruin/unpowered)
"sS" = (
/turf/template_noop,
/area/template_noop)
"th" = (
/obj/structure/table/wood,
/obj/item/reagent_containers/food/drinks/drinkingglass{
	list_reagents = list(/datum/reagent/consumable/ethanol/turbo = 20)
	},
/turf/open/floor/plating/asteroid/basalt,
/area/ruin/unpowered)
"ui" = (
/obj/effect/decal/cleanable/blood/old{
	icon_state = "floor4-old"
	},
/turf/open/floor/plating/asteroid/basalt,
/area/lavaland/surface/outdoors)
"uW" = (
/obj/effect/decal/cleanable/blood/old{
	icon_state = "floor2-old"
	},
/turf/open/floor/plating/asteroid/basalt,
/area/lavaland/surface/outdoors)
"wm" = (
/obj/structure/bed,
/obj/item/bedsheet/random,
/turf/open/floor/plating/asteroid/basalt,
/area/ruin/unpowered)
"xi" = (
/turf/closed/mineral/volcanic/lava_land_surface,
/area/lavaland/surface/outdoors)
"xP" = (
/obj/structure/chair/wood/wings{
	dir = 1
	},
/turf/open/floor/plating/asteroid/basalt,
/area/ruin/unpowered)
"xR" = (
/turf/closed/wall/mineral/wood,
/area/ruin/unpowered)
"Ay" = (
/turf/open/floor/plating/asteroid/basalt,
/area/lavaland/surface/outdoors)
"Bb" = (
/mob/living/simple_animal/hostile/asteroid/hivelord/legion/dwarf,
/turf/open/floor/plating/asteroid/basalt,
/area/ruin/unpowered)
"Bd" = (
/obj/effect/decal/cleanable/blood/old{
	icon_state = "floor6-old"
	},
/turf/open/floor/plating/asteroid/basalt,
/area/lavaland/surface/outdoors)
"Cf" = (
/obj/structure/table/wood,
/obj/item/fireaxe/boneaxe,
/turf/open/floor/plating/asteroid/basalt,
/area/ruin/unpowered)
"CI" = (
/obj/structure/table/wood,
/obj/item/toy/plush/lizardplushie{
	pixel_y = 3
	},
/turf/open/floor/plating/asteroid/basalt,
/area/ruin/unpowered)
"Dk" = (
/obj/structure/bed,
/turf/open/floor/plating/asteroid/basalt,
/area/ruin/unpowered)
"ET" = (
/obj/structure/table/wood,
/obj/item/reagent_containers/food/drinks/drinkingglass{
	list_reagents = list(/datum/reagent/consumable/ethanol/hearty_punch = 25)
	},
/turf/open/floor/plating/asteroid/basalt,
/area/ruin/unpowered)
"Fs" = (
/obj/structure/table/wood,
/obj/item/spear/bonespear,
/turf/open/floor/plating/asteroid/basalt,
/area/ruin/unpowered)
"GD" = (
/obj/structure/table/wood,
/obj/item/reagent_containers/food/snacks/meat/steak/goliath{
	pixel_y = 6
	},
/turf/open/floor/plating/asteroid/basalt,
/area/ruin/unpowered)
"GL" = (
/mob/living/simple_animal/hostile/asteroid/hivelord/legion/dwarf,
/turf/open/floor/plating/asteroid/basalt,
/area/lavaland/surface/outdoors)
"GS" = (
/obj/item/dice/d20{
	pixel_x = 5;
	pixel_y = 6
	},
/obj/item/toy/figure/clown{
	pixel_x = -7;
	pixel_y = 1
	},
/obj/structure/table/wood/fancy/purple,
/turf/open/floor/plating/asteroid/basalt,
/area/ruin/unpowered)
"Hg" = (
/obj/structure/table/wood,
/obj/item/reagent_containers/food/drinks/drinkingglass{
	list_reagents = list(/datum/reagent/consumable/ethanol/manly_dorf = 30)
	},
/turf/open/floor/plating/asteroid/basalt,
/area/ruin/unpowered)
"Hj" = (
/obj/structure/chair/wood/wings{
	dir = 8
	},
/turf/open/floor/plating/asteroid/basalt,
/area/ruin/unpowered)
"HZ" = (
/obj/structure/table/wood,
/obj/item/flashlight/lantern,
/obj/item/flashlight/lantern,
/obj/item/flashlight/lantern,
/turf/open/floor/plating/asteroid/basalt,
/area/ruin/unpowered)
"MR" = (
/obj/structure/barricade/wooden,
/turf/open/floor/plating/asteroid/basalt,
/area/lavaland/surface/outdoors)
"NL" = (
/obj/structure/table/wood,
/obj/item/toy/cards/deck{
	pixel_y = 5
	},
/turf/open/floor/plating/asteroid/basalt,
/area/ruin/unpowered)
"Oy" = (
/obj/structure/chair/comfy/lime{
	dir = 8
	},
/turf/open/floor/plating/asteroid/basalt,
/area/ruin/unpowered)
"Pl" = (
/obj/effect/decal/cleanable/blood/gibs/old,
/obj/item/clothing/head/helmet/skull,
/turf/open/floor/plating/asteroid/basalt,
/area/lavaland/surface/outdoors)
"PB" = (
/obj/structure/table/wood,
/obj/item/shield/riot/buckler,
/obj/item/shield/riot/buckler,
/turf/open/floor/plating/asteroid/basalt,
/area/ruin/unpowered)
"PW" = (
/obj/effect/decal/cleanable/blood/old,
/obj/item/flashlight/flare/torch,
/turf/open/floor/plating/asteroid/basalt,
/area/lavaland/surface/outdoors)
"QZ" = (
/obj/structure/table/wood,
/obj/item/pickaxe,
/obj/item/pickaxe,
/turf/open/floor/plating/asteroid/basalt,
/area/ruin/unpowered)
"RP" = (
/obj/structure/reagent_dispensers/beerkeg,
/turf/open/floor/plating/asteroid/basalt,
/area/ruin/unpowered)
"Sv" = (
/obj/structure/sign/poster/official/high_class_martini,
/turf/closed/wall/mineral/wood,
/area/ruin/unpowered)
"SN" = (
/obj/effect/decal/cleanable/blood/old{
	icon_state = "floor4-old"
	},
/turf/open/floor/plating/asteroid/basalt,
/area/ruin/unpowered)
"Ti" = (
/obj/structure/table/wood,
/obj/item/reagent_containers/food/drinks/ale{
	pixel_x = -6;
	pixel_y = 2
	},
/obj/item/reagent_containers/food/drinks/bottle/lizardwine{
	pixel_x = 7;
	pixel_y = 5
	},
/turf/open/floor/plating/asteroid/basalt,
/area/ruin/unpowered)
"UM" = (
/obj/structure/table/wood,
/obj/item/clothing/shoes/cowboy/lizard,
/obj/item/tailclub{
	pixel_x = 3;
	pixel_y = 9
	},
/turf/open/floor/plating/asteroid/basalt,
/area/ruin/unpowered)
"Vk" = (
/obj/structure/chair/stool/bar,
/turf/open/floor/plating/asteroid/basalt,
/area/ruin/unpowered)
"XW" = (
/obj/effect/decal/cleanable/blood/old{
	icon_state = "floor7-old"
	},
/turf/open/floor/plating/asteroid/basalt,
/area/ruin/unpowered)
"Zc" = (
/obj/effect/decal/cleanable/blood/old{
	icon_state = "floor5-old"
	},
/turf/open/floor/plating/asteroid/basalt,
/area/lavaland/surface/outdoors)

(1,1,1) = {"
xi
xi
xi
xi
xi
xi
xi
xi
xi
xi
xi
xi
xi
xi
xi
xi
xi
xi
"}
(2,1,1) = {"
xi
xi
xi
xR
xR
xR
xR
xR
xR
xR
xR
xR
xR
xi
xi
xi
xi
xi
"}
(3,1,1) = {"
xi
xi
xR
iI
RP
jL
GS
xP
xR
Dk
Bb
wm
xR
uW
Ay
Ay
xi
xi
"}
(4,1,1) = {"
xi
xi
xR
jL
jL
jL
lV
jL
xR
wm
jL
Dk
xR
Ay
sz
Ay
Ay
xi
"}
(5,1,1) = {"
xi
xi
xR
jL
ET
Vk
jL
jL
xR
Dk
XW
Dk
xR
Ay
Ay
Zc
Ay
xi
"}
(6,1,1) = {"
xi
xi
xR
jL
lt
se
jL
jL
xR
Dk
jL
wm
xR
ui
Ay
Ay
xi
xi
"}
(7,1,1) = {"
xi
xi
xR
Bb
Hg
Vk
jL
jL
ks
jL
jL
Dk
xR
Ay
MR
xi
xi
xi
"}
(8,1,1) = {"
xi
xi
xR
jL
NL
Vk
jL
jL
xR
rP
jL
qj
xR
Ay
Ay
bP
xi
xi
"}
(9,1,1) = {"
xi
xi
xR
Ti
GD
Vk
jL
jL
xR
Dk
jL
wm
xR
Ay
Pl
Ay
xi
xi
"}
(10,1,1) = {"
xi
xi
xR
sR
jL
jL
jL
fr
xR
wm
Bb
jL
xR
xi
MR
GL
xi
xi
"}
(11,1,1) = {"
xi
xi
xR
xR
xR
xR
jL
Sv
xR
xR
xR
ks
xR
xR
Ay
Ay
xi
xi
"}
(12,1,1) = {"
xi
xi
xi
xR
mO
jL
jL
jL
jL
xR
jL
jL
UM
xR
Ay
Bd
xi
xi
"}
(13,1,1) = {"
sS
xi
xi
xR
if
jL
jL
gB
th
xR
QZ
jL
jL
xR
Ay
Ay
xi
xi
"}
(14,1,1) = {"
sS
xi
xi
xR
Hj
jL
jL
jL
jL
xR
Cf
jL
SN
ks
Ay
Ay
xi
xi
"}
(15,1,1) = {"
sS
xi
xR
xR
jL
Bb
jL
jL
jL
xR
HZ
Bb
jL
ks
uW
Ay
xi
xi
"}
(16,1,1) = {"
sS
PW
xR
jL
jL
jL
jL
CI
jL
xR
jL
XW
jL
xR
Ay
Ay
xi
xi
"}
(17,1,1) = {"
sS
Ay
ks
jL
jL
jL
jL
Oy
jL
xR
iM
Fs
PB
xR
Ay
Ay
xi
xi
"}
(18,1,1) = {"
sS
GL
xR
xR
xR
xR
xR
xR
xR
xR
xR
xR
xR
xR
GL
xi
xi
xi
"}
(19,1,1) = {"
sS
xi
xi
xi
xi
xi
xi
xi
xi
xi
xi
xi
xi
xi
xi
xi
xi
xi
"}
(20,1,1) = {"
sS
xi
xi
xi
xi
xi
xi
xi
xi
xi
xi
xi
xi
xi
xi
xi
xi
xi
"}
