//MAP CONVERTED BY dmm2tgm.py THIS HEADER COMMENT PREVENTS RECONVERSION, DO NOT REMOVE
"bP" = (
/obj/effect/decal/cleanable/blood/old{
	icon_state = "floor3-old"
	},
/turf/open/floor/plating/asteroid/basalt,
/area/overmap_encounter/planetoid/cave/explored)
"dO" = (
/mob/living/simple_animal/hostile/asteroid/hivelord/legion/dwarf{
	name = "dwarf bartender"
	},
/turf/open/floor/plating/asteroid/basalt,
/area/overmap_encounter/planetoid/cave/explored)
"fr" = (
/obj/structure/closet/cabinet,
/obj/item/instrument/banjo,
/obj/item/instrument/trombone,
/turf/open/floor/plating/asteroid/basalt,
/area/overmap_encounter/planetoid/cave/explored)
"gB" = (
/mob/living/simple_animal/hostile/asteroid/hivelord/legion{
	name = "tall dwarf legion"
	},
/turf/open/floor/plating/asteroid/basalt,
/area/overmap_encounter/planetoid/cave/explored)
"if" = (
/obj/structure/table/wood,
/obj/item/reagent_containers/food/drinks/drinkingglass{
	list_reagents = list(/datum/reagent/consumable/ethanol/fetching_fizz=30)
	},
/turf/open/floor/plating/asteroid/basalt,
/area/overmap_encounter/planetoid/cave/explored)
"iI" = (
/obj/structure/sign/poster/contraband/eat,
/turf/closed/wall/mineral/wood,
/area/overmap_encounter/planetoid/cave/explored)
"iM" = (
/obj/structure/table/wood,
/obj/item/hatchet/wooden,
/obj/item/hatchet/wooden,
/turf/open/floor/plating/asteroid/basalt,
/area/overmap_encounter/planetoid/cave/explored)
"ks" = (
/obj/structure/mineral_door/iron,
/turf/open/floor/plating/asteroid/basalt,
/area/overmap_encounter/planetoid/cave/explored)
"kY" = (
/mob/living/simple_animal/hostile/asteroid/hivelord/legion/dwarf{
	name = "dwarf armorer"
	},
/turf/open/floor/plating/asteroid/basalt,
/area/overmap_encounter/planetoid/cave/explored)
"lt" = (
/obj/structure/table/wood,
/obj/item/reagent_containers/food/drinks/drinkingglass{
	list_reagents = list(/datum/reagent/consumable/ethanol/quintuple_sec=20)
	},
/turf/open/floor/plating/asteroid/basalt,
/area/overmap_encounter/planetoid/cave/explored)
"mN" = (
/obj/structure/chair/stool/bar,
/mob/living/simple_animal/hostile/asteroid/hivelord/legion{
	icon_aggro = "dwarf_legion";
	icon_dead = "dwarf_legion";
	icon_living = "dwarf_legion";
	icon_state = "dwarf_legion";
	name = "dwarf legion"
	},
/turf/open/floor/plating/asteroid/basalt,
/area/overmap_encounter/planetoid/cave/explored)
"mO" = (
/obj/item/chair/wood/wings,
/turf/open/floor/plating/asteroid/basalt,
/area/overmap_encounter/planetoid/cave/explored)
"qj" = (
/mob/living/simple_animal/hostile/asteroid/hivelord/legion/dwarf,
/obj/effect/decal/cleanable/blood/old,
/turf/open/floor/plating/asteroid/basalt,
/area/overmap_encounter/planetoid/cave/explored)
"sz" = (
/obj/structure/spawner/lavaland/legion,
/turf/open/floor/plating/asteroid/basalt,
/area/overmap_encounter/planetoid/cave/explored)
"sR" = (
/obj/structure/fermenting_barrel,
/turf/open/floor/plating/asteroid/basalt,
/area/overmap_encounter/planetoid/cave/explored)
"sS" = (
/turf/template_noop,
/area/template_noop)
"th" = (
/obj/structure/table/wood,
/obj/item/reagent_containers/food/drinks/drinkingglass{
	list_reagents = list(/datum/reagent/consumable/ethanol/turbo=20)
	},
/turf/open/floor/plating/asteroid/basalt,
/area/overmap_encounter/planetoid/cave/explored)
"ui" = (
/obj/effect/decal/cleanable/blood/old{
	icon_state = "floor4-old"
	},
/turf/open/floor/plating/asteroid/basalt,
/area/overmap_encounter/planetoid/cave/explored)
"uW" = (
/obj/effect/decal/cleanable/blood/old{
	icon_state = "floor2-old"
	},
/turf/open/floor/plating/asteroid/basalt,
/area/overmap_encounter/planetoid/cave/explored)
"wm" = (
/obj/structure/bed,
/obj/item/bedsheet/dorms,
/turf/open/floor/plating/asteroid/basalt,
/area/overmap_encounter/planetoid/cave/explored)
"xi" = (
/turf/closed/mineral/volcanic/lava_land_surface,
/area/overmap_encounter/planetoid/cave/explored)
"xP" = (
/obj/structure/chair/wood/wings{
	dir = 1
	},
/mob/living/simple_animal/hostile/asteroid/hivelord/legion{
	icon_aggro = "dwarf_legion";
	icon_dead = "dwarf_legion";
	icon_living = "dwarf_legion";
	icon_state = "dwarf_legion";
	name = "dwarf legion"
	},
/turf/open/floor/plating/asteroid/basalt,
/area/overmap_encounter/planetoid/cave/explored)
"xR" = (
/turf/closed/wall/mineral/wood,
/area/overmap_encounter/planetoid/cave/explored)
"zY" = (
/mob/living/simple_animal/hostile/asteroid/hivelord/legion{
	icon_aggro = "dwarf_legion";
	icon_dead = "dwarf_legion";
	icon_living = "dwarf_legion";
	icon_state = "dwarf_legion";
	name = "dwarf legion"
	},
/turf/open/floor/plating/asteroid/basalt,
/area/overmap_encounter/planetoid/cave/explored)
"Ay" = (
/turf/open/floor/plating/asteroid/basalt,
/area/overmap_encounter/planetoid/cave/explored)
"Bd" = (
/obj/effect/decal/cleanable/blood/old{
	icon_state = "floor6-old"
	},
/turf/open/floor/plating/asteroid/basalt,
/area/overmap_encounter/planetoid/cave/explored)
"Cf" = (
/obj/structure/table/wood,
/obj/item/fireaxe/boneaxe,
/turf/open/floor/plating/asteroid/basalt,
/area/overmap_encounter/planetoid/cave/explored)
"CI" = (
/obj/structure/table/wood,
/obj/item/toy/plush/lizardplushie{
	pixel_y = 3
	},
/turf/open/floor/plating/asteroid/basalt,
/area/overmap_encounter/planetoid/cave/explored)
"Dk" = (
/obj/structure/bed,
/turf/open/floor/plating/asteroid/basalt,
/area/overmap_encounter/planetoid/cave/explored)
"ET" = (
/obj/structure/table/wood,
/obj/item/reagent_containers/food/drinks/drinkingglass{
	list_reagents = list(/datum/reagent/consumable/ethanol/hearty_punch=25)
	},
/turf/open/floor/plating/asteroid/basalt,
/area/overmap_encounter/planetoid/cave/explored)
"Fs" = (
/obj/structure/table/wood,
/obj/item/spear/bonespear,
/turf/open/floor/plating/asteroid/basalt,
/area/overmap_encounter/planetoid/cave/explored)
"GD" = (
/obj/structure/table/wood,
/obj/item/reagent_containers/food/snacks/meat/steak/goliath{
	pixel_y = 6
	},
/turf/open/floor/plating/asteroid/basalt,
/area/overmap_encounter/planetoid/cave/explored)
"GL" = (
/mob/living/simple_animal/hostile/asteroid/hivelord/legion/dwarf,
/turf/open/floor/plating/asteroid/basalt,
/area/overmap_encounter/planetoid/cave/explored)
"GS" = (
/obj/item/dice/d20{
	pixel_x = 5;
	pixel_y = 6
	},
/obj/item/toy/figure/clown{
	pixel_x = -7;
	pixel_y = 1
	},
/obj/structure/table/wood/fancy/purple,
/turf/open/floor/plating/asteroid/basalt,
/area/overmap_encounter/planetoid/cave/explored)
"Hg" = (
/obj/structure/table/wood,
/obj/item/reagent_containers/food/drinks/drinkingglass{
	list_reagents = list(/datum/reagent/consumable/ethanol/manly_dorf=30)
	},
/turf/open/floor/plating/asteroid/basalt,
/area/overmap_encounter/planetoid/cave/explored)
"Hj" = (
/obj/structure/chair/wood/wings{
	dir = 8
	},
/turf/open/floor/plating/asteroid/basalt,
/area/overmap_encounter/planetoid/cave/explored)
"HZ" = (
/obj/structure/table/wood,
/obj/item/flashlight/lantern,
/obj/item/flashlight/lantern,
/obj/item/flashlight/lantern,
/turf/open/floor/plating/asteroid/basalt,
/area/overmap_encounter/planetoid/cave/explored)
"MR" = (
/obj/structure/barricade/wooden,
/turf/open/floor/plating/asteroid/basalt,
/area/overmap_encounter/planetoid/cave/explored)
"NL" = (
/obj/structure/table/wood,
/obj/item/toy/cards/deck{
	pixel_y = 5
	},
/turf/open/floor/plating/asteroid/basalt,
/area/overmap_encounter/planetoid/cave/explored)
"Oy" = (
/obj/structure/chair/comfy/lime{
	dir = 8
	},
/turf/open/floor/plating/asteroid/basalt,
/area/overmap_encounter/planetoid/cave/explored)
"Pl" = (
/obj/effect/decal/cleanable/blood/gibs/old,
/obj/item/clothing/head/helmet/skull,
/turf/open/floor/plating/asteroid/basalt,
/area/overmap_encounter/planetoid/cave/explored)
"PB" = (
/obj/structure/table/wood,
/obj/item/shield/riot/buckler,
/obj/item/shield/riot/buckler,
/turf/open/floor/plating/asteroid/basalt,
/area/overmap_encounter/planetoid/cave/explored)
"PW" = (
/obj/effect/decal/cleanable/blood/old,
/obj/item/flashlight/flare/torch,
/turf/open/floor/plating/asteroid/basalt,
/area/overmap_encounter/planetoid/cave/explored)
"QZ" = (
/obj/structure/table/wood,
/obj/item/pickaxe,
/obj/item/pickaxe,
/turf/open/floor/plating/asteroid/basalt,
/area/overmap_encounter/planetoid/cave/explored)
"RP" = (
/obj/structure/reagent_dispensers/beerkeg,
/turf/open/floor/plating/asteroid/basalt,
/area/overmap_encounter/planetoid/cave/explored)
"Sv" = (
/obj/structure/sign/poster/official/high_class_martini,
/turf/closed/wall/mineral/wood,
/area/overmap_encounter/planetoid/cave/explored)
"Ti" = (
/obj/structure/table/wood,
/obj/item/reagent_containers/food/drinks/ale{
	pixel_x = -6;
	pixel_y = 2
	},
/obj/item/reagent_containers/food/drinks/bottle/lizardwine{
	pixel_x = 7;
	pixel_y = 5
	},
/turf/open/floor/plating/asteroid/basalt,
/area/overmap_encounter/planetoid/cave/explored)
"UM" = (
/obj/structure/table/wood,
/obj/item/clothing/shoes/cowboy/lizard,
/obj/item/tailclub{
	pixel_x = 3;
	pixel_y = 9
	},
/turf/open/floor/plating/asteroid/basalt,
/area/overmap_encounter/planetoid/cave/explored)
"Vk" = (
/obj/structure/chair/stool/bar,
/turf/open/floor/plating/asteroid/basalt,
/area/overmap_encounter/planetoid/cave/explored)
"XW" = (
/obj/effect/decal/cleanable/blood/old{
	icon_state = "floor7-old"
	},
/turf/open/floor/plating/asteroid/basalt,
/area/overmap_encounter/planetoid/cave/explored)
"Zc" = (
/obj/effect/decal/cleanable/blood/old{
	icon_state = "floor5-old"
	},
/turf/open/floor/plating/asteroid/basalt,
/area/overmap_encounter/planetoid/cave/explored)

(1,1,1) = {"
xi
xi
xi
xi
xi
xi
xi
xi
xi
xi
xi
xi
xi
xi
xi
xi
xi
xi
"}
(2,1,1) = {"
xi
xi
xi
xR
xR
xR
xR
xR
xR
xR
xR
xR
xR
xi
xi
xi
xi
xi
"}
(3,1,1) = {"
xi
xi
xR
iI
RP
Ay
GS
xP
xR
Dk
zY
wm
xR
uW
Ay
Ay
xi
xi
"}
(4,1,1) = {"
xi
xi
xR
Ay
Ay
Ay
Hj
Ay
xR
wm
Ay
Dk
xR
Ay
sz
Ay
Ay
xi
"}
(5,1,1) = {"
xi
xi
xR
Ay
ET
Vk
Ay
Ay
xR
Dk
XW
Dk
xR
Ay
Ay
Zc
Ay
xi
"}
(6,1,1) = {"
xi
xi
xR
Ay
lt
Vk
Ay
Ay
xR
Dk
Ay
wm
xR
ui
Ay
Ay
xi
xi
"}
(7,1,1) = {"
xi
xi
xR
dO
Hg
mN
Ay
Ay
ks
Ay
Ay
Dk
xR
Ay
MR
xi
xi
xi
"}
(8,1,1) = {"
xi
xi
xR
Ay
NL
Vk
Ay
Ay
xR
uW
Ay
qj
xR
Ay
Ay
bP
xi
xi
"}
(9,1,1) = {"
xi
xi
xR
Ti
GD
Vk
Ay
Ay
xR
Dk
Ay
wm
xR
Ay
Pl
Ay
xi
xi
"}
(10,1,1) = {"
xi
xi
xR
sR
Ay
Ay
Ay
fr
xR
wm
zY
Ay
xR
xi
MR
GL
xi
xi
"}
(11,1,1) = {"
xi
xi
xR
xR
xR
xR
Ay
Sv
xR
xR
xR
ks
xR
xR
Ay
Ay
xi
xi
"}
(12,1,1) = {"
xi
xi
xi
xR
mO
Ay
Ay
Ay
Ay
xR
Ay
Ay
UM
xR
Ay
Bd
xi
xi
"}
(13,1,1) = {"
sS
xi
xi
xR
if
Ay
Ay
gB
th
xR
QZ
Ay
Ay
xR
Ay
Ay
xi
xi
"}
(14,1,1) = {"
sS
xi
xi
xR
Hj
Ay
Ay
Ay
Ay
xR
Cf
Ay
ui
ks
Ay
Ay
xi
xi
"}
(15,1,1) = {"
sS
xi
xR
xR
Ay
GL
Ay
Ay
Ay
xR
HZ
kY
Ay
ks
uW
Ay
xi
xi
"}
(16,1,1) = {"
sS
PW
xR
Ay
Ay
Ay
Ay
CI
Ay
xR
Ay
XW
Ay
xR
Ay
Ay
xi
xi
"}
(17,1,1) = {"
sS
Ay
ks
Ay
Ay
Ay
Ay
Oy
Ay
xR
iM
Fs
PB
xR
Ay
Ay
xi
xi
"}
(18,1,1) = {"
sS
zY
xR
xR
xR
xR
xR
xR
xR
xR
xR
xR
xR
xR
zY
xi
xi
xi
"}
(19,1,1) = {"
sS
xi
xi
xi
xi
xi
xi
xi
xi
xi
xi
xi
xi
xi
xi
xi
xi
xi
"}
(20,1,1) = {"
sS
xi
xi
xi
xi
xi
xi
xi
xi
xi
xi
xi
xi
xi
xi
xi
xi
xi
"}
