//MAP CONVERTED BY dmm2tgm.py THIS HEADER COMMENT PREVENTS RECONVERSION, DO NOT REMOVE
"an" = (
/obj/machinery/power/smes/shuttle{
	dir = 4
	},
/turf/open/floor/plasteel/mono/white,
/area/overmap_encounter/planetoid/lava/explored)
"aE" = (
/obj/structure/cable{
	icon_state = "4-8"
	},
/obj/structure/table/reinforced,
/obj/item/clothing/head/caphat{
	desc = "It's good being the Conductor.";
	name = "Conductor's peaked cap"
	},
/turf/open/floor/plasteel/mono/white,
/area/overmap_encounter/planetoid/lava/explored)
"bm" = (
/turf/closed/wall/mineral/titanium,
/area/overmap_encounter/planetoid/lava/explored)
"cj" = (
/obj/effect/decal/cleanable/dirt/dust,
/obj/effect/decal/cleanable/dirt/dust,
/obj/effect/decal/cleanable/blood/gibs/up,
/turf/open/floor/engine,
/area/overmap_encounter/planetoid/lava/explored)
"cp" = (
/obj/effect/turf_decal/corner/opaque/blue/border,
/mob/living/simple_animal/hostile/asteroid/goliath/beast,
/obj/effect/decal/cleanable/dirt/dust,
/turf/open/floor/engine,
/area/overmap_encounter/planetoid/lava/explored)
"cC" = (
/obj/effect/turf_decal/corner/opaque/blue/border{
	dir = 4
	},
/obj/effect/decal/cleanable/dirt/dust,
/obj/effect/decal/cleanable/dirt/dust,
/turf/open/floor/engine,
/area/overmap_encounter/planetoid/lava/explored)
"cH" = (
/obj/effect/turf_decal/corner/opaque/blue/border,
/obj/effect/decal/cleanable/dirt/dust,
/turf/open/floor/engine,
/area/overmap_encounter/planetoid/lava/explored)
"cR" = (
/obj/structure/cable{
	icon_state = "2-9"
	},
/turf/closed/wall/mineral/titanium,
/area/overmap_encounter/planetoid/lava/explored)
"da" = (
/obj/effect/turf_decal/industrial/traffic,
/obj/effect/decal/cleanable/dirt/dust,
/obj/effect/decal/cleanable/blood/tracks,
/turf/open/floor/plating,
/area/overmap_encounter/planetoid/lava/explored)
"dg" = (
/obj/machinery/power/terminal{
	dir = 8
	},
/obj/structure/cable,
/turf/closed/wall/mineral/titanium,
/area/overmap_encounter/planetoid/lava/explored)
"du" = (
/mob/living/simple_animal/hostile/asteroid/hivelord/legion,
/turf/open/floor/plasteel/mono/white,
/area/overmap_encounter/planetoid/lava/explored)
"dx" = (
/obj/structure/closet/crate/large,
/obj/machinery/portable_atmospherics/scrubber/huge/movable/cargo,
/turf/open/floor/engine,
/area/overmap_encounter/planetoid/lava/explored)
"dC" = (
/obj/effect/decal/cleanable/dirt/dust,
/turf/closed/wall/mineral/titanium,
/area/overmap_encounter/planetoid/lava/explored)
"dQ" = (
/obj/structure/closet/crate/large,
/obj/item/mecha_parts/mecha_equipment/anticcw_armor_booster,
/obj/item/mecha_parts/mecha_equipment/repair_droid,
/obj/item/mecha_parts/mecha_equipment/weapon/energy/laser/heavy,
/obj/item/mecha_parts/mecha_equipment/weapon/energy/plasma,
/turf/open/floor/plasteel/mono/white,
/area/overmap_encounter/planetoid/lava/explored)
"ec" = (
/mob/living/simple_animal/hostile/asteroid/hivelord/legion,
/obj/effect/decal/cleanable/dirt/dust,
/obj/effect/decal/cleanable/dirt/dust,
/turf/open/floor/plasteel/mono/white,
/area/overmap_encounter/planetoid/lava/explored)
"fo" = (
/mob/living/simple_animal/hostile/asteroid/goliath/beast,
/obj/effect/decal/cleanable/dirt/dust,
/obj/effect/decal/cleanable/dirt/dust,
/turf/open/floor/engine,
/area/overmap_encounter/planetoid/lava/explored)
"fz" = (
/obj/effect/turf_decal/corner/opaque/blue/border{
	dir = 1
	},
/obj/effect/decal/cleanable/blood/gibs/down,
/turf/open/floor/engine,
/area/overmap_encounter/planetoid/lava/explored)
"fT" = (
/obj/effect/turf_decal/corner/opaque/blue/border,
/obj/effect/decal/cleanable/dirt/dust,
/obj/effect/decal/cleanable/dirt/dust,
/obj/effect/decal/cleanable/dirt/dust,
/obj/effect/decal/cleanable/blood,
/turf/open/floor/engine,
/area/overmap_encounter/planetoid/lava/explored)
"gk" = (
/obj/structure/salvageable/safe_server,
/turf/open/floor/plasteel/mono/white,
/area/overmap_encounter/planetoid/lava/explored)
"gN" = (
/obj/structure/cable{
	icon_state = "1-4"
	},
/obj/effect/decal/cleanable/dirt/dust,
/turf/open/floor/plasteel/mono/white,
/area/overmap_encounter/planetoid/lava/explored)
"hg" = (
/obj/effect/decal/cleanable/dirt/dust,
/obj/effect/decal/cleanable/blood/gibs/core,
/turf/open/floor/engine,
/area/overmap_encounter/planetoid/lava/explored)
"hq" = (
/obj/effect/turf_decal/industrial/traffic{
	dir = 5
	},
/turf/open/floor/plating,
/area/overmap_encounter/planetoid/lava/explored)
"hK" = (
/obj/effect/turf_decal/corner/opaque/blue/border{
	dir = 10
	},
/mob/living/simple_animal/hostile/asteroid/elite/broodmother_child,
/obj/effect/decal/cleanable/dirt/dust,
/turf/open/floor/engine,
/area/overmap_encounter/planetoid/lava/explored)
"hM" = (
/obj/effect/turf_decal/corner/opaque/blue/border,
/mob/living/simple_animal/hostile/asteroid/goliath/beast,
/turf/open/floor/engine,
/area/overmap_encounter/planetoid/lava/explored)
"ij" = (
/obj/effect/turf_decal/corner/opaque/blue/border{
	dir = 8
	},
/mob/living/simple_animal/hostile/asteroid/elite/broodmother_child,
/obj/effect/decal/cleanable/dirt/dust,
/turf/open/floor/engine,
/area/overmap_encounter/planetoid/lava/explored)
"iq" = (
/obj/effect/decal/cleanable/dirt/dust,
/obj/effect/decal/cleanable/dirt/dust,
/obj/effect/decal/cleanable/blood/gibs/limb,
/turf/open/floor/engine,
/area/overmap_encounter/planetoid/lava/explored)
"jr" = (
/obj/structure/railing/modern{
	dir = 1
	},
/mob/living/simple_animal/hostile/asteroid/elite/broodmother_child,
/turf/open/floor/plating/asteroid/basalt/lava_land_surface,
/area/overmap_encounter/planetoid/lava/explored)
"jF" = (
/obj/machinery/door/airlock/freezer{
	name = "Airlock"
	},
/obj/effect/decal/cleanable/dirt/dust,
/turf/open/floor/plasteel/mono/white,
/area/overmap_encounter/planetoid/lava/explored)
"ks" = (
/obj/structure/closet/crate/engineering/electrical,
/obj/item/stack/cable_coil/red,
/obj/item/stack/cable_coil/red,
/obj/item/stack/cable_coil/red,
/obj/item/stock_parts/cell/gun/large,
/obj/item/stock_parts/cell/gun/large,
/obj/item/stock_parts/cell/gun,
/obj/item/stock_parts/cell/gun/mini,
/obj/item/stock_parts/cell/gun/mini,
/obj/item/stock_parts/cell/gun/mini,
/obj/item/stock_parts/cell/bluespace,
/obj/item/stock_parts/cell/bluespace,
/obj/effect/decal/cleanable/dirt/dust,
/turf/open/floor/plasteel/mono/white,
/area/overmap_encounter/planetoid/lava/explored)
"kP" = (
/obj/structure/flora/rock/pile,
/turf/open/floor/plating/asteroid/basalt/lava_land_surface,
/area/overmap_encounter/planetoid/lava/explored)
"kW" = (
/obj/structure/closet/crate,
/obj/item/reagent_containers/food/drinks/waterbottle/large,
/obj/item/reagent_containers/food/drinks/waterbottle/large,
/obj/item/reagent_containers/food/drinks/waterbottle/large,
/obj/item/reagent_containers/food/drinks/waterbottle/large,
/obj/item/reagent_containers/food/drinks/waterbottle/large,
/obj/item/reagent_containers/food/drinks/waterbottle/large,
/obj/item/reagent_containers/food/drinks/waterbottle/large,
/obj/item/reagent_containers/food/drinks/waterbottle/large,
/obj/effect/decal/cleanable/dirt/dust,
/turf/open/floor/plasteel/mono/white,
/area/overmap_encounter/planetoid/lava/explored)
"lP" = (
/mob/living/simple_animal/hostile/asteroid/goliath/beast,
/obj/effect/decal/cleanable/dirt/dust,
/turf/open/floor/plasteel/mono/white,
/area/overmap_encounter/planetoid/lava/explored)
"lU" = (
/mob/living/simple_animal/hostile/asteroid/elite/broodmother_child,
/obj/effect/decal/cleanable/dirt/dust,
/obj/effect/decal/cleanable/dirt/dust,
/turf/open/floor/engine,
/area/overmap_encounter/planetoid/lava/explored)
"lV" = (
/obj/structure/closet/crate/large,
/obj/item/stack/sheet/mineral/silver/fifty,
/turf/open/floor/plasteel/mono/white,
/area/overmap_encounter/planetoid/lava/explored)
"mv" = (
/obj/machinery/power/terminal{
	dir = 8
	},
/obj/structure/cable{
	icon_state = "0-2"
	},
/turf/closed/wall/mineral/titanium,
/area/overmap_encounter/planetoid/lava/explored)
"nj" = (
/obj/structure/closet/wardrobe/cargotech,
/obj/effect/decal/cleanable/dirt/dust,
/turf/open/floor/engine,
/area/overmap_encounter/planetoid/lava/explored)
"nP" = (
/obj/structure/closet/crate,
/obj/item/circuitboard/mecha/durand/main,
/obj/item/circuitboard/mecha/durand/peripherals,
/obj/item/circuitboard/mecha/durand/targeting,
/obj/item/stack/cable_coil/red,
/obj/item/stock_parts/scanning_module/triphasic,
/obj/item/stock_parts/capacitor/quadratic,
/obj/item/stock_parts/cell/bluespace,
/turf/open/floor/plasteel/mono/white,
/area/overmap_encounter/planetoid/lava/explored)
"nZ" = (
/obj/structure/cable{
	icon_state = "4-8"
	},
/obj/structure/table/reinforced,
/obj/item/paper{
	name = "Old Timetable";
	desc = "a spreed sheet that seems to have once shown stations and arrival and leaving times";
	default_raw_text = "Station $@*!"
	},
/turf/open/floor/plasteel/mono/white,
/area/overmap_encounter/planetoid/lava/explored)
"od" = (
/obj/structure/railing/modern,
/turf/open/floor/plating/asteroid/basalt/lava_land_surface,
/area/overmap_encounter/planetoid/lava/explored)
"of" = (
/obj/effect/turf_decal/industrial/traffic,
/obj/effect/decal/cleanable/dirt/dust,
/turf/open/floor/plating,
/area/overmap_encounter/planetoid/lava/explored)
"pa" = (
/obj/structure/salvageable/computer{
	dir = 8
	},
/turf/open/floor/plasteel/mono/white,
/area/overmap_encounter/planetoid/lava/explored)
"pB" = (
/turf/closed/wall/concrete/reinforced,
/area/overmap_encounter/planetoid/lava/explored)
"pN" = (
/obj/structure/closet/crate,
/obj/item/reagent_containers/food/snacks/rationpack,
/obj/item/reagent_containers/food/snacks/rationpack,
/obj/item/reagent_containers/food/snacks/rationpack,
/obj/item/reagent_containers/food/snacks/rationpack,
/turf/open/floor/plasteel/mono/white,
/area/overmap_encounter/planetoid/lava/explored)
"re" = (
/obj/effect/turf_decal/industrial/traffic{
	dir = 6
	},
/obj/effect/decal/cleanable/dirt/dust,
/turf/open/floor/plating,
/area/overmap_encounter/planetoid/lava/explored)
"rG" = (
/obj/effect/turf_decal/industrial/traffic,
/turf/open/floor/plating,
/area/overmap_encounter/planetoid/lava/explored)
"rW" = (
/obj/structure/flora/rock,
/turf/open/floor/plating/asteroid/basalt/lava_land_surface,
/area/overmap_encounter/planetoid/lava/explored)
"sD" = (
/turf/open/floor/engine,
/area/overmap_encounter/planetoid/lava/explored)
"tb" = (
/mob/living/simple_animal/hostile/asteroid/goliath/beast,
/obj/effect/decal/cleanable/dirt/dust,
/obj/effect/decal/cleanable/dirt/dust,
/obj/effect/decal/cleanable/dirt/dust,
/turf/open/floor/engine,
/area/overmap_encounter/planetoid/lava/explored)
"us" = (
/obj/structure/closet/crate/internals,
/obj/item/tank/internals/oxygen,
/obj/item/tank/internals/oxygen,
/obj/effect/decal/cleanable/dirt/dust,
/turf/open/floor/plasteel/mono/white,
/area/overmap_encounter/planetoid/lava/explored)
"uu" = (
/obj/structure/cable{
	icon_state = "1-2"
	},
/turf/open/floor/plasteel/mono/white,
/area/overmap_encounter/planetoid/lava/explored)
"vr" = (
/obj/effect/turf_decal/corner/opaque/blue/border{
	dir = 1
	},
/obj/effect/decal/cleanable/dirt/dust,
/obj/effect/decal/cleanable/dirt/dust,
/turf/open/floor/engine,
/area/overmap_encounter/planetoid/lava/explored)
"vF" = (
/obj/structure/closet/crate/large,
/obj/item/mecha_parts/part/durand_right_arm,
/obj/item/mecha_parts/part/durand_right_leg,
/turf/open/floor/plasteel/mono/white,
/area/overmap_encounter/planetoid/lava/explored)
"vH" = (
/mob/living/simple_animal/hostile/asteroid/goliath/beast,
/obj/effect/decal/cleanable/dirt/dust,
/turf/open/floor/engine,
/area/overmap_encounter/planetoid/lava/explored)
"wu" = (
/obj/machinery/door/poddoor/shutters/preopen,
/mob/living/simple_animal/hostile/asteroid/goliath/beast,
/turf/open/floor/plasteel/mono/white,
/area/overmap_encounter/planetoid/lava/explored)
"wB" = (
/obj/effect/turf_decal/industrial/traffic{
	dir = 1
	},
/mob/living/simple_animal/hostile/asteroid/elite/broodmother_child,
/turf/open/floor/plating,
/area/overmap_encounter/planetoid/lava/explored)
"wU" = (
/obj/effect/decal/cleanable/dirt/dust,
/obj/effect/decal/cleanable/blood/splatter,
/turf/open/floor/engine,
/area/overmap_encounter/planetoid/lava/explored)
"wV" = (
/obj/machinery/power/terminal,
/obj/structure/cable{
	icon_state = "0-8"
	},
/obj/effect/decal/cleanable/dirt/dust,
/turf/open/floor/plasteel/mono/white,
/area/overmap_encounter/planetoid/lava/explored)
"xp" = (
/obj/machinery/power/terminal{
	dir = 1
	},
/obj/structure/cable{
	icon_state = "0-8"
	},
/obj/effect/decal/cleanable/dirt/dust,
/obj/effect/decal/cleanable/dirt/dust,
/turf/open/floor/plasteel/mono/white,
/area/overmap_encounter/planetoid/lava/explored)
"xx" = (
/obj/structure/lattice,
/obj/item/stack/ore/salvage/scraptitanium,
/turf/open/floor/plating/asteroid/basalt/lava_land_surface,
/area/overmap_encounter/planetoid/lava/explored)
"xF" = (
/obj/machinery/power/shuttle/engine/electric{
	dir = 4
	},
/turf/open/floor/plasteel/mono/white,
/area/overmap_encounter/planetoid/lava/explored)
"xV" = (
/obj/structure/closet/crate,
/obj/item/clothing/gloves/color/latex/nitrile/evil{
	pixel_x = 1;
	pixel_y = -3
	},
/obj/item/clothing/suit/longcoat/roboblack,
/obj/item/clothing/suit/longcoat/robowhite,
/obj/item/clothing/gloves/color/latex/nitrile/evil,
/turf/open/floor/plasteel/mono/white,
/area/overmap_encounter/planetoid/lava/explored)
"zi" = (
/obj/machinery/door/poddoor/shutters,
/turf/open/floor/plasteel/mono/white,
/area/overmap_encounter/planetoid/lava/explored)
"zJ" = (
/obj/machinery/door/airlock/freezer{
	name = "Airlock"
	},
/obj/structure/cable{
	icon_state = "1-2"
	},
/turf/open/floor/plasteel/mono/white,
/area/overmap_encounter/planetoid/lava/explored)
"Ab" = (
/obj/effect/turf_decal/corner/opaque/blue/border{
	dir = 9
	},
/obj/effect/decal/cleanable/dirt/dust,
/turf/open/floor/engine,
/area/overmap_encounter/planetoid/lava/explored)
"AO" = (
/obj/structure/railing,
/turf/open/floor/plating/asteroid/basalt/lava_land_surface,
/area/overmap_encounter/planetoid/lava/explored)
"Bc" = (
/obj/effect/turf_decal/corner/opaque/blue/border,
/turf/open/floor/engine,
/area/overmap_encounter/planetoid/lava/explored)
"Bi" = (
/obj/effect/decal/cleanable/dirt/dust,
/turf/open/floor/plating/asteroid/basalt/lava_land_surface,
/area/overmap_encounter/planetoid/lava/explored)
"Bl" = (
/obj/machinery/power/smes,
/obj/structure/cable{
	icon_state = "0-4"
	},
/turf/open/floor/plasteel/mono/white,
/area/overmap_encounter/planetoid/lava/explored)
"Bv" = (
/obj/structure/mecha_wreckage/durand,
/turf/open/floor/plasteel/mono/white,
/area/overmap_encounter/planetoid/lava/explored)
"By" = (
/obj/structure/railing/modern/corner{
	dir = 1
	},
/obj/structure/railing/modern{
	dir = 1
	},
/turf/open/floor/plating/asteroid/basalt/lava_land_surface,
/area/overmap_encounter/planetoid/lava/explored)
"Bz" = (
/obj/structure/cable{
	icon_state = "6-8"
	},
/obj/structure/table/reinforced,
/obj/item/radio/intercom/table,
/turf/open/floor/plasteel/mono/white,
/area/overmap_encounter/planetoid/lava/explored)
"BU" = (
/obj/structure/closet/crate/hydroponics,
/obj/item/seeds/apple,
/obj/item/seeds/apple,
/obj/item/seeds/berry,
/obj/item/seeds/berry,
/obj/item/seeds/banana,
/obj/item/seeds/banana,
/obj/item/storage/bag/plants/portaseeder,
/obj/item/shovel/serrated,
/obj/item/cultivator/rake,
/obj/item/stack/sheet/mineral/sandstone/thirty,
/turf/open/floor/plasteel/mono/white,
/area/overmap_encounter/planetoid/lava/explored)
"CG" = (
/obj/structure/cable{
	icon_state = "1-10"
	},
/turf/closed/wall/mineral/titanium,
/area/overmap_encounter/planetoid/lava/explored)
"DB" = (
/obj/effect/turf_decal/corner/opaque/blue/border,
/obj/effect/decal/cleanable/dirt/dust,
/obj/effect/decal/cleanable/dirt/dust,
/turf/open/floor/engine,
/area/overmap_encounter/planetoid/lava/explored)
"Fj" = (
/obj/structure/railing{
	dir = 1
	},
/turf/open/floor/plating/asteroid/basalt/lava_land_surface,
/area/overmap_encounter/planetoid/lava/explored)
"FC" = (
/mob/living/simple_animal/hostile/asteroid/goliath/beast,
/turf/open/floor/plating/asteroid/basalt/lava_land_surface,
/area/overmap_encounter/planetoid/lava/explored)
"Gk" = (
/obj/effect/turf_decal/corner/opaque/blue/border,
/obj/effect/decal/cleanable/dirt/dust,
/obj/effect/decal/cleanable/dirt/dust,
/obj/effect/decal/cleanable/blood/splatter,
/turf/open/floor/engine,
/area/overmap_encounter/planetoid/lava/explored)
"Gs" = (
/mob/living/simple_animal/hostile/asteroid/hivelord/legion,
/obj/effect/decal/cleanable/dirt/dust,
/turf/open/floor/plasteel/mono/white,
/area/overmap_encounter/planetoid/lava/explored)
"GA" = (
/obj/structure/railing/modern/corner,
/obj/structure/railing/modern,
/turf/open/floor/plating/asteroid/basalt/lava_land_surface,
/area/overmap_encounter/planetoid/lava/explored)
"Hq" = (
/obj/effect/turf_decal/industrial/traffic{
	dir = 9
	},
/turf/open/floor/plating,
/area/overmap_encounter/planetoid/lava/explored)
"HL" = (
/obj/effect/turf_decal/corner/opaque/blue/border{
	dir = 1
	},
/obj/structure/closet/crate/large,
/obj/machinery/portable_atmospherics/scrubber/huge/movable/cargo,
/turf/open/floor/engine,
/area/overmap_encounter/planetoid/lava/explored)
"Ix" = (
/turf/template_noop,
/area/template_noop)
"IY" = (
/obj/item/stack/sheet/mineral/wood,
/turf/open/floor/plasteel/mono/white,
/area/overmap_encounter/planetoid/lava/explored)
"Jj" = (
/obj/machinery/door/poddoor/shutters/preopen,
/obj/effect/decal/cleanable/dirt/dust,
/obj/effect/decal/cleanable/dirt/dust,
/obj/effect/decal/cleanable/dirt/dust,
/turf/open/floor/plasteel/mono/white,
/area/overmap_encounter/planetoid/lava/explored)
"JD" = (
/obj/structure/railing/modern/corner{
	dir = 8
	},
/obj/structure/railing/modern,
/turf/open/floor/plating/asteroid/basalt/lava_land_surface,
/area/overmap_encounter/planetoid/lava/explored)
"JH" = (
/obj/effect/decal/cleanable/dirt/dust,
/turf/open/floor/engine,
/area/overmap_encounter/planetoid/lava/explored)
"JK" = (
/obj/effect/turf_decal/corner/opaque/blue/border,
/obj/effect/decal/cleanable/dirt/dust,
/obj/effect/decal/cleanable/dirt/dust,
/obj/effect/decal/cleanable/dirt/dust,
/turf/open/floor/engine,
/area/overmap_encounter/planetoid/lava/explored)
"Kb" = (
/obj/effect/decal/cleanable/dirt/dust,
/obj/effect/decal/cleanable/dirt/dust,
/obj/effect/decal/cleanable/dirt/dust,
/obj/effect/decal/cleanable/blood/gibs/up,
/turf/open/floor/engine,
/area/overmap_encounter/planetoid/lava/explored)
"Km" = (
/obj/structure/closet/crate/large,
/obj/item/mecha_parts/part/durand_left_arm,
/obj/item/mecha_parts/part/durand_left_leg,
/turf/open/floor/plasteel/mono/white,
/area/overmap_encounter/planetoid/lava/explored)
"Kv" = (
/obj/effect/turf_decal/corner/opaque/blue/border{
	dir = 8
	},
/obj/effect/decal/cleanable/dirt/dust,
/obj/effect/decal/cleanable/dirt/dust,
/turf/open/floor/engine,
/area/overmap_encounter/planetoid/lava/explored)
"KG" = (
/obj/structure/grille,
/obj/structure/window/reinforced/fulltile,
/turf/open/floor/plating,
/area/overmap_encounter/planetoid/lava/explored)
"Lg" = (
/obj/structure/railing/modern/corner{
	dir = 4
	},
/turf/open/floor/plating/asteroid/basalt/lava_land_surface,
/area/overmap_encounter/planetoid/lava/explored)
"LP" = (
/obj/item/crowbar/large,
/mob/living/simple_animal/hostile/asteroid/hivelord/legion,
/turf/open/floor/plasteel/mono/white,
/area/overmap_encounter/planetoid/lava/explored)
"Nx" = (
/obj/effect/turf_decal/industrial/traffic{
	dir = 1
	},
/turf/open/floor/plating,
/area/overmap_encounter/planetoid/lava/explored)
"NQ" = (
/obj/effect/turf_decal/corner/opaque/blue/border{
	dir = 1
	},
/obj/effect/decal/cleanable/dirt/dust,
/obj/effect/decal/cleanable/blood/gibs/core,
/turf/open/floor/engine,
/area/overmap_encounter/planetoid/lava/explored)
"Or" = (
/obj/structure/lattice,
/obj/item/stack/ore/salvage/scrapmetal,
/turf/open/floor/plating/asteroid/basalt/lava_land_surface,
/area/overmap_encounter/planetoid/lava/explored)
"Ot" = (
/obj/effect/turf_decal/corner/opaque/blue/border{
	dir = 1
	},
/turf/open/floor/engine,
/area/overmap_encounter/planetoid/lava/explored)
"Pt" = (
/obj/effect/turf_decal/corner/opaque/blue/border{
	dir = 1
	},
/obj/effect/decal/cleanable/dirt/dust,
/turf/open/floor/engine,
/area/overmap_encounter/planetoid/lava/explored)
"Pw" = (
/obj/effect/decal/cleanable/dirt/dust,
/obj/effect/decal/cleanable/blood/gibs/limb,
/turf/open/floor/engine,
/area/overmap_encounter/planetoid/lava/explored)
"PB" = (
/obj/effect/turf_decal/corner/opaque/blue/border{
	dir = 10
	},
/obj/effect/decal/cleanable/dirt/dust,
/turf/open/floor/engine,
/area/overmap_encounter/planetoid/lava/explored)
"PC" = (
/obj/item/stack/sheet/mineral/wood,
/obj/effect/decal/cleanable/dirt/dust,
/turf/open/floor/plasteel/mono/white,
/area/overmap_encounter/planetoid/lava/explored)
"PT" = (
/obj/structure/closet/crate/large,
/obj/item/stack/sheet/mineral/titanium/fifty,
/turf/open/floor/plasteel/mono/white,
/area/overmap_encounter/planetoid/lava/explored)
"Qk" = (
/obj/structure/closet/crate/internals,
/obj/item/tank/internals/oxygen,
/obj/item/tank/internals/oxygen,
/turf/open/floor/plasteel/mono/white,
/area/overmap_encounter/planetoid/lava/explored)
"Qm" = (
/obj/effect/turf_decal/corner/opaque/blue/border{
	dir = 5
	},
/obj/effect/decal/cleanable/dirt/dust,
/turf/open/floor/engine,
/area/overmap_encounter/planetoid/lava/explored)
"Qs" = (
/obj/effect/turf_decal/corner/opaque/blue/border{
	dir = 1
	},
/obj/effect/decal/cleanable/dirt/dust,
/obj/effect/decal/cleanable/blood,
/turf/open/floor/engine,
/area/overmap_encounter/planetoid/lava/explored)
"RB" = (
/obj/item/stack/ore/salvage/scraptitanium,
/obj/effect/decal/cleanable/dirt/dust,
/turf/open/floor/plasteel/mono/white,
/area/overmap_encounter/planetoid/lava/explored)
"RF" = (
/mob/living/simple_animal/hostile/asteroid/hivelord/legion,
/obj/structure/chair/comfy/shuttle{
	dir = 4;
	name = "Train seat";
	desc = "A comfortable, secure seat. It has a more sturdy looking buckling system, for smoother rides."
	},
/obj/effect/decal/cleanable/dirt/dust,
/turf/open/floor/plasteel/mono/white,
/area/overmap_encounter/planetoid/lava/explored)
"Sn" = (
/obj/structure/closet/crate/large,
/obj/item/stack/sheet/mineral/plastitanium/fifty,
/turf/open/floor/plasteel/mono/white,
/area/overmap_encounter/planetoid/lava/explored)
"SB" = (
/obj/structure/spawner/mining/goliath,
/turf/open/floor/plating/asteroid/basalt/lava_land_surface,
/area/overmap_encounter/planetoid/lava/explored)
"Te" = (
/obj/effect/turf_decal/corner/opaque/blue/border{
	dir = 8
	},
/obj/effect/decal/cleanable/dirt/dust,
/turf/open/floor/engine,
/area/overmap_encounter/planetoid/lava/explored)
"TK" = (
/mob/living/simple_animal/hostile/asteroid/elite/broodmother_child,
/turf/open/floor/plating/asteroid/basalt/lava_land_surface,
/area/overmap_encounter/planetoid/lava/explored)
"TL" = (
/obj/effect/turf_decal/corner/opaque/blue/border{
	dir = 1
	},
/obj/effect/decal/cleanable/dirt/dust,
/obj/effect/decal/cleanable/blood/gibs,
/turf/open/floor/engine,
/area/overmap_encounter/planetoid/lava/explored)
"TY" = (
/obj/structure/cable{
	icon_state = "5-8"
	},
/obj/structure/table/reinforced,
/obj/item/paper{
	name = "Old Manifest";
	desc = "a old sheet of paper that supposdly contained a list of carried goods its unreadable now";
	default_raw_text = "Contents by Car @#$&*"
	},
/turf/open/floor/plasteel/mono/white,
/area/overmap_encounter/planetoid/lava/explored)
"Uh" = (
/obj/structure/salvageable/machine,
/turf/open/floor/plasteel/mono/white,
/area/overmap_encounter/planetoid/lava/explored)
"Ul" = (
/obj/effect/decal/cleanable/dirt/dust,
/obj/effect/decal/cleanable/dirt/dust,
/obj/effect/decal/cleanable/dirt/dust,
/turf/open/floor/engine,
/area/overmap_encounter/planetoid/lava/explored)
"Ut" = (
/obj/structure/closet/wardrobe/cargotech,
/turf/open/floor/engine,
/area/overmap_encounter/planetoid/lava/explored)
"Uw" = (
/obj/effect/turf_decal/corner/opaque/blue/border{
	dir = 6
	},
/obj/effect/decal/cleanable/dirt/dust,
/turf/open/floor/engine,
/area/overmap_encounter/planetoid/lava/explored)
"Uz" = (
/obj/effect/decal/cleanable/dirt/dust,
/obj/effect/decal/cleanable/dirt/dust,
/turf/open/floor/engine,
/area/overmap_encounter/planetoid/lava/explored)
"UE" = (
/turf/open/floor/plating/asteroid/basalt/lava_land_surface,
/area/overmap_encounter/planetoid/lava/explored)
"UK" = (
/obj/structure/cable{
	icon_state = "1-2"
	},
/obj/effect/decal/cleanable/dirt/dust,
/turf/open/floor/plasteel/mono/white,
/area/overmap_encounter/planetoid/lava/explored)
"Vq" = (
/obj/structure/closet/crate/large,
/obj/item/stack/sheet/mineral/gold/fifty,
/turf/open/floor/plasteel/mono/white,
/area/overmap_encounter/planetoid/lava/explored)
"VA" = (
/obj/structure/railing/modern{
	dir = 1
	},
/turf/open/floor/plating/asteroid/basalt/lava_land_surface,
/area/overmap_encounter/planetoid/lava/explored)
"We" = (
/obj/mecha/working/ripley/cargo,
/obj/effect/decal/cleanable/dirt/dust,
/turf/open/floor/engine,
/area/overmap_encounter/planetoid/lava/explored)
"Wv" = (
/obj/effect/turf_decal/industrial/traffic{
	dir = 10
	},
/turf/open/floor/plating,
/area/overmap_encounter/planetoid/lava/explored)
"WJ" = (
/obj/structure/closet/crate/large,
/obj/item/stack/sheet/mineral/plasma/fifty,
/turf/open/floor/plasteel/mono/white,
/area/overmap_encounter/planetoid/lava/explored)
"WM" = (
/mob/living/simple_animal/hostile/asteroid/elite/broodmother_child,
/obj/effect/decal/cleanable/dirt/dust,
/turf/open/floor/engine,
/area/overmap_encounter/planetoid/lava/explored)
"Xf" = (
/obj/structure/chair/comfy/shuttle{
	dir = 4;
	name = "Train seat";
	desc = "A comfortable, secure seat. It has a more sturdy looking buckling system, for smoother rides."
	},
/obj/effect/decal/cleanable/dirt/dust,
/turf/open/floor/plasteel/mono/white,
/area/overmap_encounter/planetoid/lava/explored)
"Xg" = (
/obj/structure/closet/crate/internals,
/obj/item/tank/internals/oxygen,
/obj/item/tank/internals/oxygen,
/obj/effect/decal/cleanable/dirt/dust,
/obj/effect/decal/cleanable/dirt/dust,
/turf/open/floor/plasteel/mono/white,
/area/overmap_encounter/planetoid/lava/explored)
"Xw" = (
/obj/effect/turf_decal/corner/opaque/blue/border{
	dir = 4
	},
/obj/effect/decal/cleanable/dirt/dust,
/turf/open/floor/engine,
/area/overmap_encounter/planetoid/lava/explored)
"Xy" = (
/obj/effect/decal/cleanable/dirt/dust,
/obj/effect/decal/cleanable/dirt/dust,
/turf/open/floor/plating/asteroid/basalt/lava_land_surface,
/area/overmap_encounter/planetoid/lava/explored)
"XL" = (
/obj/effect/decal/cleanable/dirt/dust,
/turf/open/floor/plasteel/mono/white,
/area/overmap_encounter/planetoid/lava/explored)
"XO" = (
/obj/structure/cable{
	icon_state = "2-4"
	},
/turf/open/floor/plasteel/mono/white,
/area/overmap_encounter/planetoid/lava/explored)
"Yu" = (
/mob/living/simple_animal/hostile/asteroid/goliath/beast/ancient,
/obj/effect/decal/cleanable/dirt/dust,
/turf/open/floor/plasteel/mono/white,
/area/overmap_encounter/planetoid/lava/explored)
"ZK" = (
/obj/effect/turf_decal/industrial/caution{
	dir = 8
	},
/turf/open/floor/plating,
/area/overmap_encounter/planetoid/lava/explored)
"ZQ" = (
/obj/item/toy/prize/durand,
/turf/open/floor/plasteel/mono/white,
/area/overmap_encounter/planetoid/lava/explored)
"ZZ" = (
/obj/machinery/door/airlock/freezer{
	name = "Airlock"
	},
/turf/open/floor/plasteel/mono/white,
/area/overmap_encounter/planetoid/lava/explored)

(1,1,1) = {"
Ix
Ix
Ix
UE
UE
kP
UE
UE
GA
UE
UE
UE
UE
Lg
UE
UE
UE
Ix
Ix
Ix
Ix
"}
(2,1,1) = {"
Ix
Ix
UE
Bi
Bi
Bi
UE
UE
od
UE
UE
UE
UE
VA
UE
UE
UE
UE
UE
UE
Ix
"}
(3,1,1) = {"
Ix
Bi
Ab
Kv
Te
hK
Wv
UE
bm
bm
bm
bm
bm
bm
kP
Hq
Ab
Te
ij
PB
UE
"}
(4,1,1) = {"
Ix
Bi
Pt
Uz
iq
DB
rG
UE
bm
xV
kW
us
BU
bm
UE
Nx
Pt
Uz
Uz
cH
UE
"}
(5,1,1) = {"
Ix
Bi
Pt
pB
JH
cp
rG
UE
ZZ
XL
lP
XL
XL
jF
FC
Nx
Pt
dx
pB
Bc
UE
"}
(6,1,1) = {"
UE
Bi
NQ
pB
JH
DB
of
TK
bm
ks
Qk
Xg
pN
dC
UE
wB
Pt
JH
pB
hM
UE
"}
(7,1,1) = {"
UE
Bi
vr
Ul
Uz
DB
of
UE
bm
bm
bm
bm
bm
bm
UE
Nx
Ot
cj
JH
cH
UE
"}
(8,1,1) = {"
UE
Bi
vr
tb
Uz
DB
of
UE
od
UE
AO
Fj
UE
jr
UE
Nx
fz
JH
JH
cH
UE
"}
(9,1,1) = {"
UE
Bi
vr
Kb
Uz
cH
rG
UE
bm
bm
bm
bm
bm
bm
UE
Nx
Ot
JH
JH
cH
UE
"}
(10,1,1) = {"
UE
Bi
vr
Uz
Uz
DB
of
Bi
zi
Vq
Or
lV
Yu
Jj
UE
Nx
Pt
JH
hg
cH
UE
"}
(11,1,1) = {"
UE
Bi
Pt
pB
JH
cH
rG
UE
zi
RB
SB
xx
ec
Jj
TK
Nx
Pt
nj
pB
Bc
UE
"}
(12,1,1) = {"
UE
Bi
Pt
pB
JH
DB
of
UE
zi
Sn
Or
PT
WJ
wu
UE
Nx
Pt
nj
pB
Bc
UE
"}
(13,1,1) = {"
UE
Xy
vr
JH
JH
Gk
da
UE
bm
bm
bm
bm
bm
bm
UE
Nx
Pt
fo
Uz
cH
UE
"}
(14,1,1) = {"
UE
Bi
Pt
JH
JH
DB
of
UE
od
UE
AO
Fj
UE
VA
UE
Nx
Pt
JH
lU
cH
UE
"}
(15,1,1) = {"
UE
Bi
Pt
vH
JH
DB
of
UE
bm
bm
bm
bm
bm
bm
UE
Nx
Qs
JH
Uz
cH
UE
"}
(16,1,1) = {"
UE
Bi
Pt
JH
JH
DB
of
UE
zi
ZQ
PC
dQ
vF
zi
UE
Nx
Pt
hg
JH
cH
UE
"}
(17,1,1) = {"
UE
UE
HL
pB
WM
DB
of
UE
zi
LP
XL
Bv
nP
zi
UE
Nx
TL
JH
pB
Bc
UE
"}
(18,1,1) = {"
UE
UE
Ot
pB
JH
Gk
of
UE
zi
Km
IY
du
PC
zi
UE
Nx
Pt
We
pB
cH
Bi
"}
(19,1,1) = {"
UE
Bi
vr
JH
cj
JK
of
UE
bm
bm
bm
bm
bm
bm
UE
Nx
Pt
JH
sD
DB
Bi
"}
(20,1,1) = {"
UE
Bi
vr
JH
Uz
fT
of
UE
od
UE
AO
Fj
UE
VA
UE
Nx
Pt
Uz
dx
cH
Bi
"}
(21,1,1) = {"
UE
Bi
vr
JH
Uz
JK
of
UE
bm
bm
bm
bm
bm
bm
UE
Nx
Pt
Uz
dx
cH
Bi
"}
(22,1,1) = {"
UE
Bi
vr
wU
Uz
JK
of
UE
zJ
UK
gN
XO
uu
zJ
UE
Nx
Pt
Uz
JH
DB
Bi
"}
(23,1,1) = {"
UE
Bi
Pt
pB
nj
DB
of
ZK
bm
Bl
xp
wV
Bl
bm
ZK
Nx
Pt
Pw
pB
hM
UE
"}
(24,1,1) = {"
Ix
UE
Ot
pB
Ut
cp
of
xF
bm
nZ
XL
Gs
aE
bm
xF
Nx
Pt
JH
pB
Bc
UE
"}
(25,1,1) = {"
Ix
UE
Ot
sD
sD
cH
of
an
bm
TY
RF
Xf
Bz
bm
an
Nx
Pt
JH
sD
Bc
Ix
"}
(26,1,1) = {"
Ix
UE
Qm
Xw
Xw
Uw
re
mv
CG
Uh
pa
pa
gk
cR
dg
hq
Qm
cC
Xw
Uw
Ix
"}
(27,1,1) = {"
Ix
UE
Bi
Bi
Bi
UE
UE
UE
bm
bm
KG
KG
bm
bm
UE
UE
UE
UE
UE
UE
Ix
"}
(28,1,1) = {"
Ix
UE
UE
UE
kP
UE
UE
UE
od
UE
FC
UE
UE
VA
UE
UE
rW
UE
UE
UE
Ix
"}
(29,1,1) = {"
Ix
Ix
UE
rW
UE
UE
UE
UE
JD
UE
UE
UE
UE
By
UE
UE
UE
UE
UE
Ix
Ix
"}
(30,1,1) = {"
Ix
Ix
UE
UE
UE
UE
UE
UE
UE
UE
UE
UE
UE
VA
UE
UE
UE
UE
UE
Ix
Ix
"}
(31,1,1) = {"
Ix
Ix
Ix
UE
UE
UE
UE
UE
UE
UE
UE
UE
UE
UE
UE
Ix
Ix
Ix
Ix
Ix
Ix
"}
