//MAP CONVERTED BY dmm2tgm.py THIS HEADER COMMENT PREVENTS RECONVERSION, DO NOT REMOVE
"bk" = (
/obj/machinery/light/dim/directional/south,
/turf/open/floor/mineral/plastitanium{
	name = "base floor"
	},
/area/ruin/unpowered/syndicate_outpost)
"bA" = (
/obj/machinery/computer/telecomms/monitor,
/turf/open/floor/mineral/plastitanium/red{
	name = "base floor"
	},
/area/ruin/unpowered/syndicate_outpost)
"cO" = (
/obj/structure/chair/comfy/black{
	desc = "It looks like it hasn't been used in a long time.";
	dir = 1
	},
/turf/open/floor/carpet/black,
/area/ruin/unpowered/syndicate_outpost)
"eF" = (
/obj/machinery/computer/telecomms{
	dir = 8
	},
/turf/open/floor/mineral/plastitanium/red{
	name = "base floor"
	},
/area/ruin/unpowered/syndicate_outpost)
"fa" = (
/obj/machinery/door/window/survival_pod{
	dir = 1
	},
/turf/open/floor/mineral/plastitanium/airless{
	name = "telecomms floor"
	},
/area/ruin/unpowered/syndicate_outpost)
"ho" = (
/turf/closed/wall/mineral/plastitanium,
/area/ruin/unpowered/syndicate_outpost)
"iT" = (
/obj/structure/table/reinforced,
/obj/item/storage/toolbox/syndicate,
/turf/open/floor/mineral/plastitanium/red{
	name = "base floor"
	},
/area/ruin/unpowered/syndicate_outpost)
"js" = (
/turf/open/floor/mineral/plastitanium/red{
	name = "base floor"
	},
/area/ruin/unpowered/syndicate_outpost)
"ql" = (
/obj/structure/table/reinforced,
/turf/open/floor/mineral/plastitanium/red{
	name = "base floor"
	},
/area/ruin/unpowered/syndicate_outpost)
"qp" = (
/obj/structure/chair/comfy/black{
	dir = 8
	},
/turf/open/floor/mineral/plastitanium/red{
	name = "base floor"
	},
/area/ruin/unpowered/syndicate_outpost)
"so" = (
/obj/machinery/telecomms/broadcaster,
/turf/open/floor/mineral/plastitanium/airless{
	name = "telecomms floor"
	},
/area/ruin/unpowered/syndicate_outpost)
"uM" = (
/obj/machinery/light/dim/directional/west,
/turf/open/floor/mineral/plastitanium{
	name = "base floor"
	},
/area/ruin/unpowered/syndicate_outpost)
"xV" = (
/obj/machinery/light/dim/directional/north,
/turf/open/floor/carpet,
/area/ruin/unpowered/syndicate_outpost)
"AV" = (
/obj/structure/table/reinforced,
/obj/item/paper/crumpled/awaymissions/moonoutpost19/hastey_note{
	desc = "It seems like it was written in a hurry";
	default_raw_text = "<i>Hey, you're probably reading this after having killed me, but that's alright. I probably shot first. Names' Yuto, Syndicate Radio Operator, there used to be another op here, a nice one too. Had syndicate command not forgotten about this post, we'd of probably been executed for sentinmental attachments on the job. Although she didn't have to worry about that, the local fauna got her first. I guess this note is my way of saying sorry. Take what you want from this station and my body, you need it more than I do now. Good luck out there, whoever you are. - Syndicate Radio</i><br><br><i>e f.</i>";
	pixel_x = -3;
	pixel_y = 2
	},
/obj/item/candle{
	pixel_x = 8;
	pixel_y = 5
	},
/turf/open/floor/carpet,
/area/ruin/unpowered/syndicate_outpost)
"Cs" = (
/obj/item/trash/sosjerky{
	pixel_x = -9;
	pixel_y = 16
	},
/turf/open/floor/mineral/plastitanium{
	name = "base floor"
	},
/area/ruin/unpowered/syndicate_outpost)
"Et" = (
/obj/machinery/vending/cigarette/syndicate,
/turf/open/floor/carpet/black,
/area/ruin/unpowered/syndicate_outpost)
"EJ" = (
/obj/machinery/vending/sustenance,
/turf/open/floor/carpet/black,
/area/ruin/unpowered/syndicate_outpost)
"Hz" = (
/obj/structure/table/reinforced,
/obj/item/flashlight/lantern/lanternbang,
/turf/open/floor/mineral/plastitanium/red{
	name = "base floor"
	},
/area/ruin/unpowered/syndicate_outpost)
"II" = (
/obj/structure/table/reinforced,
/obj/item/trash/syndi_cakes{
	pixel_y = 13
	},
/turf/open/floor/mineral/plastitanium/red{
	name = "base floor"
	},
/area/ruin/unpowered/syndicate_outpost)
"JO" = (
/obj/machinery/door/airlock/highsecurity{
	hackProof = 1;
	name = "Secure Airlock"
	},
/turf/open/floor/mineral/plastitanium{
	name = "base floor"
	},
/area/ruin/unpowered/syndicate_outpost)
"Kq" = (
/obj/structure/chair/comfy/black,
/turf/open/floor/carpet,
/area/ruin/unpowered/syndicate_outpost)
"Kw" = (
/obj/machinery/telecomms/receiver,
/turf/open/floor/mineral/plastitanium/airless{
	name = "telecomms floor"
	},
/area/ruin/unpowered/syndicate_outpost)
"Lu" = (
/obj/effect/spawner/structure/window/plasma/reinforced/plastitanium,
/turf/open/floor/plating,
/area/ruin/unpowered/syndicate_outpost)
"Mo" = (
/obj/machinery/door/airlock/hatch{
	dir = 4
	},
/turf/open/floor/mineral/plastitanium/red{
	name = "base floor"
	},
/area/ruin/unpowered/syndicate_outpost)
"MK" = (
/obj/structure/closet/crate/grave/loot,
/turf/open/floor/plating/asteroid/basalt/lava_land_surface,
/area/overmap_encounter/planetoid/lava/explored)
"NT" = (
/turf/open/floor/mineral/plastitanium{
	name = "base floor"
	},
/area/ruin/unpowered/syndicate_outpost)
"OA" = (
/obj/structure/window/reinforced/survival_pod{
	dir = 1;
	name = "window"
	},
/turf/open/floor/mineral/plastitanium/airless{
	name = "telecomms floor"
	},
/area/ruin/unpowered/syndicate_outpost)
"Pi" = (
/obj/structure/bed/dogbed{
	desc = "A well worn dog bed, wait... are dog beds supposed to have burn marks?."
	},
/mob/living/simple_animal/hostile/asteroid/basilisk/watcher/magmawing{
	desc = "A domesticated Magmawing watcher, you weren't aware that was even possible. Unfortunately though, it's been domesticated by the Syndicate..";
	dir = 4;
	faction = list("Syndicate");
	movement_type = 1
	},
/turf/open/floor/mineral/plastitanium{
	name = "base floor"
	},
/area/ruin/unpowered/syndicate_outpost)
"PG" = (
/turf/closed/wall/mineral/plastitanium/interior,
/area/ruin/unpowered/syndicate_outpost)
"PX" = (
/turf/open/floor/carpet,
/area/ruin/unpowered/syndicate_outpost)
"RV" = (
/turf/open/floor/plating/asteroid/basalt/lava_land_surface,
/area/overmap_encounter/planetoid/lava/explored)
"SD" = (
/obj/structure/closet/crate,
/obj/item/clothing/gloves/combat,
/obj/item/gun/ballistic/automatic/pistol,
/obj/item/ammo_box/magazine/pistolm9mm,
/obj/item/ammo_box/magazine/pistolm9mm,
/obj/item/ammo_box/magazine/pistolm9mm,
/turf/open/floor/carpet/black,
/area/ruin/unpowered/syndicate_outpost)
"To" = (
/obj/machinery/light/dim/directional/west,
/turf/open/floor/mineral/plastitanium/red{
	name = "base floor"
	},
/area/ruin/unpowered/syndicate_outpost)
"Ts" = (
/mob/living/simple_animal/hostile/syndicate/ranged{
	dir = 8;
	health = 125;
	name = "Syndicate Radio Operative"
	},
/turf/open/floor/mineral/plastitanium/red{
	name = "base floor"
	},
/area/ruin/unpowered/syndicate_outpost)
"VY" = (
/obj/machinery/telecomms/bus,
/turf/open/floor/mineral/plastitanium/airless{
	name = "telecomms floor"
	},
/area/ruin/unpowered/syndicate_outpost)
"Wt" = (
/turf/template_noop,
/area/template_noop)
"WA" = (
/obj/machinery/portable_atmospherics/canister/air,
/turf/open/floor/mineral/plastitanium/red{
	name = "base floor"
	},
/area/ruin/unpowered/syndicate_outpost)
"WS" = (
/turf/open/floor/carpet/black,
/area/ruin/unpowered/syndicate_outpost)
"Xz" = (
/obj/machinery/door/window,
/turf/open/floor/mineral/plastitanium/red{
	name = "base floor"
	},
/area/ruin/unpowered/syndicate_outpost)
"XB" = (
/obj/structure/window/reinforced/survival_pod{
	dir = 1;
	name = "Window"
	},
/turf/open/floor/mineral/plastitanium/airless{
	name = "telecomms floor"
	},
/area/ruin/unpowered/syndicate_outpost)
"YJ" = (
/obj/structure/table/reinforced,
/obj/item/radio/intercom/wideband/directional/north,
/turf/open/floor/mineral/plastitanium/red{
	name = "base floor"
	},
/area/ruin/unpowered/syndicate_outpost)
"ZH" = (
/obj/machinery/door/airlock/hatch,
/turf/open/floor/mineral/plastitanium{
	name = "base floor"
	},
/area/ruin/unpowered/syndicate_outpost)

(1,1,1) = {"
RV
RV
RV
RV
RV
RV
RV
RV
Wt
Wt
Wt
Wt
Wt
Wt
"}
(2,1,1) = {"
RV
ho
ho
ho
JO
ho
ho
RV
RV
Wt
Wt
Wt
Wt
Wt
"}
(3,1,1) = {"
RV
ho
Pi
uM
NT
NT
ho
ho
RV
RV
RV
RV
RV
Wt
"}
(4,1,1) = {"
RV
Lu
NT
Cs
NT
NT
NT
ho
ho
ho
ho
ho
RV
RV
"}
(5,1,1) = {"
RV
Lu
II
YJ
ql
ql
NT
NT
PG
Et
EJ
ho
ho
RV
"}
(6,1,1) = {"
RV
Lu
js
qp
js
Hz
NT
NT
ZH
PX
WS
SD
ho
RV
"}
(7,1,1) = {"
RV
ho
js
Ts
js
Xz
NT
bk
PG
xV
PX
WS
ho
RV
"}
(8,1,1) = {"
RV
ho
PG
PG
Mo
PG
PG
PG
PG
Kq
AV
cO
ho
RV
"}
(9,1,1) = {"
RV
ho
bA
To
js
js
OA
so
PG
Lu
Lu
Lu
ho
RV
"}
(10,1,1) = {"
RV
ho
ho
eF
js
js
fa
VY
ho
RV
RV
RV
RV
RV
"}
(11,1,1) = {"
RV
RV
ho
ho
iT
WA
XB
Kw
ho
MK
RV
RV
RV
Wt
"}
(12,1,1) = {"
Wt
RV
RV
ho
ho
ho
ho
ho
ho
RV
RV
RV
RV
Wt
"}
(13,1,1) = {"
Wt
Wt
RV
RV
RV
RV
RV
RV
RV
RV
RV
RV
Wt
Wt
"}
