//MAP CONVERTED BY dmm2tgm.py THIS HEADER COMMENT PREVENTS RECONVERSION, DO NOT REMOVE
"a" = (
/turf/closed/mineral/random/snow,
/area/space)
"c" = (
/obj/machinery/door/airlock/external,
/turf/open/floor/plating/airless,
/area/space)
"g" = (
/obj/structure/window/plasma/fulltile,
/obj/structure/grille,
/turf/open/floor/plating,
/area/space)
"k" = (
/turf/open/space/basic,
/area/space)
"q" = (
/turf/open/floor/plating,
/area/space)
"u" = (
/obj/effect/anomaly/tvstatic/planetary,
/turf/open/space/basic,
/area/space)
"I" = (
/obj/machinery/power/tesla_coil/power,
/turf/open/floor/plating/airless,
/area/space)
"J" = (
/obj/effect/anomaly/flux/big/planetary{
	drops_core = 0
	},
/turf/open/floor/plating/airless,
/area/space)
"M" = (
/turf/open/floor/plating/airless,
/area/space)
"O" = (
/turf/open/floor/concrete/pavement,
/area/space)
"R" = (
/obj/machinery/power/grounding_rod,
/turf/open/floor/plating/airless,
/area/space)
"T" = (
/turf/open/floor/plasteel/dark,
/area/space)
"Y" = (
/turf/closed/wall/mineral/plastitanium,
/area/space)

(1,1,1) = {"
k
k
k
k
k
k
k
k
k
k
k
k
k
k
k
k
k
k
k
k
k
k
k
k
k
k
k
k
k
k
k
k
k
k
k
k
k
k
k
k
k
k
k
k
k
k
k
a
a
a
"}
(2,1,1) = {"
k
k
k
k
k
k
k
k
k
k
k
k
k
k
k
k
k
k
k
k
k
k
k
k
k
k
k
k
k
k
k
k
k
k
k
k
k
k
k
k
k
k
k
k
k
k
k
a
a
a
"}
(3,1,1) = {"
k
k
k
k
k
k
k
k
k
k
k
k
k
k
k
k
k
k
k
k
k
k
k
k
k
k
k
k
k
k
k
k
k
k
k
k
k
k
k
k
k
k
k
k
k
k
k
a
a
a
"}
(4,1,1) = {"
a
a
a
a
a
a
a
a
a
a
a
a
a
a
a
a
a
a
a
a
a
a
a
a
a
a
a
Y
Y
Y
Y
Y
Y
a
a
a
a
a
a
a
a
a
a
a
a
a
a
a
a
a
"}
(5,1,1) = {"
a
a
a
a
a
a
a
a
a
a
a
a
a
a
a
a
a
a
a
a
a
a
a
a
a
a
a
Y
q
q
q
q
Y
Y
a
a
a
a
a
a
a
a
a
a
a
a
a
a
a
a
"}
(6,1,1) = {"
a
a
a
a
a
a
a
a
a
a
a
a
a
a
a
a
a
a
a
a
a
a
a
a
a
a
a
Y
q
q
q
q
Y
Y
Y
Y
Y
Y
Y
Y
Y
Y
Y
Y
Y
a
a
a
a
a
"}
(7,1,1) = {"
a
a
a
a
a
a
a
a
Y
Y
Y
Y
a
a
a
a
a
a
a
a
a
a
a
a
Y
k
k
Y
q
q
q
q
Y
q
q
q
Y
q
q
q
Y
q
q
q
Y
a
a
a
a
a
"}
(8,1,1) = {"
a
a
a
a
a
a
a
a
Y
k
k
Y
Y
Y
a
a
a
a
Y
Y
Y
Y
Y
a
Y
Y
Y
Y
Y
q
q
q
Y
q
q
q
Y
q
q
q
Y
q
q
q
Y
k
a
a
a
a
"}
(9,1,1) = {"
a
a
a
a
a
a
a
a
Y
k
k
k
k
Y
a
a
Y
Y
Y
k
k
k
Y
Y
Y
k
k
k
Y
Y
T
T
Y
Y
Y
q
Y
Y
Y
q
Y
Y
Y
q
Y
Y
k
a
a
a
"}
(10,1,1) = {"
a
a
a
a
a
a
a
a
Y
k
k
k
k
Y
a
a
Y
k
k
k
k
k
k
k
Y
k
k
k
k
Y
T
T
T
T
T
T
T
T
T
T
T
T
T
T
T
Y
k
a
a
a
"}
(11,1,1) = {"
a
a
a
a
a
a
a
a
Y
k
k
k
k
Y
a
a
Y
k
k
k
k
k
k
k
Y
k
k
k
k
q
T
T
T
T
T
T
T
T
T
T
T
T
T
T
T
Y
k
a
a
a
"}
(12,1,1) = {"
a
a
a
a
Y
Y
Y
Y
Y
Y
k
Y
Y
Y
Y
a
Y
Y
k
k
k
k
k
k
Y
k
k
k
k
Y
T
T
Y
Y
Y
q
Y
Y
Y
q
Y
Y
Y
q
Y
Y
k
a
a
a
"}
(13,1,1) = {"
a
a
a
Y
Y
k
k
Y
k
k
k
k
k
k
Y
Y
Y
Y
Y
k
k
k
k
Y
Y
Y
k
k
k
Y
T
T
Y
q
q
q
Y
q
q
q
Y
q
q
q
Y
k
k
a
a
a
"}
(14,1,1) = {"
a
a
a
Y
k
k
k
Y
k
k
k
k
k
k
k
Y
T
T
Y
Y
Y
k
Y
Y
k
Y
k
k
Y
Y
T
T
Y
q
q
q
Y
q
q
q
Y
q
q
q
Y
a
a
a
a
a
"}
(15,1,1) = {"
a
a
a
Y
k
k
k
k
k
k
k
k
k
k
k
Y
T
T
Y
k
k
k
k
Y
Y
Y
Y
Y
Y
q
T
T
Y
Y
Y
Y
Y
Y
Y
Y
Y
Y
Y
Y
Y
a
a
a
a
a
"}
(16,1,1) = {"
a
a
a
Y
k
k
k
Y
k
k
k
k
k
k
k
Y
T
T
Y
k
k
k
k
Y
M
c
M
M
Y
Y
T
T
Y
Y
Y
q
q
q
q
Y
k
k
k
k
Y
a
a
a
a
a
"}
(17,1,1) = {"
a
a
a
Y
Y
k
k
Y
k
k
k
k
k
k
k
Y
T
T
k
k
k
k
k
Y
M
Y
M
M
M
Y
T
T
T
T
Y
q
q
q
q
Y
k
k
k
k
Y
Y
Y
a
a
a
"}
(18,1,1) = {"
a
a
a
a
Y
Y
Y
Y
k
Y
Y
g
g
g
g
Y
T
T
Y
Y
k
k
k
c
M
Y
M
M
M
Y
T
T
T
T
Y
q
q
q
q
k
k
k
q
q
q
q
Y
a
a
a
"}
(19,1,1) = {"
a
a
a
a
Y
Y
Y
Y
T
T
Y
k
k
k
k
q
T
T
k
Y
Y
k
Y
Y
Y
Y
M
R
M
Y
Y
Y
T
T
Y
q
q
q
q
Y
Y
Y
q
q
q
q
Y
Y
Y
Y
"}
(20,1,1) = {"
a
a
Y
Y
Y
k
k
Y
T
T
Y
k
k
k
k
q
T
T
Y
Y
k
k
k
Y
R
M
M
M
M
M
R
Y
T
T
Y
Y
q
Y
Y
Y
q
q
q
q
q
q
q
k
k
q
"}
(21,1,1) = {"
a
a
Y
k
k
k
k
Y
T
T
Y
k
k
k
k
Y
T
T
Y
k
k
k
k
g
M
M
I
M
I
M
M
Y
T
T
q
q
q
q
q
q
q
q
q
q
q
q
q
k
k
q
"}
(22,1,1) = {"
a
a
Y
k
k
k
T
T
T
T
k
k
k
k
k
Y
T
T
Y
k
k
k
k
g
M
M
M
J
M
M
M
Y
T
T
q
q
q
q
q
q
q
q
q
q
q
q
Y
Y
Y
Y
"}
(23,1,1) = {"
a
a
Y
k
k
k
T
T
T
T
Y
k
k
k
k
Y
T
T
Y
Y
k
k
k
g
M
M
I
M
I
M
M
Y
T
T
Y
Y
Y
Y
Y
Y
Y
q
q
q
q
q
Y
k
k
k
"}
(24,1,1) = {"
a
a
Y
k
k
k
T
T
T
T
Y
g
g
g
g
Y
T
T
k
Y
k
k
k
Y
R
M
M
M
M
M
R
Y
T
T
Y
k
k
k
Y
k
Y
Y
q
q
Y
Y
Y
k
k
k
"}
(25,1,1) = {"
a
a
Y
k
k
k
k
Y
T
T
T
T
T
T
T
T
T
T
k
Y
Y
Y
Y
Y
Y
Y
M
R
M
Y
Y
Y
T
T
Y
k
k
k
k
k
k
k
q
q
q
Y
k
k
k
k
"}
(26,1,1) = {"
a
a
Y
Y
Y
Y
k
Y
T
T
T
T
T
T
T
T
T
T
T
T
T
T
T
T
T
Y
M
M
M
Y
T
T
T
T
Y
k
k
k
k
k
k
k
k
k
k
g
k
k
k
k
"}
(27,1,1) = {"
a
a
a
a
Y
k
k
Y
T
T
Y
Y
Y
Y
Y
Y
Y
T
T
T
T
T
T
T
T
Y
Y
Y
Y
Y
T
T
T
T
Y
k
k
k
k
k
k
k
k
k
k
g
k
k
k
k
"}
(28,1,1) = {"
a
a
a
a
Y
Y
Y
Y
T
T
Y
q
q
q
Y
a
Y
Y
Y
k
Y
Y
Y
T
T
T
T
T
T
T
T
T
Y
Y
Y
k
k
Y
Y
k
k
k
k
k
k
g
k
k
k
k
"}
(29,1,1) = {"
a
a
a
a
Y
k
k
Y
T
T
Y
q
q
q
Y
Y
Y
k
k
k
k
k
Y
T
T
T
T
T
T
T
T
T
Y
a
Y
Y
Y
Y
Y
k
k
k
k
k
k
g
k
k
k
k
"}
(30,1,1) = {"
a
a
a
a
Y
k
k
k
T
T
q
q
q
q
q
Y
k
k
k
k
k
k
Y
Y
Y
Y
Y
T
T
Y
Y
Y
Y
Y
Y
a
a
a
Y
k
k
k
k
k
g
g
k
k
k
k
"}
(31,1,1) = {"
a
a
a
a
Y
k
k
Y
T
T
Y
q
q
q
q
Y
k
k
k
k
k
k
Y
a
a
a
Y
T
T
Y
a
a
a
a
a
a
a
a
Y
Y
Y
Y
Y
g
g
k
k
k
k
k
"}
(32,1,1) = {"
a
a
a
Y
Y
Y
Y
Y
T
T
Y
q
q
q
Y
Y
Y
k
k
k
k
Y
Y
a
a
a
Y
T
T
Y
a
a
a
Y
Y
a
a
k
k
k
k
k
k
k
k
k
k
k
k
k
"}
(33,1,1) = {"
a
a
a
a
Y
k
T
T
T
T
Y
q
q
q
Y
a
Y
Y
Y
Y
Y
Y
a
a
a
a
Y
T
T
Y
a
a
Y
Y
k
k
k
k
k
k
k
k
k
k
k
k
k
k
k
k
"}
(34,1,1) = {"
a
a
a
a
Y
k
T
T
T
T
Y
Y
Y
Y
Y
Y
Y
k
k
k
k
Y
Y
a
a
a
Y
T
T
Y
a
a
Y
k
k
k
k
k
k
k
k
k
k
k
k
k
k
k
k
k
"}
(35,1,1) = {"
a
a
a
a
Y
Y
k
Y
Y
Y
Y
a
a
a
Y
k
k
k
k
k
k
k
Y
Y
a
a
Y
T
T
Y
a
a
Y
k
k
k
O
O
O
O
O
O
O
O
O
k
k
k
k
k
"}
(36,1,1) = {"
a
a
a
Y
Y
a
k
k
k
k
Y
Y
a
a
Y
k
k
k
k
k
k
k
k
Y
a
a
Y
T
T
Y
a
a
Y
k
k
k
O
O
O
O
O
O
O
O
O
k
k
k
k
k
"}
(37,1,1) = {"
a
a
k
Y
a
a
a
k
Y
k
k
Y
Y
a
Y
k
k
k
k
k
k
k
k
Y
Y
Y
Y
T
T
Y
Y
Y
Y
Y
k
k
O
O
O
O
O
O
O
O
O
k
k
k
k
k
"}
(38,1,1) = {"
a
a
Y
Y
a
a
a
k
Y
k
Y
Y
Y
a
Y
k
k
k
k
k
k
k
k
Y
Y
k
k
T
T
k
k
k
Y
Y
Y
k
O
O
O
O
O
O
O
O
O
k
k
k
k
k
"}
(39,1,1) = {"
a
a
Y
Y
Y
a
a
Y
Y
k
k
Y
Y
a
Y
k
k
k
k
k
k
k
k
k
k
k
k
k
k
k
k
k
k
k
k
k
O
O
O
O
O
O
O
O
O
k
k
k
k
k
"}
(40,1,1) = {"
a
a
Y
k
k
k
k
k
k
k
k
k
Y
a
Y
k
k
k
k
k
k
k
k
k
k
k
k
k
k
k
k
k
k
k
k
k
O
O
O
O
O
O
O
O
O
k
k
k
k
k
"}
(41,1,1) = {"
a
a
Y
k
k
k
k
k
k
k
k
k
Y
a
Y
k
k
k
k
k
k
k
k
k
k
k
k
k
k
k
k
k
k
k
k
k
O
O
O
O
O
O
O
O
O
k
k
k
k
k
"}
(42,1,1) = {"
a
a
Y
k
k
k
k
k
k
k
k
k
Y
a
Y
k
k
k
k
k
k
k
k
Y
Y
k
k
k
k
k
k
k
Y
Y
Y
k
O
O
O
O
O
O
O
O
O
k
k
k
k
k
"}
(43,1,1) = {"
a
a
Y
k
k
k
k
u
k
k
k
k
Y
a
Y
k
k
k
k
k
k
k
k
Y
Y
Y
Y
Y
Y
Y
k
Y
Y
Y
Y
k
O
O
O
O
O
O
O
O
O
k
k
k
k
k
"}
(44,1,1) = {"
a
a
Y
k
k
k
k
k
k
k
k
k
Y
a
Y
Y
k
k
k
k
k
k
Y
Y
a
a
a
a
Y
k
k
k
k
Y
k
k
O
O
O
O
O
O
O
O
O
k
k
k
k
k
"}
(45,1,1) = {"
a
a
Y
Y
k
k
k
k
k
k
k
Y
Y
a
a
Y
Y
Y
Y
Y
Y
Y
Y
a
a
a
a
a
Y
k
k
k
k
k
k
k
O
O
O
O
O
O
O
O
O
k
k
k
k
k
"}
(46,1,1) = {"
a
a
a
Y
Y
Y
Y
Y
Y
Y
Y
Y
a
a
a
a
a
a
a
a
a
a
a
a
a
a
a
a
Y
k
k
k
k
k
k
k
O
O
O
O
O
O
O
O
O
k
k
k
k
k
"}
(47,1,1) = {"
a
a
a
a
a
a
a
a
a
a
a
a
a
a
a
a
a
a
a
a
a
a
a
a
a
a
a
a
Y
k
k
k
k
Y
k
k
O
O
O
O
O
O
O
O
O
k
k
k
k
k
"}
(48,1,1) = {"
a
a
a
a
a
a
a
a
a
a
a
a
a
a
a
a
a
a
a
a
a
a
a
a
a
a
a
a
Y
Y
Y
Y
Y
Y
k
k
k
k
k
k
k
k
k
k
k
k
k
k
k
k
"}
(49,1,1) = {"
a
a
a
a
a
a
a
a
a
a
a
a
a
a
a
a
a
a
a
a
a
a
a
a
a
a
a
a
a
a
a
a
a
a
a
k
k
k
k
k
k
k
k
k
k
k
k
k
k
k
"}
(50,1,1) = {"
a
a
a
a
a
a
a
a
a
a
a
a
a
a
a
a
a
a
a
a
a
a
a
a
a
a
a
a
a
a
a
a
a
a
a
a
a
a
k
k
k
k
k
k
k
k
k
k
k
k
"}
