//MAP CONVERTED BY dmm2tgm.py THIS HEADER COMMENT PREVENTS RECONVERSION, DO NOT REMOVE
"a" = (
/turf/closed/mineral/random/snow,
/area/space)
"c" = (
/obj/machinery/door/airlock/external,
/turf/open/floor/plating/airless,
/area/space)
"g" = (
/obj/structure/window/plasma/fulltile,
/obj/structure/grille,
/turf/open/floor/plating,
/area/space)
"k" = (
/turf/open/space/basic,
/area/space)
"q" = (
/turf/open/floor/plating,
/area/space)
"I" = (
/obj/machinery/power/tesla_coil/power,
/turf/open/floor/plating/airless,
/area/space)
"J" = (
/obj/effect/anomaly/flux/big/planetary{
	drops_core = 0
	},
/turf/open/floor/plating/airless,
/area/space)
"M" = (
/turf/open/floor/plating/airless,
/area/space)
"R" = (
/obj/machinery/power/grounding_rod,
/turf/open/floor/plating/airless,
/area/space)
"Y" = (
/turf/closed/wall/mineral/titanium,
/area/space)

(1,1,1) = {"
a
a
a
a
a
a
a
a
a
a
a
a
a
a
a
a
a
a
a
a
a
a
a
a
a
a
a
a
a
a
a
a
a
a
a
a
a
a
a
a
a
a
a
a
a
a
a
a
a
a
"}
(2,1,1) = {"
a
a
a
a
a
a
a
a
a
a
a
a
a
a
a
a
a
a
a
a
a
a
a
a
a
a
a
a
a
a
a
a
a
a
a
a
a
a
a
a
a
a
a
a
a
a
a
a
a
a
"}
(3,1,1) = {"
a
a
a
a
a
a
a
a
a
a
a
a
a
a
a
a
a
a
a
a
a
a
a
a
a
a
a
a
a
a
a
a
a
a
a
a
a
a
a
a
a
a
a
a
a
a
a
a
a
a
"}
(4,1,1) = {"
a
a
a
a
a
a
a
a
a
a
a
a
a
a
a
a
a
a
a
a
a
a
a
a
a
a
a
a
a
a
a
a
a
a
a
a
a
a
a
a
a
a
a
a
a
a
a
a
a
a
"}
(5,1,1) = {"
a
a
a
a
a
a
a
a
a
a
a
a
a
a
a
a
a
a
a
a
a
a
a
a
a
a
a
a
a
a
a
a
a
a
a
a
a
a
a
a
a
a
a
a
a
a
a
a
a
a
"}
(6,1,1) = {"
a
a
a
a
a
a
a
a
a
a
a
a
a
a
a
a
a
a
a
a
a
a
a
a
a
a
a
a
a
a
a
a
a
a
a
a
a
a
a
a
a
a
a
a
a
a
a
a
a
a
"}
(7,1,1) = {"
a
a
a
a
a
a
a
a
a
a
a
a
a
a
a
a
a
a
a
a
a
a
a
a
a
a
a
a
a
a
a
a
a
a
a
a
a
a
a
a
a
a
a
a
a
a
a
a
a
a
"}
(8,1,1) = {"
a
a
a
a
a
a
a
a
a
a
a
a
a
a
a
a
a
a
a
a
a
a
a
a
a
a
a
a
a
a
k
k
a
a
a
a
a
a
a
a
a
a
a
a
a
a
a
a
a
a
"}
(9,1,1) = {"
a
a
a
a
a
a
a
a
a
k
k
k
k
k
a
a
k
k
a
a
a
a
a
a
a
a
a
a
a
a
k
k
a
a
a
a
a
a
a
a
a
a
a
a
a
a
a
a
a
a
"}
(10,1,1) = {"
a
a
a
a
a
a
a
a
k
k
k
k
k
k
k
a
k
k
a
a
a
a
a
a
a
a
a
a
a
a
k
k
a
a
a
a
a
a
a
a
a
a
a
a
a
a
a
a
a
a
"}
(11,1,1) = {"
a
a
a
a
a
a
a
a
k
k
k
k
k
k
k
a
k
k
Y
Y
Y
Y
Y
Y
a
a
a
a
a
a
k
k
a
a
a
a
a
a
a
a
a
a
a
a
a
a
a
a
a
a
"}
(12,1,1) = {"
a
a
a
a
a
a
a
a
a
a
k
a
M
M
a
a
k
k
Y
k
k
k
k
Y
Y
Y
Y
Y
Y
k
k
k
a
a
a
a
a
a
a
a
a
a
a
a
a
a
a
a
a
a
"}
(13,1,1) = {"
a
a
a
a
a
k
k
k
k
k
k
k
k
k
k
k
k
k
Y
k
k
k
k
Y
M
c
M
M
Y
Y
k
k
Y
Y
Y
q
q
q
q
a
a
a
a
a
a
a
a
a
a
a
"}
(14,1,1) = {"
a
a
a
a
a
k
k
k
k
k
k
k
k
k
k
k
k
k
k
k
k
k
k
Y
M
Y
M
M
M
Y
k
k
k
k
Y
q
q
q
q
a
a
a
a
a
a
a
a
a
a
a
"}
(15,1,1) = {"
a
a
a
a
a
a
a
a
k
k
a
M
M
M
M
a
k
k
Y
Y
k
k
k
c
M
Y
M
M
M
Y
k
k
k
k
Y
q
q
q
q
a
a
a
q
q
q
q
a
a
a
a
"}
(16,1,1) = {"
a
a
a
a
a
a
a
a
k
k
a
k
k
k
k
M
k
k
k
Y
Y
Y
Y
Y
Y
Y
M
R
M
Y
Y
Y
k
k
Y
q
q
q
q
a
a
q
q
q
q
q
q
a
a
a
"}
(17,1,1) = {"
a
a
k
k
k
k
k
a
k
k
a
k
k
k
k
M
k
k
Y
Y
k
k
k
Y
R
M
M
M
M
M
R
Y
k
k
Y
Y
q
a
a
a
a
q
q
q
q
q
q
a
a
a
"}
(18,1,1) = {"
a
a
k
k
k
k
k
k
k
k
a
k
k
k
k
a
k
k
Y
k
k
k
k
g
M
M
I
M
I
M
M
Y
k
k
q
q
q
q
q
q
q
q
q
q
q
q
q
a
a
a
"}
(19,1,1) = {"
a
a
k
k
k
k
k
a
k
k
k
k
k
k
k
a
k
k
Y
k
k
k
k
g
M
M
M
J
M
M
M
Y
k
k
q
q
q
q
q
q
q
q
q
q
q
q
q
a
a
a
"}
(20,1,1) = {"
a
a
k
k
k
k
k
a
k
k
a
k
k
k
k
a
a
k
Y
Y
k
k
k
g
M
M
I
M
I
M
M
Y
k
k
Y
Y
Y
Y
a
a
a
q
q
q
q
q
q
a
a
a
"}
(21,1,1) = {"
a
a
a
k
k
k
a
a
k
k
a
a
a
a
a
a
a
k
k
Y
k
k
k
Y
R
M
M
M
M
M
R
Y
k
k
Y
k
k
k
a
a
a
q
q
q
q
q
q
a
a
a
"}
(22,1,1) = {"
a
a
a
k
k
a
a
a
k
k
a
a
a
a
a
a
a
k
k
Y
Y
k
Y
Y
Y
Y
M
R
M
Y
Y
Y
k
k
Y
k
k
k
k
a
a
a
q
q
q
q
a
a
a
a
"}
(23,1,1) = {"
a
a
a
a
a
a
a
a
k
k
a
a
a
a
a
a
a
k
k
k
k
k
k
k
k
Y
M
M
M
Y
k
k
k
k
k
k
k
k
k
a
a
a
a
a
a
a
a
a
a
a
"}
(24,1,1) = {"
a
a
a
a
a
a
a
a
k
k
a
a
a
a
a
a
a
k
k
k
k
k
k
k
k
Y
Y
Y
Y
Y
k
k
k
k
a
k
k
k
a
a
a
a
a
a
a
a
a
a
a
a
"}
(25,1,1) = {"
a
a
a
a
a
a
a
a
k
k
a
a
a
a
a
a
a
a
a
k
a
a
k
k
k
k
k
k
k
k
k
k
k
a
a
k
k
a
a
a
a
a
a
a
a
a
a
a
a
a
"}
(26,1,1) = {"
a
a
a
a
a
a
a
a
k
k
a
a
a
a
a
a
a
k
k
k
k
a
a
k
k
k
k
k
k
k
k
k
a
a
a
a
a
a
a
a
a
a
a
a
a
a
a
a
a
a
"}
(27,1,1) = {"
a
a
a
a
a
a
a
a
k
k
a
a
a
a
a
a
k
k
k
k
k
k
a
a
a
a
a
k
k
a
a
a
a
a
a
a
a
a
a
a
a
a
a
a
a
a
a
a
a
a
"}
(28,1,1) = {"
a
a
a
a
a
a
a
a
k
k
a
a
a
a
a
a
k
k
k
k
k
k
a
a
a
a
a
k
k
a
a
a
a
a
a
a
a
a
a
a
a
a
a
a
a
a
a
a
a
a
"}
(29,1,1) = {"
a
a
a
a
a
a
a
a
k
k
a
a
a
a
a
a
k
k
k
k
k
a
a
a
a
a
a
k
k
a
a
a
a
a
a
a
a
a
a
a
a
a
a
a
a
a
a
a
a
a
"}
(30,1,1) = {"
a
a
a
a
a
a
a
a
a
a
a
a
a
a
a
a
a
a
a
a
a
a
a
a
a
a
a
k
k
a
a
a
a
a
a
a
a
a
a
a
a
a
a
a
a
a
a
a
a
a
"}
(31,1,1) = {"
a
a
a
a
a
a
a
a
a
a
a
a
a
a
a
a
a
a
a
a
a
a
a
a
a
a
a
k
k
a
a
a
a
a
a
a
a
a
a
a
a
a
a
a
a
a
a
a
a
a
"}
(32,1,1) = {"
a
a
a
a
a
a
a
a
a
a
a
a
a
a
a
k
k
k
k
k
k
k
k
a
a
a
a
k
k
a
a
a
a
a
a
a
a
a
a
a
a
a
a
a
a
a
a
a
a
a
"}
(33,1,1) = {"
a
a
a
a
a
a
a
a
a
a
a
a
a
a
a
k
k
k
k
k
k
k
k
a
a
a
a
k
k
a
a
a
a
a
a
a
a
a
a
a
a
a
a
a
a
a
a
a
a
a
"}
(34,1,1) = {"
a
a
a
a
a
a
a
a
a
a
a
a
a
a
a
k
k
k
k
k
k
k
k
a
a
a
a
k
k
a
a
a
a
a
a
a
a
a
a
a
a
a
a
a
a
a
a
a
a
a
"}
(35,1,1) = {"
a
a
a
a
a
a
a
a
a
a
a
a
a
a
a
k
k
k
k
k
k
k
k
a
a
k
k
k
k
k
k
k
a
a
a
a
a
a
a
a
a
a
a
a
a
a
a
a
a
a
"}
(36,1,1) = {"
a
a
a
a
a
a
a
a
a
a
a
a
a
a
a
k
k
k
k
k
k
k
k
k
k
k
k
k
k
k
k
k
a
a
a
a
a
a
a
a
a
a
a
a
a
a
a
a
a
a
"}
(37,1,1) = {"
a
a
a
a
a
a
a
a
a
a
a
a
a
a
a
k
k
k
k
k
k
k
k
k
k
k
k
k
k
k
k
k
a
a
a
a
a
a
a
a
a
a
a
a
a
a
a
a
a
a
"}
(38,1,1) = {"
a
a
a
a
a
a
a
a
a
a
a
a
a
a
a
k
k
k
k
k
k
k
k
k
k
k
k
k
k
k
k
k
a
a
a
a
a
a
a
a
a
a
a
a
a
a
a
a
a
a
"}
(39,1,1) = {"
a
a
a
a
a
a
a
a
a
a
a
a
a
a
a
k
k
k
k
k
k
k
k
a
a
k
k
k
k
k
k
k
a
a
a
a
a
a
a
a
a
a
a
a
a
a
a
a
a
a
"}
(40,1,1) = {"
a
a
a
a
a
a
a
a
a
a
a
a
a
a
a
k
k
k
k
k
k
k
k
a
a
a
k
a
a
a
a
a
a
a
a
a
a
a
a
a
a
a
a
a
a
a
a
a
a
a
"}
(41,1,1) = {"
a
a
a
a
a
a
a
a
a
a
a
a
a
a
a
k
k
k
k
k
k
k
k
k
k
k
k
k
k
a
a
a
a
a
a
a
a
a
a
a
a
a
a
a
a
a
a
a
a
a
"}
(42,1,1) = {"
a
a
a
a
a
a
a
a
a
a
a
a
a
a
a
k
k
k
k
k
k
k
k
k
k
k
k
k
k
a
a
a
a
a
a
a
a
a
a
a
a
a
a
a
a
a
a
a
a
a
"}
(43,1,1) = {"
a
a
a
a
a
a
a
a
a
a
a
a
a
a
a
k
k
k
k
k
k
k
k
k
k
k
k
k
k
a
a
a
a
a
a
a
a
a
a
a
a
a
a
a
a
a
a
a
a
a
"}
(44,1,1) = {"
a
a
a
a
a
a
a
a
a
a
a
a
a
a
a
k
k
k
k
k
k
k
k
k
k
k
k
k
k
a
a
a
a
a
a
a
a
a
a
a
a
a
a
a
a
a
a
a
a
a
"}
(45,1,1) = {"
a
a
a
a
a
a
a
a
a
a
a
a
a
a
a
k
k
k
k
k
k
k
k
a
a
a
a
a
a
a
a
a
a
a
a
a
a
a
a
a
a
a
a
a
a
a
a
a
a
a
"}
(46,1,1) = {"
a
a
a
a
a
a
a
a
a
a
a
a
a
a
a
k
k
k
k
k
k
k
k
a
a
a
a
a
a
a
a
a
a
a
a
a
a
a
a
a
a
a
a
a
a
a
a
a
a
a
"}
(47,1,1) = {"
a
a
a
a
a
a
a
a
a
a
a
a
a
a
a
a
a
a
a
a
a
a
a
a
a
a
a
a
a
a
a
a
a
a
a
a
a
a
a
a
a
a
a
a
a
a
a
a
a
a
"}
(48,1,1) = {"
a
a
a
a
a
a
a
a
a
a
a
a
a
a
a
a
a
a
a
a
a
a
a
a
a
a
a
a
a
a
a
a
a
a
a
a
a
a
a
a
a
a
a
a
a
a
a
a
a
a
"}
(49,1,1) = {"
a
a
a
a
a
a
a
a
a
a
a
a
a
a
a
a
a
a
a
a
a
a
a
a
a
a
a
a
a
a
a
a
a
a
a
a
a
a
a
a
a
a
a
a
a
a
a
a
a
a
"}
(50,1,1) = {"
a
a
a
a
a
a
a
a
a
a
a
a
a
a
a
a
a
a
a
a
a
a
a
a
a
a
a
a
a
a
a
a
a
a
a
a
a
a
a
a
a
a
a
a
a
a
a
a
a
a
"}
