//MAP CONVERTED BY dmm2tgm.py THIS HEADER COMMENT PREVENTS RECONVERSION, DO NOT REMOVE
"aH" = (
/obj/effect/turf_decal/trimline/transparent/blue/line{
	dir = 1
	},
/turf/open/floor/plasteel/dark,
/area/space)
"aW" = (
/obj/effect/turf_decal/trimline/transparent/blue/corner,
/turf/open/floor/plasteel/dark,
/area/space)
"bi" = (
/obj/effect/turf_decal/industrial/warning{
	dir = 1
	},
/turf/open/floor/engine/hull,
/area/space)
"bP" = (
/obj/structure/catwalk/over,
/obj/effect/turf_decal/techfloor{
	dir = 9
	},
/turf/open/floor/plating/airless,
/area/space)
"cM" = (
/obj/effect/anomaly/tvstatic/planetary,
/turf/open/space/basic,
/area/space)
"dd" = (
/obj/effect/turf_decal/industrial/warning,
/turf/open/floor/engine/hull,
/area/space)
"dL" = (
/obj/effect/turf_decal/trimline/transparent/blue/line{
	dir = 10
	},
/obj/effect/turf_decal/siding/thinplating/dark{
	dir = 10
	},
/turf/open/floor/plasteel/dark,
/area/space)
"go" = (
/obj/machinery/door/airlock/external,
/turf/open/floor/plating/airless,
/area/space)
"js" = (
/obj/effect/turf_decal/trimline/transparent/blue/corner{
	dir = 4
	},
/turf/open/floor/plasteel/dark,
/area/space)
"kB" = (
/obj/effect/anomaly/flux/big/planetary{
	drops_core = 0
	},
/obj/effect/turf_decal/industrial,
/turf/open/floor/engine/hull,
/area/space)
"nx" = (
/obj/effect/turf_decal/trimline/transparent/blue/line,
/turf/open/floor/plasteel/dark,
/area/space)
"nL" = (
/turf/open/floor/plating/airless,
/area/space)
"od" = (
/obj/structure/catwalk/over,
/obj/effect/turf_decal/techfloor{
	dir = 6
	},
/turf/open/floor/plating/airless,
/area/space)
"om" = (
/obj/machinery/power/grounding_rod,
/obj/effect/turf_decal/industrial,
/turf/open/floor/plasteel/tech/airless,
/area/space)
"oX" = (
/obj/machinery/power/tesla_coil/power,
/obj/effect/turf_decal/industrial/outline/yellow,
/turf/open/floor/engine/hull,
/area/space)
"qy" = (
/obj/structure/catwalk/over,
/obj/effect/turf_decal/techfloor{
	dir = 8
	},
/turf/open/floor/plating/airless,
/area/space)
"qO" = (
/obj/effect/turf_decal/trimline/transparent/blue/line{
	dir = 5
	},
/turf/open/floor/plasteel/dark,
/area/space)
"qR" = (
/obj/effect/turf_decal/trimline/transparent/blue/line{
	dir = 10
	},
/turf/open/floor/plasteel/dark,
/area/space)
"sv" = (
/turf/open/floor/concrete/pavement,
/area/space)
"uk" = (
/obj/effect/turf_decal/trimline/transparent/blue/corner{
	dir = 1
	},
/turf/open/floor/plasteel/dark,
/area/space)
"uP" = (
/turf/open/space/basic,
/area/space)
"vc" = (
/obj/effect/turf_decal/trimline/transparent/blue/line{
	dir = 8
	},
/turf/open/floor/plasteel/dark,
/area/space)
"vf" = (
/obj/effect/turf_decal/industrial/warning,
/turf/open/floor/plating,
/area/space)
"vr" = (
/obj/effect/turf_decal/siding/wood{
	dir = 8
	},
/obj/machinery/door/firedoor/border_only{
	dir = 8
	},
/obj/machinery/door/firedoor/border_only{
	dir = 4
	},
/turf/open/floor/plasteel/dark,
/area/space)
"vV" = (
/obj/effect/turf_decal/trimline/transparent/blue/line{
	dir = 4
	},
/obj/effect/turf_decal/siding/thinplating/dark{
	dir = 4
	},
/turf/open/floor/plasteel/dark,
/area/space)
"wx" = (
/obj/effect/spawner/bunk_bed,
/turf/open/floor/carpet/blue,
/area/space)
"zf" = (
/obj/effect/turf_decal/trimline/transparent/blue/line{
	dir = 8
	},
/obj/effect/turf_decal/siding/thinplating/dark{
	dir = 8
	},
/turf/open/floor/plasteel/dark,
/area/space)
"AK" = (
/obj/effect/turf_decal/industrial/caution{
	dir = 8
	},
/obj/effect/turf_decal/industrial/warning{
	dir = 4;
	layer = 2.456
	},
/turf/open/floor/plasteel/tech/airless,
/area/space)
"BD" = (
/obj/effect/turf_decal/industrial/warning{
	dir = 4;
	layer = 2.456
	},
/turf/open/floor/plasteel/tech/airless,
/area/space)
"CE" = (
/turf/open/floor/engine/hull,
/area/space)
"Fl" = (
/obj/effect/spawner/bunk_bed{
	dir = 1
	},
/turf/open/floor/carpet/blue,
/area/space)
"FL" = (
/turf/open/floor/plasteel/tech,
/area/space)
"FX" = (
/obj/structure/catwalk/over,
/obj/effect/turf_decal/techfloor{
	dir = 10
	},
/turf/open/floor/plating/airless,
/area/space)
"Gh" = (
/obj/structure/table/wood,
/turf/open/floor/carpet/blue,
/area/space)
"GY" = (
/obj/effect/turf_decal/siding/wood{
	dir = 4
	},
/obj/machinery/door/firedoor/border_only{
	dir = 8
	},
/obj/machinery/door/firedoor/border_only{
	dir = 4
	},
/turf/open/floor/plasteel/dark,
/area/space)
"Hl" = (
/obj/machinery/recharge_station,
/turf/open/floor/carpet/blue,
/area/space)
"Hm" = (
/obj/structure/catwalk/over,
/turf/open/floor/plating/airless,
/area/space)
"Io" = (
/obj/structure/dresser,
/turf/open/floor/carpet/blue,
/area/space)
"Ir" = (
/turf/open/floor/plasteel/dark,
/area/space)
"IZ" = (
/obj/effect/turf_decal/trimline/transparent/blue/line{
	dir = 6
	},
/turf/open/floor/plasteel/dark,
/area/space)
"Ka" = (
/obj/effect/turf_decal/industrial/warning{
	dir = 8
	},
/turf/open/floor/plasteel/tech/airless,
/area/space)
"KX" = (
/turf/closed/wall/mineral/plastitanium,
/area/space)
"Lp" = (
/obj/effect/turf_decal/industrial/warning{
	layer = 2.456;
	dir = 1
	},
/turf/open/floor/plating,
/area/space)
"Lx" = (
/turf/open/floor/plating,
/area/space)
"Me" = (
/turf/open/floor/plasteel/grimy,
/area/space)
"Mo" = (
/obj/effect/turf_decal/trimline/transparent/blue/line{
	dir = 6
	},
/obj/effect/turf_decal/siding/thinplating/dark{
	dir = 6
	},
/turf/open/floor/plasteel/dark,
/area/space)
"ML" = (
/obj/effect/turf_decal/trimline/transparent/blue/line{
	dir = 4
	},
/turf/open/floor/plasteel/dark,
/area/space)
"MV" = (
/obj/effect/turf_decal/industrial,
/turf/open/floor/engine/hull,
/area/space)
"NY" = (
/obj/machinery/door/firedoor/heavy,
/turf/open/floor/plasteel/mono/dark,
/area/space)
"Qg" = (
/obj/effect/turf_decal/trimline/transparent/blue/corner{
	dir = 8
	},
/turf/open/floor/plasteel/dark,
/area/space)
"QM" = (
/turf/open/floor/wood,
/area/space)
"Sd" = (
/obj/effect/turf_decal/trimline/transparent/blue/line{
	dir = 9
	},
/turf/open/floor/plasteel/dark,
/area/space)
"SD" = (
/obj/structure/window/plasma/fulltile,
/obj/structure/grille,
/turf/open/floor/plating,
/area/space)
"SK" = (
/turf/closed/mineral/random/snow,
/area/space)
"Uj" = (
/obj/effect/turf_decal/siding/wood{
	dir = 4
	},
/obj/machinery/door/firedoor/border_only{
	dir = 8
	},
/obj/machinery/door/firedoor/border_only{
	dir = 4
	},
/turf/open/floor/plating,
/turf/open/floor/plasteel/dark,
/area/space)
"Ux" = (
/turf/open/floor/carpet/blue,
/area/space)
"VY" = (
/obj/structure/catwalk/over,
/obj/effect/turf_decal/techfloor{
	dir = 1
	},
/turf/open/floor/plating/airless,
/area/space)
"Wr" = (
/obj/structure/catwalk/over,
/obj/effect/turf_decal/techfloor{
	dir = 5
	},
/turf/open/floor/plating/airless,
/area/space)
"YI" = (
/obj/structure/catwalk/over,
/obj/effect/turf_decal/techfloor{
	dir = 4
	},
/turf/open/floor/plating/airless,
/area/space)
"Zk" = (
/obj/structure/catwalk/over,
/obj/effect/turf_decal/techfloor,
/turf/open/floor/plating/airless,
/area/space)

(1,1,1) = {"
uP
uP
uP
uP
uP
uP
uP
uP
uP
uP
uP
uP
uP
uP
uP
uP
uP
uP
uP
uP
uP
uP
uP
uP
uP
uP
uP
uP
uP
uP
uP
uP
uP
uP
uP
uP
uP
uP
uP
uP
uP
uP
uP
uP
uP
uP
uP
SK
SK
SK
"}
(2,1,1) = {"
uP
uP
uP
uP
uP
uP
uP
uP
uP
uP
uP
uP
uP
uP
uP
uP
uP
uP
uP
uP
uP
uP
uP
uP
uP
uP
uP
uP
uP
uP
uP
uP
uP
uP
uP
uP
uP
uP
uP
uP
uP
uP
uP
uP
uP
uP
uP
SK
SK
SK
"}
(3,1,1) = {"
uP
uP
uP
uP
uP
uP
uP
uP
uP
uP
uP
uP
uP
uP
uP
uP
uP
uP
uP
uP
uP
uP
uP
uP
uP
uP
uP
uP
uP
uP
uP
uP
uP
uP
uP
uP
uP
uP
uP
uP
uP
uP
uP
uP
uP
uP
uP
SK
SK
SK
"}
(4,1,1) = {"
SK
SK
SK
SK
SK
SK
SK
SK
SK
SK
SK
SK
SK
SK
SK
SK
SK
SK
SK
SK
SK
SK
SK
SK
SK
SK
SK
KX
KX
KX
KX
KX
KX
SK
SK
SK
SK
SK
SK
SK
SK
SK
SK
SK
SK
SK
SK
SK
SK
SK
"}
(5,1,1) = {"
SK
SK
SK
SK
SK
SK
SK
SK
SK
SK
SK
SK
SK
SK
SK
SK
SK
SK
SK
SK
SK
SK
SK
SK
SK
SK
KX
Lx
Lx
Lx
Lx
KX
KX
KX
KX
KX
KX
KX
KX
KX
KX
KX
KX
KX
SK
SK
SK
SK
SK
SK
"}
(6,1,1) = {"
SK
SK
SK
SK
SK
SK
SK
KX
KX
KX
KX
SK
SK
SK
SK
SK
SK
SK
SK
SK
SK
SK
SK
KX
uP
uP
KX
Lx
Lx
Lx
Lx
KX
Io
Ux
Gh
KX
Io
Ux
Gh
KX
Io
Ux
Gh
KX
SK
SK
SK
SK
SK
uP
"}
(7,1,1) = {"
SK
SK
SK
SK
SK
SK
SK
KX
uP
uP
KX
KX
KX
SK
SK
SK
SK
KX
KX
KX
KX
KX
SK
KX
KX
KX
KX
KX
Lx
Lx
Lx
KX
wx
Ux
Ux
KX
wx
Ux
Ux
KX
wx
Ux
Ux
KX
uP
SK
SK
SK
SK
uP
"}
(8,1,1) = {"
SK
SK
SK
SK
SK
SK
SK
KX
uP
uP
uP
uP
KX
SK
SK
KX
KX
KX
uP
uP
uP
KX
KX
KX
uP
uP
uP
KX
KX
Sd
qR
KX
KX
KX
vr
KX
KX
KX
vr
KX
KX
KX
vr
KX
KX
uP
SK
SK
SK
uP
"}
(9,1,1) = {"
SK
SK
SK
SK
SK
SK
SK
KX
uP
uP
uP
uP
KX
SK
SK
KX
uP
uP
uP
uP
uP
uP
uP
KX
uP
uP
uP
uP
KX
aH
Qg
NY
zf
zf
zf
zf
zf
zf
zf
zf
zf
zf
zf
dL
KX
uP
SK
SK
SK
uP
"}
(10,1,1) = {"
SK
SK
SK
SK
SK
SK
SK
KX
uP
uP
uP
uP
KX
SK
SK
KX
uP
uP
uP
uP
uP
uP
uP
KX
uP
uP
uP
uP
Lx
aH
aW
NY
vV
vV
vV
vV
vV
vV
vV
vV
vV
vV
vV
Mo
KX
uP
SK
SK
SK
uP
"}
(11,1,1) = {"
SK
SK
SK
KX
KX
KX
KX
KX
KX
uP
KX
KX
KX
KX
SK
KX
KX
uP
uP
uP
uP
uP
uP
KX
uP
uP
uP
uP
KX
aH
nx
KX
KX
KX
GY
KX
KX
KX
GY
KX
KX
KX
Uj
KX
KX
uP
SK
SK
SK
uP
"}
(12,1,1) = {"
SK
SK
KX
KX
uP
uP
KX
uP
uP
uP
uP
uP
uP
KX
KX
KX
KX
KX
uP
uP
uP
uP
KX
KX
KX
uP
uP
uP
KX
aH
nx
KX
Fl
Ux
Ux
KX
Hl
Ux
Ux
KX
Fl
Ux
Ux
KX
uP
uP
SK
SK
SK
uP
"}
(13,1,1) = {"
SK
SK
KX
uP
uP
uP
KX
uP
uP
uP
uP
uP
uP
uP
KX
Sd
qR
KX
KX
KX
uP
KX
KX
SK
KX
KX
KX
KX
KX
aH
nx
KX
Io
Ux
Gh
KX
Io
Ux
Gh
KX
Io
Ux
Gh
KX
SK
SK
SK
SK
SK
uP
"}
(14,1,1) = {"
SK
SK
KX
uP
uP
uP
uP
uP
uP
uP
uP
uP
uP
uP
KX
aH
nx
KX
uP
uP
uP
uP
KX
KX
KX
CE
CE
CE
KX
aH
nx
KX
KX
KX
KX
KX
KX
KX
KX
KX
KX
KX
KX
KX
uP
uP
uP
uP
uP
uP
"}
(15,1,1) = {"
SK
SK
KX
uP
uP
uP
KX
uP
uP
uP
uP
uP
uP
uP
KX
aH
nx
KX
uP
uP
uP
uP
KX
nL
go
Ka
Ka
Ka
KX
NY
NY
KX
KX
KX
Lx
Lx
Lx
Lx
KX
QM
QM
QM
QM
KX
uP
uP
uP
uP
uP
uP
"}
(16,1,1) = {"
SK
SK
KX
KX
uP
uP
KX
uP
uP
uP
uP
uP
uP
uP
KX
aH
nx
uP
uP
uP
uP
uP
KX
nL
KX
BD
AK
BD
KX
aH
Qg
vc
qR
KX
Lx
Lx
Lx
Lx
KX
QM
QM
QM
QM
KX
KX
KX
uP
uP
uP
uP
"}
(17,1,1) = {"
SK
SK
SK
KX
KX
KX
KX
uP
KX
KX
SD
SD
SD
SD
KX
aH
nx
KX
KX
uP
uP
uP
go
nL
KX
bP
qy
FX
KX
qO
ML
js
nx
KX
Lx
Lx
Lx
Lx
uP
QM
QM
Lx
Lx
Lx
Lx
KX
uP
uP
uP
uP
"}
(18,1,1) = {"
SK
SK
SK
KX
KX
KX
KX
Sd
qR
KX
uP
uP
uP
uP
Lx
aH
nx
uP
KX
KX
uP
KX
KX
KX
KX
VY
om
Zk
KX
KX
KX
aH
nx
KX
Lx
Lx
Lx
Lx
KX
KX
KX
Lx
Lx
Lx
Lx
KX
KX
KX
KX
uP
"}
(19,1,1) = {"
SK
KX
KX
KX
uP
uP
KX
aH
nx
KX
uP
uP
uP
uP
Lx
aH
nx
KX
KX
uP
uP
uP
KX
om
bP
Hm
Hm
Hm
FX
om
KX
aH
nx
KX
KX
Lx
KX
KX
KX
Lx
Lx
Lx
Lx
Lx
Lx
Lx
uP
uP
Lx
uP
"}
(20,1,1) = {"
SK
KX
uP
uP
uP
uP
KX
aH
nx
KX
uP
uP
uP
uP
KX
aH
nx
KX
uP
uP
uP
uP
SD
dd
VY
oX
MV
oX
Zk
bi
KX
aH
Qg
NY
vc
vc
vc
vc
vc
vc
vc
vc
qR
Lx
Lx
Lx
uP
uP
Lx
uP
"}
(21,1,1) = {"
SK
KX
uP
uP
uP
Sd
vc
uk
nx
uP
uP
uP
uP
uP
KX
aH
nx
KX
uP
uP
uP
uP
SD
dd
VY
MV
kB
MV
Zk
bi
KX
aH
aW
NY
ML
ML
ML
ML
ML
ML
ML
js
nx
Lx
Lx
KX
KX
KX
KX
uP
"}
(22,1,1) = {"
SK
KX
uP
uP
uP
aH
Ir
Ir
nx
KX
uP
uP
uP
uP
KX
aH
nx
KX
uP
uP
uP
uP
SD
dd
VY
oX
MV
oX
Zk
bi
KX
aH
nx
KX
KX
KX
KX
KX
KX
KX
KX
aH
nx
Lx
Lx
KX
uP
uP
uP
uP
"}
(23,1,1) = {"
SK
KX
uP
uP
uP
qO
ML
js
nx
KX
SD
SD
SD
SD
KX
NY
NY
KX
KX
uP
uP
uP
KX
om
Wr
Hm
Hm
Hm
od
om
KX
aH
nx
KX
uP
uP
uP
KX
uP
uP
KX
aH
nx
KX
KX
KX
uP
uP
uP
uP
"}
(24,1,1) = {"
SK
KX
uP
uP
uP
uP
KX
aH
Qg
NY
vc
vc
vc
vc
vc
uk
Qg
qR
KX
KX
KX
KX
KX
KX
KX
VY
om
Zk
KX
KX
KX
aH
nx
KX
uP
uP
uP
uP
Ir
Ir
Ir
qO
IZ
Ir
KX
uP
uP
uP
uP
uP
"}
(25,1,1) = {"
SK
KX
KX
KX
KX
uP
KX
aH
aW
NY
ML
ML
ML
ML
ML
ML
js
Qg
vc
vc
vc
NY
vc
qR
KX
Wr
YI
od
KX
Sd
vc
uk
nx
KX
uP
uP
uP
uP
Ir
Me
Me
Me
Me
Ir
SD
uP
uP
uP
uP
uP
"}
(26,1,1) = {"
SK
SK
SK
KX
uP
uP
KX
aH
nx
KX
KX
KX
KX
KX
KX
KX
qO
ML
ML
ML
ML
NY
js
nx
KX
KX
KX
KX
KX
aH
aW
ML
IZ
KX
uP
uP
uP
uP
Ir
Me
Me
Me
Me
Ir
SD
uP
uP
uP
uP
uP
"}
(27,1,1) = {"
SK
SK
SK
KX
KX
KX
KX
aH
nx
KX
Lx
Lx
Lx
KX
SK
KX
KX
KX
uP
KX
KX
KX
aH
Qg
vc
vc
vc
vc
vc
uk
nx
KX
KX
KX
uP
uP
KX
KX
Ir
Me
Me
Me
Me
Ir
SD
uP
uP
uP
uP
uP
"}
(28,1,1) = {"
SK
SK
SK
KX
uP
uP
KX
aH
nx
KX
Lx
Lx
Lx
KX
KX
KX
uP
uP
uP
uP
uP
KX
qO
ML
ML
ML
js
aW
ML
ML
IZ
KX
SK
KX
KX
KX
KX
KX
Ir
Me
Me
Me
Me
Ir
SD
uP
uP
uP
uP
uP
"}
(29,1,1) = {"
SK
SK
SK
KX
uP
uP
uP
aH
nx
Lx
Lx
Lx
Lx
Lx
KX
uP
uP
uP
uP
uP
uP
KX
KX
KX
KX
KX
NY
NY
KX
KX
KX
KX
KX
KX
SK
SK
SK
KX
Ir
Ir
Ir
Ir
Ir
Ir
SD
uP
uP
uP
uP
uP
"}
(30,1,1) = {"
SK
SK
SK
KX
uP
uP
KX
aH
nx
KX
Lx
Lx
Lx
Lx
KX
uP
uP
uP
uP
uP
uP
KX
SK
SK
SK
KX
aH
nx
KX
SK
SK
SK
SK
SK
uP
SK
SK
KX
KX
KX
KX
KX
SD
SD
SD
uP
uP
uP
uP
uP
"}
(31,1,1) = {"
SK
SK
KX
KX
KX
KX
KX
NY
NY
KX
Lx
Lx
Lx
KX
KX
KX
uP
uP
uP
uP
KX
KX
SK
SK
SK
KX
aH
nx
KX
SK
SK
SK
KX
KX
KX
SK
uP
uP
uP
uP
uP
uP
uP
uP
uP
uP
uP
uP
uP
uP
"}
(32,1,1) = {"
SK
SK
SK
KX
Sd
vc
vc
uk
nx
KX
Lx
Lx
Lx
KX
SK
KX
KX
KX
KX
KX
KX
SK
SK
SK
SK
KX
aH
nx
KX
SK
SK
KX
KX
sv
uP
uP
uP
uP
uP
uP
uP
uP
uP
uP
uP
uP
uP
uP
uP
uP
"}
(33,1,1) = {"
SK
SK
SK
KX
qO
ML
ML
ML
IZ
KX
KX
KX
KX
KX
KX
KX
uP
uP
uP
uP
KX
KX
SK
SK
SK
KX
aH
nx
KX
SK
SK
KX
sv
sv
uP
uP
uP
uP
uP
uP
uP
uP
uP
uP
uP
uP
uP
uP
uP
uP
"}
(34,1,1) = {"
SK
SK
SK
KX
KX
uP
KX
KX
KX
KX
SK
SK
SK
KX
uP
uP
uP
uP
uP
uP
uP
KX
KX
SK
SK
KX
aH
nx
KX
SK
SK
KX
sv
sv
uP
sv
sv
sv
sv
sv
sv
sv
sv
sv
uP
uP
uP
uP
uP
uP
"}
(35,1,1) = {"
SK
SK
KX
KX
SK
uP
uP
uP
uP
KX
KX
SK
SK
KX
uP
uP
uP
uP
uP
uP
uP
uP
KX
SK
SK
KX
aH
nx
KX
SK
SK
KX
sv
sv
uP
sv
sv
sv
sv
sv
sv
sv
sv
sv
uP
uP
uP
uP
uP
uP
"}
(36,1,1) = {"
SK
uP
KX
SK
SK
SK
uP
KX
uP
uP
KX
KX
SK
KX
uP
uP
uP
uP
uP
uP
uP
uP
KX
KX
KX
KX
aH
nx
KX
KX
KX
KX
KX
sv
uP
sv
sv
sv
sv
sv
sv
sv
sv
sv
uP
uP
uP
uP
uP
uP
"}
(37,1,1) = {"
SK
KX
KX
SK
SK
SK
uP
KX
uP
KX
KX
KX
SK
KX
uP
uP
uP
uP
uP
uP
uP
uP
KX
KX
uP
uP
qO
IZ
uP
uP
uP
KX
KX
KX
uP
sv
sv
sv
sv
sv
sv
sv
sv
sv
uP
uP
uP
uP
uP
uP
"}
(38,1,1) = {"
SK
KX
KX
KX
SK
SK
KX
KX
uP
uP
KX
KX
SK
KX
uP
uP
uP
uP
uP
uP
uP
uP
uP
uP
uP
uP
uP
uP
uP
uP
uP
Lp
FL
vf
uP
sv
sv
sv
sv
sv
sv
sv
sv
sv
uP
uP
uP
uP
uP
uP
"}
(39,1,1) = {"
SK
KX
uP
uP
uP
uP
uP
uP
uP
uP
uP
KX
SK
KX
uP
uP
uP
uP
uP
uP
uP
uP
uP
uP
uP
uP
uP
uP
uP
uP
uP
Lp
FL
vf
uP
sv
sv
sv
sv
sv
sv
sv
sv
sv
uP
uP
uP
uP
uP
uP
"}
(40,1,1) = {"
SK
KX
uP
uP
uP
uP
uP
uP
uP
uP
uP
KX
SK
KX
uP
uP
uP
uP
uP
uP
uP
uP
uP
uP
uP
uP
uP
uP
uP
uP
uP
Lp
FL
vf
uP
sv
sv
sv
sv
sv
sv
sv
sv
sv
uP
uP
uP
uP
uP
uP
"}
(41,1,1) = {"
SK
KX
uP
uP
uP
uP
uP
uP
uP
uP
uP
KX
SK
KX
uP
uP
uP
uP
uP
uP
uP
uP
KX
KX
uP
uP
uP
uP
uP
uP
uP
KX
KX
KX
uP
sv
sv
sv
sv
sv
sv
sv
sv
sv
uP
uP
uP
uP
uP
uP
"}
(42,1,1) = {"
SK
KX
uP
uP
uP
uP
cM
uP
uP
uP
uP
KX
SK
KX
uP
uP
uP
uP
uP
uP
uP
uP
KX
KX
KX
KX
KX
KX
KX
uP
KX
KX
KX
KX
uP
sv
sv
sv
sv
sv
sv
sv
sv
sv
uP
uP
uP
uP
uP
uP
"}
(43,1,1) = {"
SK
KX
uP
uP
uP
uP
uP
uP
uP
uP
uP
KX
SK
KX
KX
uP
uP
uP
uP
uP
uP
KX
KX
SK
SK
SK
SK
KX
uP
uP
uP
uP
KX
uP
uP
sv
sv
sv
sv
sv
sv
sv
sv
sv
uP
uP
uP
uP
uP
uP
"}
(44,1,1) = {"
SK
KX
KX
uP
uP
uP
uP
uP
uP
uP
KX
KX
SK
SK
KX
KX
KX
KX
KX
KX
KX
KX
SK
SK
SK
SK
SK
KX
uP
uP
uP
uP
uP
uP
uP
sv
sv
sv
sv
sv
sv
sv
sv
sv
uP
uP
uP
uP
uP
uP
"}
(45,1,1) = {"
SK
SK
KX
KX
KX
KX
KX
KX
KX
KX
KX
SK
SK
SK
SK
SK
SK
SK
SK
SK
SK
SK
SK
SK
SK
SK
SK
KX
uP
uP
uP
uP
uP
uP
uP
sv
sv
sv
sv
sv
sv
sv
sv
sv
uP
uP
uP
uP
uP
uP
"}
(46,1,1) = {"
SK
SK
SK
SK
SK
SK
SK
SK
SK
SK
SK
SK
SK
SK
SK
SK
SK
SK
SK
SK
SK
SK
SK
SK
SK
SK
SK
KX
uP
uP
uP
uP
KX
uP
uP
sv
sv
sv
sv
sv
sv
sv
sv
sv
uP
uP
uP
uP
uP
uP
"}
(47,1,1) = {"
SK
SK
SK
SK
SK
SK
SK
SK
SK
SK
SK
SK
SK
SK
SK
SK
SK
SK
SK
SK
SK
SK
SK
SK
SK
SK
SK
KX
KX
KX
KX
KX
KX
uP
uP
uP
uP
uP
uP
uP
uP
uP
uP
uP
uP
uP
uP
uP
uP
uP
"}
(48,1,1) = {"
SK
SK
SK
SK
SK
SK
SK
SK
SK
SK
SK
SK
SK
SK
SK
SK
SK
SK
SK
SK
SK
SK
SK
SK
SK
SK
SK
SK
SK
SK
SK
SK
SK
SK
uP
uP
uP
uP
uP
uP
uP
uP
uP
uP
uP
uP
uP
uP
uP
uP
"}
(49,1,1) = {"
SK
SK
uP
uP
uP
uP
uP
uP
uP
uP
uP
uP
uP
uP
uP
uP
uP
uP
uP
uP
uP
uP
uP
uP
uP
uP
uP
uP
uP
uP
uP
uP
uP
uP
uP
uP
uP
uP
uP
uP
uP
uP
uP
uP
uP
uP
uP
uP
uP
uP
"}
(50,1,1) = {"
SK
SK
SK
SK
SK
SK
SK
SK
SK
SK
SK
SK
SK
SK
SK
SK
SK
SK
SK
SK
SK
SK
SK
SK
SK
SK
SK
SK
SK
SK
SK
SK
SK
SK
SK
SK
SK
SK
uP
uP
uP
uP
uP
uP
uP
uP
uP
uP
uP
uP
"}
