//MAP CONVERTED BY dmm2tgm.py THIS HEADER COMMENT PREVENTS RECONVERSION, DO NOT REMOVE
"al" = (
/obj/effect/turf_decal/siding/yellow/corner,
/obj/machinery/light/dim/directional/north,
/obj/structure/cable{
	icon_state = "4-8"
	},
/obj/effect/turf_decal/siding/wood{
	dir = 1
	},
/turf/open/floor/wood,
/area/ruin/unpowered)
"ao" = (
/obj/structure/cable{
	icon_state = "1-4"
	},
/turf/open/floor/wood,
/area/ruin/unpowered)
"aq" = (
/obj/structure/flora/rock,
/turf/open/floor/plating/asteroid/snow/lit,
/area/overmap_encounter/planetoid/ice/explored)
"as" = (
/obj/structure/flora/rock/icy,
/turf/open/floor/plating/asteroid/snow/lit,
/area/overmap_encounter/planetoid/ice/explored)
"bC" = (
/obj/effect/turf_decal/siding/wood,
/obj/item/reagent_containers/glass/bucket/wooden{
	pixel_x = -8;
	pixel_y = -5
	},
/obj/item/reagent_containers/glass/rag{
	pixel_y = 3;
	pixel_x = -8
	},
/turf/open/floor/wood,
/area/ruin/unpowered)
"bE" = (
/obj/machinery/power/solar_control{
	dir = 4
	},
/obj/effect/decal/cleanable/cobweb,
/obj/structure/cable/yellow{
	icon_state = "0-4"
	},
/obj/machinery/light/small/directional/north,
/obj/machinery/airalarm/directional/west{
	locked = 0
	},
/turf/open/floor/plating,
/area/ruin/unpowered)
"bO" = (
/obj/machinery/power/floodlight{
	anchored = 1
	},
/obj/structure/cable{
	icon_state = "0-8"
	},
/turf/open/floor/wood/cold{
	icon_state = "wood-broken5"
	},
/area/ruin/unpowered)
"bW" = (
/obj/machinery/hydroponics/soil,
/obj/structure/flora/grass/brown,
/obj/structure/railing/wood,
/turf/open/floor/plating/sandy_dirt{
	light_range = 2
	},
/area/overmap_encounter/planetoid/ice/explored)
"cs" = (
/obj/structure/flora/bush,
/turf/open/floor/plating/asteroid/snow/lit,
/area/overmap_encounter/planetoid/ice/explored)
"el" = (
/obj/structure/cable{
	icon_state = "4-8"
	},
/obj/effect/turf_decal/siding/wood{
	dir = 1
	},
/obj/structure/closet/crate/wooden,
/obj/item/reagent_containers/food/snacks/rationpack{
	pixel_x = -2
	},
/obj/item/reagent_containers/food/snacks/rationpack{
	pixel_x = 4
	},
/obj/item/reagent_containers/food/snacks/breadslice/moldy{
	pixel_y = 5;
	pixel_x = -5
	},
/obj/item/reagent_containers/food/snacks/meat/slab/human/mutant/zombie,
/turf/open/floor/wood,
/area/ruin/unpowered)
"eR" = (
/turf/closed/wall,
/area/ruin/unpowered)
"eY" = (
/obj/structure/cable{
	icon_state = "4-8"
	},
/obj/structure/table/wood,
/obj/item/reagent_containers/food/drinks/drinkingglass/shotglass{
	pixel_y = 13;
	pixel_x = -8
	},
/obj/item/reagent_containers/food/drinks/drinkingglass/shotglass{
	pixel_y = 7;
	pixel_x = -6
	},
/obj/item/reagent_containers/food/drinks/bottle/sake{
	pixel_x = 3;
	pixel_y = 5
	},
/turf/open/floor/wood/cold,
/area/ruin/unpowered)
"fa" = (
/obj/structure/flora/grass/both{
	icon_state = "snowgrass1bb"
	},
/turf/open/floor/plating/asteroid/snow/lit,
/area/overmap_encounter/planetoid/ice/explored)
"fh" = (
/obj/structure/table/wood/reinforced,
/obj/item/flashlight/lamp/green{
	pixel_x = -6;
	pixel_y = 2
	},
/obj/item/assembly/timer{
	pixel_y = -2;
	pixel_x = 10;
	name = "alarm clock"
	},
/obj/effect/turf_decal/siding/wood{
	dir = 10
	},
/turf/open/floor/wood,
/area/ruin/unpowered)
"fr" = (
/turf/open/floor/plating/asteroid/snow/lit,
/area/overmap_encounter/planetoid/ice/explored)
"fX" = (
/obj/effect/decal/cleanable/blood/drip,
/turf/open/floor/wood,
/area/ruin/unpowered)
"ge" = (
/obj/effect/turf_decal/siding/yellow,
/obj/structure/cable{
	icon_state = "1-8"
	},
/turf/open/floor/wood,
/area/ruin/unpowered)
"gj" = (
/obj/structure/cable{
	icon_state = "4-8"
	},
/obj/effect/turf_decal/siding/wood/corner{
	dir = 4
	},
/obj/structure/closet/secure_closet/hunter{
	anchored = 1
	},
/obj/item/ammo_box/magazine/illestren_a850r{
	pixel_y = -10
	},
/obj/item/clothing/suit/armor/roumain{
	pixel_y = -6
	},
/obj/item/clothing/head/cowboy/sec/roumain{
	pixel_y = 6
	},
/obj/item/gun/ballistic/rifle/illestren{
	desc = "A sturdy and conventional bolt-action rifle. One of Hunter's Pride's most successful firearms, the Illestren is popular among colonists, pirates, snipers, and countless others. Chambered in 8x50mmR. This one has the initials S + R delicately carved into the stock.";
	name = "\improper Gifted HP Illestren"
	},
/turf/open/floor/wood,
/area/ruin/unpowered)
"gQ" = (
/obj/structure/closet/crate/wooden,
/obj/item/seeds/chili/ice{
	pixel_y = -5;
	pixel_x = 7
	},
/obj/item/seeds/sunflower/moonflower{
	pixel_x = -5;
	pixel_y = -5
	},
/obj/item/seeds/wheat/rice{
	pixel_y = -3
	},
/obj/item/cultivator/rake{
	pixel_y = -3
	},
/obj/item/shovel{
	pixel_y = 5
	},
/obj/item/reagent_containers/glass/bucket/wooden{
	pixel_y = -2
	},
/turf/open/floor/wood/cold{
	icon_state = "wood-broken6"
	},
/area/ruin/unpowered)
"he" = (
/obj/structure/flora/ausbushes/brflowers,
/obj/structure/flora/grass/both,
/turf/open/floor/plating/asteroid/snow/lit,
/area/overmap_encounter/planetoid/ice/explored)
"hg" = (
/turf/open/floor/plating/asteroid/sand/lit,
/area/overmap_encounter/planetoid/ice/explored)
"hB" = (
/obj/effect/turf_decal/siding/yellow{
	dir = 1
	},
/obj/effect/turf_decal/siding/wood,
/turf/open/floor/wood,
/area/ruin/unpowered)
"iv" = (
/obj/effect/decal/cleanable/blood/footprints{
	dir = 8;
	pixel_y = 6
	},
/turf/open/floor/wood,
/area/ruin/unpowered)
"iE" = (
/obj/structure/flora/tree/dead,
/turf/open/floor/plating/asteroid/snow/lit,
/area/overmap_encounter/planetoid/ice/explored)
"jR" = (
/obj/effect/turf_decal/siding/wood{
	dir = 4
	},
/obj/structure/closet/secure_closet/hunter{
	locked = 0;
	anchored = 1
	},
/obj/item/reagent_containers/food/snacks/spiderling{
	pixel_y = -5
	},
/turf/open/floor/wood,
/area/ruin/unpowered)
"ka" = (
/obj/structure/fans/tiny,
/obj/machinery/door/airlock/wood,
/turf/open/floor/wood/ebony,
/area/ruin/unpowered)
"kz" = (
/obj/structure/flora/stump,
/turf/open/floor/plating/asteroid/snow/lit,
/area/overmap_encounter/planetoid/ice/explored)
"lf" = (
/obj/structure/cable{
	icon_state = "1-2"
	},
/turf/open/floor/wood,
/area/ruin/unpowered)
"lC" = (
/obj/structure/railing/corner/wood{
	dir = 8
	},
/turf/open/floor/plating/asteroid/snow/lit,
/area/overmap_encounter/planetoid/ice/explored)
"lD" = (
/obj/structure/chair/stool/bar,
/turf/open/floor/wood,
/area/ruin/unpowered)
"lT" = (
/obj/effect/decal/cleanable/cobweb/cobweb2,
/obj/machinery/power/terminal,
/obj/structure/cable/yellow{
	icon_state = "0-8"
	},
/obj/machinery/power/port_gen/pacman,
/turf/open/floor/plating,
/area/ruin/unpowered)
"mb" = (
/obj/structure/closet/crate/grave{
	opened = 0;
	name = "memorial mound";
	desc = "Chances are nobody is buried here but this stands in rememberance to their name."
	},
/obj/item/reagent_containers/food/snacks/grown/moonflower{
	pixel_x = -2;
	pixel_y = -4;
	name = "memorial moonflower";
	desc = "I used to love our home but its far too cold to stay without you."
	},
/turf/open/floor/plating/asteroid/snow/lit,
/area/overmap_encounter/planetoid/ice/explored)
"ms" = (
/obj/structure/kitchenspike,
/obj/effect/decal/cleanable/blood/drip,
/obj/effect/decal/cleanable/blood/splatter,
/turf/open/floor/plating/asteroid/snow/lit,
/area/overmap_encounter/planetoid/ice/explored)
"mH" = (
/obj/structure/kitchenspike,
/obj/effect/decal/cleanable/blood/drip,
/turf/open/floor/plating/asteroid/snow/lit,
/area/overmap_encounter/planetoid/ice/explored)
"ni" = (
/obj/structure/bed/double{
	dir = 4
	},
/obj/item/bedsheet/double/brown{
	dir = 4
	},
/obj/effect/turf_decal/siding/wood{
	dir = 8
	},
/turf/open/floor/wood,
/area/ruin/unpowered)
"nk" = (
/obj/structure/flora/grass/both{
	icon_state = "snowbush2"
	},
/turf/open/floor/plating/asteroid/snow/lit,
/area/overmap_encounter/planetoid/ice/explored)
"nJ" = (
/obj/effect/turf_decal/solarpanel,
/obj/structure/cable/yellow{
	icon_state = "0-2"
	},
/obj/machinery/power/tracker,
/turf/open/floor/plating/icemoon{
	light_range = 2
	},
/area/overmap_encounter/planetoid/ice/explored)
"oV" = (
/obj/structure/cable{
	icon_state = "0-8"
	},
/obj/machinery/power/smes,
/turf/open/floor/plating,
/area/ruin/unpowered)
"pf" = (
/obj/item/pickaxe/rusted{
	pixel_x = 11;
	pixel_y = 13
	},
/turf/open/floor/wood,
/area/ruin/unpowered)
"pl" = (
/obj/structure/flora/grass/both{
	icon_state = "snowgrass2gb"
	},
/turf/open/floor/plating/asteroid/snow/lit,
/area/overmap_encounter/planetoid/ice/explored)
"qR" = (
/obj/structure/flora/grass/both{
	icon_state = "snowbush6"
	},
/turf/open/floor/plating/asteroid/snow/lit,
/area/overmap_encounter/planetoid/ice/explored)
"rD" = (
/obj/effect/turf_decal/siding/yellow/corner{
	dir = 4
	},
/obj/item/storage/firstaid/roumain{
	pixel_y = 12;
	pixel_x = 4
	},
/obj/item/reagent_containers/glass/mortar/mushroom{
	pixel_x = -2
	},
/obj/item/pestle{
	pixel_x = 8;
	pixel_y = -4
	},
/obj/item/reagent_containers/food/snacks/grown/ash_flora/mushroom_stem{
	pixel_y = 2;
	pixel_x = -2
	},
/obj/effect/turf_decal/siding/wood,
/obj/structure/table/wood/reinforced,
/obj/item/reagent_containers/food/drinks/breakawayflask{
	pixel_y = 18;
	pixel_x = -11
	},
/turf/open/floor/wood,
/area/ruin/unpowered)
"sx" = (
/obj/structure/flora/grass/both{
	icon_state = "snowbush4"
	},
/turf/open/floor/plating/asteroid/snow/lit,
/area/overmap_encounter/planetoid/ice/explored)
"tE" = (
/obj/structure/flora/grass/green,
/turf/open/floor/plating/asteroid/snow/lit,
/area/overmap_encounter/planetoid/ice/explored)
"tM" = (
/obj/effect/turf_decal/siding/yellow{
	dir = 1
	},
/obj/machinery/light/dim/directional/south,
/obj/effect/turf_decal/siding/wood,
/turf/open/floor/wood,
/area/ruin/unpowered)
"uD" = (
/obj/structure/dresser,
/obj/item/book/manual/srmlore{
	pixel_y = 8;
	pixel_x = -8
	},
/obj/item/book/manual/trickwines_4_brewers{
	pixel_y = 8;
	pixel_x = 4
	},
/obj/effect/turf_decal/siding/wood{
	dir = 8
	},
/turf/open/floor/wood,
/area/ruin/unpowered)
"vG" = (
/turf/open/floor/plasteel/stairs/wood{
	dir = 4
	},
/area/ruin/unpowered)
"ws" = (
/obj/item/grown/log{
	pixel_y = 12;
	pixel_x = -10
	},
/obj/item/grown/log{
	pixel_y = 12;
	pixel_x = 2
	},
/obj/item/grown/log{
	pixel_y = 20;
	pixel_x = -4
	},
/obj/item/lighter/greyscale{
	pixel_y = -2
	},
/turf/open/floor/concrete/tiles,
/area/ruin/unpowered)
"xg" = (
/obj/effect/turf_decal/solarpanel,
/obj/structure/cable/yellow{
	icon_state = "4-8"
	},
/obj/machinery/power/solar,
/obj/structure/cable/yellow{
	icon_state = "0-4"
	},
/turf/open/floor/plating/icemoon{
	light_range = 2
	},
/area/overmap_encounter/planetoid/ice/explored)
"xx" = (
/turf/open/floor/plating/ice/icemoon{
	light_range = 2
	},
/area/overmap_encounter/planetoid/ice/explored)
"yv" = (
/obj/effect/turf_decal/solarpanel,
/obj/structure/cable/yellow{
	icon_state = "0-8"
	},
/obj/machinery/power/solar,
/turf/open/floor/plating/icemoon{
	light_range = 2
	},
/area/overmap_encounter/planetoid/ice/explored)
"yZ" = (
/obj/structure/table/wood,
/obj/item/trash/plate{
	pixel_y = 10
	},
/obj/item/trash/plate{
	pixel_y = -2
	},
/obj/item/kitchen/fork{
	pixel_y = 4;
	pixel_x = -10
	},
/obj/item/kitchen/knife{
	pixel_x = 10;
	pixel_y = 4
	},
/obj/item/reagent_containers/food/snacks/breadslice/moldy{
	pixel_y = 2
	},
/turf/open/floor/carpet/red,
/area/ruin/unpowered)
"ze" = (
/obj/structure/cable/yellow{
	icon_state = "1-2"
	},
/obj/structure/cable/yellow{
	icon_state = "2-8"
	},
/obj/structure/cable/yellow{
	icon_state = "2-4"
	},
/obj/machinery/atmospherics/components/unary/passive_vent/layer2,
/turf/open/floor/plating/snowed/smoothed/icemoon{
	light_range = 2
	},
/area/overmap_encounter/planetoid/ice/explored)
"zn" = (
/obj/structure/table/wood/reinforced,
/obj/structure/window/reinforced/spawner/east,
/obj/item/stack/sheet/sinew/wolf{
	pixel_x = -4;
	pixel_y = -2
	},
/obj/item/stack/sheet/animalhide/goliath_hide/polar_bear_hide{
	pixel_y = 16;
	pixel_x = -4
	},
/obj/item/stack/sheet/animalhide/mothroach{
	pixel_y = 5;
	pixel_x = 2
	},
/turf/open/floor/wood,
/area/ruin/unpowered)
"zy" = (
/obj/structure/flora/rock/pile/icy,
/turf/open/floor/plating/asteroid/snow/lit,
/area/overmap_encounter/planetoid/ice/explored)
"zZ" = (
/obj/structure/flora/ausbushes/brflowers,
/obj/structure/flora/ash/chilly,
/turf/open/floor/grass/fairy,
/area/overmap_encounter/planetoid/ice/explored)
"Ad" = (
/obj/structure/flora/grass/both,
/obj/structure/railing/wood,
/turf/open/floor/plating/asteroid/snow/lit,
/area/overmap_encounter/planetoid/ice/explored)
"As" = (
/obj/structure/sink/puddle,
/turf/open/floor/plating/asteroid/sand/lit,
/area/overmap_encounter/planetoid/ice/explored)
"At" = (
/obj/structure/flora/driftwood{
	name = "branch";
	desc = "A fallen tree branch."
	},
/turf/open/floor/plating/asteroid/snow/lit,
/area/overmap_encounter/planetoid/ice/explored)
"Av" = (
/obj/structure/fans/tiny,
/obj/structure/cable/yellow{
	icon_state = "1-2"
	},
/obj/machinery/atmospherics/pipe/simple/supply/visible/layer4,
/obj/machinery/atmospherics/pipe/simple/scrubbers/visible/layer2,
/obj/machinery/door/airlock/freezer,
/turf/open/floor/plasteel/stairs/old{
	dir = 1
	},
/area/ruin/unpowered)
"AA" = (
/obj/machinery/door/airlock/wood,
/obj/structure/fans/tiny,
/obj/structure/cable{
	icon_state = "1-2"
	},
/turf/open/floor/wood/ebony,
/area/ruin/unpowered)
"AG" = (
/obj/structure/flora/tree/dead/tall/grey,
/turf/open/floor/plating/asteroid/snow/lit,
/area/overmap_encounter/planetoid/ice/explored)
"Bp" = (
/obj/effect/turf_decal/solarpanel,
/obj/structure/cable/yellow{
	icon_state = "4-8"
	},
/obj/machinery/power/solar,
/obj/structure/cable/yellow{
	icon_state = "0-8"
	},
/turf/open/floor/plating/icemoon{
	light_range = 2
	},
/area/overmap_encounter/planetoid/ice/explored)
"BY" = (
/obj/effect/turf_decal/siding/yellow/corner{
	dir = 1
	},
/obj/effect/turf_decal/siding/wood{
	dir = 6
	},
/turf/open/floor/wood,
/area/ruin/unpowered)
"Cf" = (
/obj/structure/barricade/wooden/snowed,
/obj/structure/barricade/wooden/crude/snow,
/turf/open/floor/wood,
/area/ruin/unpowered)
"Cr" = (
/obj/structure/rack,
/obj/item/storage/toolbox/mechanical{
	pixel_y = 10;
	pixel_x = -4
	},
/obj/machinery/power/apc/auto_name/directional/west{
	locked = 0
	},
/obj/machinery/power/terminal{
	dir = 8
	},
/obj/item/clothing/head/welding{
	pixel_x = -9;
	pixel_y = 2
	},
/obj/structure/cable{
	icon_state = "0-4"
	},
/obj/item/extinguisher{
	pixel_y = 17;
	pixel_x = 10
	},
/obj/item/stack/sheet/mineral/plasma/five{
	pixel_x = 7;
	pixel_y = -2
	},
/obj/item/tank/internals/emergency_oxygen/engi{
	pixel_x = 3;
	pixel_y = -1
	},
/obj/item/tank/internals/emergency_oxygen/engi{
	pixel_x = -2;
	pixel_y = -1
	},
/obj/item/clothing/mask/breath{
	pixel_x = 5
	},
/obj/item/clothing/mask/breath{
	pixel_x = -6
	},
/turf/open/floor/plating,
/area/ruin/unpowered)
"CF" = (
/obj/structure/chair/comfy/lime{
	dir = 1
	},
/turf/open/floor/carpet/red,
/area/ruin/unpowered)
"DQ" = (
/obj/item/weaponcrafting/stock{
	pixel_x = 6
	},
/obj/item/weaponcrafting/receiver{
	pixel_y = 8;
	pixel_x = 8
	},
/obj/item/screwdriver{
	pixel_y = 6;
	pixel_x = -4
	},
/obj/effect/turf_decal/siding/wood,
/obj/structure/table/wood/reinforced,
/obj/item/ammo_casing/spent{
	pixel_y = 12;
	pixel_x = -8
	},
/obj/item/ammo_casing/c38{
	pixel_y = 8;
	pixel_x = -12
	},
/turf/open/floor/wood,
/area/ruin/unpowered)
"DW" = (
/obj/structure/flora/ausbushes/brflowers,
/obj/structure/flora/grass/green,
/turf/open/floor/plating/asteroid/snow/lit,
/area/overmap_encounter/planetoid/ice/explored)
"Ey" = (
/obj/structure/flora/grass/both{
	icon_state = "snowgrass2bb"
	},
/turf/open/floor/plating/asteroid/snow/lit,
/area/overmap_encounter/planetoid/ice/explored)
"EO" = (
/obj/machinery/smartfridge/drying_rack{
	pixel_y = 14
	},
/turf/open/floor/plating/asteroid/snow/lit,
/area/overmap_encounter/planetoid/ice/explored)
"EP" = (
/obj/structure/curtain/bounty{
	icon_state = "bounty-closed"
	},
/turf/open/floor/wood,
/area/ruin/unpowered)
"Fb" = (
/obj/structure/cable{
	icon_state = "4-8"
	},
/obj/machinery/atmospherics/components/unary/vent_pump/layer4{
	dir = 1
	},
/obj/structure/cable{
	icon_state = "2-4"
	},
/turf/open/floor/plating,
/area/ruin/unpowered)
"FC" = (
/obj/structure/cable/yellow{
	icon_state = "1-2"
	},
/turf/open/floor/plating/snowed/smoothed/icemoon{
	light_range = 2
	},
/area/overmap_encounter/planetoid/ice/explored)
"Gn" = (
/obj/structure/flora/grass/brown,
/turf/open/floor/grass/fairy,
/area/overmap_encounter/planetoid/ice/explored)
"Hi" = (
/obj/structure/cable/yellow{
	icon_state = "1-8"
	},
/obj/machinery/atmospherics/components/unary/vent_scrubber/layer2{
	dir = 1
	},
/obj/machinery/atmospherics/pipe/simple/supply/visible/layer4,
/obj/structure/cable/yellow{
	icon_state = "1-4"
	},
/turf/open/floor/plating,
/area/ruin/unpowered)
"HH" = (
/obj/structure/fireplace{
	dir = 4;
	pixel_x = -8
	},
/turf/open/floor/concrete/tiles,
/area/ruin/unpowered)
"HL" = (
/turf/closed/wall/mineral/wood,
/area/ruin/unpowered)
"Ix" = (
/obj/structure/flora/grass/both{
	icon_state = "snowgrass1gb"
	},
/turf/open/floor/plating/asteroid/snow/lit,
/area/overmap_encounter/planetoid/ice/explored)
"IF" = (
/obj/machinery/hydroponics/soil,
/obj/structure/railing/wood,
/turf/open/floor/plating/asteroid/sand/lit,
/area/overmap_encounter/planetoid/ice/explored)
"IM" = (
/obj/machinery/hydroponics/soil,
/turf/open/floor/grass/fairy,
/area/overmap_encounter/planetoid/ice/explored)
"Jh" = (
/obj/structure/flora/grass/both{
	icon_state = "snowbush3"
	},
/turf/open/floor/plating/asteroid/snow/lit,
/area/overmap_encounter/planetoid/ice/explored)
"Kp" = (
/obj/structure/flora/rock/pile,
/turf/open/floor/plating/asteroid/snow/lit,
/area/overmap_encounter/planetoid/ice/explored)
"La" = (
/obj/machinery/hydroponics/soil,
/obj/structure/flora/grass/both,
/turf/open/floor/grass/fairy,
/area/overmap_encounter/planetoid/ice/explored)
"Ly" = (
/obj/effect/turf_decal/siding/wood,
/obj/structure/curtain/bounty{
	icon_state = "bounty-closed"
	},
/turf/open/floor/wood,
/area/ruin/unpowered)
"Ma" = (
/obj/structure/railing/wood,
/turf/open/floor/plating/asteroid/snow/lit,
/area/overmap_encounter/planetoid/ice/explored)
"MO" = (
/turf/open/floor/carpet/red,
/area/ruin/unpowered)
"Nh" = (
/turf/template_noop,
/area/template_noop)
"NU" = (
/obj/structure/flora/grass/both{
	icon_state = "snowbush5"
	},
/turf/open/floor/plating/asteroid/snow/lit,
/area/overmap_encounter/planetoid/ice/explored)
"OU" = (
/obj/structure/flora/grass/brown,
/turf/open/floor/plating/asteroid/snow/lit,
/area/overmap_encounter/planetoid/ice/explored)
"PJ" = (
/obj/effect/turf_decal/solarpanel,
/obj/structure/cable/yellow{
	icon_state = "0-8"
	},
/obj/machinery/power/solar,
/obj/structure/railing/corner/wood,
/turf/open/floor/plating/icemoon{
	light_range = 2
	},
/area/overmap_encounter/planetoid/ice/explored)
"Qu" = (
/obj/structure/chair/wood{
	dir = 1
	},
/turf/open/floor/wood/cold,
/area/ruin/unpowered)
"Qx" = (
/obj/structure/table/wood/reinforced,
/obj/structure/window/reinforced/spawner/east,
/obj/item/reagent_containers/glass/rag{
	pixel_y = 2;
	pixel_x = 4
	},
/obj/item/hatchet/wooden{
	pixel_y = 13;
	pixel_x = -1
	},
/obj/item/kitchen/knife/hunting{
	pixel_y = 5;
	pixel_x = -5
	},
/obj/effect/decal/cleanable/cobweb/cobweb2,
/turf/open/floor/wood,
/area/ruin/unpowered)
"QJ" = (
/obj/structure/fermenting_barrel/distiller{
	pixel_x = -3;
	pixel_y = 11
	},
/obj/effect/decal/cleanable/cobweb,
/obj/structure/spider/stickyweb,
/obj/item/reagent_containers/food/snacks/spiderling,
/turf/open/floor/wood,
/area/ruin/unpowered)
"Rd" = (
/obj/effect/turf_decal/solarpanel,
/obj/structure/cable/yellow{
	icon_state = "0-4"
	},
/obj/machinery/power/solar,
/turf/open/floor/plating/icemoon{
	light_range = 2
	},
/area/overmap_encounter/planetoid/ice/explored)
"Ro" = (
/obj/structure/curtain/cloth/fancy,
/obj/structure/window/reinforced/fulltile,
/obj/structure/grille,
/turf/open/floor/plating,
/area/ruin/unpowered)
"Sg" = (
/obj/structure/curtain/bounty,
/obj/structure/window/reinforced/fulltile,
/obj/structure/grille,
/turf/open/floor/plating,
/area/ruin/unpowered)
"Sq" = (
/obj/effect/turf_decal/siding/yellow,
/turf/open/floor/wood,
/area/ruin/unpowered)
"Sr" = (
/turf/closed/wall/mineral/iron,
/area/ruin/unpowered)
"Sx" = (
/obj/effect/turf_decal/siding/yellow/corner{
	dir = 8
	},
/obj/effect/decal/cleanable/cobweb/cobweb2,
/obj/effect/turf_decal/siding/wood{
	dir = 5
	},
/obj/item/kirbyplants/dead{
	pixel_y = 9
	},
/turf/open/floor/wood,
/area/ruin/unpowered)
"Tj" = (
/obj/effect/turf_decal/siding/yellow{
	dir = 4
	},
/obj/item/chair/stool/bar{
	pixel_x = 10
	},
/turf/open/floor/wood,
/area/ruin/unpowered)
"Tu" = (
/obj/structure/flora/grass/both{
	icon_state = "snowbush1"
	},
/turf/open/floor/plating/asteroid/snow/lit,
/area/overmap_encounter/planetoid/ice/explored)
"Uj" = (
/obj/structure/cable{
	icon_state = "2-4"
	},
/obj/structure/chair/wood{
	dir = 1
	},
/turf/open/floor/wood/cold{
	icon_state = "wood-broken2"
	},
/area/ruin/unpowered)
"UJ" = (
/obj/structure/cable/yellow{
	icon_state = "1-2"
	},
/obj/structure/cable/yellow{
	icon_state = "2-8"
	},
/obj/structure/cable/yellow{
	icon_state = "2-4"
	},
/obj/machinery/atmospherics/components/unary/vent_scrubber/layer4,
/obj/machinery/atmospherics/pipe/simple/scrubbers/visible/layer2,
/turf/open/floor/plating/snowed/smoothed/icemoon{
	light_range = 2
	},
/area/ruin/unpowered)
"Vf" = (
/obj/effect/turf_decal/siding/yellow{
	dir = 8
	},
/obj/effect/turf_decal/siding/wood{
	dir = 4
	},
/turf/open/floor/wood,
/area/ruin/unpowered)
"Vy" = (
/turf/open/floor/wood,
/area/ruin/unpowered)
"VH" = (
/turf/open/floor/wood/cold,
/area/ruin/unpowered)
"We" = (
/obj/structure/flora/driftlog{
	name = "log"
	},
/turf/open/floor/plating/asteroid/snow/lit,
/area/overmap_encounter/planetoid/ice/explored)
"Wq" = (
/obj/structure/flora/tree/pine,
/turf/open/floor/plating/asteroid/snow/lit,
/area/overmap_encounter/planetoid/ice/explored)
"WF" = (
/obj/effect/turf_decal/siding/yellow{
	dir = 4
	},
/turf/open/floor/wood,
/area/ruin/unpowered)
"Xk" = (
/turf/open/floor/concrete/tiles,
/area/ruin/unpowered)
"YI" = (
/obj/structure/flora/grass/both,
/turf/open/floor/plating/asteroid/snow/lit,
/area/overmap_encounter/planetoid/ice/explored)
"Zc" = (
/obj/structure/cable{
	icon_state = "1-2"
	},
/turf/open/floor/wood/cold,
/area/ruin/unpowered)
"Zr" = (
/obj/structure/chair/comfy/brown,
/turf/open/floor/carpet/red,
/area/ruin/unpowered)
"Zx" = (
/obj/machinery/hydroponics/soil,
/turf/open/floor/plating/sandy_dirt{
	light_range = 2
	},
/area/overmap_encounter/planetoid/ice/explored)

(1,1,1) = {"
Nh
Nh
Nh
Nh
Nh
fr
YI
fr
aq
fr
fr
Nh
Nh
Nh
Nh
Nh
Nh
Nh
Wq
pl
Ey
Nh
Nh
Nh
"}
(2,1,1) = {"
Nh
Nh
Nh
Nh
fr
fr
fr
fr
fr
fr
fr
fr
fr
fr
fr
Ey
fr
fr
fr
fr
fr
fr
fr
Nh
"}
(3,1,1) = {"
Nh
fr
Kp
Tu
fr
fr
fr
fr
fr
fr
Rd
Rd
eR
eR
eR
Sr
Sr
Sr
HL
Sg
HL
HL
fr
Nh
"}
(4,1,1) = {"
nk
HL
HL
HL
HL
EO
fr
fr
cs
fr
xg
xg
eR
bE
Cr
Xk
HH
ws
uD
ni
fh
HL
he
fr
"}
(5,1,1) = {"
fr
HL
QJ
fX
Cf
fr
fr
fr
nJ
FC
ze
UJ
Av
Hi
Fb
lf
ao
Vy
Vy
Vy
bC
HL
mb
fr
"}
(6,1,1) = {"
fr
HL
pf
iv
HL
ms
fr
fr
fr
tE
Bp
Bp
eR
lT
oV
jR
gj
Vy
EP
EP
Ly
HL
DW
fr
"}
(7,1,1) = {"
fr
HL
Qx
zn
HL
mH
fr
fr
fr
kz
yv
PJ
HL
HL
HL
HL
el
Vy
Vy
lD
DQ
HL
fr
fr
"}
(8,1,1) = {"
fr
fr
fr
fr
fr
fr
fr
fr
fr
YI
IM
bW
Qu
VH
gQ
HL
al
WF
WF
Tj
rD
HL
fr
fr
"}
(9,1,1) = {"
Wq
fr
fr
fr
zy
xx
xx
tE
Zx
Gn
hg
Ma
Uj
Zc
Zc
AA
ge
MO
MO
MO
hB
HL
fr
fr
"}
(10,1,1) = {"
Nh
fr
fr
fr
xx
xx
xx
xx
As
zZ
Zx
IF
eY
VH
VH
ka
Sq
Zr
yZ
CF
tM
HL
fr
fr
"}
(11,1,1) = {"
Nh
NU
fr
tE
xx
xx
xx
xx
xx
Zx
IM
Ad
bO
VH
VH
HL
Sx
Vf
Vf
Vf
BY
HL
fr
fr
"}
(12,1,1) = {"
Nh
fr
fr
fr
AG
xx
xx
xx
xx
tE
fr
lC
HL
vG
vG
HL
HL
Ro
Ro
Ro
HL
HL
fr
fa
"}
(13,1,1) = {"
Nh
qR
YI
We
OU
xx
xx
xx
as
fr
fr
La
fr
fr
fr
fr
fr
fr
fr
fr
fr
fr
fr
fr
"}
(14,1,1) = {"
Nh
Nh
fr
fr
fr
fr
fr
fr
fr
fr
fr
fr
fr
fr
fr
iE
At
fr
fr
fr
fr
fr
Ix
Nh
"}
(15,1,1) = {"
Nh
Nh
Jh
fr
fr
fr
fr
fr
fr
fr
fr
fr
Nh
Nh
Nh
Nh
Nh
fr
OU
fr
fr
fr
Nh
Nh
"}
(16,1,1) = {"
Nh
Nh
Nh
fr
fr
sx
fr
fr
fr
fr
fr
Nh
Nh
Nh
Nh
Nh
Nh
Nh
Nh
Nh
Nh
Nh
Nh
Nh
"}
