//MAP CONVERTED BY dmm2tgm.py THIS HEADER COMMENT PREVENTS RECONVERSION, DO NOT REMOVE
"bQ" = (
/obj/machinery/light/dim{
	dir = 8
	},
/turf/open/floor/concrete/slab_1,
/area/ruin/unpowered/gasstation)
"cr" = (
/obj/structure/chair{
	dir = 8
	},
/turf/open/floor/plasteel/white,
/area/ruin/unpowered/gasstation)
"cX" = (
/obj/structure/sign/poster/contraband/smoke,
/turf/closed/wall/rust,
/area/ruin/unpowered/gasstation)
"ei" = (
/obj/effect/turf_decal/corner/bar/half{
	dir = 4
	},
/turf/open/floor/plasteel/white,
/area/ruin/unpowered/gasstation)
"ey" = (
/obj/machinery/light/broken{
	dir = 8
	},
/obj/effect/turf_decal/corner/bottlegreen/three_quarters{
	dir = 1
	},
/turf/open/floor/plasteel/white,
/area/ruin/unpowered/gasstation)
"eN" = (
/obj/structure/rack,
/obj/structure/window,
/turf/open/floor/plasteel/white,
/area/ruin/unpowered/gasstation)
"eR" = (
/obj/structure/sign/warning/nosmoking,
/turf/closed/wall/rust,
/area/ruin/unpowered/gasstation)
"eU" = (
/obj/structure/rack,
/obj/structure/window{
	dir = 4
	},
/obj/item/toy/foamblade,
/turf/open/floor/plasteel/white,
/area/ruin/unpowered/gasstation)
"gs" = (
/obj/structure/barricade/wooden,
/obj/effect/turf_decal/corner/bar/half{
	dir = 4
	},
/turf/open/floor/plasteel/white,
/area/ruin/unpowered/gasstation)
"gF" = (
/obj/machinery/light/broken{
	dir = 4
	},
/obj/effect/turf_decal/corner/bar/half{
	dir = 4
	},
/turf/open/floor/plasteel/white,
/area/ruin/unpowered/gasstation)
"ht" = (
/obj/item/trash/can/food/beans,
/obj/effect/turf_decal/corner/bar/three_quarters{
	dir = 4
	},
/turf/open/floor/plasteel/white,
/area/ruin/unpowered/gasstation)
"hx" = (
/obj/item/trash/energybar,
/turf/open/floor/plasteel/white,
/area/ruin/unpowered/gasstation)
"hG" = (
/obj/effect/turf_decal/corner/red/full,
/obj/machinery/door/airlock/glass_large{
	doorOpen = 'sound/machines/defib_success.ogg'
	},
/turf/open/floor/plasteel/white,
/area/ruin/unpowered/gasstation)
"jd" = (
/obj/structure/tank_dispenser/plasma,
/turf/open/floor/plasteel,
/area/ruin/unpowered/gasstation)
"jj" = (
/obj/effect/decal/cleanable/crayon{
	icon_state = "Diablo";
	name = "pirate graffiti";
	paint_colour = "#DA0000"
	},
/turf/closed/wall/rust,
/area/ruin/unpowered/gasstation)
"jT" = (
/obj/machinery/light/dim,
/turf/open/floor/plasteel/grimy,
/area/ruin/unpowered/gasstation)
"ke" = (
/turf/open/floor/plating,
/area/ruin/unpowered/gasstation)
"kv" = (
/obj/structure/sign/warning/fire,
/turf/closed/wall/rust,
/area/ruin/unpowered/gasstation)
"kz" = (
/obj/structure/girder,
/turf/open/floor/plating,
/area/ruin/unpowered/gasstation)
"lo" = (
/obj/structure/sink,
/obj/effect/turf_decal/corner/blue/diagonal,
/turf/open/floor/plasteel/white,
/area/ruin/unpowered/gasstation)
"ls" = (
/obj/structure/rack,
/obj/structure/window{
	dir = 4
	},
/obj/structure/window,
/turf/open/floor/plasteel/white,
/area/ruin/unpowered/gasstation)
"lP" = (
/obj/item/trash/candy,
/turf/open/floor/concrete/slab_1,
/area/ruin/unpowered/gasstation)
"mM" = (
/obj/structure/rack,
/obj/structure/window{
	dir = 1
	},
/obj/item/toy/cards/deck/syndicate,
/turf/open/floor/plasteel/white,
/area/ruin/unpowered/gasstation)
"mW" = (
/obj/item/trash/popcorn,
/turf/open/floor/plasteel/white,
/area/ruin/unpowered/gasstation)
"nq" = (
/obj/structure/chair{
	dir = 8
	},
/obj/item/trash/can,
/turf/open/floor/plasteel/white,
/area/ruin/unpowered/gasstation)
"nC" = (
/mob/living/simple_animal/hostile/russian/ranged/officer{
	atmos_requirements = list("min_oxy" = 0, "max_oxy" = 0, "min_tox" = 0, "max_tox" = 0, "min_co2" = 0, "max_co2" = 0, "min_n2" = 0, "max_n2" = 0);
	minbodytemp = 0
	},
/turf/open/floor/plasteel/grimy,
/area/ruin/unpowered/gasstation)
"nO" = (
/obj/structure/table,
/turf/open/floor/plasteel/white,
/area/ruin/unpowered/gasstation)
"ot" = (
/obj/item/trash/sosjerky,
/turf/open/floor/plasteel/white,
/area/ruin/unpowered/gasstation)
"oA" = (
/obj/effect/decal/cleanable/cobweb,
/obj/effect/turf_decal/corner/bottlegreen/three_quarters{
	dir = 4
	},
/turf/open/floor/plasteel/white,
/area/ruin/unpowered/gasstation)
"pZ" = (
/obj/effect/decal/cleanable/crayon{
	icon_state = "Diablo";
	name = "pirate graffiti";
	paint_colour = "#DA0000"
	},
/obj/effect/turf_decal/corner/bar/half{
	dir = 1
	},
/turf/open/floor/plasteel/white,
/area/ruin/unpowered/gasstation)
"qs" = (
/obj/machinery/vending/cigarette,
/turf/open/floor/plasteel/white,
/area/ruin/unpowered/gasstation)
"qS" = (
/obj/item/trash/boritos,
/turf/open/floor/concrete/slab_1,
/area/ruin/unpowered/gasstation)
"qW" = (
/obj/machinery/vending/boozeomat{
	products = list(/obj/item/reagent_containers/food/drinks/bottle/gin = 2, /obj/item/reagent_containers/food/drinks/bottle/whiskey = 2, /obj/item/reagent_containers/food/drinks/bottle/tequila = 3, /obj/item/reagent_containers/food/drinks/bottle/vodka = 1, /obj/item/reagent_containers/food/drinks/bottle/vermouth = 3, /obj/item/reagent_containers/food/drinks/bottle/rum = 5, /obj/item/reagent_containers/food/drinks/bottle/wine = 2, /obj/item/reagent_containers/food/drinks/bottle/cognac = 3, /obj/item/reagent_containers/food/drinks/bottle/kahlua = 1, /obj/item/reagent_containers/food/drinks/bottle/absinthe = 2, /obj/item/reagent_containers/food/drinks/ale = 3, /obj/item/reagent_containers/food/drinks/flask = 1)
	},
/turf/open/floor/plasteel/white,
/area/ruin/unpowered/gasstation)
"rs" = (
/obj/structure/rack,
/obj/structure/window{
	dir = 1
	},
/obj/item/reagent_containers/food/snacks/chips,
/obj/item/reagent_containers/food/snacks/chips,
/turf/open/floor/plasteel/white,
/area/ruin/unpowered/gasstation)
"sd" = (
/obj/machinery/light/broken{
	dir = 4
	},
/turf/open/floor/concrete/slab_1,
/area/ruin/unpowered/gasstation)
"sp" = (
/obj/item/cigbutt,
/turf/open/floor/plating,
/area/ruin/unpowered/gasstation)
"tq" = (
/mob/living/simple_animal/hostile/pirate/melee/space,
/turf/open/floor/concrete/slab_1,
/area/ruin/unpowered/gasstation)
"tM" = (
/obj/machinery/door/window{
	dir = 4
	},
/obj/effect/turf_decal/corner/bottlegreen/full,
/turf/open/floor/plasteel/white,
/area/ruin/unpowered/gasstation)
"tN" = (
/obj/structure/sign/poster/contraband/space_cola,
/turf/closed/wall/rust,
/area/ruin/unpowered/gasstation)
"tS" = (
/turf/open/floor/plasteel/grimy,
/area/ruin/unpowered/gasstation)
"tT" = (
/obj/structure/rack,
/obj/structure/window{
	dir = 8
	},
/obj/item/storage/cans/sixbeer,
/turf/open/floor/plasteel/white,
/area/ruin/unpowered/gasstation)
"ut" = (
/obj/structure/table,
/obj/machinery/microwave,
/obj/effect/turf_decal/corner/bar/half{
	dir = 1
	},
/turf/open/floor/plasteel/white,
/area/ruin/unpowered/gasstation)
"ux" = (
/obj/structure/sign/poster/official/foam_force_ad,
/turf/closed/wall/rust,
/area/ruin/unpowered/gasstation)
"uR" = (
/obj/structure/sign/poster/contraband/pwr_game,
/turf/closed/wall/rust,
/area/ruin/unpowered/gasstation)
"uW" = (
/obj/effect/turf_decal/corner/bottlegreen/three_quarters,
/turf/open/floor/plasteel/white,
/area/ruin/unpowered/gasstation)
"vE" = (
/obj/effect/turf_decal/corner/bar{
	dir = 1
	},
/turf/open/floor/plasteel/white,
/area/ruin/unpowered/gasstation)
"vZ" = (
/obj/structure/table,
/obj/item/storage/box/drinkingglasses,
/obj/effect/turf_decal/corner/bar/half{
	dir = 1
	},
/obj/effect/spawner/lootdrop/donkpockets,
/turf/open/floor/plasteel/white,
/area/ruin/unpowered/gasstation)
"xX" = (
/turf/open/floor/plasteel/white,
/area/ruin/unpowered/gasstation)
"ym" = (
/obj/item/cigbutt,
/turf/open/floor/concrete/slab_1,
/area/ruin/unpowered/gasstation)
"yu" = (
/obj/structure/flora/grass/brown,
/turf/open/floor/plating/asteroid/snow/icemoon,
/area/ruin/unpowered/gasstation)
"yI" = (
/obj/effect/turf_decal/corner/bar/half{
	dir = 8
	},
/turf/open/floor/plasteel/white,
/area/ruin/unpowered/gasstation)
"yP" = (
/obj/item/storage/toolbox/ammo,
/turf/open/floor/plasteel/grimy,
/area/ruin/unpowered/gasstation)
"yS" = (
/obj/effect/turf_decal/box/white,
/turf/open/floor/concrete/slab_1,
/area/ruin/unpowered/gasstation)
"zi" = (
/obj/structure/table/reinforced,
/turf/open/floor/plasteel/white,
/area/ruin/unpowered/gasstation)
"zK" = (
/obj/structure/rack,
/obj/structure/window,
/obj/item/gun/ballistic/shotgun/toy,
/obj/item/ammo_box/foambox,
/turf/open/floor/plasteel/white,
/area/ruin/unpowered/gasstation)
"Ay" = (
/obj/structure/table,
/obj/machinery/chem_dispenser/drinks,
/obj/machinery/light{
	dir = 1;
	light_color = "#c1caff"
	},
/obj/effect/turf_decal/corner/bar/half{
	dir = 1
	},
/turf/open/floor/plasteel/white,
/area/ruin/unpowered/gasstation)
"BA" = (
/obj/structure/chair/sofa/right{
	dir = 4
	},
/turf/open/floor/plasteel/grimy,
/area/ruin/unpowered/gasstation)
"Cz" = (
/obj/effect/turf_decal/corner/bar/three_quarters{
	dir = 4
	},
/turf/open/floor/plasteel/white,
/area/ruin/unpowered/gasstation)
"CI" = (
/obj/effect/turf_decal/corner/bar/half,
/turf/open/floor/plasteel/white,
/area/ruin/unpowered/gasstation)
"CP" = (
/obj/item/trash/syndi_cakes,
/turf/open/floor/concrete/slab_1,
/area/ruin/unpowered/gasstation)
"CX" = (
/obj/item/trash/cheesie,
/turf/open/floor/plasteel/white,
/area/ruin/unpowered/gasstation)
"Dd" = (
/obj/machinery/light/dim{
	dir = 4
	},
/turf/open/floor/concrete/slab_1,
/area/ruin/unpowered/gasstation)
"Dk" = (
/obj/item/reagent_containers/food/drinks/bottle/moonshine,
/turf/open/floor/plasteel/white,
/area/ruin/unpowered/gasstation)
"Dy" = (
/obj/structure/chair{
	dir = 4
	},
/obj/effect/turf_decal/corner/bar/half{
	dir = 8
	},
/turf/open/floor/plasteel/white,
/area/ruin/unpowered/gasstation)
"DL" = (
/obj/machinery/light/dim{
	dir = 8
	},
/obj/effect/turf_decal/corner/bar/half{
	dir = 8
	},
/turf/open/floor/plasteel/white,
/area/ruin/unpowered/gasstation)
"Eb" = (
/obj/machinery/door/airlock/grunge,
/obj/structure/barricade/wooden/crude/snow,
/turf/open/floor/plasteel/white,
/area/ruin/unpowered/gasstation)
"EN" = (
/obj/structure/rack,
/obj/structure/window{
	dir = 8
	},
/obj/item/reagent_containers/food/snacks/sosjerky,
/turf/open/floor/plasteel/white,
/area/ruin/unpowered/gasstation)
"FK" = (
/obj/item/storage/cans/sixbeer,
/turf/open/floor/plasteel/white,
/area/ruin/unpowered/gasstation)
"FY" = (
/obj/machinery/vending/donksofttoyvendor,
/obj/effect/turf_decal/corner/bar/three_quarters{
	dir = 8
	},
/turf/open/floor/plasteel/white,
/area/ruin/unpowered/gasstation)
"GT" = (
/obj/structure/sign/poster/official/cohiba_robusto_ad,
/turf/closed/wall/rust,
/area/ruin/unpowered/gasstation)
"Ih" = (
/obj/structure/bonfire/prelit,
/turf/open/floor/plating,
/area/ruin/unpowered/gasstation)
"IF" = (
/obj/structure/rack,
/obj/structure/window{
	dir = 1
	},
/obj/item/reagent_containers/food/snacks/cornchips,
/obj/item/trash/boritos,
/turf/open/floor/plasteel/white,
/area/ruin/unpowered/gasstation)
"IH" = (
/obj/effect/turf_decal/corner/bar/half{
	dir = 1
	},
/turf/open/floor/plasteel/white,
/area/ruin/unpowered/gasstation)
"II" = (
/obj/effect/decal/cleanable/crayon{
	icon_state = "Diablo";
	name = "pirate graffiti";
	paint_colour = "#DA0000"
	},
/turf/open/floor/concrete/slab_1,
/area/ruin/unpowered/gasstation)
"IP" = (
/obj/structure/chair/office,
/mob/living/simple_animal/hostile/pirate/ranged/space,
/turf/open/floor/plasteel/white,
/area/ruin/unpowered/gasstation)
"IU" = (
/turf/open/floor/plating/asteroid/snow/icemoon,
/area/ruin/unpowered/gasstation)
"JA" = (
/obj/item/trash/can,
/obj/effect/turf_decal/corner/bar/half{
	dir = 8
	},
/turf/open/floor/plasteel/white,
/area/ruin/unpowered/gasstation)
"JR" = (
/obj/structure/sign/poster/contraband/space_up,
/turf/closed/wall/rust,
/area/ruin/unpowered/gasstation)
"Ku" = (
/obj/structure/closet/firecloset,
/turf/open/floor/plasteel/grimy,
/area/ruin/unpowered/gasstation)
"KQ" = (
/obj/structure/rack,
/obj/structure/window{
	dir = 4
	},
/obj/item/toy/plush/nukeplushie,
/obj/item/toy/nuke,
/turf/open/floor/plasteel/white,
/area/ruin/unpowered/gasstation)
"Lm" = (
/mob/living/simple_animal/hostile/russian/ranged{
	atmos_requirements = list("min_oxy" = 0, "max_oxy" = 0, "min_tox" = 0, "max_tox" = 0, "min_co2" = 0, "max_co2" = 0, "min_n2" = 0, "max_n2" = 0);
	minbodytemp = 0
	},
/obj/effect/turf_decal/corner/blue/diagonal,
/turf/open/floor/plasteel/white,
/area/ruin/unpowered/gasstation)
"LP" = (
/obj/structure/barricade/sandbags,
/turf/open/floor/plasteel/grimy,
/area/ruin/unpowered/gasstation)
"LT" = (
/obj/machinery/door/airlock/grunge,
/obj/structure/barricade/wooden/crude,
/turf/open/floor/plasteel/grimy,
/area/ruin/unpowered/gasstation)
"Mk" = (
/turf/template_noop,
/area/template_noop)
"Mp" = (
/obj/structure/toilet,
/obj/effect/mob_spawn/human/corpse/assistant,
/obj/effect/decal/cleanable/blood,
/obj/item/storage/fancy/cigarettes/dromedaryco,
/obj/effect/turf_decal/corner/blue/diagonal,
/turf/open/floor/plasteel/white,
/area/ruin/unpowered/gasstation)
"Ms" = (
/obj/effect/mob_spawn/human/corpse/russian/ranged/trooper,
/obj/effect/decal/cleanable/blood,
/turf/open/floor/plasteel/white,
/area/ruin/unpowered/gasstation)
"My" = (
/obj/effect/decal/cleanable/crayon{
	icon_state = "Diablo";
	name = "pirate graffiti";
	paint_colour = "#DA0000"
	},
/obj/machinery/light/broken{
	dir = 8
	},
/turf/open/floor/concrete/slab_1,
/area/ruin/unpowered/gasstation)
"Nt" = (
/turf/closed/wall/mineral/wood,
/area/ruin/unpowered/gasstation)
"Nx" = (
/obj/effect/turf_decal/corner/red/full,
/turf/open/floor/plasteel/white,
/area/ruin/unpowered/gasstation)
"OX" = (
/obj/structure/extinguisher_cabinet{
	pixel_y = 30
	},
/turf/open/floor/concrete/slab_1,
/area/ruin/unpowered/gasstation)
"Pp" = (
/obj/item/gun/ballistic/automatic/pistol/disposable,
/turf/open/floor/plasteel/white,
/area/ruin/unpowered/gasstation)
"Pq" = (
/obj/structure/barricade/sandbags,
/obj/item/reagent_containers/food/drinks/bottle/vodka,
/turf/open/floor/plasteel/grimy,
/area/ruin/unpowered/gasstation)
"Pw" = (
/obj/structure/chair/sofa/left{
	dir = 4
	},
/turf/open/floor/plasteel/grimy,
/area/ruin/unpowered/gasstation)
"PG" = (
/obj/machinery/vending/coffee,
/obj/effect/turf_decal/corner/bar/half{
	dir = 4
	},
/turf/open/floor/plasteel/white,
/area/ruin/unpowered/gasstation)
"PJ" = (
/obj/structure/flora/grass/brown,
/turf/open/floor/concrete/slab_1,
/area/ruin/unpowered/gasstation)
"PS" = (
/obj/item/trash/can,
/turf/open/floor/plasteel/white,
/area/ruin/unpowered/gasstation)
"PV" = (
/obj/item/storage/fancy/cigarettes/cigars/cohiba{
	pixel_x = 5;
	pixel_y = -4
	},
/obj/item/cigbutt/cigarbutt,
/turf/open/floor/plasteel/white,
/area/ruin/unpowered/gasstation)
"Qa" = (
/obj/item/trash/pistachios,
/obj/effect/turf_decal/corner/bar/half,
/turf/open/floor/plasteel/white,
/area/ruin/unpowered/gasstation)
"Rl" = (
/obj/structure/rack,
/obj/structure/window{
	dir = 4
	},
/obj/item/reagent_containers/food/snacks/burrito,
/obj/item/reagent_containers/food/snacks/carneburrito,
/turf/open/floor/plating,
/area/ruin/unpowered/gasstation)
"Rq" = (
/obj/item/trash/can/food/beans,
/turf/open/floor/plasteel/grimy,
/area/ruin/unpowered/gasstation)
"Rt" = (
/obj/effect/turf_decal/corner/blue/diagonal,
/turf/open/floor/plasteel/white,
/area/ruin/unpowered/gasstation)
"Sa" = (
/obj/effect/mob_spawn/human/corpse/assistant,
/obj/effect/decal/cleanable/blood,
/obj/effect/turf_decal/corner/bar/half{
	dir = 8
	},
/turf/open/floor/plasteel/white,
/area/ruin/unpowered/gasstation)
"Sm" = (
/obj/structure/table/reinforced,
/obj/structure/barricade/wooden,
/turf/open/floor/plasteel/white,
/area/ruin/unpowered/gasstation)
"Sn" = (
/obj/item/trash/can,
/obj/effect/turf_decal/corner/bar/half{
	dir = 1
	},
/turf/open/floor/plasteel/white,
/area/ruin/unpowered/gasstation)
"SB" = (
/turf/open/floor/concrete/slab_1,
/area/ruin/unpowered/gasstation)
"SN" = (
/obj/structure/chair/comfy,
/mob/living/simple_animal/hostile/pirate/ranged/space,
/turf/open/floor/plasteel/white,
/area/ruin/unpowered/gasstation)
"SX" = (
/obj/effect/turf_decal/corner/bar/three_quarters{
	dir = 1
	},
/turf/open/floor/plasteel/white,
/area/ruin/unpowered/gasstation)
"Te" = (
/obj/structure/reagent_dispensers/fueltank,
/turf/open/floor/plasteel,
/area/ruin/unpowered/gasstation)
"Tl" = (
/obj/machinery/vending/cola/random,
/obj/machinery/light/dim{
	dir = 4
	},
/obj/effect/turf_decal/corner/bar/half{
	dir = 4
	},
/turf/open/floor/plasteel/white,
/area/ruin/unpowered/gasstation)
"Tv" = (
/obj/structure/closet,
/obj/item/gun/ballistic/automatic/p16,
/obj/item/ammo_box/magazine/p16,
/obj/item/ammo_box/magazine/p16,
/turf/open/floor/plasteel/grimy,
/area/ruin/unpowered/gasstation)
"Ty" = (
/mob/living/simple_animal/hostile/russian/ranged/mosin{
	atmos_requirements = list("min_oxy" = 0, "max_oxy" = 0, "min_tox" = 0, "max_tox" = 0, "min_co2" = 0, "max_co2" = 0, "min_n2" = 0, "max_n2" = 0);
	minbodytemp = 0
	},
/turf/open/floor/plasteel/grimy,
/area/ruin/unpowered/gasstation)
"TX" = (
/obj/structure/chair{
	dir = 4
	},
/mob/living/simple_animal/hostile/pirate/melee/space,
/turf/open/floor/plasteel/white,
/area/ruin/unpowered/gasstation)
"UA" = (
/obj/structure/rack,
/obj/structure/window{
	dir = 8
	},
/obj/item/toy/balloon/syndicate,
/turf/open/floor/plasteel/white,
/area/ruin/unpowered/gasstation)
"UB" = (
/obj/item/chair,
/turf/open/floor/plasteel/white,
/area/ruin/unpowered/gasstation)
"Vl" = (
/obj/item/trash/can/food/beans{
	pixel_x = -6;
	pixel_y = -4
	},
/obj/item/trash/can/food/beans{
	pixel_x = 10;
	pixel_y = -18
	},
/obj/item/trash/can/food/beans{
	pixel_x = 5;
	pixel_y = 15
	},
/obj/item/trash/can/food/beans,
/turf/open/floor/plasteel/grimy,
/area/ruin/unpowered/gasstation)
"VH" = (
/obj/machinery/light/broken{
	dir = 8
	},
/turf/open/floor/concrete/slab_1,
/area/ruin/unpowered/gasstation)
"VY" = (
/obj/structure/flora/grass/green,
/turf/open/floor/plating/asteroid/snow/icemoon,
/area/ruin/unpowered/gasstation)
"Wd" = (
/obj/item/gun/ballistic/automatic/surplus,
/obj/item/ammo_box/magazine/m10mm/rifle,
/turf/open/floor/plasteel/white,
/area/ruin/unpowered/gasstation)
"Wg" = (
/obj/item/reagent_containers/food/drinks/bottle/vodka{
	pixel_x = 8;
	pixel_y = -2
	},
/turf/open/floor/plasteel/grimy,
/area/ruin/unpowered/gasstation)
"Wj" = (
/obj/structure/sign/poster/contraband/red_rum,
/turf/closed/wall/rust,
/area/ruin/unpowered/gasstation)
"Wz" = (
/turf/closed/wall/rust,
/area/ruin/unpowered/gasstation)
"Xf" = (
/obj/item/stack/spacecash/c20{
	pixel_x = 3;
	pixel_y = -2
	},
/obj/item/stack/spacecash/c20,
/obj/item/stack/spacecash/c20{
	pixel_x = -1;
	pixel_y = 3
	},
/turf/open/floor/plasteel/white,
/area/ruin/unpowered/gasstation)
"Ye" = (
/obj/machinery/vending/snack/random,
/obj/effect/turf_decal/corner/bar/half{
	dir = 4
	},
/turf/open/floor/plasteel/white,
/area/ruin/unpowered/gasstation)
"YX" = (
/obj/structure/sign/poster/contraband/lusty_xenomorph,
/turf/closed/wall/rust,
/area/ruin/unpowered/gasstation)
"Zf" = (
/obj/item/gun/ballistic/automatic/pistol/disposable,
/obj/machinery/light/small/broken{
	dir = 1
	},
/obj/effect/turf_decal/corner/blue/diagonal,
/turf/open/floor/plasteel/white,
/area/ruin/unpowered/gasstation)
"Zg" = (
/obj/structure/rack,
/obj/structure/window{
	dir = 8
	},
/turf/open/floor/plating,
/area/ruin/unpowered/gasstation)
"ZF" = (
/obj/item/reagent_containers/food/drinks/bottle/hooch,
/turf/open/floor/plasteel/white,
/area/ruin/unpowered/gasstation)
"ZU" = (
/obj/structure/rack,
/obj/structure/window{
	dir = 1
	},
/turf/open/floor/plasteel/white,
/area/ruin/unpowered/gasstation)

(1,1,1) = {"
kz
Wz
Wz
Wz
Wz
YX
Wz
Wz
Wz
Wz
kz
kz
SB
SB
Dd
SB
SB
sd
SB
SB
"}
(2,1,1) = {"
Wz
tS
LP
Pq
Pw
BA
Vl
Rq
Wz
lo
Rt
Wz
SB
SB
eR
ym
SB
eR
SB
SB
"}
(3,1,1) = {"
kz
tS
tS
LP
Ty
yP
tS
jT
Wz
Zf
Rt
Eb
SB
SB
jd
yS
SB
jd
yS
SB
"}
(4,1,1) = {"
kz
ke
tS
LP
nC
Wg
Ku
Tv
Wz
Mp
Lm
Wz
SB
SB
SB
SB
SB
SB
SB
SB
"}
(5,1,1) = {"
ke
kz
LT
Wz
Wz
Wz
Wz
Wz
Wz
jj
Wz
Wz
SB
SB
SB
SB
SB
PJ
SB
SB
"}
(6,1,1) = {"
Wj
oA
xX
ey
zi
ht
yI
Sa
DL
yI
SX
Wz
SB
CP
jd
yS
IU
jd
yS
SB
"}
(7,1,1) = {"
Wz
qs
Ms
xX
zi
IH
xX
Wd
CX
xX
ke
Wz
SB
SB
kv
SB
SB
kv
SB
SB
"}
(8,1,1) = {"
Wz
qW
Pp
IP
zi
pZ
xX
xX
xX
xX
CI
hG
SB
SB
My
SB
SB
VH
SB
SB
"}
(9,1,1) = {"
GT
xX
PS
xX
zi
IH
xX
hx
xX
xX
Qa
Nx
SB
SB
Dd
SB
SB
Dd
SB
SB
"}
(10,1,1) = {"
cX
sp
xX
uW
zi
IH
UB
xX
ke
xX
CI
Wz
SB
SB
eR
tq
SB
eR
SB
SB
"}
(11,1,1) = {"
eR
tM
Sm
Sm
Sm
Nt
Nt
xX
xX
ot
CI
Wz
SB
SB
jd
yS
SB
jd
yS
SB
"}
(12,1,1) = {"
Wz
Cz
JA
yI
Dy
vE
Nt
Rl
ls
IF
CI
Wz
OX
SB
SB
SB
SB
SB
lP
SB
"}
(13,1,1) = {"
Wz
ut
PV
TX
Dk
PS
Nt
tT
EN
rs
CI
Wz
SB
yu
SB
SB
SB
SB
II
SB
"}
(14,1,1) = {"
Wz
vZ
SN
FK
Ih
ke
nO
mW
xX
xX
CI
jj
SB
SB
Te
yS
SB
Te
yS
SB
"}
(15,1,1) = {"
jj
Ay
ZF
Xf
nq
xX
eN
KQ
eU
mM
ke
Wz
qS
SB
kv
SB
SB
kv
SB
SB
"}
(16,1,1) = {"
Wz
Sn
xX
cr
xX
xX
zK
Zg
UA
ZU
ke
kz
SB
VY
bQ
II
SB
bQ
SB
SB
"}
(17,1,1) = {"
Wz
FY
PG
Tl
Ye
gs
gs
ei
gF
ke
ke
kz
SB
SB
SB
SB
SB
SB
SB
SB
"}
(18,1,1) = {"
Wz
tN
Wz
JR
uR
Wz
Wz
Wz
jj
ux
Wz
Wz
Mk
Mk
Mk
Mk
Mk
Mk
Mk
Mk
"}
