//MAP CONVERTED BY dmm2tgm.py THIS HEADER COMMENT PREVENTS RECONVERSION, DO NOT REMOVE
"aL" = (
/obj/structure/chair/office,
/turf/open/floor/plasteel/mono/dark,
/area/space)
"bc" = (
/obj/structure/table/reinforced,
/turf/closed/wall/mineral/titanium/nodiagonal,
/area/space)
"bk" = (
/obj/structure/railing{
	dir = 6;
	layer = 3.1
	},
/turf/open/floor/plasteel/mono/dark,
/area/space)
"cf" = (
/obj/machinery/door/poddoor,
/turf/template_noop,
/area/space)
"cm" = (
/obj/machinery/door/airlock/command{
	dir = 4;
	name = "Captain's Quarters";
	req_access_txt = "20"
	},
/turf/open/floor/plasteel/dark,
/area/space)
"da" = (
/obj/structure/table/reinforced,
/obj/machinery/recharger,
/turf/open/floor/plasteel/mono/dark,
/area/space)
"dj" = (
/obj/structure/table/reinforced,
/turf/closed/wall/mineral/titanium/nodiagonal,
/area/ship/cargo)
"dA" = (
/obj/structure/railing{
	dir = 5;
	layer = 4.1
	},
/obj/structure/table/reinforced,
/turf/open/floor/plasteel/mono/dark,
/area/space)
"fu" = (
/obj/structure/railing{
	dir = 6;
	layer = 3.1
	},
/obj/structure/table/reinforced,
/obj/item/paper_bin{
	pixel_x = -6
	},
/obj/item/stamp/head_of_personnel{
	pixel_x = 6
	},
/turf/open/floor/plasteel/mono/dark,
/area/space)
"jl" = (
/obj/structure/filingcabinet/double/grey,
/turf/open/floor/plasteel/mono/dark,
/area/space)
"jN" = (
/obj/structure/chair/office{
	dir = 1
	},
/turf/open/floor/plasteel/mono/dark,
/area/space)
"kh" = (
/obj/structure/railing/corner,
/obj/structure/table/reinforced,
/obj/machinery/fax/nanotrasen,
/turf/open/floor/plasteel/mono/dark,
/area/space)
"ki" = (
/obj/machinery/holopad/emergency/command,
/turf/open/floor/plasteel/mono/dark,
/area/space)
"kr" = (
/obj/machinery/atmospherics/components/binary/circulator,
/turf/template_noop,
/area/space)
"kJ" = (
/obj/machinery/modular_computer/console/preset/command{
	dir = 8
	},
/turf/open/floor/plasteel/dark,
/area/space)
"lE" = (
/turf/template_noop,
/area/ship/cargo)
"ol" = (
/turf/open/floor/carpet/blue,
/area/space)
"pd" = (
/obj/structure/chair/comfy/blue/corpo/directional/south,
/turf/open/floor/plasteel/mono/dark,
/area/space)
"pQ" = (
/obj/machinery/atmospherics/components/binary/circulator/cold{
	dir = 1
	},
/turf/template_noop,
/area/space)
"ql" = (
/obj/machinery/computer/helm{
	dir = 8
	},
/turf/open/floor/plasteel/dark,
/area/space)
"se" = (
/obj/machinery/door/airlock/command{
	dir = 8;
	name = "First Officer's Quarters";
	req_access_txt = "57"
	},
/turf/open/floor/plasteel/dark,
/area/space)
"sh" = (
/obj/machinery/door/poddoor{
	dir = 4
	},
/turf/template_noop,
/area/space)
"st" = (
/obj/machinery/door/airlock{
	dir = 4;
	name = "Custodial Closet"
	},
/turf/template_noop,
/area/space)
"tO" = (
/obj/machinery/conveyor{
	dir = 1;
	id = "osprey_garbage"
	},
/turf/template_noop,
/area/space)
"uf" = (
/obj/machinery/door/airlock/mining{
	dir = 4
	},
/turf/closed/wall/mineral/titanium/nodiagonal,
/area/ship/cargo)
"ux" = (
/obj/structure/railing/corner{
	dir = 8
	},
/turf/open/floor/plasteel/mono/dark,
/area/space)
"wL" = (
/obj/machinery/door/airlock/grunge{
	dir = 4
	},
/turf/open/floor/plasteel/dark,
/area/space)
"xJ" = (
/obj/machinery/door/poddoor/shutters{
	dir = 4
	},
/turf/template_noop,
/area/ship/cargo)
"yO" = (
/turf/closed/wall/mineral/titanium/nodiagonal,
/area/space)
"BF" = (
/obj/machinery/door/airlock/command{
	dir = 4;
	name = "Bridge";
	req_access_txt = "19"
	},
/turf/open/floor/plasteel,
/area/space)
"CW" = (
/obj/effect/spawner/structure/window/shuttle,
/turf/open/floor/plating,
/area/space)
"Em" = (
/obj/structure/AIcore,
/turf/open/floor/plasteel/dark,
/area/space)
"Fx" = (
/obj/machinery/mass_driver{
	dir = 8;
	id = "osprey_disposals"
	},
/turf/template_noop,
/area/space)
"Fy" = (
/obj/structure/railing{
	dir = 5;
	layer = 4.1
	},
/turf/open/floor/plasteel/mono/dark,
/area/space)
"Gt" = (
/obj/structure/chair/comfy/shuttle{
	dir = 4;
	name = "Helm"
	},
/turf/open/floor/plasteel/dark,
/area/space)
"HC" = (
/obj/structure/railing{
	dir = 4
	},
/obj/structure/chair/comfy/blue/corpo/directional/west,
/turf/open/floor/plasteel/mono/dark,
/area/space)
"Kg" = (
/obj/structure/railing{
	dir = 1
	},
/turf/open/floor/plasteel/mono/dark,
/area/space)
"Kt" = (
/obj/structure/table/reinforced,
/turf/open/floor/plasteel/mono/dark,
/area/space)
"Kz" = (
/obj/machinery/door/airlock/security,
/turf/template_noop,
/area/space)
"KX" = (
/obj/structure/railing/corner{
	dir = 4
	},
/obj/structure/table/reinforced,
/turf/open/floor/plasteel/mono/dark,
/area/space)
"LC" = (
/obj/structure/railing{
	dir = 8
	},
/turf/open/floor/plasteel/stairs,
/area/space)
"MO" = (
/obj/machinery/door/airlock/mining{
	dir = 4
	},
/turf/template_noop,
/area/ship/cargo)
"MT" = (
/turf/open/floor/carpet/royalblue,
/area/space)
"MZ" = (
/turf/template_noop,
/area/space)
"Ny" = (
/obj/machinery/power/generator{
	dir = 4
	},
/turf/template_noop,
/area/space)
"NS" = (
/turf/open/floor/plasteel,
/area/space)
"Od" = (
/obj/structure/railing{
	dir = 8
	},
/turf/open/floor/plasteel/stairs{
	dir = 1
	},
/area/space)
"Pj" = (
/turf/open/floor/plasteel/dark,
/area/space)
"Rg" = (
/obj/structure/chair/comfy/blue/corpo/directional/north,
/turf/open/floor/plasteel/mono/dark,
/area/space)
"Rt" = (
/obj/structure/railing,
/turf/open/floor/plasteel/mono/dark,
/area/space)
"TX" = (
/obj/item/kirbyplants/random,
/turf/open/floor/plasteel,
/area/space)
"Ub" = (
/obj/machinery/door/airlock/external,
/turf/template_noop,
/area/space)
"Ur" = (
/obj/machinery/computer/atmos_control/incinerator{
	dir = 4;
	sensors = list("nemo_incinerator_sensor"="Incinerator  Chamber")
	},
/turf/template_noop,
/area/space)
"VV" = (
/turf/open/floor/plasteel/mono/dark,
/area/space)
"WT" = (
/turf/open/floor/plasteel/stairs{
	dir = 4
	},
/area/space)
"Xo" = (
/obj/machinery/door/airlock/mining,
/turf/template_noop,
/area/ship/cargo)
"Yp" = (
/turf/closed/wall/mineral/titanium/nodiagonal,
/area/ship/cargo)
"YZ" = (
/obj/structure/railing/corner{
	dir = 1
	},
/turf/open/floor/plasteel/mono/dark,
/area/space)

(1,1,1) = {"
MZ
MZ
MZ
MZ
MZ
MZ
yO
yO
yO
yO
yO
MZ
MZ
MZ
MZ
MZ
MZ
MZ
MZ
MZ
MZ
MZ
MZ
MZ
MZ
MZ
MZ
MZ
MZ
MZ
yO
yO
yO
yO
yO
MZ
MZ
MZ
MZ
MZ
"}
(2,1,1) = {"
MZ
MZ
yO
yO
yO
yO
yO
MZ
MZ
MZ
yO
MZ
MZ
MZ
MZ
MZ
MZ
MZ
MZ
MZ
MZ
MZ
MZ
MZ
MZ
MZ
MZ
MZ
MZ
MZ
yO
MZ
MZ
MZ
yO
yO
yO
yO
yO
MZ
"}
(3,1,1) = {"
MZ
MZ
yO
MZ
MZ
MZ
MZ
MZ
MZ
MZ
yO
MZ
MZ
MZ
MZ
MZ
MZ
MZ
yO
yO
yO
yO
yO
MZ
MZ
MZ
MZ
MZ
MZ
MZ
yO
MZ
MZ
MZ
MZ
MZ
MZ
MZ
yO
MZ
"}
(4,1,1) = {"
MZ
MZ
yO
MZ
MZ
MZ
MZ
MZ
MZ
MZ
yO
MZ
MZ
MZ
MZ
yO
yO
yO
yO
MZ
MZ
MZ
yO
yO
yO
yO
MZ
MZ
MZ
MZ
yO
MZ
MZ
MZ
MZ
MZ
MZ
MZ
yO
MZ
"}
(5,1,1) = {"
MZ
MZ
yO
MZ
MZ
MZ
MZ
MZ
MZ
MZ
yO
MZ
MZ
MZ
MZ
yO
MZ
MZ
yO
yO
yO
yO
yO
MZ
MZ
yO
MZ
MZ
MZ
MZ
yO
MZ
MZ
MZ
MZ
MZ
MZ
MZ
yO
MZ
"}
(6,1,1) = {"
MZ
MZ
yO
MZ
MZ
MZ
MZ
MZ
MZ
MZ
yO
yO
yO
yO
yO
yO
MZ
MZ
MZ
MZ
MZ
MZ
MZ
MZ
MZ
yO
sh
yO
yO
yO
yO
MZ
MZ
MZ
MZ
MZ
MZ
MZ
yO
MZ
"}
(7,1,1) = {"
MZ
MZ
yO
MZ
MZ
MZ
MZ
MZ
MZ
MZ
MZ
MZ
MZ
MZ
MZ
MZ
MZ
MZ
MZ
MZ
MZ
MZ
MZ
MZ
MZ
MZ
MZ
MZ
MZ
MZ
MZ
MZ
MZ
MZ
MZ
MZ
MZ
MZ
yO
MZ
"}
(8,1,1) = {"
MZ
MZ
yO
MZ
MZ
MZ
MZ
MZ
MZ
MZ
MZ
MZ
MZ
MZ
MZ
yO
MZ
MZ
MZ
kr
Ny
pQ
MZ
MZ
MZ
yO
MZ
MZ
MZ
MZ
MZ
MZ
MZ
MZ
MZ
MZ
MZ
MZ
yO
MZ
"}
(9,1,1) = {"
MZ
MZ
yO
MZ
MZ
MZ
MZ
MZ
MZ
MZ
MZ
MZ
MZ
MZ
MZ
yO
MZ
MZ
MZ
MZ
Ur
MZ
MZ
MZ
MZ
yO
sh
yO
yO
yO
yO
yO
MZ
MZ
MZ
MZ
MZ
MZ
yO
MZ
"}
(10,1,1) = {"
MZ
MZ
yO
MZ
MZ
MZ
MZ
MZ
MZ
MZ
MZ
MZ
MZ
MZ
MZ
yO
MZ
MZ
MZ
MZ
MZ
MZ
MZ
MZ
MZ
yO
Fx
tO
tO
tO
MZ
yO
MZ
MZ
MZ
MZ
MZ
MZ
yO
MZ
"}
(11,1,1) = {"
MZ
MZ
yO
MZ
MZ
MZ
MZ
MZ
MZ
MZ
MZ
MZ
MZ
yO
yO
yO
yO
yO
yO
yO
yO
yO
yO
yO
yO
yO
yO
yO
MZ
MZ
MZ
yO
MZ
MZ
MZ
MZ
MZ
MZ
yO
MZ
"}
(12,1,1) = {"
MZ
MZ
yO
MZ
MZ
MZ
MZ
MZ
MZ
MZ
MZ
MZ
MZ
yO
MT
MT
MT
yO
Pj
yO
Em
yO
Pj
yO
ol
ol
ol
yO
MZ
MZ
MZ
yO
MZ
MZ
MZ
MZ
MZ
MZ
yO
MZ
"}
(13,1,1) = {"
MZ
MZ
yO
MZ
MZ
MZ
MZ
MZ
MZ
MZ
MZ
MZ
MZ
yO
MT
MT
MT
yO
Pj
Pj
Pj
Pj
Pj
yO
ol
ol
ol
yO
MZ
MZ
MZ
yO
MZ
MZ
MZ
MZ
MZ
MZ
yO
MZ
"}
(14,1,1) = {"
MZ
MZ
yO
MZ
MZ
MZ
MZ
MZ
MZ
MZ
MZ
MZ
MZ
yO
MT
MT
MT
yO
Pj
Pj
Pj
Pj
Pj
yO
ol
ol
ol
yO
MZ
MZ
MZ
yO
MZ
MZ
MZ
MZ
MZ
MZ
yO
MZ
"}
(15,1,1) = {"
MZ
MZ
yO
yO
yO
yO
yO
yO
MZ
MZ
MZ
MZ
MZ
yO
MT
MT
MT
yO
Pj
Pj
Pj
Pj
Pj
yO
ol
ol
ol
yO
MZ
MZ
MZ
yO
MZ
yO
yO
yO
yO
yO
yO
MZ
"}
(16,1,1) = {"
MZ
MZ
yO
MZ
MZ
MZ
MZ
yO
MZ
MZ
yO
yO
yO
yO
yO
cm
yO
yO
yO
yO
wL
yO
yO
yO
yO
se
yO
yO
yO
yO
st
yO
MZ
yO
MZ
MZ
MZ
MZ
yO
MZ
"}
(17,1,1) = {"
MZ
MZ
Ub
MZ
MZ
MZ
MZ
Ub
MZ
MZ
MZ
yO
NS
NS
TX
Kg
VV
VV
VV
VV
VV
VV
VV
VV
VV
Rt
TX
NS
NS
yO
MZ
MZ
MZ
Ub
MZ
MZ
MZ
MZ
Ub
MZ
"}
(18,1,1) = {"
MZ
MZ
yO
yO
yO
yO
yO
yO
MZ
MZ
MZ
yO
NS
Od
Od
YZ
VV
VV
VV
VV
ki
VV
VV
VV
VV
ux
LC
LC
NS
yO
MZ
MZ
MZ
yO
yO
yO
yO
yO
yO
MZ
"}
(19,1,1) = {"
MZ
MZ
yO
MZ
MZ
MZ
MZ
yO
yO
MZ
MZ
yO
BF
yO
yO
jl
VV
VV
VV
pd
da
Rg
VV
VV
VV
Kt
yO
yO
BF
yO
MZ
MZ
yO
yO
MZ
MZ
MZ
MZ
yO
MZ
"}
(20,1,1) = {"
MZ
MZ
yO
MZ
MZ
MZ
MZ
MZ
yO
MZ
MZ
NS
NS
NS
CW
Kt
jN
VV
VV
pd
Kt
Rg
VV
VV
aL
Kt
CW
NS
NS
NS
MZ
MZ
yO
MZ
MZ
MZ
MZ
MZ
yO
MZ
"}
(21,1,1) = {"
MZ
MZ
yO
MZ
MZ
MZ
MZ
MZ
MZ
MZ
MZ
NS
NS
NS
CW
kh
fu
WT
WT
Fy
HC
bk
WT
WT
dA
KX
CW
NS
NS
NS
MZ
MZ
MZ
MZ
MZ
MZ
MZ
MZ
yO
MZ
"}
(22,1,1) = {"
MZ
MZ
yO
MZ
MZ
MZ
MZ
MZ
yO
yO
yO
yO
NS
NS
yO
yO
Pj
Pj
Pj
Pj
Pj
Pj
Pj
Pj
Pj
yO
yO
NS
NS
yO
yO
yO
yO
MZ
MZ
MZ
MZ
MZ
yO
MZ
"}
(23,1,1) = {"
MZ
MZ
yO
MZ
MZ
MZ
MZ
MZ
yO
MZ
MZ
yO
MZ
MZ
MZ
CW
Pj
Pj
Gt
Pj
Pj
Pj
Gt
Pj
Pj
CW
MZ
MZ
MZ
yO
MZ
MZ
yO
MZ
MZ
MZ
MZ
MZ
yO
MZ
"}
(24,1,1) = {"
MZ
MZ
yO
MZ
MZ
MZ
MZ
MZ
yO
MZ
MZ
yO
MZ
MZ
MZ
CW
CW
yO
ql
Pj
Pj
Pj
kJ
yO
CW
CW
MZ
MZ
MZ
yO
MZ
MZ
yO
MZ
MZ
MZ
MZ
MZ
yO
MZ
"}
(25,1,1) = {"
MZ
MZ
yO
MZ
MZ
MZ
yO
yO
yO
MZ
MZ
yO
MZ
MZ
MZ
MZ
MZ
yO
CW
CW
CW
CW
CW
yO
MZ
MZ
MZ
MZ
MZ
yO
MZ
MZ
yO
yO
yO
MZ
MZ
MZ
yO
MZ
"}
(26,1,1) = {"
MZ
MZ
yO
yO
yO
yO
yO
MZ
MZ
MZ
MZ
yO
MZ
MZ
MZ
MZ
MZ
MZ
MZ
MZ
MZ
MZ
MZ
MZ
MZ
MZ
MZ
MZ
MZ
yO
MZ
MZ
MZ
MZ
yO
yO
yO
yO
yO
MZ
"}
(27,1,1) = {"
MZ
MZ
MZ
MZ
MZ
MZ
MZ
MZ
MZ
MZ
MZ
yO
MZ
MZ
MZ
MZ
MZ
MZ
MZ
MZ
MZ
MZ
MZ
MZ
MZ
MZ
MZ
MZ
MZ
yO
MZ
MZ
MZ
MZ
MZ
MZ
MZ
MZ
MZ
MZ
"}
(28,1,1) = {"
MZ
MZ
MZ
MZ
MZ
MZ
MZ
MZ
MZ
MZ
MZ
yO
MZ
MZ
MZ
MZ
MZ
MZ
MZ
MZ
MZ
MZ
MZ
MZ
MZ
MZ
MZ
MZ
MZ
yO
MZ
MZ
MZ
MZ
MZ
MZ
MZ
MZ
MZ
MZ
"}
(29,1,1) = {"
MZ
MZ
MZ
MZ
MZ
MZ
MZ
MZ
MZ
MZ
MZ
yO
MZ
MZ
MZ
MZ
MZ
MZ
MZ
MZ
MZ
MZ
MZ
MZ
MZ
MZ
MZ
MZ
MZ
yO
MZ
MZ
MZ
MZ
MZ
MZ
MZ
MZ
MZ
MZ
"}
(30,1,1) = {"
MZ
MZ
MZ
MZ
MZ
MZ
MZ
MZ
MZ
yO
yO
yO
yO
yO
yO
yO
yO
yO
MZ
MZ
MZ
MZ
yO
yO
yO
yO
yO
yO
yO
yO
yO
yO
MZ
MZ
MZ
MZ
MZ
MZ
MZ
MZ
"}
(31,1,1) = {"
MZ
MZ
MZ
MZ
MZ
MZ
MZ
yO
yO
yO
MZ
MZ
MZ
MZ
MZ
MZ
MZ
yO
MZ
MZ
MZ
MZ
Yp
lE
lE
lE
lE
lE
lE
lE
lE
yO
yO
yO
MZ
MZ
MZ
MZ
MZ
MZ
"}
(32,1,1) = {"
MZ
MZ
MZ
MZ
MZ
yO
yO
yO
MZ
MZ
MZ
MZ
MZ
MZ
MZ
MZ
MZ
yO
MZ
MZ
MZ
MZ
Yp
lE
lE
lE
lE
lE
lE
lE
lE
lE
lE
yO
yO
yO
MZ
MZ
MZ
MZ
"}
(33,1,1) = {"
MZ
MZ
MZ
MZ
MZ
yO
MZ
MZ
MZ
MZ
MZ
MZ
MZ
MZ
MZ
MZ
MZ
yO
MZ
MZ
MZ
MZ
dj
lE
lE
lE
lE
lE
lE
lE
lE
lE
lE
lE
lE
yO
MZ
MZ
MZ
MZ
"}
(34,1,1) = {"
MZ
MZ
MZ
MZ
MZ
yO
MZ
MZ
MZ
MZ
MZ
MZ
MZ
MZ
MZ
MZ
MZ
yO
MZ
MZ
MZ
MZ
dj
lE
lE
lE
lE
lE
lE
lE
lE
lE
lE
lE
lE
yO
MZ
MZ
MZ
MZ
"}
(35,1,1) = {"
MZ
MZ
MZ
MZ
MZ
yO
MZ
MZ
MZ
MZ
MZ
MZ
MZ
MZ
MZ
MZ
MZ
yO
MZ
MZ
MZ
MZ
dj
lE
lE
lE
lE
lE
lE
lE
lE
lE
lE
lE
lE
yO
MZ
MZ
MZ
MZ
"}
(36,1,1) = {"
MZ
MZ
MZ
MZ
MZ
yO
MZ
MZ
MZ
MZ
MZ
MZ
MZ
MZ
MZ
MZ
MZ
yO
MZ
MZ
MZ
MZ
Yp
Yp
uf
Yp
Yp
Yp
Yp
Yp
MO
Yp
Yp
Yp
Yp
yO
MZ
MZ
MZ
MZ
"}
(37,1,1) = {"
MZ
MZ
MZ
MZ
MZ
yO
MZ
MZ
MZ
MZ
MZ
MZ
MZ
MZ
MZ
MZ
MZ
yO
MZ
MZ
MZ
MZ
MZ
MZ
MZ
MZ
Yp
lE
lE
lE
lE
lE
lE
lE
lE
cf
MZ
MZ
MZ
MZ
"}
(38,1,1) = {"
MZ
MZ
MZ
MZ
MZ
yO
MZ
MZ
MZ
MZ
MZ
MZ
MZ
MZ
MZ
MZ
MZ
yO
MZ
MZ
MZ
MZ
MZ
MZ
MZ
MZ
Xo
lE
lE
lE
lE
lE
lE
lE
lE
cf
MZ
MZ
MZ
MZ
"}
(39,1,1) = {"
MZ
MZ
MZ
MZ
MZ
yO
MZ
MZ
MZ
MZ
MZ
MZ
MZ
MZ
MZ
MZ
MZ
yO
MZ
MZ
MZ
MZ
MZ
MZ
MZ
MZ
Xo
lE
lE
lE
lE
lE
lE
lE
lE
cf
MZ
MZ
MZ
MZ
"}
(40,1,1) = {"
MZ
MZ
MZ
MZ
MZ
yO
MZ
MZ
MZ
MZ
MZ
MZ
MZ
MZ
MZ
MZ
MZ
yO
MZ
MZ
MZ
MZ
MZ
MZ
MZ
MZ
Yp
lE
lE
lE
lE
lE
lE
lE
lE
cf
MZ
MZ
MZ
MZ
"}
(41,1,1) = {"
MZ
MZ
MZ
MZ
MZ
yO
yO
yO
yO
yO
yO
yO
yO
yO
yO
yO
yO
yO
yO
MZ
MZ
MZ
yO
bc
bc
bc
yO
yO
yO
Yp
xJ
xJ
xJ
Yp
yO
yO
MZ
MZ
MZ
MZ
"}
(42,1,1) = {"
MZ
MZ
MZ
MZ
MZ
yO
yO
MZ
MZ
MZ
MZ
MZ
MZ
MZ
MZ
MZ
MZ
MZ
yO
MZ
MZ
MZ
yO
MZ
MZ
MZ
MZ
MZ
yO
lE
lE
lE
lE
lE
yO
yO
MZ
MZ
MZ
MZ
"}
(43,1,1) = {"
MZ
MZ
MZ
MZ
MZ
MZ
yO
MZ
MZ
MZ
MZ
MZ
MZ
MZ
MZ
MZ
MZ
MZ
yO
MZ
MZ
MZ
Kz
MZ
MZ
MZ
MZ
MZ
yO
lE
lE
lE
lE
lE
yO
MZ
MZ
MZ
MZ
MZ
"}
(44,1,1) = {"
MZ
MZ
MZ
MZ
MZ
MZ
yO
yO
MZ
MZ
MZ
MZ
MZ
MZ
MZ
MZ
MZ
MZ
yO
MZ
MZ
MZ
yO
MZ
MZ
MZ
MZ
MZ
yO
lE
lE
lE
lE
yO
yO
MZ
MZ
MZ
MZ
MZ
"}
(45,1,1) = {"
MZ
MZ
MZ
MZ
MZ
MZ
MZ
yO
MZ
MZ
MZ
MZ
MZ
MZ
MZ
MZ
MZ
MZ
yO
MZ
MZ
MZ
yO
MZ
MZ
MZ
MZ
MZ
yO
lE
lE
lE
lE
yO
MZ
MZ
MZ
MZ
MZ
MZ
"}
(46,1,1) = {"
MZ
MZ
MZ
MZ
MZ
MZ
MZ
yO
yO
MZ
MZ
MZ
MZ
MZ
MZ
MZ
MZ
MZ
yO
MZ
MZ
MZ
yO
yO
yO
yO
yO
yO
yO
yO
yO
yO
yO
yO
MZ
MZ
MZ
MZ
MZ
MZ
"}
(47,1,1) = {"
MZ
MZ
MZ
MZ
MZ
MZ
MZ
MZ
yO
MZ
MZ
MZ
MZ
MZ
MZ
MZ
MZ
MZ
yO
MZ
MZ
MZ
yO
MZ
MZ
MZ
MZ
MZ
MZ
MZ
MZ
MZ
yO
MZ
MZ
MZ
MZ
MZ
MZ
MZ
"}
(48,1,1) = {"
MZ
MZ
MZ
MZ
MZ
MZ
MZ
MZ
yO
yO
MZ
MZ
MZ
MZ
MZ
MZ
MZ
MZ
yO
MZ
MZ
MZ
yO
MZ
MZ
MZ
MZ
MZ
MZ
MZ
MZ
yO
yO
MZ
MZ
MZ
MZ
MZ
MZ
MZ
"}
(49,1,1) = {"
MZ
MZ
MZ
MZ
MZ
MZ
MZ
MZ
MZ
yO
MZ
MZ
MZ
MZ
MZ
MZ
MZ
MZ
yO
MZ
MZ
MZ
yO
MZ
MZ
MZ
MZ
MZ
MZ
MZ
MZ
yO
MZ
MZ
MZ
MZ
MZ
MZ
MZ
MZ
"}
(50,1,1) = {"
MZ
MZ
MZ
MZ
MZ
MZ
MZ
MZ
MZ
yO
yO
MZ
MZ
MZ
MZ
MZ
MZ
MZ
yO
yO
yO
yO
yO
MZ
MZ
MZ
MZ
MZ
MZ
MZ
yO
yO
MZ
MZ
MZ
MZ
MZ
MZ
MZ
MZ
"}
(51,1,1) = {"
MZ
MZ
MZ
MZ
MZ
MZ
MZ
MZ
MZ
MZ
yO
MZ
MZ
MZ
MZ
MZ
MZ
yO
yO
MZ
MZ
MZ
yO
yO
MZ
MZ
MZ
MZ
MZ
MZ
yO
MZ
MZ
MZ
MZ
MZ
MZ
MZ
MZ
MZ
"}
(52,1,1) = {"
MZ
MZ
MZ
MZ
MZ
MZ
MZ
MZ
MZ
MZ
yO
yO
MZ
MZ
MZ
MZ
MZ
yO
MZ
MZ
MZ
MZ
MZ
yO
MZ
MZ
MZ
MZ
MZ
yO
yO
MZ
MZ
MZ
MZ
MZ
MZ
MZ
MZ
MZ
"}
(53,1,1) = {"
MZ
MZ
MZ
MZ
MZ
MZ
MZ
MZ
MZ
MZ
MZ
yO
MZ
MZ
MZ
MZ
MZ
yO
MZ
MZ
MZ
MZ
MZ
yO
MZ
MZ
MZ
MZ
MZ
yO
MZ
MZ
MZ
MZ
MZ
MZ
MZ
MZ
MZ
MZ
"}
(54,1,1) = {"
MZ
MZ
MZ
MZ
MZ
MZ
MZ
MZ
MZ
MZ
MZ
yO
yO
MZ
MZ
MZ
MZ
yO
MZ
MZ
MZ
MZ
MZ
yO
MZ
MZ
MZ
MZ
yO
yO
MZ
MZ
MZ
MZ
MZ
MZ
MZ
MZ
MZ
MZ
"}
(55,1,1) = {"
MZ
MZ
MZ
MZ
MZ
MZ
MZ
MZ
MZ
MZ
MZ
MZ
yO
yO
MZ
MZ
MZ
yO
MZ
MZ
MZ
MZ
MZ
yO
MZ
MZ
MZ
yO
yO
MZ
MZ
MZ
MZ
MZ
MZ
MZ
MZ
MZ
MZ
MZ
"}
(56,1,1) = {"
MZ
MZ
MZ
MZ
MZ
MZ
MZ
MZ
MZ
MZ
MZ
MZ
MZ
yO
yO
yO
yO
yO
MZ
MZ
MZ
MZ
MZ
yO
yO
yO
yO
yO
MZ
MZ
MZ
MZ
MZ
MZ
MZ
MZ
MZ
MZ
MZ
MZ
"}
