//MAP CONVERTED BY dmm2tgm.py THIS HEADER COMMENT PREVENTS RECONVERSION, DO NOT REMOVE
"a" = (
/turf/open/floor/plating/grass/jungle,
/area/space)
"c" = (
/obj/machinery/power/shuttle/engine/electric{
	dir = 1
	},
/turf/open/floor/plating,
/area/space)
"e" = (
/obj/structure/fence{
	dir = 8
	},
/turf/open/floor/plating/dirt/jungle,
/area/space)
"f" = (
/obj/structure/fence/door{
	dir = 4
	},
/turf/open/floor/plating/dirt/jungle,
/area/space)
"h" = (
/obj/machinery/hydroponics/constructable,
/turf/open/floor/plating/dirt/jungle,
/area/space)
"k" = (
/obj/machinery/seed_extractor,
/obj/machinery/door/window/northleft{
	dir = 4
	},
/turf/open/floor/wood,
/area/space)
"l" = (
/obj/structure/fence,
/turf/open/water/jungle,
/area/space)
"m" = (
/obj/structure/fence{
	dir = 8
	},
/turf/open/water/jungle,
/area/space)
"n" = (
/turf/open/floor/plating/dirt/jungle,
/area/space)
"o" = (
/obj/machinery/door/poddoor/multi_tile/three_tile_hor,
/turf/open/floor/oldshuttle,
/area/space)
"u" = (
/obj/structure/fence/corner{
	dir = 9
	},
/turf/open/water/jungle,
/area/space)
"v" = (
/obj/effect/spawner/structure/window/shuttle,
/turf/open/floor/plating,
/area/space)
"x" = (
/obj/structure/shuttle/engine/large,
/turf/open/floor/plating/dirt/jungle,
/area/space)
"z" = (
/obj/structure/fence/corner{
	dir = 8
	},
/turf/open/floor/plating/dirt/jungle,
/area/space)
"A" = (
/obj/machinery/hydroponics/soil,
/turf/open/floor/plating/dirt/jungle,
/area/space)
"C" = (
/obj/machinery/power/smes/shuttle/precharged{
	dir = 1
	},
/turf/open/floor/plating,
/area/space)
"E" = (
/obj/structure/fence{
	dir = 8
	},
/turf/open/floor/plating/grass/jungle,
/area/space)
"G" = (
/obj/effect/spawner/structure/window/shuttle,
/turf/open/water/jungle,
/area/space)
"H" = (
/turf/open/water/jungle,
/area/space)
"I" = (
/obj/machinery/power/shuttle/engine/fueled/plasma{
	dir = 1
	},
/turf/open/floor/plating,
/area/space)
"J" = (
/turf/open/floor/wood,
/area/space)
"K" = (
/obj/structure/table/wood,
/turf/open/floor/wood,
/area/space)
"L" = (
/turf/closed/wall/mineral/wood/nonmetal,
/area/space)
"M" = (
/turf/open/floor/oldshuttle,
/area/space)
"N" = (
/obj/structure/mineral_door/wood,
/turf/open/floor/plating/grass/jungle,
/area/space)
"Q" = (
/turf/open/floor/plating,
/area/space)
"S" = (
/obj/machinery/biogenerator,
/obj/machinery/door/window/northleft{
	dir = 4
	},
/turf/open/floor/wood,
/area/space)
"T" = (
/turf/closed/wall/mineral/titanium/nodiagonal,
/area/space)
"U" = (
/obj/structure/mineral_door/wood,
/turf/open/floor/wood,
/area/space)
"V" = (
/obj/structure/fence,
/turf/open/floor/plating/dirt/jungle,
/area/space)
"Z" = (
/obj/machinery/atmospherics/components/unary/shuttle/heater{
	dir = 1
	},
/turf/open/floor/plating,
/area/space)

(1,1,1) = {"
a
a
a
a
a
a
a
n
n
n
n
n
n
n
n
a
a
a
a
a
a
a
a
a
a
a
a
a
a
a
a
a
a
a
a
a
a
a
a
a
a
a
a
a
a
a
a
a
a
a
a
a
a
a
a
a
a
a
a
a
"}
(2,1,1) = {"
a
a
a
a
a
n
n
n
n
n
H
H
H
n
n
a
a
a
a
a
a
a
a
a
a
a
a
a
a
a
a
a
a
a
a
a
a
a
a
a
a
a
a
a
a
a
a
a
a
a
a
a
a
a
a
a
a
a
a
a
"}
(3,1,1) = {"
a
n
n
n
n
n
n
n
n
H
H
H
n
n
n
n
a
a
a
a
a
a
a
a
a
a
a
a
a
a
a
a
a
n
a
a
a
a
a
a
a
a
a
a
a
a
a
a
a
a
a
a
a
a
a
a
a
a
a
a
"}
(4,1,1) = {"
a
n
n
n
n
n
n
H
H
H
H
n
n
n
n
n
a
a
a
a
a
a
a
a
a
a
a
a
a
a
a
a
n
a
n
n
n
a
a
a
a
a
a
a
a
a
a
a
a
a
a
n
a
a
a
a
a
a
a
a
"}
(5,1,1) = {"
a
n
n
n
n
H
H
H
H
H
n
n
n
n
n
n
n
v
v
T
T
T
T
T
T
n
n
a
a
a
a
a
n
a
a
a
a
n
n
n
a
a
a
a
n
a
a
a
a
a
a
n
a
a
a
a
a
a
a
a
"}
(6,1,1) = {"
n
n
n
H
H
H
H
H
H
H
n
n
n
n
n
n
n
M
M
M
T
Q
Q
Z
I
n
n
n
n
n
n
n
n
a
a
a
a
a
a
n
a
a
a
n
a
a
a
a
a
a
a
a
n
a
a
a
a
a
a
a
"}
(7,1,1) = {"
n
n
H
H
H
H
H
H
H
T
v
v
T
T
n
n
M
M
M
M
M
Q
Q
Z
I
n
n
n
n
n
n
n
n
n
n
n
n
n
n
a
n
n
a
a
n
n
a
n
n
a
a
n
n
a
a
a
a
a
a
a
"}
(8,1,1) = {"
a
n
H
H
H
H
H
H
H
T
M
M
T
M
M
M
M
M
M
M
T
Q
Q
Z
I
n
n
n
n
n
n
n
n
n
n
n
n
n
n
n
n
n
n
n
n
n
n
n
a
n
n
n
a
a
a
a
n
n
n
a
"}
(9,1,1) = {"
n
n
H
H
H
H
H
H
H
H
M
M
M
M
M
M
M
M
M
M
T
T
T
T
T
T
T
T
n
x
n
n
n
n
n
n
n
n
n
n
n
n
n
n
n
n
n
n
n
n
n
n
a
a
a
n
n
a
a
a
"}
(10,1,1) = {"
n
H
H
H
H
H
H
H
H
H
M
M
T
M
M
M
M
M
T
T
T
M
M
M
M
M
M
T
n
n
H
n
n
n
H
H
n
n
n
n
n
n
n
n
H
H
n
n
n
n
n
n
n
n
n
n
n
a
n
a
"}
(11,1,1) = {"
n
H
H
H
H
H
H
T
H
T
T
T
T
T
T
M
T
T
T
M
M
M
M
M
M
M
M
T
T
n
n
H
n
n
n
n
n
H
H
u
V
l
l
V
V
f
V
z
n
n
n
n
n
n
n
n
n
a
n
n
"}
(12,1,1) = {"
n
H
H
H
H
H
H
H
H
H
H
M
T
M
M
M
M
M
M
M
M
M
M
M
M
M
M
M
o
H
n
H
n
n
n
n
n
n
H
m
H
n
n
H
n
n
n
e
n
n
n
n
n
n
n
n
n
n
a
n
"}
(13,1,1) = {"
n
H
H
H
H
H
G
H
H
M
H
M
M
M
M
M
M
M
M
M
M
M
M
M
M
M
M
M
M
n
n
H
H
n
n
H
H
n
n
e
A
n
A
n
A
n
A
e
n
n
n
n
n
n
n
n
n
n
a
n
"}
(14,1,1) = {"
n
H
H
H
H
H
v
H
H
H
M
M
T
M
M
M
M
M
M
M
M
M
M
M
M
M
M
M
M
n
n
n
n
n
n
H
n
n
H
e
H
n
n
H
n
n
n
e
n
n
n
n
n
n
n
n
n
n
n
n
"}
(15,1,1) = {"
n
n
H
H
H
H
T
H
T
T
T
T
T
T
T
M
T
T
T
M
M
M
M
M
M
M
M
T
T
n
n
n
n
H
n
n
n
n
n
e
A
n
A
n
h
n
A
e
n
n
n
n
n
n
n
n
n
n
a
n
"}
(16,1,1) = {"
n
n
H
H
H
H
H
v
H
M
M
M
T
M
M
M
M
M
T
T
T
M
M
M
M
M
M
T
n
x
n
n
n
n
H
n
n
n
n
e
n
H
n
n
n
n
n
e
n
n
n
n
n
n
n
a
a
a
a
n
"}
(17,1,1) = {"
a
n
H
H
H
H
H
T
H
H
M
M
M
M
M
M
M
M
M
M
T
T
T
T
T
T
T
T
n
n
n
n
n
n
n
n
n
n
n
e
A
n
h
n
A
n
A
e
n
n
n
n
a
a
n
n
n
a
a
a
"}
(18,1,1) = {"
a
n
H
H
H
H
H
H
T
T
M
M
T
M
M
M
M
M
M
M
T
Q
Q
C
c
n
n
n
n
n
n
n
n
n
n
n
n
n
n
e
n
n
n
n
n
n
n
E
n
a
a
n
n
a
a
a
n
a
a
a
"}
(19,1,1) = {"
n
n
H
H
H
H
H
H
H
T
v
v
T
T
M
M
M
M
M
M
M
Q
Q
C
c
n
n
n
n
n
n
n
n
n
n
n
L
L
L
L
L
k
S
L
L
U
L
L
n
a
n
a
a
a
a
a
a
a
a
a
"}
(20,1,1) = {"
n
n
H
H
H
H
H
H
n
n
a
a
a
T
T
T
M
M
M
M
T
Q
Q
C
c
n
n
n
n
n
n
n
n
a
a
a
L
J
J
J
L
J
J
J
J
J
J
L
n
a
a
a
a
a
a
a
a
a
a
a
"}
(21,1,1) = {"
n
n
n
H
H
H
H
H
n
a
a
a
a
a
a
T
T
Q
Q
T
T
T
T
T
T
n
n
a
a
a
a
a
a
a
a
a
L
J
J
J
U
J
J
K
K
K
K
L
n
a
a
a
a
a
a
a
a
a
a
a
"}
(22,1,1) = {"
n
n
n
n
H
H
H
n
n
a
a
a
a
a
a
a
a
n
n
a
a
a
a
a
a
a
a
a
a
a
a
a
a
a
a
a
L
J
J
J
L
J
J
J
J
J
J
L
n
a
a
a
a
a
a
a
a
a
a
a
"}
(23,1,1) = {"
n
n
n
n
H
n
n
n
a
a
a
a
a
a
a
a
a
n
a
a
a
a
a
a
a
a
a
a
a
a
a
a
a
a
a
a
L
J
J
J
L
L
L
L
L
L
L
L
a
a
a
a
a
a
a
a
a
a
a
a
"}
(24,1,1) = {"
a
n
n
n
n
n
n
n
a
a
a
a
a
a
a
a
a
a
n
a
a
a
a
a
a
a
a
a
a
a
a
a
a
a
a
a
L
J
J
J
J
J
J
L
J
J
J
L
a
a
a
a
a
a
a
a
a
a
a
a
"}
(25,1,1) = {"
a
a
n
n
n
n
a
n
a
a
a
a
a
a
a
a
a
n
n
a
a
a
a
a
a
a
a
a
a
a
a
a
n
a
a
a
L
J
J
J
J
J
J
J
J
J
J
L
a
a
a
a
a
a
a
a
a
a
a
a
"}
(26,1,1) = {"
a
a
a
a
n
a
a
n
a
a
a
a
a
a
a
a
a
a
n
a
n
a
a
a
a
n
n
a
n
n
n
a
a
n
n
a
L
L
U
L
L
L
L
L
L
L
L
L
a
a
a
a
a
a
a
a
a
a
a
a
"}
(27,1,1) = {"
a
a
a
a
a
a
a
a
a
a
a
a
a
a
a
a
a
n
n
n
n
n
n
n
n
a
n
n
n
n
a
n
n
n
a
n
n
n
n
a
n
J
J
J
J
a
a
a
a
a
a
a
a
a
a
a
a
a
a
a
"}
(28,1,1) = {"
a
a
a
a
a
a
a
a
a
a
a
a
a
a
a
a
n
n
n
n
a
a
n
n
n
a
n
a
n
n
n
n
n
a
n
n
n
n
n
n
n
n
J
J
J
a
a
a
a
a
a
a
a
a
a
a
a
a
a
a
"}
(29,1,1) = {"
a
a
a
a
a
a
a
a
a
a
a
a
a
a
a
a
a
n
a
a
a
n
n
a
a
n
a
n
n
n
a
n
n
n
n
n
n
a
a
a
a
a
a
a
a
a
a
a
a
a
a
a
a
a
a
a
a
a
a
a
"}
(30,1,1) = {"
a
a
a
a
a
a
a
a
a
a
a
a
a
a
a
a
a
n
n
a
a
a
a
a
a
a
a
a
a
a
a
a
a
a
a
a
a
a
a
a
a
a
a
a
a
a
a
a
a
a
a
a
a
a
a
a
a
a
a
a
"}
(31,1,1) = {"
a
a
a
a
a
a
a
a
a
a
a
a
a
a
a
a
a
n
a
a
a
a
a
a
a
a
a
a
a
a
a
a
a
a
a
a
a
a
a
a
a
a
a
a
a
a
a
a
a
a
a
a
a
a
a
a
a
a
a
a
"}
(32,1,1) = {"
a
a
a
a
a
a
a
a
a
a
a
a
a
n
n
a
n
n
a
n
a
a
a
a
a
a
a
a
a
a
a
a
a
a
a
a
a
a
a
a
a
a
a
a
a
a
a
a
a
a
a
a
a
a
a
a
a
a
a
a
"}
(33,1,1) = {"
a
a
a
a
L
L
L
L
L
L
L
a
a
n
n
n
n
n
a
a
a
a
a
a
a
a
a
a
a
a
a
a
a
a
a
a
a
a
a
a
a
a
a
a
a
a
a
a
a
a
a
a
a
a
a
a
a
a
a
a
"}
(34,1,1) = {"
a
a
a
a
L
a
a
a
a
a
L
a
n
n
n
n
a
a
a
a
a
a
a
a
a
a
a
a
a
a
a
a
a
a
a
a
a
a
a
a
a
a
a
a
a
a
a
a
a
a
a
a
a
a
a
a
a
a
a
a
"}
(35,1,1) = {"
a
a
a
a
L
a
a
a
a
a
N
n
n
a
n
n
a
a
a
a
a
a
a
a
a
a
a
a
a
a
a
a
a
a
a
a
a
a
a
a
a
a
a
a
a
a
a
a
a
a
a
a
a
a
a
a
a
a
a
a
"}
(36,1,1) = {"
a
a
a
a
L
a
a
a
a
a
N
n
a
n
n
a
a
a
a
a
a
a
a
a
a
a
a
a
a
a
a
a
a
a
a
a
a
a
a
a
a
a
a
a
a
a
a
a
a
a
a
a
a
a
a
a
a
a
a
a
"}
(37,1,1) = {"
a
a
a
a
L
a
a
a
a
a
L
a
a
a
a
a
a
a
a
a
a
a
a
a
a
a
a
a
a
a
a
a
a
a
a
a
a
a
a
a
a
a
a
a
a
a
a
a
a
a
a
a
a
a
a
a
a
a
a
a
"}
(38,1,1) = {"
a
a
a
a
L
a
a
a
a
a
L
a
a
a
a
a
a
a
a
a
a
a
a
a
a
a
a
a
a
a
a
a
a
a
a
a
a
a
a
a
a
a
a
a
a
a
a
a
a
a
a
a
a
a
a
a
a
a
a
a
"}
(39,1,1) = {"
a
a
a
a
L
a
a
a
a
a
L
a
a
a
a
a
a
a
a
a
a
a
a
a
a
a
a
a
a
a
a
a
a
a
a
a
a
a
a
a
a
a
a
a
a
a
a
a
a
a
a
a
a
a
a
a
a
a
a
a
"}
(40,1,1) = {"
a
a
a
a
L
a
a
a
a
a
L
a
a
a
a
a
a
a
a
a
a
a
a
a
a
a
a
a
a
a
a
a
a
a
a
a
a
a
a
a
a
a
a
a
a
a
a
a
a
a
a
a
a
a
a
a
a
a
a
a
"}
(41,1,1) = {"
a
a
a
a
L
a
a
a
a
a
L
a
a
a
a
a
a
a
a
a
a
a
a
a
a
a
a
a
a
a
a
a
a
a
a
a
a
a
a
a
a
a
a
a
a
a
a
a
a
a
a
a
a
a
a
a
a
a
a
a
"}
(42,1,1) = {"
a
a
a
a
L
a
a
a
a
a
L
a
a
a
a
a
a
a
a
a
a
a
a
a
a
a
a
a
a
a
a
a
a
a
a
a
a
a
a
a
a
a
a
a
a
a
a
a
a
a
a
a
a
a
a
a
a
a
a
a
"}
(43,1,1) = {"
a
a
a
a
L
a
a
a
a
a
L
a
a
a
a
a
a
a
a
a
a
a
a
a
a
a
a
a
a
a
a
a
a
a
a
a
a
a
a
a
a
a
a
a
a
a
a
a
a
a
a
a
a
a
a
a
a
a
a
a
"}
(44,1,1) = {"
a
a
a
a
L
a
a
a
a
a
L
a
a
a
a
a
a
a
a
a
a
a
a
a
a
a
a
a
a
a
a
a
a
a
a
a
a
a
a
a
a
a
a
a
a
a
a
a
a
a
a
a
a
a
a
a
a
a
a
a
"}
(45,1,1) = {"
a
a
a
a
L
a
a
a
a
a
L
a
a
a
a
a
a
a
a
a
a
a
a
a
a
a
a
a
a
a
a
a
a
a
a
a
a
a
a
a
a
a
a
a
a
a
a
a
a
a
a
a
a
a
a
a
a
a
a
a
"}
(46,1,1) = {"
a
a
a
a
L
a
a
L
L
L
L
a
a
a
a
a
a
a
a
a
a
a
a
a
a
a
a
a
a
a
a
a
a
a
a
a
a
a
a
a
a
a
a
a
a
a
a
a
a
a
a
a
a
a
a
a
a
a
a
a
"}
(47,1,1) = {"
a
a
a
a
L
a
a
L
a
a
a
a
a
a
a
a
a
a
a
a
a
a
a
a
a
a
a
a
a
a
a
a
a
a
a
a
a
a
a
a
a
a
a
a
a
a
a
a
a
a
a
a
a
a
a
a
a
a
a
a
"}
(48,1,1) = {"
a
a
a
a
L
L
L
L
a
a
a
a
a
a
a
a
a
a
a
a
a
a
a
a
a
a
a
a
a
a
a
a
a
a
a
a
a
a
a
a
a
a
a
a
a
a
a
a
a
a
a
a
a
a
a
a
a
a
a
a
"}
(49,1,1) = {"
a
a
a
a
a
a
a
a
a
a
a
a
a
a
a
a
a
a
a
a
a
a
a
a
a
a
a
a
a
a
a
a
a
a
a
a
a
a
a
a
a
a
a
a
a
a
a
a
a
a
a
a
a
a
a
a
a
a
a
a
"}
(50,1,1) = {"
a
a
a
a
a
a
a
a
a
a
a
a
a
a
a
a
a
a
a
a
a
a
a
a
a
a
a
a
a
a
a
a
a
a
a
a
a
a
a
a
a
a
a
a
a
a
a
a
a
a
a
a
a
a
a
a
a
a
a
a
"}
