//MAP CONVERTED BY dmm2tgm.py THIS HEADER COMMENT PREVENTS RECONVERSION, DO NOT REMOVE
"az" = (
/obj/structure/window/bronze{
	dir = 4
	},
/obj/structure/window/bronze,
/turf/open/floor/carpet/nanoweave/red,
/area/shuttle/radio/ship/main)
"aA" = (
/obj/machinery/computer/camera_advanced/shuttle_docker/nav,
/turf/open/floor/carpet/nanoweave/blue,
/area/shuttle/radio/ship/main)
"aJ" = (
/obj/structure/sink{
	dir = 1
	},
/obj/structure/mirror{
	pixel_y = -30
	},
/obj/machinery/light,
/turf/open/floor/plasteel/freezer,
/area/shuttle/radio/ship/main)
"aW" = (
/obj/machinery/computer/autopilot,
/turf/open/floor/carpet/nanoweave/blue,
/area/shuttle/radio/ship/main)
"bD" = (
/obj/structure/shuttle/engine/heater,
/obj/structure/window/reinforced/spawner,
/turf/open/floor/plasteel/freezer,
/area/shuttle/radio/ship/main)
"bF" = (
/obj/structure/table/bronze,
/obj/item/storage/firstaid/advanced,
/obj/machinery/light{
	dir = 1
	},
/turf/open/floor/carpet/nanoweave/blue,
/area/shuttle/radio/ship/main)
"cS" = (
/obj/structure/chair/bronze{
	dir = 1
	},
/turf/open/floor/carpet/nanoweave/blue,
/area/shuttle/radio/ship/main)
"de" = (
/turf/open/floor/plasteel/freezer,
/area/shuttle/radio/ship/main)
"eI" = (
/obj/structure/table/bronze,
/obj/item/storage/belt/utility,
/turf/open/floor/carpet/nanoweave/blue,
/area/shuttle/radio/ship/main)
"gb" = (
/turf/open/floor/carpet/nanoweave/red,
/area/shuttle/radio/ship/main)
"gG" = (
/obj/machinery/light/floor,
/turf/open/floor/carpet/nanoweave/blue,
/area/shuttle/radio/ship/main)
"io" = (
/obj/structure/chair/bronze,
/obj/item/radio/intercom/wideband{
	pixel_y = -32
	},
/obj/machinery/door/window{
	dir = 1
	},
/turf/open/floor/carpet/nanoweave/beige,
/area/shuttle/radio/ship/main)
"iX" = (
/obj/structure/window/bronze{
	dir = 4
	},
/obj/structure/window/bronze{
	dir = 1
	},
/obj/structure/table/bronze,
/obj/item/encryptionkey/wideband{
	pixel_y = 12
	},
/turf/open/floor/carpet/nanoweave/beige,
/area/shuttle/radio/ship/main)
"lm" = (
/obj/machinery/atmospherics/components/unary/tank/air,
/obj/structure/curtain/cloth/grey,
/turf/open/floor/plasteel/freezer,
/area/shuttle/radio/ship/main)
"oK" = (
/obj/machinery/power/shuttle/engine/void{
	dir = 1
	},
/turf/open/floor/plating,
/area/shuttle/radio/ship/main)
"pO" = (
/obj/structure/table/bronze,
/turf/open/floor/carpet/nanoweave/blue,
/area/shuttle/radio/ship/main)
"pY" = (
/obj/structure/table/bronze,
/turf/open/floor/carpet/nanoweave/orange,
/area/shuttle/radio/ship/main)
"rm" = (
/obj/structure/window/bronze,
/obj/structure/table/bronze,
/obj/item/storage/toolbox/mechanical/old/clean,
/turf/open/floor/carpet/nanoweave/blue,
/area/shuttle/radio/ship/main)
"sq" = (
/obj/machinery/door/airlock/external/glass,
/obj/structure/fans/tiny,
/turf/open/floor/carpet/nanoweave/red,
/area/shuttle/radio/ship/main)
"th" = (
/obj/machinery/light/floor,
/turf/open/floor/carpet/nanoweave/red,
/area/shuttle/radio/ship/main)
"tv" = (
/obj/structure/shuttle/engine/heater,
/obj/structure/window/reinforced/spawner,
/turf/open/floor/carpet/nanoweave/orange,
/area/shuttle/radio/ship/main)
"up" = (
/obj/structure/window/bronze,
/turf/open/floor/carpet/nanoweave/blue,
/area/shuttle/radio/ship/main)
"uS" = (
/obj/structure/window/bronze{
	dir = 4
	},
/turf/open/floor/carpet/nanoweave/red,
/area/shuttle/radio/ship/main)
"vt" = (
/obj/structure/window/bronze{
	dir = 4
	},
/obj/structure/table/bronze,
/turf/open/floor/carpet/nanoweave/beige,
/area/shuttle/radio/ship/main)
"wJ" = (
/obj/structure/tank_dispenser/oxygen,
/obj/structure/window/bronze{
	dir = 8
	},
/obj/machinery/light,
/turf/open/floor/carpet/nanoweave/red,
/area/shuttle/radio/ship/main)
"wV" = (
/obj/structure/window/bronze{
	dir = 8
	},
/obj/machinery/jukebox,
/obj/structure/window/bronze{
	dir = 1
	},
/turf/open/floor/carpet/nanoweave/beige,
/area/shuttle/radio/ship/main)
"xx" = (
/obj/structure/table/bronze,
/obj/machinery/light{
	dir = 1
	},
/turf/open/floor/carpet/nanoweave,
/area/shuttle/radio/ship/main)
"yX" = (
/obj/machinery/shower{
	dir = 1
	},
/obj/structure/curtain,
/obj/machinery/light{
	dir = 8
	},
/turf/open/floor/plasteel/freezer,
/area/shuttle/radio/ship/main)
"Au" = (
/obj/structure/bed,
/obj/item/bedsheet/syndie,
/obj/structure/curtain/cloth/grey,
/turf/open/floor/carpet/nanoweave,
/area/shuttle/radio/ship/main)
"Ba" = (
/obj/structure/window/bronze{
	dir = 8
	},
/turf/open/floor/carpet/nanoweave/red,
/area/shuttle/radio/ship/main)
"BI" = (
/obj/structure/table/bronze,
/obj/item/trash/plate,
/turf/open/floor/carpet/nanoweave/orange,
/area/shuttle/radio/ship/main)
"EK" = (
/turf/open/floor/carpet/nanoweave,
/area/shuttle/radio/ship/main)
"EY" = (
/obj/structure/table/bronze,
/obj/machinery/light{
	dir = 1
	},
/turf/open/floor/carpet/nanoweave/blue,
/area/shuttle/radio/ship/main)
"GQ" = (
/obj/machinery/door/window/westright{
	dir = 2
	},
/turf/open/floor/carpet/nanoweave/blue,
/area/shuttle/radio/ship/main)
"Hu" = (
/obj/machinery/door/window/westright,
/turf/open/floor/carpet/nanoweave,
/area/shuttle/radio/ship/main)
"HJ" = (
/obj/structure/window/bronze,
/obj/structure/window/bronze{
	dir = 8
	},
/turf/open/floor/carpet/nanoweave/red,
/area/shuttle/radio/ship/main)
"HZ" = (
/obj/effect/mob_spawn/human/lavaland_syndicate/comms/space{
	dir = 4
	},
/turf/open/floor/carpet/nanoweave,
/area/shuttle/radio/ship/main)
"Jz" = (
/obj/machinery/vending/autodrobe/all_access{
	default_price = 0;
	extra_price = 0
	},
/turf/open/floor/carpet/nanoweave,
/area/shuttle/radio/ship/main)
"Kn" = (
/obj/machinery/computer/helm,
/turf/open/floor/carpet/nanoweave/blue,
/area/shuttle/radio/ship/main)
"Kr" = (
/turf/open/floor/carpet/nanoweave/blue,
/area/shuttle/radio/ship/main)
"Ky" = (
/turf/open/space/basic,
/area/space)
"KK" = (
/turf/open/floor/carpet/nanoweave/beige,
/area/shuttle/radio/ship/main)
"Lu" = (
/obj/structure/table/bronze,
/obj/item/kitchen/knife,
/turf/open/floor/carpet/nanoweave/orange,
/area/shuttle/radio/ship/main)
"Mj" = (
/obj/machinery/suit_storage_unit/standard_unit,
/obj/structure/window/bronze{
	dir = 4
	},
/obj/machinery/light,
/turf/open/floor/carpet/nanoweave/red,
/area/shuttle/radio/ship/main)
"Mo" = (
/obj/structure/table/bronze,
/obj/machinery/microwave,
/obj/machinery/light{
	dir = 4
	},
/turf/open/floor/carpet/nanoweave/orange,
/area/shuttle/radio/ship/main)
"MW" = (
/obj/structure/curtain/cloth/grey,
/obj/structure/table,
/turf/open/floor/plasteel/freezer,
/area/shuttle/radio/ship/main)
"Nh" = (
/obj/machinery/door/window{
	dir = 4
	},
/turf/open/floor/carpet/nanoweave/orange,
/area/shuttle/radio/ship/main)
"Ob" = (
/obj/structure/chair/plastic{
	dir = 4
	},
/turf/open/floor/carpet/nanoweave/orange,
/area/shuttle/radio/ship/main)
"Ph" = (
/obj/structure/table/bronze,
/obj/machinery/light/floor,
/turf/open/floor/carpet/nanoweave/beige,
/area/shuttle/radio/ship/main)
"Qw" = (
/obj/structure/window/bronze{
	dir = 1
	},
/obj/structure/toilet{
	dir = 4
	},
/turf/open/floor/plasteel/freezer,
/area/shuttle/radio/ship/main)
"QG" = (
/obj/structure/window/bronze{
	dir = 8
	},
/obj/structure/table/bronze,
/turf/open/floor/carpet/nanoweave/beige,
/area/shuttle/radio/ship/main)
"Rj" = (
/obj/machinery/door/window{
	dir = 1
	},
/turf/open/floor/plasteel/freezer,
/area/shuttle/radio/ship/main)
"Tq" = (
/turf/open/floor/carpet/nanoweave/orange,
/area/shuttle/radio/ship/main)
"Ve" = (
/obj/effect/spawner/structure/window/shuttle,
/turf/open/floor/plating,
/area/shuttle/radio/ship/main)
"Vx" = (
/obj/structure/table/bronze,
/obj/machinery/light{
	dir = 1
	},
/turf/open/floor/carpet/nanoweave/orange,
/area/shuttle/radio/ship/main)
"VS" = (
/obj/machinery/telecomms/allinone,
/obj/structure/window/bronze,
/turf/open/floor/carpet/nanoweave/blue,
/area/shuttle/radio/ship/main)
"Xu" = (
/obj/effect/spawner/lootdrop/donkpockets,
/obj/effect/spawner/lootdrop/donkpockets,
/obj/structure/closet/secure_closet/freezer,
/obj/effect/spawner/lootdrop/donkpockets,
/obj/effect/spawner/lootdrop/donkpockets,
/turf/open/floor/carpet/nanoweave/orange,
/area/shuttle/radio/ship/main)
"Ya" = (
/obj/machinery/door/window/westright{
	dir = 2
	},
/obj/machinery/holopad,
/obj/structure/chair/comfy/teal{
	dir = 1
	},
/turf/open/floor/carpet/nanoweave/red,
/area/shuttle/radio/ship/main)
"Yx" = (
/turf/closed/wall/mineral/titanium/nodiagonal,
/area/shuttle/radio/ship/main)
"Zp" = (
/obj/structure/window/bronze{
	dir = 1
	},
/obj/structure/curtain/cloth/grey,
/obj/structure/table,
/turf/open/floor/plasteel/freezer,
/area/shuttle/radio/ship/main)

(1,1,1) = {"
Ky
Ky
Ky
Ky
Ky
Ky
Yx
Ve
Ve
Ve
Yx
Ky
Ky
"}
(2,1,1) = {"
Ky
Ky
Ky
Ky
Yx
Ve
Yx
HZ
Qw
aJ
Yx
Yx
Ky
"}
(3,1,1) = {"
Ky
Yx
Ve
Ve
Yx
xx
EK
EK
Rj
de
yX
Yx
Yx
"}
(4,1,1) = {"
Yx
Yx
bF
eI
rm
Au
EK
Jz
Zp
MW
lm
bD
oK
"}
(5,1,1) = {"
Ve
aA
Kr
Kr
up
Ba
Hu
Ba
wV
QG
HJ
wJ
Yx
"}
(6,1,1) = {"
Ve
Kn
cS
gG
GQ
Kr
th
KK
io
Ph
Ya
gb
sq
"}
(7,1,1) = {"
Ve
aW
Kr
Kr
up
uS
Nh
uS
iX
vt
az
Mj
Yx
"}
(8,1,1) = {"
Yx
Yx
EY
pO
VS
pY
Tq
Tq
Tq
Tq
Xu
tv
oK
"}
(9,1,1) = {"
Ky
Yx
Ve
Ve
Yx
Vx
Tq
Ob
Ob
Ob
Mo
Yx
Yx
"}
(10,1,1) = {"
Ky
Ky
Ky
Ky
Yx
Ve
Yx
BI
BI
Lu
Yx
Yx
Ky
"}
(11,1,1) = {"
Ky
Ky
Ky
Ky
Ky
Ky
Yx
Ve
Ve
Ve
Yx
Ky
Ky
"}
