//MAP CONVERTED BY dmm2tgm.py THIS HEADER COMMENT PREVENTS RECONVERSION, DO NOT REMOVE
"a" = (
/turf/open/space/basic,
/area/space)
"b" = (
/obj/structure/window/reinforced/spawner/north{
	dir = 2
	},
/obj/structure/window/reinforced/spawner/north{
	dir = 4
	},
/obj/structure/disposalpipe/trunk{
	dir = 4
	},
/obj/machinery/disposal/deliveryChute{
	dir = 8
	},
/turf/open/floor/plating,
/area/space)
"c" = (
/obj/machinery/atmospherics/pipe/simple/purple{
	dir = 6
	},
/turf/open/floor/plating,
/area/space)
"d" = (
/obj/machinery/power/shuttle/engine/fueled{
	dir = 1
	},
/turf/open/floor/plating,
/area/space)
"f" = (
/obj/structure/window/reinforced/spawner/north,
/obj/structure/window/reinforced/spawner/north{
	dir = 4
	},
/obj/structure/disposalpipe/trunk{
	dir = 4
	},
/obj/machinery/disposal/deliveryChute{
	dir = 8
	},
/turf/open/floor/plating,
/area/space)
"g" = (
/obj/machinery/power/smes/shuttle/precharged{
	dir = 1
	},
/obj/structure/window/reinforced/spawner/north{
	dir = 2
	},
/turf/open/floor/plating,
/area/space)
"i" = (
/obj/machinery/door/airlock/mining/glass,
/turf/open/floor/plating,
/area/space)
"j" = (
/obj/structure/disposalpipe/segment{
	dir = 4
	},
/turf/open/floor/plating,
/area/space)
"k" = (
/obj/structure/disposalpipe/segment,
/turf/open/floor/plating,
/area/space)
"l" = (
/obj/effect/spawner/structure/window/reinforced,
/turf/open/floor/plating,
/area/space)
"m" = (
/obj/machinery/atmospherics/pipe/manifold/purple{
	dir = 1
	},
/turf/open/floor/plating,
/area/space)
"n" = (
/obj/machinery/atmospherics/components/binary/volume_pump,
/turf/open/floor/plating,
/area/space)
"o" = (
/obj/structure/window/reinforced/spawner/north{
	dir = 2
	},
/obj/machinery/atmospherics/components/unary/shuttle/heater/tank{
	dir = 1
	},
/turf/open/floor/plating,
/area/space)
"q" = (
/obj/structure/window/reinforced/spawner/north{
	dir = 2
	},
/obj/structure/window/reinforced/spawner/north{
	dir = 8
	},
/obj/structure/disposalpipe/trunk,
/obj/machinery/disposal/deliveryChute{
	dir = 1
	},
/turf/open/floor/plating,
/area/space)
"r" = (
/obj/structure/disposalpipe/segment{
	dir = 9
	},
/turf/closed/wall,
/area/space)
"s" = (
/obj/structure/window/reinforced/spawner/north{
	dir = 2
	},
/obj/structure/window/reinforced/spawner/north{
	dir = 4
	},
/obj/structure/disposalpipe/trunk,
/obj/machinery/disposal/deliveryChute{
	dir = 1
	},
/turf/open/floor/plating,
/area/space)
"t" = (
/obj/machinery/atmospherics/pipe/simple/purple,
/turf/open/floor/plating,
/area/space)
"w" = (
/obj/structure/table/wood,
/turf/open/floor/plating,
/area/space)
"x" = (
/turf/closed/wall,
/area/space)
"y" = (
/obj/machinery/button/massdriver{
	pixel_x = 25
	},
/turf/open/floor/plating,
/area/space)
"A" = (
/obj/machinery/atmospherics/pipe/manifold/purple{
	dir = 4
	},
/turf/open/floor/plating,
/area/space)
"B" = (
/obj/machinery/atmospherics/components/unary/portables_connector,
/obj/machinery/portable_atmospherics/canister/toxins,
/turf/open/floor/plating,
/area/space)
"G" = (
/obj/structure/disposalpipe/segment{
	dir = 9
	},
/turf/open/floor/plating,
/area/space)
"I" = (
/obj/structure/window/reinforced/spawner/west,
/obj/structure/window/reinforced/spawner/north,
/obj/machinery/disposal/deliveryChute{
	dir = 4
	},
/obj/structure/disposalpipe/trunk{
	dir = 8
	},
/turf/open/floor/plating,
/area/space)
"M" = (
/obj/structure/window/reinforced/spawner/east,
/obj/structure/window/reinforced/spawner/north,
/obj/machinery/disposal/deliveryChute{
	dir = 8
	},
/obj/structure/disposalpipe/trunk{
	dir = 4
	},
/turf/open/floor/plating,
/area/space)
"N" = (
/turf/open/floor/plating,
/area/space)
"P" = (
/obj/structure/disposalpipe/segment{
	dir = 8
	},
/turf/open/floor/plating,
/area/space)
"Q" = (
/obj/machinery/mass_driver{
	dir = 1
	},
/turf/open/floor/plating,
/area/space)
"R" = (
/obj/structure/window/reinforced/spawner/west,
/obj/structure/window/reinforced/spawner,
/obj/machinery/disposal/deliveryChute{
	dir = 4
	},
/obj/structure/disposalpipe/trunk{
	dir = 8
	},
/turf/open/floor/plating,
/area/space)
"S" = (
/obj/machinery/power/shuttle/engine/electric{
	dir = 1
	},
/turf/open/floor/plating,
/area/space)
"U" = (
/obj/structure/window/reinforced/spawner/east,
/obj/structure/window/reinforced/spawner,
/obj/machinery/disposal/deliveryChute{
	dir = 8
	},
/obj/structure/disposalpipe/trunk{
	dir = 4
	},
/turf/open/floor/plating,
/area/space)
"V" = (
/obj/machinery/button/massdriver{
	pixel_x = -25
	},
/turf/open/floor/plating,
/area/space)
"X" = (
/obj/machinery/computer/helm,
/turf/open/floor/plating,
/area/space)
"Y" = (
/obj/machinery/door/poddoor,
/turf/open/floor/plating,
/area/space)

(1,1,1) = {"
a
a
a
a
a
a
a
a
a
a
a
a
a
a
a
a
a
a
a
a
a
a
a
a
a
a
a
a
a
a
a
a
a
a
a
"}
(2,1,1) = {"
a
a
a
a
a
a
a
a
a
a
a
a
a
a
a
a
a
a
a
a
a
a
a
a
a
a
a
a
a
a
a
a
a
a
a
"}
(3,1,1) = {"
a
a
a
a
a
a
a
a
a
a
a
a
a
a
a
a
a
a
a
a
a
a
a
a
a
a
a
a
a
a
a
a
a
a
a
"}
(4,1,1) = {"
a
a
a
a
a
a
a
a
a
a
a
a
a
a
a
a
a
a
a
a
a
a
a
a
a
a
a
a
a
a
a
a
a
a
a
"}
(5,1,1) = {"
a
a
a
a
a
a
x
x
x
Y
Y
Y
Y
x
x
x
a
a
a
a
a
a
a
a
a
a
a
a
a
a
a
a
a
a
a
"}
(6,1,1) = {"
a
a
a
a
x
x
x
N
N
N
N
N
N
N
N
x
x
x
x
x
x
a
a
a
a
a
a
a
a
a
a
a
a
a
a
"}
(7,1,1) = {"
a
a
a
a
a
Y
Q
y
N
N
N
N
N
N
N
x
N
N
N
N
x
x
a
a
a
a
a
a
a
a
a
a
a
a
a
"}
(8,1,1) = {"
a
a
a
a
x
x
x
x
N
N
N
N
N
N
N
x
N
N
N
c
o
d
a
a
a
a
a
a
a
a
a
a
a
a
a
"}
(9,1,1) = {"
a
a
a
a
a
a
a
x
x
x
x
x
U
i
M
x
N
N
N
m
o
d
a
a
a
a
a
a
a
a
a
a
a
a
a
"}
(10,1,1) = {"
a
a
a
a
a
a
a
a
a
a
a
x
j
N
j
x
N
N
N
m
o
d
a
a
a
a
a
a
a
a
a
a
a
a
a
"}
(11,1,1) = {"
a
a
a
a
a
a
a
a
a
a
a
x
j
N
j
x
B
n
t
A
o
d
a
a
a
a
a
a
a
a
a
a
a
a
a
"}
(12,1,1) = {"
a
a
a
a
a
a
x
l
l
l
x
x
R
i
I
x
x
x
N
x
x
x
x
a
a
a
a
a
a
a
a
a
a
a
a
"}
(13,1,1) = {"
a
a
a
a
x
x
x
N
N
N
x
N
N
N
N
N
N
N
N
N
N
N
x
a
a
a
a
a
a
a
a
a
a
a
a
"}
(14,1,1) = {"
a
a
a
a
l
w
w
N
N
N
N
N
N
N
N
N
N
N
N
N
N
N
x
a
a
a
a
a
a
a
a
a
a
a
a
"}
(15,1,1) = {"
a
a
a
a
l
N
N
N
N
N
x
N
N
N
N
N
N
N
N
N
N
N
x
a
a
a
a
a
a
a
a
a
a
a
a
"}
(16,1,1) = {"
a
a
a
a
l
X
N
N
N
N
x
N
N
N
N
N
N
N
N
N
N
N
x
a
a
a
a
a
a
a
a
a
a
a
a
"}
(17,1,1) = {"
a
a
a
a
l
N
N
N
N
N
x
x
N
x
x
N
N
N
x
x
N
x
x
a
a
a
a
a
a
a
a
a
a
a
a
"}
(18,1,1) = {"
a
a
a
a
l
w
w
N
N
N
N
N
N
N
x
x
x
x
x
N
N
N
x
x
a
a
a
a
a
a
a
a
a
a
a
"}
(19,1,1) = {"
a
a
a
a
x
x
x
N
N
N
x
N
N
N
N
N
x
N
N
N
N
N
g
S
a
a
a
a
a
a
a
a
a
a
a
"}
(20,1,1) = {"
a
a
a
a
a
a
x
l
l
l
x
N
N
N
N
N
x
N
N
N
N
N
g
S
a
a
a
a
a
a
a
a
a
a
a
"}
(21,1,1) = {"
a
a
a
a
a
a
a
a
a
a
x
N
N
N
N
N
x
N
N
N
N
N
g
S
a
a
a
a
a
a
a
a
a
a
a
"}
(22,1,1) = {"
a
a
a
a
a
a
a
a
a
a
x
N
N
N
N
N
x
N
N
N
N
N
x
x
a
a
a
a
a
a
a
a
a
a
a
"}
(23,1,1) = {"
a
a
a
a
a
a
a
a
x
x
x
x
x
x
x
x
x
x
b
i
f
x
x
a
a
a
a
a
a
a
a
a
a
a
a
"}
(24,1,1) = {"
a
a
a
a
a
x
x
x
x
N
N
N
N
N
N
N
N
s
G
N
P
x
a
a
a
a
a
a
a
a
a
a
a
a
a
"}
(25,1,1) = {"
a
a
a
a
a
a
Y
Q
V
N
N
N
N
N
N
N
N
i
N
N
P
x
a
a
a
a
a
a
a
a
a
a
a
a
a
"}
(26,1,1) = {"
a
a
a
a
a
x
x
x
N
N
N
N
N
N
N
N
N
q
k
k
r
x
a
a
a
a
a
a
a
a
a
a
a
a
a
"}
(27,1,1) = {"
a
a
a
a
a
a
a
x
x
x
x
Y
Y
Y
Y
x
x
x
x
x
x
a
a
a
a
a
a
a
a
a
a
a
a
a
a
"}
(28,1,1) = {"
a
a
a
a
a
a
a
a
a
a
a
a
a
a
a
a
a
a
a
a
a
a
a
a
a
a
a
a
a
a
a
a
a
a
a
"}
(29,1,1) = {"
a
a
a
a
a
a
a
a
a
a
a
a
a
a
a
a
a
a
a
a
a
a
a
a
a
a
a
a
a
a
a
a
a
a
a
"}
(30,1,1) = {"
a
a
a
a
a
a
a
a
a
a
a
a
a
a
a
a
a
a
a
a
a
a
a
a
a
a
a
a
a
a
a
a
a
a
a
"}
(31,1,1) = {"
a
a
a
a
a
a
a
a
a
a
a
a
a
a
a
a
a
a
a
a
a
a
a
a
a
a
a
a
a
a
a
a
a
a
a
"}
(32,1,1) = {"
a
a
a
a
a
a
a
a
a
a
a
a
a
a
a
a
a
a
a
a
a
a
a
a
a
a
a
a
a
a
a
a
a
a
a
"}
(33,1,1) = {"
a
a
a
a
a
a
a
a
a
a
a
a
a
a
a
a
a
a
a
a
a
a
a
a
a
a
a
a
a
a
a
a
a
a
a
"}
(34,1,1) = {"
a
a
a
a
a
a
a
a
a
a
a
a
a
a
a
a
a
a
a
a
a
a
a
a
a
a
a
a
a
a
a
a
a
a
a
"}
(35,1,1) = {"
a
a
a
a
a
a
a
a
a
a
a
a
a
a
a
a
a
a
a
a
a
a
a
a
a
a
a
a
a
a
a
a
a
a
a
"}
