//MAP CONVERTED BY dmm2tgm.py THIS HEADER COMMENT PREVENTS RECONVERSION, DO NOT REMOVE
"aH" = (
/obj/effect/turf_decal/corner/white{
	dir = 1
	},
/obj/effect/turf_decal/corner/white{
	dir = 2
	},
/turf/open/floor/plasteel,
/area/space)
"df" = (
/obj/structure/table,
/turf/open/floor/carpet/nanoweave/orange,
/area/space)
"dx" = (
/obj/machinery/shower{
	dir = 4
	},
/turf/open/floor/plasteel/freezer,
/area/space)
"dW" = (
/obj/structure/table/reinforced,
/turf/open/floor/plasteel/dark,
/area/space)
"eO" = (
/obj/machinery/suit_storage_unit,
/turf/open/floor/plating,
/area/space)
"fB" = (
/obj/structure/chair/office,
/turf/open/floor/carpet/nanoweave/blue,
/area/space)
"fJ" = (
/obj/structure/table/wood/bar,
/obj/item/paper_bin,
/obj/item/pen/fountain/solgov,
/turf/open/floor/carpet/nanoweave/orange,
/area/space)
"gp" = (
/obj/structure/railing,
/obj/structure/railing{
	dir = 1
	},
/turf/open/floor/plasteel/stairs{
	dir = 4
	},
/area/space)
"gy" = (
/obj/effect/turf_decal/arrows,
/turf/open/floor/carpet/nanoweave/beige,
/area/space)
"gX" = (
/obj/structure/railing,
/turf/open/floor/plasteel/stairs/left{
	dir = 4
	},
/area/space)
"hl" = (
/turf/open/floor/engine/airless,
/area/space)
"iz" = (
/obj/structure/table/reinforced,
/obj/effect/turf_decal/corner/white{
	dir = 1
	},
/obj/effect/turf_decal/corner/white{
	dir = 2
	},
/turf/open/floor/plasteel,
/area/space)
"iY" = (
/obj/structure/railing{
	dir = 1
	},
/turf/open/floor/plasteel/stairs/right{
	dir = 4
	},
/area/space)
"ji" = (
/obj/machinery/door/window{
	dir = 4
	},
/turf/open/floor/carpet/nanoweave/blue,
/area/space)
"kc" = (
/obj/machinery/door/airlock/maintenance_hatch,
/turf/open/floor/plating,
/area/space)
"lg" = (
/turf/open/floor/carpet/nanoweave/red,
/area/space)
"lr" = (
/obj/structure/mirror{
	pixel_y = 30
	},
/obj/structure/sink{
	pixel_y = 20
	},
/turf/open/floor/plasteel/freezer,
/area/space)
"lU" = (
/obj/structure/closet/crate/engineering,
/turf/open/floor/carpet/nanoweave/orange,
/area/space)
"mg" = (
/obj/machinery/shower{
	dir = 8
	},
/turf/open/floor/plasteel/freezer,
/area/space)
"nu" = (
/obj/structure/chair/office{
	dir = 8
	},
/turf/open/floor/carpet/nanoweave/orange,
/area/space)
"nP" = (
/obj/structure/window/spawner,
/obj/structure/reagent_dispensers/water_cooler,
/turf/open/floor/carpet/nanoweave/purple,
/area/space)
"os" = (
/obj/structure/table/wood/bar,
/obj/item/paper_bin,
/obj/item/pen/solgov,
/turf/open/floor/carpet/nanoweave/purple,
/area/space)
"pK" = (
/obj/effect/turf_decal/arrows{
	dir = 1
	},
/turf/open/floor/carpet/nanoweave/beige,
/area/space)
"qi" = (
/obj/machinery/door/window{
	dir = 1
	},
/turf/open/floor/carpet/nanoweave/orange,
/area/space)
"ry" = (
/obj/effect/turf_decal/box,
/turf/open/floor/carpet/nanoweave/beige,
/area/space)
"sc" = (
/obj/effect/turf_decal/lumos/tile/bar/checker,
/obj/structure/table,
/turf/open/floor/plasteel,
/area/space)
"sq" = (
/obj/machinery/vending/engivend,
/turf/open/floor/carpet/nanoweave/orange,
/area/space)
"sJ" = (
/obj/structure/catwalk,
/obj/structure/catwalk,
/turf/open/space/basic,
/area/space)
"sS" = (
/turf/open/floor/plasteel/freezer,
/area/space)
"ti" = (
/obj/structure/chair/sofa/left{
	dir = 1
	},
/turf/open/floor/carpet/nanoweave/beige,
/area/space)
"tm" = (
/obj/machinery/vending/tool,
/turf/open/floor/carpet/nanoweave/orange,
/area/space)
"tt" = (
/obj/structure/table/reinforced,
/turf/open/floor/plasteel,
/area/space)
"uy" = (
/obj/structure/table/wood/bar,
/turf/open/floor/carpet/nanoweave/red,
/area/space)
"vL" = (
/obj/effect/turf_decal/box,
/turf/open/floor/carpet/nanoweave/red,
/area/space)
"vP" = (
/turf/open/floor/carpet/nanoweave/orange,
/area/space)
"vS" = (
/obj/structure/chair/stool/bar,
/turf/open/floor/carpet/nanoweave/beige,
/area/space)
"wx" = (
/obj/structure/chair/sofa/corner{
	dir = 4
	},
/turf/open/floor/carpet/nanoweave/beige,
/area/space)
"wz" = (
/obj/structure/table/wood/bar,
/obj/item/paper_bin,
/obj/item/pen/solgov,
/turf/open/floor/carpet/nanoweave/red,
/area/space)
"wH" = (
/obj/machinery/door/airlock/engineering/glass,
/turf/open/floor/plating,
/area/space)
"xU" = (
/obj/structure/chair/wood{
	dir = 4
	},
/turf/open/floor/carpet/nanoweave/beige,
/area/space)
"zk" = (
/obj/machinery/door/window{
	dir = 4
	},
/turf/open/floor/carpet/nanoweave/red,
/area/space)
"zE" = (
/obj/structure/table,
/obj/item/soap/deluxe,
/obj/item/soap/deluxe,
/obj/item/soap/deluxe,
/turf/open/floor/plasteel,
/area/space)
"Af" = (
/turf/open/floor/plating,
/area/space)
"By" = (
/obj/structure/table,
/obj/effect/turf_decal/corner/white{
	dir = 1
	},
/obj/effect/turf_decal/corner/white{
	dir = 2
	},
/turf/open/floor/plasteel,
/area/space)
"Ci" = (
/turf/open/space/basic,
/area/space)
"CN" = (
/obj/effect/turf_decal/box,
/turf/open/floor/carpet/nanoweave/blue,
/area/space)
"EB" = (
/obj/structure/chair/office{
	dir = 1
	},
/turf/open/floor/carpet/nanoweave/red,
/area/space)
"EI" = (
/obj/structure/window/spawner/north,
/obj/structure/filingcabinet,
/turf/open/floor/carpet/nanoweave/orange,
/area/space)
"Fy" = (
/obj/structure/catwalk,
/turf/open/space/basic,
/area/space)
"FO" = (
/obj/structure/table/wood/bar,
/obj/item/paper_bin,
/obj/item/pen/solgov,
/turf/open/floor/carpet/nanoweave/blue,
/area/space)
"FS" = (
/obj/structure/table/wood/bar,
/obj/machinery/photocopier/faxmachine/longrange{
	department = "Solgov Drydock"
	},
/turf/open/floor/carpet/nanoweave/orange,
/area/space)
"GK" = (
/obj/structure/table/wood/bar,
/turf/open/floor/carpet/nanoweave/beige,
/area/space)
"Hs" = (
/obj/effect/turf_decal/lumos/tile/bar/checker,
/turf/open/floor/plasteel,
/area/space)
"Hv" = (
/turf/open/floor/carpet/nanoweave/blue,
/area/space)
"HL" = (
/obj/structure/table/wood/bar,
/obj/item/modular_computer/laptop/preset/civilian,
/turf/open/floor/carpet/nanoweave/purple,
/area/space)
"Im" = (
/obj/machinery/power/rad_collector,
/obj/machinery/power/rad_collector,
/obj/machinery/power/rad_collector,
/obj/machinery/power/rad_collector,
/obj/machinery/power/rad_collector,
/obj/machinery/power/rad_collector,
/obj/structure/closet/crate/radiation{
	desc = "A crate with six radiation collectors tightly packed in it";
	name = "Radiation Collector Crate"
	},
/turf/open/floor/carpet/nanoweave/orange,
/area/space)
"IT" = (
/turf/open/floor/carpet/nanoweave,
/area/space)
"Kt" = (
/obj/structure/chair/sofa/left{
	dir = 4
	},
/turf/open/floor/carpet/nanoweave/beige,
/area/space)
"KO" = (
/obj/machinery/door/airlock/engineering/glass,
/turf/open/floor/carpet/nanoweave/orange,
/area/space)
"LQ" = (
/turf/closed/wall,
/area/space)
"LX" = (
/obj/machinery/suit_storage_unit,
/turf/open/floor/plasteel/dark,
/area/space)
"Mw" = (
/obj/machinery/door/airlock/solgov/glass,
/turf/open/floor/carpet/nanoweave/beige,
/area/space)
"Ou" = (
/obj/machinery/door/airlock,
/turf/open/floor/plasteel/freezer,
/area/space)
"PJ" = (
/obj/structure/chair/wood{
	dir = 1
	},
/turf/open/floor/carpet/nanoweave/beige,
/area/space)
"QK" = (
/obj/machinery/door/airlock/external/glass,
/turf/open/floor/plasteel/dark,
/area/space)
"QO" = (
/obj/machinery/door/window,
/turf/open/floor/carpet/nanoweave/purple,
/area/space)
"Ro" = (
/obj/machinery/the_singularitygen/tesla,
/turf/open/floor/carpet/nanoweave/orange,
/area/space)
"Sk" = (
/obj/structure/table/wood/bar,
/obj/structure/window/spawner/east,
/obj/machinery/computer/med_data/laptop{
	dir = 1
	},
/turf/open/floor/carpet/nanoweave/blue,
/area/space)
"Sv" = (
/obj/machinery/door/airlock/external/glass,
/obj/structure/fans/tiny,
/turf/open/floor/plasteel/dark,
/area/space)
"Sw" = (
/obj/structure/chair/office{
	dir = 8
	},
/turf/open/floor/carpet/nanoweave/purple,
/area/space)
"TN" = (
/obj/structure/chair/wood{
	dir = 8
	},
/turf/open/floor/carpet/nanoweave/beige,
/area/space)
"Ut" = (
/obj/structure/toilet{
	dir = 1
	},
/turf/open/floor/plasteel/freezer,
/area/space)
"VI" = (
/turf/open/floor/carpet/nanoweave/beige,
/area/space)
"Wa" = (
/obj/effect/spawner/structure/window/reinforced,
/turf/open/floor/plating,
/area/space)
"Wj" = (
/obj/structure/chair/sofa{
	dir = 1
	},
/turf/open/floor/carpet/nanoweave/beige,
/area/space)
"Wr" = (
/turf/open/floor/plasteel/dark,
/area/space)
"Wv" = (
/obj/structure/closet/crate/radiation,
/turf/open/floor/carpet/nanoweave/orange,
/area/space)
"Xd" = (
/obj/structure/table/wood/bar,
/obj/structure/window/spawner/east,
/obj/item/paper_bin,
/obj/structure/table/wood/bar,
/obj/machinery/computer/secure_data/laptop,
/turf/open/floor/carpet/nanoweave/red,
/area/space)
"YZ" = (
/obj/structure/chair/wood,
/turf/open/floor/carpet/nanoweave/beige,
/area/space)

(1,1,1) = {"
Ci
Ci
Ci
Ci
Ci
Ci
Ci
Ci
Ci
Ci
LQ
LQ
Wa
LQ
LQ
Ci
LQ
Wa
Wa
Wa
LQ
Wa
Wa
Wa
LQ
Ci
LQ
LQ
Wa
LQ
LQ
Ci
Ci
Ci
Ci
Ci
Ci
Ci
Ci
Ci
Ci
"}
(2,1,1) = {"
Ci
Ci
Ci
Ci
Ci
Ci
Ci
Ci
LQ
LQ
LQ
sS
Ou
Ut
LQ
LQ
LQ
sc
sc
sc
LQ
By
By
By
LQ
LQ
LQ
lU
vP
vP
LQ
LQ
LQ
Ci
Ci
Ci
Ci
Ci
Ci
Ci
Ci
"}
(3,1,1) = {"
Ci
Ci
Ci
Ci
Ci
Ci
LQ
LQ
LQ
LQ
lr
sS
LQ
LQ
LQ
sc
Hs
Hs
Hs
Hs
iz
aH
aH
aH
aH
By
LQ
Wv
vP
vP
vP
vP
LQ
LQ
LQ
Ci
Ci
Ci
Ci
Ci
Ci
"}
(4,1,1) = {"
Ci
Ci
Ci
Ci
Ci
Ci
LQ
dx
dx
LQ
lr
sS
Ou
Ut
LQ
sc
Hs
Hs
Hs
Hs
iz
aH
By
By
aH
By
LQ
Im
vP
vP
vP
vP
vP
vP
LQ
Ci
Ci
Ci
Ci
Ci
Ci
"}
(5,1,1) = {"
Ci
Ci
Ci
Ci
Ci
LQ
LQ
sS
sS
Ou
sS
sS
LQ
LQ
LQ
sc
Hs
Hs
Hs
Hs
iz
aH
aH
aH
aH
By
LQ
LQ
vP
vP
vP
vP
vP
Ro
LQ
LQ
Ci
Ci
Ci
Ci
Ci
"}
(6,1,1) = {"
Ci
Ci
Ci
Ci
Ci
LQ
zE
mg
mg
LQ
sS
sS
sS
LQ
LQ
LQ
tt
tt
tt
Hs
LQ
iz
iz
iz
aH
LQ
LQ
LQ
LQ
LQ
wH
LQ
LQ
LQ
LQ
LQ
Ci
Ci
Ci
Ci
Ci
"}
(7,1,1) = {"
Ci
Ci
Ci
Ci
LQ
LQ
LQ
LQ
LQ
LQ
Ou
Ou
LQ
LQ
GK
vS
vS
vS
vS
VI
VI
VI
VI
VI
VI
Kt
wx
LQ
vP
vP
vP
vP
LQ
vP
vP
LQ
LQ
Ci
Ci
Ci
Ci
"}
(8,1,1) = {"
Ci
Ci
Ci
Ci
Wa
IT
IT
IT
LQ
IT
IT
IT
IT
LQ
GK
vS
VI
xU
xU
VI
VI
xU
xU
VI
YZ
GK
Wj
LQ
vP
vP
vP
vP
LQ
vP
vP
vP
Wa
Ci
Ci
Ci
Ci
"}
(9,1,1) = {"
Ci
Ci
Ci
Ci
Wa
IT
IT
IT
IT
IT
IT
IT
IT
LQ
GK
vS
YZ
GK
GK
PJ
YZ
GK
GK
PJ
YZ
GK
Wj
LQ
vP
vP
vP
vP
LQ
vP
vP
vP
Wa
Ci
Ci
Ci
Ci
"}
(10,1,1) = {"
Ci
Ci
Ci
Ci
Wa
IT
IT
IT
LQ
IT
IT
IT
IT
LQ
GK
vS
YZ
GK
GK
PJ
YZ
GK
GK
PJ
YZ
GK
Wj
LQ
df
vP
vP
tm
LQ
vP
vP
vP
Wa
Ci
Ci
Ci
Ci
"}
(11,1,1) = {"
Ci
Ci
Ci
LQ
LQ
IT
IT
IT
IT
IT
IT
IT
IT
LQ
GK
vS
VI
TN
TN
VI
VI
TN
TN
VI
YZ
GK
ti
LQ
df
vP
vP
vP
KO
vP
vP
vP
LQ
LQ
Ci
Ci
Ci
"}
(12,1,1) = {"
Ci
Ci
Ci
LQ
IT
IT
IT
IT
LQ
IT
IT
IT
IT
LQ
LQ
VI
VI
VI
VI
VI
VI
VI
VI
VI
VI
TN
LQ
LQ
df
vP
vP
sq
LQ
vP
vP
vP
vP
LQ
Ci
Ci
Ci
"}
(13,1,1) = {"
Ci
Ci
Ci
LQ
LQ
LQ
LQ
LQ
LQ
LQ
IT
IT
LQ
LQ
LQ
LQ
Wa
LQ
VI
VI
LQ
VI
VI
LQ
Wa
LQ
LQ
LQ
LQ
KO
KO
LQ
LQ
LQ
LQ
LQ
LQ
LQ
Ci
Ci
Ci
"}
(14,1,1) = {"
Ci
Ci
Ci
Wa
VI
VI
VI
VI
VI
VI
VI
VI
VI
VI
VI
VI
VI
VI
VI
VI
VI
VI
VI
VI
VI
VI
VI
VI
VI
VI
VI
VI
VI
VI
VI
VI
VI
Wa
Ci
Ci
Ci
"}
(15,1,1) = {"
Ci
Ci
Ci
Wa
VI
VI
VI
VI
VI
VI
VI
VI
VI
VI
VI
VI
VI
VI
VI
VI
VI
VI
VI
VI
VI
VI
VI
VI
VI
VI
VI
VI
VI
VI
VI
VI
VI
Wa
Ci
Ci
Ci
"}
(16,1,1) = {"
Ci
Ci
Ci
LQ
LQ
QK
LQ
QK
LQ
LQ
lg
lg
lg
lg
lg
lg
lg
LQ
QK
QK
LQ
QK
QK
LQ
LQ
LQ
LQ
Mw
LQ
LQ
LQ
LQ
LQ
QK
LQ
QK
LQ
LQ
Ci
Ci
Ci
"}
(17,1,1) = {"
Ci
Ci
Ci
Wa
dW
Wr
dW
Wr
dW
LQ
lg
uy
lg
lg
lg
uy
lg
LQ
Wr
Wr
LX
Wr
Wr
LQ
fB
FO
CN
VI
vL
wz
EB
LQ
dW
Wr
dW
Wr
dW
Wa
Ci
Ci
Ci
"}
(18,1,1) = {"
Ci
Ci
Ci
Wa
LX
Wr
dW
Wr
LX
Wa
lg
uy
lg
lg
lg
uy
lg
Wa
dW
Wr
LX
Wr
dW
Wa
ji
Sk
Hv
VI
lg
Xd
zk
Wa
LX
Wr
dW
Wr
LX
Wa
Ci
Ci
Ci
"}
(19,1,1) = {"
Ci
Ci
Ci
Wa
dW
Wr
dW
Wr
dW
LQ
lg
uy
lg
lg
lg
uy
lg
Wa
dW
Wr
LX
Wr
dW
Wa
VI
ry
pK
VI
gy
ry
VI
LQ
dW
Wr
dW
Wr
dW
Wa
Ci
Ci
Ci
"}
(20,1,1) = {"
Ci
Ci
Ci
LQ
LQ
Sv
LQ
Sv
LQ
LQ
lg
lg
uy
uy
uy
lg
lg
LQ
Wr
Wr
LX
Wr
Wr
LQ
nP
HL
os
VI
FS
fJ
EI
LQ
LQ
Sv
LQ
Sv
LQ
LQ
Ci
Ci
Ci
"}
(21,1,1) = {"
Ci
Ci
LQ
LQ
hl
gp
hl
gp
hl
LQ
LQ
lg
lg
lg
lg
lg
LQ
LQ
Sv
Sv
LQ
Sv
Sv
LQ
LQ
Sw
QO
VI
qi
nu
LQ
LQ
hl
gp
hl
gp
hl
LQ
LQ
Ci
Ci
"}
(22,1,1) = {"
Ci
Ci
LQ
hl
hl
hl
hl
hl
hl
hl
LQ
LQ
LQ
LQ
LQ
LQ
LQ
hl
iY
gX
hl
iY
gX
hl
LQ
LQ
LQ
LQ
LQ
LQ
LQ
hl
hl
hl
hl
hl
hl
hl
LQ
Ci
Ci
"}
(23,1,1) = {"
Ci
Ci
Wa
hl
hl
hl
hl
hl
hl
hl
LQ
Af
Af
Af
eO
LQ
hl
hl
hl
hl
hl
hl
hl
hl
hl
LQ
eO
Af
Af
Af
LQ
hl
hl
hl
hl
hl
hl
hl
Wa
Ci
Ci
"}
(24,1,1) = {"
Ci
Ci
Wa
hl
hl
hl
hl
hl
hl
hl
LQ
Af
Af
Af
LQ
LQ
hl
hl
hl
hl
hl
hl
hl
hl
hl
LQ
LQ
Af
Af
Af
LQ
hl
hl
hl
hl
hl
hl
hl
Wa
Ci
Ci
"}
(25,1,1) = {"
Ci
Ci
LQ
hl
hl
hl
hl
hl
hl
hl
kc
Af
Af
Af
kc
hl
hl
hl
hl
hl
hl
hl
hl
hl
hl
hl
kc
Af
Af
Af
kc
hl
hl
hl
hl
hl
hl
hl
LQ
Ci
Ci
"}
(26,1,1) = {"
Ci
Ci
LQ
hl
hl
hl
hl
hl
hl
hl
kc
Af
Af
Af
kc
hl
hl
hl
hl
hl
hl
hl
hl
hl
hl
hl
kc
Af
Af
Af
kc
hl
hl
hl
hl
hl
hl
hl
LQ
Ci
Ci
"}
(27,1,1) = {"
Ci
Ci
Wa
hl
hl
hl
hl
hl
hl
hl
LQ
Af
Af
LQ
LQ
hl
hl
hl
hl
hl
hl
hl
hl
hl
hl
hl
LQ
LQ
Af
Af
LQ
hl
hl
hl
hl
hl
hl
hl
Wa
Ci
Ci
"}
(28,1,1) = {"
Ci
Ci
Wa
hl
hl
hl
hl
hl
hl
hl
LQ
Af
Af
LQ
hl
hl
hl
hl
hl
hl
hl
hl
hl
hl
hl
hl
hl
LQ
Af
Af
LQ
hl
hl
hl
hl
hl
hl
hl
Wa
Ci
Ci
"}
(29,1,1) = {"
Ci
Ci
LQ
hl
hl
hl
hl
hl
hl
hl
LQ
Af
LQ
LQ
hl
hl
Ci
Fy
Fy
Fy
Fy
Fy
Fy
Fy
Ci
hl
hl
LQ
LQ
Af
LQ
hl
hl
hl
hl
hl
hl
hl
LQ
Ci
Ci
"}
(30,1,1) = {"
Ci
LQ
LQ
hl
hl
hl
hl
hl
hl
hl
LQ
LQ
LQ
hl
hl
Ci
Ci
Ci
Fy
Fy
Fy
Fy
Fy
Ci
Ci
Ci
hl
hl
LQ
LQ
LQ
hl
hl
hl
hl
hl
hl
hl
LQ
LQ
Ci
"}
(31,1,1) = {"
LQ
LQ
hl
hl
Fy
Fy
Fy
Fy
Fy
hl
hl
LQ
LQ
hl
Ci
Ci
Ci
Ci
Ci
Fy
Fy
Fy
Ci
Ci
Ci
Ci
Ci
hl
LQ
LQ
hl
hl
Fy
Fy
Fy
Fy
Fy
hl
hl
LQ
LQ
"}
(32,1,1) = {"
Wa
hl
hl
Ci
Ci
Fy
Fy
Fy
Ci
Ci
hl
hl
LQ
hl
Ci
Ci
Ci
Ci
Ci
Fy
Fy
Fy
Ci
Ci
Ci
Ci
Ci
hl
LQ
hl
hl
Ci
Ci
Fy
Fy
Fy
Ci
Ci
hl
hl
Wa
"}
(33,1,1) = {"
Wa
hl
Ci
Ci
Ci
Ci
Fy
Ci
Ci
Ci
Ci
hl
Wa
hl
Fy
Ci
Ci
Ci
Ci
Fy
Fy
Fy
Ci
Ci
Ci
Ci
Fy
hl
Wa
hl
Ci
Ci
Ci
Ci
Fy
Ci
Ci
Ci
Ci
hl
Wa
"}
(34,1,1) = {"
Wa
hl
Ci
Ci
Ci
Ci
Fy
Ci
Ci
Ci
Ci
hl
Wa
hl
Fy
Fy
Ci
Ci
Fy
Fy
Fy
Fy
Fy
Ci
Ci
Fy
Fy
hl
Wa
hl
Ci
Ci
Ci
Ci
Fy
Ci
Ci
Ci
Ci
hl
Wa
"}
(35,1,1) = {"
LQ
hl
Fy
Ci
Ci
Ci
Fy
Ci
Ci
Ci
Fy
hl
Wa
hl
Fy
Fy
Fy
Fy
Fy
Fy
Fy
Fy
Fy
Fy
Fy
Fy
Fy
hl
Wa
hl
Fy
Ci
Ci
Ci
Fy
Ci
Ci
Ci
Fy
hl
LQ
"}
(36,1,1) = {"
Wa
hl
Fy
Fy
Ci
Fy
Fy
Fy
Ci
Fy
Fy
hl
LQ
hl
Fy
Fy
Fy
Fy
Fy
Fy
Fy
Fy
Fy
Fy
Fy
Fy
Fy
hl
LQ
hl
Fy
Fy
Ci
Fy
Fy
Fy
Ci
Fy
Fy
hl
Wa
"}
(37,1,1) = {"
Wa
hl
Fy
Fy
Fy
Fy
Fy
Fy
Fy
Fy
Fy
hl
Wa
hl
Ci
Fy
Fy
Fy
Fy
Fy
Fy
Fy
Fy
Fy
Fy
Fy
Ci
hl
Wa
hl
Fy
Fy
Fy
Fy
Fy
Fy
Fy
Fy
Fy
hl
Wa
"}
(38,1,1) = {"
Wa
hl
Fy
Fy
Ci
Fy
Fy
Fy
Ci
Fy
Fy
hl
LQ
hl
Ci
Ci
Ci
Ci
Fy
Fy
Fy
Fy
Fy
Ci
Ci
Ci
Ci
hl
LQ
hl
Fy
Fy
Ci
Fy
Fy
Fy
Ci
Fy
Fy
hl
Wa
"}
(39,1,1) = {"
LQ
hl
Fy
Ci
Ci
Ci
Fy
Ci
Ci
Ci
Fy
hl
Wa
hl
Ci
Ci
Ci
Ci
Ci
Fy
Fy
Fy
Ci
Ci
Ci
Ci
Ci
hl
Wa
hl
Fy
Ci
Ci
Ci
Fy
Ci
Ci
Ci
Fy
hl
LQ
"}
(40,1,1) = {"
Wa
hl
Ci
Ci
Ci
Ci
Fy
Ci
Ci
Ci
Ci
hl
Wa
hl
Ci
Ci
Ci
Ci
Ci
Fy
Fy
Fy
Ci
Ci
Ci
Ci
Ci
hl
Wa
hl
Ci
Ci
Ci
Ci
Fy
Ci
Ci
Ci
Ci
hl
Wa
"}
(41,1,1) = {"
Wa
hl
Ci
Ci
Ci
Ci
Fy
Ci
Ci
Ci
Ci
hl
Wa
hl
Ci
Ci
Ci
Ci
Ci
Fy
Fy
Fy
Ci
Ci
Ci
Ci
Ci
hl
Wa
hl
Ci
Ci
Ci
Ci
Fy
Ci
Ci
Ci
Ci
hl
Wa
"}
(42,1,1) = {"
Wa
hl
Ci
Fy
Fy
Fy
Fy
Fy
Fy
Fy
Ci
hl
LQ
hl
Ci
Ci
Ci
Ci
Fy
Fy
Fy
Fy
Fy
Ci
Ci
Ci
Ci
hl
LQ
hl
Ci
Fy
Fy
Fy
Fy
Fy
Fy
Fy
Ci
hl
Wa
"}
(43,1,1) = {"
LQ
LQ
Fy
Fy
Ci
Ci
Ci
Ci
Ci
Fy
Fy
LQ
LQ
hl
Ci
Ci
Ci
Fy
Fy
Fy
Fy
Fy
Fy
Fy
Ci
Ci
Ci
hl
LQ
LQ
Fy
Fy
Ci
Ci
Ci
Ci
Ci
Fy
Fy
LQ
LQ
"}
(44,1,1) = {"
Ci
Ci
Ci
Ci
Ci
Ci
Ci
Ci
Ci
Ci
Ci
Ci
Wa
hl
Ci
Fy
Fy
Fy
Fy
Fy
Fy
Fy
Fy
Fy
Fy
Fy
Ci
hl
Wa
Ci
Ci
Ci
Ci
Ci
Ci
Ci
Ci
Ci
Ci
Ci
Ci
"}
(45,1,1) = {"
Ci
Ci
Ci
Ci
Ci
Ci
Ci
Ci
Ci
Ci
Ci
Ci
Wa
hl
Fy
Fy
Fy
Fy
sJ
Fy
Fy
Fy
Fy
Fy
Fy
Fy
Fy
hl
Wa
Ci
Ci
Ci
Ci
Ci
Ci
Ci
Ci
Ci
Ci
Ci
Ci
"}
(46,1,1) = {"
Ci
Ci
Ci
Ci
Ci
Ci
Ci
Ci
Ci
Ci
Ci
Ci
Wa
hl
Fy
Fy
sJ
Fy
Fy
Ci
Ci
Ci
Fy
Fy
Fy
Fy
Fy
hl
Wa
Ci
Ci
Ci
Ci
Ci
Ci
Ci
Ci
Ci
Ci
Ci
Ci
"}
(47,1,1) = {"
Ci
Ci
Ci
Ci
Ci
Ci
Ci
Ci
Ci
Ci
Ci
Ci
LQ
LQ
Fy
Fy
Fy
Ci
Ci
Ci
Ci
Ci
Ci
Ci
Fy
Fy
Fy
LQ
LQ
Ci
Ci
Ci
Ci
Ci
Ci
Ci
Ci
Ci
Ci
Ci
Ci
"}
