//MAP CONVERTED BY dmm2tgm.py THIS HEADER COMMENT PREVENTS RECONVERSION, DO NOT REMOVE
"cY" = (
/obj/effect/turf_decal{
	dir = 6
	},
/obj/item/spacepod_equipment/weaponry/pod_ka,
/turf/open/floor/plating,
/area/ruin/space/has_grav/spacegarage/main)
"dH" = (
/obj/effect/turf_decal,
/obj/machinery/light,
/turf/open/floor/plating,
/area/ruin/space/has_grav/spacegarage/main)
"eq" = (
/obj/effect/turf_decal/sand/plating,
/turf/open/floor/plating,
/area/ruin/unpowered/no_grav)
"ez" = (
/turf/closed/wall/mineral/plastitanium/nodiagonal,
/area/ruin/space/has_grav/spacegarage/main)
"fZ" = (
/obj/structure/chair/sofa/corner{
	dir = 8
	},
/obj/machinery/light{
	dir = 4
	},
/turf/open/floor/carpet/nanoweave/blue,
/area/ruin/space/has_grav/spacegarage/main)
"gR" = (
/turf/closed/wall/mineral/titanium/nodiagonal,
/area/ruin/space/has_grav/spacegarage/main)
"hk" = (
/turf/open/floor/plating/asteroid/airless,
/area/ruin/unpowered/no_grav)
"ia" = (
/turf/open/floor/plating,
/area/ruin/space/has_grav/spacegarage/main)
"iu" = (
/obj/structure/table/reinforced,
/obj/item/storage/toolbox/syndicate,
/obj/machinery/light{
	dir = 4
	},
/turf/open/floor/carpet/nanoweave/red,
/area/ruin/space/has_grav/spacegarage/main)
"jI" = (
/obj/structure/table/wood,
/obj/item/ammo_box/magazine/toy/smgm45/riot,
/obj/item/ammo_box/magazine/toy/smgm45/riot,
/obj/machinery/light{
	dir = 4
	},
/turf/open/floor/carpet/nanoweave/red,
/area/ruin/space/has_grav/spacegarage/main)
"kV" = (
/obj/effect/turf_decal,
/obj/machinery/button/door{
	id = "larperjones";
	pixel_y = -25
	},
/turf/open/floor/plating,
/area/ruin/space/has_grav/spacegarage/main)
"ld" = (
/obj/structure/table/wood,
/obj/item/ammo_box/magazine/pistolm9mm,
/obj/item/ammo_box/magazine/pistolm9mm,
/obj/item/ammo_box/magazine/pistolm9mm,
/obj/item/ammo_box/magazine/pistolm9mm,
/turf/open/floor/carpet/nanoweave/red,
/area/ruin/space/has_grav/spacegarage/main)
"lo" = (
/obj/structure/table/reinforced,
/obj/item/storage/toolbox/mechanical/old/clean,
/obj/machinery/light{
	dir = 4
	},
/turf/open/floor/carpet/nanoweave/blue,
/area/ruin/space/has_grav/spacegarage/main)
"lE" = (
/obj/structure/displaycase{
	start_showpiece_type = "/obj/item/toy/nuke"
	},
/obj/machinery/light{
	dir = 1
	},
/turf/open/floor/carpet/nanoweave/blue,
/area/ruin/space/has_grav/spacegarage/main)
"mk" = (
/obj/effect/turf_decal{
	dir = 1
	},
/turf/open/floor/plating,
/area/ruin/space/has_grav/spacegarage/main)
"na" = (
/obj/item/pod_parts/armor/security,
/turf/open/floor/plating,
/area/ruin/space/has_grav/spacegarage/main)
"pn" = (
/obj/structure/displaycase{
	start_showpiece_type = "/obj/item/toy/talking/AI"
	},
/turf/open/floor/carpet/nanoweave/blue,
/area/ruin/space/has_grav/spacegarage/main)
"qb" = (
/obj/structure/fans/tiny,
/obj/machinery/door/airlock/external/glass,
/turf/open/floor/carpet/nanoweave/blue,
/area/ruin/space/has_grav/spacegarage/main)
"qt" = (
/obj/item/pod_parts/pod_frame/fore_starboard,
/turf/open/floor/plating,
/area/ruin/space/has_grav/spacegarage/main)
"qL" = (
/obj/effect/turf_decal{
	dir = 1
	},
/turf/open/floor/plating,
/area/ruin/unpowered/no_grav)
"rS" = (
/obj/effect/turf_decal,
/turf/open/floor/plating,
/area/ruin/space/has_grav/spacegarage/main)
"su" = (
/obj/effect/turf_decal{
	dir = 6
	},
/obj/machinery/light/floor,
/turf/open/floor/plating,
/area/ruin/space/has_grav/spacegarage/main)
"tb" = (
/obj/item/pod_parts/pod_frame/fore_port,
/turf/open/floor/plating,
/area/ruin/space/has_grav/spacegarage/main)
"tx" = (
/obj/structure/spacepoddoor,
/turf/open/floor/plating,
/area/ruin/space/has_grav/spacegarage/main)
"ug" = (
/obj/structure/displaycase{
	start_showpiece_type = "/obj/item/melee/classic_baton/telescopic"
	},
/obj/machinery/light{
	dir = 1
	},
/turf/open/floor/carpet/nanoweave/blue,
/area/ruin/space/has_grav/spacegarage/main)
"vA" = (
/obj/effect/turf_decal,
/turf/open/floor/plating,
/area/ruin/unpowered/no_grav)
"xn" = (
/obj/structure/table/reinforced,
/obj/item/pod_parts/core,
/turf/open/floor/carpet/nanoweave/red,
/area/ruin/space/has_grav/spacegarage/main)
"xF" = (
/obj/structure/showcase/machinery/tv{
	pixel_x = 4
	},
/turf/open/floor/carpet/nanoweave/blue,
/area/ruin/space/has_grav/spacegarage/main)
"yi" = (
/obj/structure/displaycase{
	start_showpiece_type = "/obj/item/card/emagfake"
	},
/turf/open/floor/carpet/nanoweave/red,
/area/ruin/space/has_grav/spacegarage/main)
"yS" = (
/obj/structure/displaycase{
	start_showpiece_type = "/obj/item/card/id/ert/deathsquad"
	},
/turf/open/floor/carpet/nanoweave/blue,
/area/ruin/space/has_grav/spacegarage/main)
"zl" = (
/obj/structure/displaycase{
	start_showpiece_type = "/obj/item/card/emag"
	},
/turf/open/floor/carpet/nanoweave/red,
/area/ruin/space/has_grav/spacegarage/main)
"Bx" = (
/obj/structure/displaycase{
	start_showpiece_type = "/obj/item/dualsaber/toy"
	},
/turf/open/floor/carpet/nanoweave/red,
/area/ruin/space/has_grav/spacegarage/main)
"Cw" = (
/obj/effect/turf_decal{
	dir = 1
	},
/obj/structure/spacepoddoor,
/turf/open/floor/plating,
/area/ruin/space/has_grav/spacegarage/main)
"CR" = (
/turf/open/floor/plating,
/area/ruin/unpowered/no_grav)
"DB" = (
/obj/effect/turf_decal{
	dir = 4
	},
/obj/item/pod_parts/pod_frame/fore_port,
/turf/open/floor/plating,
/area/ruin/space/has_grav/spacegarage/main)
"Fh" = (
/obj/item/pod_parts/pod_frame/aft_starboard,
/turf/open/floor/plating,
/area/ruin/space/has_grav/spacegarage/main)
"Fu" = (
/obj/effect/turf_decal{
	dir = 5
	},
/obj/item/spacepod_equipment/weaponry/plasma_cutter,
/turf/open/floor/plating,
/area/ruin/space/has_grav/spacegarage/main)
"FC" = (
/obj/structure/chair/sofa/right{
	dir = 8
	},
/turf/open/floor/carpet/nanoweave/blue,
/area/ruin/space/has_grav/spacegarage/main)
"HP" = (
/obj/structure/reagent_dispensers/fueltank,
/turf/open/floor/carpet/nanoweave/blue,
/area/ruin/space/has_grav/spacegarage/main)
"IT" = (
/obj/effect/turf_decal{
	dir = 5
	},
/obj/machinery/light/floor,
/turf/open/floor/plating,
/area/ruin/space/has_grav/spacegarage/main)
"IV" = (
/obj/structure/displaycase{
	start_showpiece_type = "/obj/item/melee/baton"
	},
/turf/open/floor/carpet/nanoweave/blue,
/area/ruin/space/has_grav/spacegarage/main)
"Jo" = (
/obj/structure/displaycase{
	start_showpiece_type = "/obj/item/toy/balloon/syndicate"
	},
/obj/machinery/light,
/turf/open/floor/carpet/nanoweave/red,
/area/ruin/space/has_grav/spacegarage/main)
"JQ" = (
/obj/effect/turf_decal{
	dir = 1
	},
/obj/item/pod_parts/pod_frame/aft_starboard,
/turf/open/floor/plating,
/area/ruin/space/has_grav/spacegarage/main)
"KC" = (
/obj/structure/chair/sofa/right{
	dir = 1
	},
/turf/open/floor/carpet/nanoweave/blue,
/area/ruin/space/has_grav/spacegarage/main)
"KD" = (
/obj/machinery/porta_turret/lasertag/red,
/turf/open/floor/plating/asteroid/airless,
/area/ruin/space/has_grav/spacegarage/main)
"Lc" = (
/obj/effect/turf_decal{
	dir = 1
	},
/obj/item/pod_parts/core,
/obj/machinery/button/door{
	id = "larperjones";
	pixel_y = 25
	},
/turf/open/floor/plating,
/area/ruin/space/has_grav/spacegarage/main)
"Ls" = (
/obj/structure/displaycase{
	start_showpiece_type = "/obj/item/gun/energy/laser/retro"
	},
/turf/open/floor/carpet/nanoweave/blue,
/area/ruin/space/has_grav/spacegarage/main)
"LH" = (
/obj/effect/turf_decal{
	dir = 4
	},
/turf/open/floor/plating,
/area/ruin/space/has_grav/spacegarage/main)
"Rc" = (
/obj/structure/table/wood,
/obj/item/ammo_box/magazine/toy/smgm45,
/obj/item/ammo_box/magazine/toy/smgm45,
/turf/open/floor/carpet/nanoweave/red,
/area/ruin/space/has_grav/spacegarage/main)
"Ri" = (
/obj/structure/rack,
/obj/item/weldingtool/experimental,
/turf/open/floor/carpet/nanoweave/blue,
/area/ruin/space/has_grav/spacegarage/main)
"Ss" = (
/obj/machinery/porta_turret/lasertag/blue,
/turf/open/floor/plating/asteroid/airless,
/area/ruin/space/has_grav/spacegarage/main)
"Tv" = (
/obj/effect/turf_decal,
/obj/item/pod_parts/pod_frame/aft_port,
/turf/open/floor/plating,
/area/ruin/space/has_grav/spacegarage/main)
"TH" = (
/turf/open/floor/carpet/nanoweave/blue,
/area/ruin/space/has_grav/spacegarage/main)
"Ub" = (
/obj/effect/turf_decal{
	dir = 1
	},
/obj/item/pod_parts/armor/syndicate,
/turf/open/floor/plating,
/area/ruin/space/has_grav/spacegarage/main)
"Up" = (
/obj/structure/displaycase{
	start_showpiece_type = "/obj/item/card/id/gold"
	},
/turf/open/floor/carpet/nanoweave/blue,
/area/ruin/space/has_grav/spacegarage/main)
"UF" = (
/obj/structure/fans/tiny,
/obj/machinery/door/airlock/external/glass,
/turf/open/floor/carpet/nanoweave/red,
/area/ruin/space/has_grav/spacegarage/main)
"Vh" = (
/obj/structure/table/reinforced,
/obj/item/circuitboard/mecha/pod,
/turf/open/floor/carpet/nanoweave/red,
/area/ruin/space/has_grav/spacegarage/main)
"VU" = (
/obj/item/pod_parts/pod_frame/aft_port,
/turf/open/floor/plating,
/area/ruin/space/has_grav/spacegarage/main)
"Xb" = (
/obj/structure/displaycase{
	start_showpiece_type = "/obj/item/gun/ballistic/automatic/pistol"
	},
/turf/open/floor/carpet/nanoweave/red,
/area/ruin/space/has_grav/spacegarage/main)
"XT" = (
/obj/effect/turf_decal,
/obj/structure/spacepoddoor,
/obj/machinery/door/poddoor/multi_tile/four_tile_ver{
	id = "larperjones"
	},
/turf/open/floor/plating,
/area/ruin/space/has_grav/spacegarage/main)
"Ya" = (
/obj/structure/table/wood,
/turf/open/floor/carpet/nanoweave/blue,
/area/ruin/space/has_grav/spacegarage/main)
"Yh" = (
/obj/structure/displaycase{
	start_showpiece_type = "/obj/item/gun/ballistic/automatic/c20r/toy"
	},
/turf/open/floor/carpet/nanoweave/red,
/area/ruin/space/has_grav/spacegarage/main)
"Yk" = (
/obj/structure/displaycase{
	start_showpiece_type = "/obj/item/toy/sword"
	},
/obj/machinery/light,
/turf/open/floor/carpet/nanoweave/red,
/area/ruin/space/has_grav/spacegarage/main)
"Yl" = (
/obj/effect/turf_decal{
	dir = 1
	},
/obj/machinery/light{
	dir = 1
	},
/turf/open/floor/plating,
/area/ruin/space/has_grav/spacegarage/main)
"Yq" = (
/turf/open/floor/carpet/nanoweave/red,
/area/ruin/space/has_grav/spacegarage/main)
"YM" = (
/turf/closed/mineral/random,
/area/ruin/unpowered/no_grav)
"ZB" = (
/obj/item/circuitboard/mecha/pod,
/turf/open/floor/plating,
/area/ruin/space/has_grav/spacegarage/main)

(1,1,1) = {"
hk
hk
hk
hk
qL
eq
eq
eq
eq
CR
eq
vA
hk
hk
hk
hk
"}
(2,1,1) = {"
hk
hk
hk
hk
qL
eq
CR
eq
qL
eq
CR
eq
hk
hk
hk
hk
"}
(3,1,1) = {"
hk
hk
hk
hk
eq
CR
eq
eq
qL
CR
CR
vA
hk
hk
hk
hk
"}
(4,1,1) = {"
hk
hk
hk
hk
eq
CR
CR
vA
eq
CR
eq
eq
hk
hk
hk
hk
"}
(5,1,1) = {"
hk
hk
hk
hk
qL
eq
CR
vA
qL
eq
CR
vA
hk
hk
hk
hk
"}
(6,1,1) = {"
hk
hk
hk
Ss
qL
CR
eq
vA
qL
eq
eq
vA
KD
hk
hk
hk
"}
(7,1,1) = {"
hk
gR
qb
gR
Cw
tx
tx
XT
Cw
tx
tx
XT
ez
UF
ez
hk
"}
(8,1,1) = {"
hk
gR
TH
gR
Lc
ia
qt
rS
mk
ia
ia
kV
ez
Yq
ez
hk
"}
(9,1,1) = {"
gR
gR
qb
gR
Yl
ia
ia
rS
Ub
ia
qt
dH
ez
UF
ez
ez
"}
(10,1,1) = {"
gR
ug
TH
TH
JQ
ia
ia
rS
mk
VU
ia
rS
Yq
Yq
Yk
ez
"}
(11,1,1) = {"
gR
IV
TH
TH
mk
ia
na
rS
mk
ia
tb
rS
Yq
Yq
Bx
ez
"}
(12,1,1) = {"
gR
yS
TH
TH
mk
ZB
ia
Tv
mk
ia
ia
rS
Yq
Yq
yi
ez
"}
(13,1,1) = {"
gR
Ls
TH
TH
mk
ia
ia
rS
mk
ia
Fh
rS
Yq
Yq
Xb
ez
"}
(14,1,1) = {"
gR
Up
TH
TH
Fu
LH
DB
su
IT
LH
LH
cY
Yq
Yq
zl
ez
"}
(15,1,1) = {"
gR
pn
TH
TH
TH
TH
TH
TH
Yq
Yq
Yq
Yq
Yq
Yq
Yh
ez
"}
(16,1,1) = {"
gR
lE
TH
TH
TH
TH
TH
TH
Yq
Yq
Yq
Yq
Yq
Yq
Jo
ez
"}
(17,1,1) = {"
gR
gR
xF
Ya
KC
TH
TH
TH
Yq
Yq
Yq
Yq
Yq
ld
ez
ez
"}
(18,1,1) = {"
YM
gR
gR
FC
fZ
TH
TH
TH
Yq
Yq
Yq
jI
Rc
ez
ez
YM
"}
(19,1,1) = {"
YM
YM
gR
gR
gR
HP
Ri
lo
iu
Vh
xn
ez
ez
ez
YM
YM
"}
(20,1,1) = {"
YM
YM
YM
YM
gR
gR
gR
gR
ez
ez
ez
ez
YM
YM
YM
YM
"}
