//MAP CONVERTED BY dmm2tgm.py THIS HEADER COMMENT PREVENTS RECONVERSION, DO NOT REMOVE
"ab" = (
/turf/open/floor/engine/hull,
/area/template_noop)
"bj" = (
/obj/machinery/nanite_program_hub,
/turf/open/floor/circuit/green,
/area/template_noop)
"bO" = (
/obj/machinery/mineral/ore_redemption,
/turf/open/floor/plasteel/dark,
/area/template_noop)
"bR" = (
/turf/open/floor/engine/plasma,
/area/template_noop)
"cl" = (
/turf/open/floor/engine/o2,
/area/template_noop)
"ct" = (
/obj/item/clothing/under/rank/rnd/scientist/nanite,
/turf/open/floor/circuit/red,
/area/template_noop)
"dh" = (
/turf/closed/wall/r_wall/syndicate/nodiagonal,
/area/template_noop)
"dB" = (
/obj/structure/tank_dispenser/oxygen,
/turf/open/floor/plasteel/dark,
/area/template_noop)
"dQ" = (
/obj/machinery/power/shuttle/engine/fueled/plasma{
	dir = 1
	},
/turf/open/floor/plating,
/area/template_noop)
"ee" = (
/obj/machinery/nanite_chamber,
/turf/open/floor/circuit/green,
/area/template_noop)
"ey" = (
/obj/machinery/power/shuttle/engine/electric,
/obj/structure/cable{
	icon_state = "0-2"
	},
/turf/open/floor/plating,
/area/template_noop)
"eL" = (
/obj/structure/table/glass,
/obj/item/nanite_remote,
/obj/item/nanite_remote/comm,
/obj/item/nanite_scanner,
/obj/item/storage/box/disks_nanite,
/turf/open/floor/circuit/red,
/area/template_noop)
"fg" = (
/obj/machinery/power/smes/shuttle/precharged,
/obj/structure/cable,
/turf/open/floor/plating,
/area/template_noop)
"fA" = (
/obj/machinery/computer/helm,
/turf/open/floor/mineral/plastitanium{
	color = "#f3b3fe"
	},
/area/template_noop)
"gi" = (
/turf/open/floor/plasteel/dark,
/area/template_noop)
"gI" = (
/obj/machinery/suit_storage_unit/syndicate,
/turf/open/floor/plasteel/dark,
/area/template_noop)
"hh" = (
/obj/structure/cable{
	icon_state = "1-4"
	},
/turf/open/floor/plating,
/area/template_noop)
"hm" = (
/obj/item/clothing/under/rank/rnd/scientist/nanite/skirt,
/turf/open/floor/circuit/red,
/area/template_noop)
"hs" = (
/obj/structure/cable{
	icon_state = "2-8"
	},
/obj/structure/cable{
	icon_state = "1-2"
	},
/turf/open/floor/plasteel/dark,
/area/template_noop)
"ht" = (
/obj/structure/table/glass,
/turf/open/floor/mineral/plastitanium/red,
/area/template_noop)
"hR" = (
/obj/machinery/computer/nanite_chamber_control{
	dir = 8
	},
/turf/open/floor/circuit/red,
/area/template_noop)
"io" = (
/obj/machinery/nanite_programmer,
/turf/open/floor/circuit/green,
/area/template_noop)
"ix" = (
/turf/open/floor/circuit/red,
/area/template_noop)
"iy" = (
/obj/machinery/computer/nanite_cloud_controller,
/turf/open/floor/circuit/green,
/area/template_noop)
"iL" = (
/obj/structure/closet/emcloset,
/turf/open/floor/plasteel/dark,
/area/template_noop)
"iU" = (
/obj/structure/cable{
	icon_state = "2-4"
	},
/obj/structure/cable{
	icon_state = "1-2"
	},
/turf/open/floor/plasteel/dark,
/area/template_noop)
"je" = (
/obj/machinery/door/airlock/medical/glass,
/turf/open/floor/plasteel/dark,
/area/template_noop)
"jf" = (
/obj/structure/cable{
	icon_state = "1-8"
	},
/turf/open/floor/plasteel/dark,
/area/template_noop)
"jg" = (
/obj/structure/window/plasma/reinforced/spawner,
/turf/open/floor/engine/plasma,
/area/template_noop)
"js" = (
/obj/structure/cable{
	icon_state = "2-8"
	},
/turf/open/floor/plasteel/dark,
/area/template_noop)
"jB" = (
/obj/structure/closet/firecloset,
/turf/open/floor/plasteel/dark,
/area/template_noop)
"jF" = (
/obj/machinery/door/airlock/public/glass,
/turf/open/floor/mineral/plastitanium,
/area/template_noop)
"jN" = (
/obj/structure/window/plasma/reinforced/spawner,
/turf/open/floor/engine/o2,
/area/template_noop)
"jZ" = (
/obj/structure/AIcore/latejoin_inactive,
/turf/open/floor/plasteel/dark,
/area/template_noop)
"kl" = (
/obj/effect/spawner/structure/window/plasma/reinforced,
/turf/open/floor/plating,
/area/template_noop)
"lh" = (
/obj/structure/window/plasma/reinforced/spawner{
	dir = 4
	},
/turf/open/floor/engine/plasma,
/area/template_noop)
"lr" = (
/obj/machinery/door/poddoor,
/turf/open/floor/plasteel/dark,
/area/template_noop)
"lA" = (
/obj/structure/window/plasma/reinforced/spawner{
	dir = 8
	},
/turf/open/floor/engine/o2,
/area/template_noop)
"lN" = (
/obj/machinery/door/airlock/atmos/glass,
/turf/open/floor/plating,
/area/template_noop)
"lV" = (
/obj/machinery/computer/turbine_computer{
	dir = 1;
	id = "incineratorturbine"
	},
/turf/open/floor/plating,
/area/template_noop)
"mM" = (
/obj/structure/window/plasma/reinforced/spawner,
/obj/structure/window/plasma/reinforced/spawner{
	dir = 4
	},
/turf/open/floor/engine/plasma,
/area/template_noop)
"mX" = (
/obj/machinery/atmospherics/components/trinary/mixer/on,
/turf/open/floor/plating,
/area/template_noop)
"nx" = (
/obj/structure/cable{
	icon_state = "1-8"
	},
/turf/open/floor/plating,
/area/template_noop)
"nJ" = (
/obj/machinery/power/terminal{
	dir = 1
	},
/obj/structure/cable{
	icon_state = "0-2"
	},
/turf/open/floor/plating,
/area/template_noop)
"ou" = (
/obj/structure/cable{
	icon_state = "2-4"
	},
/turf/open/floor/plasteel/dark,
/area/template_noop)
"oK" = (
/obj/machinery/door/poddoor,
/obj/structure/fans/tiny,
/turf/open/floor/plasteel/dark,
/area/template_noop)
"pE" = (
/obj/structure/window/plasma/reinforced/spawner,
/obj/structure/window/plasma/reinforced/spawner{
	dir = 8
	},
/turf/open/floor/engine/o2,
/area/template_noop)
"pR" = (
/obj/structure/table/glass,
/turf/open/floor/plating,
/area/template_noop)
"qq" = (
/obj/machinery/vending/autodrobe/all_access{
	default_price = 0;
	extra_price = 0
	},
/turf/template_noop,
/area/template_noop)
"qR" = (
/obj/structure/closet,
/obj/item/clothing/under/syndicate/skirt,
/obj/item/clothing/under/syndicate/skirt,
/obj/item/clothing/under/syndicate/bloodred/sleepytime,
/obj/item/clothing/under/syndicate/bloodred/sleepytime,
/obj/item/clothing/under/syndicate/bloodred/sleepytime,
/obj/item/clothing/under/syndicate/bloodred/sleepytime,
/obj/item/clothing/under/syndicate/bloodred/sleepytime,
/obj/item/clothing/under/syndicate,
/obj/item/clothing/under/syndicate,
/obj/item/clothing/under/syndicate,
/obj/item/clothing/under/syndicate/skirt,
/obj/item/clothing/under/syndicate/intern,
/obj/item/clothing/under/syndicate/intern,
/obj/item/clothing/under/syndicate/intern,
/obj/item/clothing/under/syndicate/intern,
/obj/item/clothing/under/syndicate/intern,
/obj/item/clothing/under/syndicate/intern,
/turf/open/floor/mineral/plastitanium,
/area/template_noop)
"rV" = (
/obj/structure/table/reinforced,
/turf/open/floor/plasteel/dark,
/area/template_noop)
"sN" = (
/obj/machinery/power/turbine{
	luminosity = 2
	},
/turf/open/floor/engine/vacuum,
/area/template_noop)
"tZ" = (
/obj/machinery/ore_silo,
/turf/open/floor/plasteel/dark,
/area/template_noop)
"xj" = (
/obj/machinery/door/poddoor/incinerator_atmos_main,
/turf/open/floor/engine/vacuum,
/area/template_noop)
"zO" = (
/obj/structure/tank_dispenser/oxygen,
/turf/open/floor/mineral/plastitanium,
/area/template_noop)
"Ct" = (
/obj/machinery/power/compressor{
	comp_id = "incineratorturbine";
	dir = 1;
	luminosity = 2
	},
/turf/open/floor/engine/vacuum,
/area/template_noop)
"CH" = (
/obj/machinery/door/poddoor,
/obj/structure/fans/tiny,
/turf/open/floor/mineral/plastitanium,
/area/template_noop)
"Dn" = (
/obj/structure/window/plasma/reinforced/spawner/west,
/obj/machinery/door/poddoor/incinerator_atmos_aux,
/turf/open/floor/engine/vacuum,
/area/template_noop)
"DU" = (
/obj/machinery/atmospherics/components/binary/pump,
/turf/open/floor/plating,
/area/template_noop)
"HS" = (
/obj/structure/fans/tiny,
/turf/open/floor/engine,
/area/template_noop)
"Ia" = (
/obj/docking_port/mobile{
	can_move_docking_ports = 1;
	dir = 2;
	id = "syndieship";
	launch_status = 0;
	name = "SSV Shenanigans";
	undock_roundstart = 1
	},
/turf/open/floor/engine/hull,
/area/template_noop)
"Io" = (
/obj/structure/cable{
	icon_state = "1-4"
	},
/turf/open/floor/plasteel/dark,
/area/template_noop)
"Ja" = (
/obj/structure/cable{
	icon_state = "4-8"
	},
/turf/open/floor/plasteel/dark,
/area/template_noop)
"JC" = (
/obj/machinery/door/poddoor,
/obj/structure/fans/tiny,
/turf/open/floor/mineral/plastitanium/red,
/area/template_noop)
"KF" = (
/obj/machinery/mass_driver{
	dir = 1
	},
/turf/open/floor/plasteel/dark,
/area/template_noop)
"Nr" = (
/turf/template_noop,
/area/template_noop)
"Sj" = (
/obj/structure/window/plasma/reinforced/spawner/west,
/turf/open/floor/engine/vacuum,
/area/template_noop)
"VC" = (
/turf/open/floor/mineral/plastitanium{
	color = "#f3b3fe"
	},
/area/template_noop)
"Wd" = (
/obj/structure/chair/comfy/shuttle{
	dir = 1
	},
/obj/item/areaeditor/shuttle,
/turf/open/floor/mineral/plastitanium{
	color = "#f3b3fe"
	},
/area/template_noop)
"Wn" = (
/obj/machinery/autolathe,
/turf/open/floor/mineral/plastitanium/red,
/area/template_noop)
"Xx" = (
/turf/open/floor/engine/vacuum,
/area/template_noop)
"XP" = (
/turf/closed/wall/mineral/plastitanium/nodiagonal,
/area/template_noop)
"Yi" = (
/obj/machinery/atmospherics/components/unary/shuttle/heater{
	dir = 1
	},
/turf/open/floor/plating,
/area/template_noop)
"YL" = (
/turf/open/floor/mineral/plastitanium/red,
/area/template_noop)
"YW" = (
/obj/structure/fans/tiny,
/obj/machinery/door/poddoor,
/turf/open/floor/plasteel/dark,
/area/template_noop)
"YY" = (
/obj/effect/spawner/structure/window/plasma/reinforced/plastitanium,
/turf/open/floor/plating,
/area/template_noop)
"Zn" = (
/obj/structure/cable{
	icon_state = "1-2"
	},
/turf/open/floor/plasteel/dark,
/area/template_noop)
"Zo" = (
/turf/open/floor/mineral/plastitanium,
/area/template_noop)
"ZH" = (
/turf/open/floor/plating,
/area/template_noop)

(1,1,1) = {"
Nr
Nr
Nr
Nr
Nr
Nr
Nr
Nr
Nr
Nr
Nr
Nr
Nr
Nr
Nr
Nr
bj
eL
io
Nr
Nr
Nr
Nr
Nr
dh
dh
dh
dh
dh
dh
dh
Nr
Nr
Nr
Nr
Nr
Nr
Nr
Nr
Nr
Nr
Nr
Nr
Nr
Nr
"}
(2,1,1) = {"
Nr
Nr
Nr
Nr
dh
dh
dh
dh
dh
dh
dh
Nr
Nr
Nr
Nr
Nr
ct
hm
ix
Nr
Nr
Nr
dh
YY
dh
gi
gi
gi
gi
gi
dh
YY
YY
dh
Nr
Nr
Nr
Nr
Nr
Nr
Nr
Nr
Nr
Nr
Nr
"}
(3,1,1) = {"
Nr
Nr
Nr
Nr
ey
fg
nJ
hh
gi
gi
dh
dh
Nr
Nr
Nr
Nr
ee
hR
iy
Nr
Nr
dh
dh
gi
gi
gi
gi
gi
gi
gi
dh
gi
gi
dh
YY
dh
Nr
Nr
Nr
Nr
Nr
Nr
Nr
Nr
Nr
"}
(4,1,1) = {"
Nr
Nr
Nr
Nr
ey
fg
nJ
hs
Zn
Zn
Io
dh
dh
Nr
Nr
Nr
Nr
Nr
Nr
Nr
dh
dh
gi
gi
gi
gi
gi
gi
gi
gi
gi
gi
gi
gi
gi
dh
YY
dh
Nr
Nr
Nr
Nr
Nr
Nr
Nr
"}
(5,1,1) = {"
Nr
Nr
Nr
dh
dh
XP
XP
XP
XP
gi
Ja
gi
dh
Nr
Nr
Nr
Nr
Nr
Nr
Nr
YY
gi
gi
gi
gi
gi
gi
gi
gi
gi
dh
gi
gi
gi
gi
dh
pR
dh
dh
Nr
Nr
Nr
Nr
Nr
Nr
"}
(6,1,1) = {"
Nr
dh
YY
dh
dB
gI
gI
gI
XP
XP
Ja
gi
dh
YY
dh
Nr
Nr
Nr
Nr
dh
dh
gi
gi
gi
gi
gi
gi
gi
gi
gi
dh
gi
gi
gi
gi
lN
ZH
ZH
dh
YY
dh
Nr
Nr
Nr
Nr
"}
(7,1,1) = {"
dh
dh
gi
gi
gi
gi
gi
gi
gi
XP
js
Io
gi
gi
dh
dh
Nr
Nr
dh
dh
gi
gi
gi
gi
gi
gi
gi
gi
gi
gi
gi
gi
gi
gi
gi
XP
ZH
ZH
ZH
ZH
dh
dh
Nr
Nr
Nr
"}
(8,1,1) = {"
lr
KF
gi
gi
gi
gi
gi
gi
gi
gi
Zn
hs
Zn
Io
gi
dh
dh
dh
dh
gi
gi
gi
gi
gi
gi
gi
gi
gi
gi
gi
dh
gi
gi
gi
gi
XP
ZH
ZH
ZH
ZH
ZH
YY
Nr
Nr
Nr
"}
(9,1,1) = {"
dh
dh
rV
dh
dh
YW
YW
YW
dh
dh
iL
jB
gi
js
Io
tZ
gi
gi
XP
XP
gi
gi
gi
gi
gi
gi
gi
XP
XP
XP
XP
dh
gi
gi
gi
dh
ZH
ZH
ZH
ZH
ZH
dh
dh
Nr
Nr
"}
(10,1,1) = {"
Nr
dh
YY
dh
ab
ab
ab
ab
ab
dh
YY
dh
gi
gi
js
gi
gi
gi
VC
XP
XP
XP
gi
XP
gi
XP
XP
XP
VC
Zo
Zo
dh
dh
kl
kl
dh
ZH
ZH
ZH
ZH
ZH
DU
Yi
dQ
Nr
"}
(11,1,1) = {"
Nr
Nr
ab
ab
ab
ab
ab
ab
ab
ab
ab
dh
dh
bO
gi
gi
gi
VC
VC
XP
Wn
ht
YL
YL
YL
ht
ht
XP
VC
VC
Zo
Zo
dh
bR
bR
jg
ZH
ZH
ZH
ZH
ZH
DU
Yi
dQ
Nr
"}
(12,1,1) = {"
Nr
Nr
Nr
ab
ab
ab
ab
ab
ab
ab
ab
ab
oK
gi
gi
VC
VC
VC
VC
VC
VC
YL
YL
YL
YL
YL
VC
XP
VC
VC
VC
VC
dh
bR
bR
jg
ZH
ZH
ZH
ZH
dh
Dn
Sj
Nr
Nr
"}
(13,1,1) = {"
Nr
Nr
Nr
Nr
ab
ab
ab
ab
ab
ab
ab
ab
CH
Zo
Zo
Zo
Zo
Zo
XP
XP
VC
VC
YL
YL
YL
VC
VC
jF
Zo
Zo
Zo
Zo
dh
lh
lh
mM
ZH
ZH
ZH
lV
dh
Xx
dh
dh
dh
"}
(14,1,1) = {"
Nr
Nr
Nr
Nr
Ia
ab
ab
ab
ab
ab
ab
ab
JC
YL
YL
YL
YL
YL
YY
fA
Wd
VC
YL
YL
YL
VC
VC
dh
YL
YL
YL
YL
ZH
ZH
ZH
ZH
ZH
mX
ZH
ZH
HS
Xx
Ct
sN
xj
"}
(15,1,1) = {"
Nr
Nr
Nr
Nr
ab
ab
ab
ab
ab
ab
ab
ab
CH
Zo
Zo
Zo
Zo
Zo
XP
XP
VC
VC
YL
YL
YL
VC
VC
jF
Zo
Zo
Zo
Zo
dh
lA
lA
pE
ZH
ZH
ZH
ZH
dh
Xx
dh
dh
dh
"}
(16,1,1) = {"
Nr
Nr
Nr
ab
ab
ab
ab
ab
ab
ab
ab
ab
oK
gi
gi
VC
VC
VC
VC
VC
VC
YL
YL
YL
YL
YL
VC
XP
VC
VC
VC
VC
dh
cl
cl
jN
ZH
ZH
ZH
ZH
dh
dh
dh
Nr
Nr
"}
(17,1,1) = {"
Nr
Nr
ab
ab
ab
ab
ab
ab
ab
ab
ab
dh
dh
gi
gi
gi
gi
VC
VC
XP
ht
ht
YL
YL
YL
ht
ht
XP
VC
VC
Zo
Zo
dh
cl
cl
jN
ZH
ZH
ZH
ZH
ZH
DU
Yi
dQ
Nr
"}
(18,1,1) = {"
Nr
dh
YY
dh
ab
ab
ab
ab
ab
dh
YY
dh
gi
gi
ou
gi
gi
gi
VC
XP
XP
XP
je
XP
je
XP
XP
XP
VC
Zo
Zo
dh
dh
dh
dh
dh
ZH
ZH
ZH
ZH
ZH
DU
Yi
dQ
Nr
"}
(19,1,1) = {"
dh
dh
rV
dh
dh
YW
YW
YW
dh
dh
iL
jB
gi
ou
jf
gi
gi
gi
XP
XP
gi
gi
gi
gi
gi
gi
gi
XP
XP
dh
dh
dh
gi
gi
gi
XP
ZH
ZH
ZH
ZH
ZH
dh
dh
Nr
Nr
"}
(20,1,1) = {"
lr
KF
gi
gi
gi
gi
gi
gi
gi
gi
Zn
iU
Zn
jf
gi
dh
dh
dh
dh
gi
gi
gi
gi
gi
gi
gi
gi
gi
gi
gi
gi
gi
gi
gi
gi
gi
ZH
ZH
ZH
ZH
ZH
YY
Nr
Nr
Nr
"}
(21,1,1) = {"
dh
dh
gi
gi
gi
gi
gi
gi
gi
XP
ou
jf
gi
gi
dh
dh
Nr
Nr
dh
dh
gi
gi
gi
gi
gi
gi
gi
gi
gi
gi
gi
jZ
gi
gi
gi
XP
ZH
ZH
ZH
ZH
dh
dh
Nr
Nr
Nr
"}
(22,1,1) = {"
Nr
dh
YY
dh
zO
gI
gI
gI
XP
XP
Ja
gi
dh
YY
dh
Nr
Nr
Nr
Nr
dh
dh
gi
gi
gi
gi
gi
gi
gi
gi
gi
gi
gi
gi
gi
gi
XP
ZH
ZH
dh
YY
dh
Nr
Nr
Nr
Nr
"}
(23,1,1) = {"
Nr
Nr
Nr
dh
dh
dh
XP
XP
XP
gi
Ja
gi
dh
Nr
Nr
Nr
Nr
Nr
Nr
Nr
dh
gi
gi
gi
gi
gi
gi
gi
gi
gi
gi
gi
gi
gi
gi
XP
ZH
dh
dh
Nr
Nr
Nr
Nr
Nr
Nr
"}
(24,1,1) = {"
Nr
Nr
Nr
Nr
ey
fg
nJ
iU
Zn
Zn
jf
dh
dh
Nr
Nr
Nr
Nr
Nr
Nr
Nr
dh
dh
gi
gi
gi
gi
gi
gi
gi
gi
gi
gi
gi
gi
gi
dh
YY
dh
Nr
Nr
Nr
Nr
Nr
Nr
Nr
"}
(25,1,1) = {"
Nr
Nr
Nr
Nr
ey
fg
nJ
nx
gi
gi
dh
dh
Nr
Nr
Nr
Nr
Nr
Nr
Nr
Nr
Nr
dh
dh
gi
gi
gi
gi
gi
gi
gi
gi
gi
gi
dh
YY
dh
Nr
Nr
Nr
Nr
Nr
Nr
Nr
Nr
Nr
"}
(26,1,1) = {"
Nr
Nr
Nr
Nr
dh
dh
dh
dh
dh
dh
dh
Nr
Nr
Nr
Nr
Nr
Nr
Nr
Nr
Nr
Nr
Nr
dh
YY
dh
gi
gi
gi
gi
gi
dh
YY
YY
dh
Nr
Nr
Nr
Nr
Nr
Nr
Nr
Nr
Nr
Nr
Nr
"}
(27,1,1) = {"
Nr
Nr
Nr
Nr
Nr
Nr
Nr
Nr
Nr
Nr
Nr
Nr
Nr
Nr
Nr
Nr
Nr
Nr
Nr
Nr
Nr
Nr
Nr
Nr
dh
dh
YY
dh
dh
dh
dh
Nr
Nr
Nr
Nr
Nr
qq
Nr
Nr
qR
Nr
Nr
Nr
Nr
Nr
"}
