//MAP CONVERTED BY dmm2tgm.py THIS HEADER COMMENT PREVENTS RECONVERSION, DO NOT REMOVE
"an" = (
/obj/structure/filingcabinet,
/turf/open/floor/carpet/nanoweave/blue,
/area/space)
"aM" = (
/obj/machinery/suit_storage_unit,
/turf/open/floor/mineral/titanium,
/area/space)
"bS" = (
/obj/machinery/power/shuttle/engine/electric{
	dir = 4
	},
/turf/open/floor/mineral/plastitanium,
/area/space)
"cg" = (
/obj/structure/closet/secure_closet/freezer/fridge,
/turf/open/floor/plasteel/freezer,
/area/space)
"cq" = (
/obj/effect/turf_decal/dept/mining,
/turf/open/floor/mineral/titanium,
/area/space)
"cy" = (
/obj/machinery/atmospherics/miner/nitrogen,
/turf/open/floor/engine/n2,
/area/space)
"cH" = (
/obj/machinery/computer/autopilot{
	ship_id = "syndietest"
	},
/turf/open/floor/plasteel/freezer,
/area/space)
"cR" = (
/obj/effect/turf_decal/number/two,
/turf/open/floor/engine/airless,
/area/space)
"cU" = (
/obj/machinery/power/smes/shuttle/precharged{
	dir = 8
	},
/turf/open/floor/carpet/nanoweave/blue,
/area/space)
"dj" = (
/obj/machinery/atmospherics/miner/toxins,
/turf/open/floor/engine/plasma,
/area/space)
"dC" = (
/turf/open/floor/engine/plasma,
/area/space)
"dZ" = (
/obj/machinery/door/window{
	dir = 4
	},
/turf/open/floor/carpet/nanoweave/beige,
/area/space)
"eH" = (
/obj/machinery/power/shuttle/engine/fueled/plasma{
	dir = 8
	},
/turf/open/floor/mineral/titanium,
/area/space)
"fI" = (
/obj/machinery/atmospherics/components/unary/shuttle/heater{
	dir = 1
	},
/turf/open/floor/carpet/nanoweave/beige,
/area/space)
"gg" = (
/obj/machinery/computer/autopilot,
/turf/open/floor/mineral/plastitanium,
/area/space)
"gx" = (
/obj/structure/fans/tiny,
/obj/machinery/door/poddoor,
/turf/open/floor/mineral/titanium/yellow,
/area/space)
"gR" = (
/obj/machinery/computer/helm{
	dir = 8
	},
/turf/open/floor/mineral/plastitanium,
/area/space)
"hU" = (
/obj/machinery/microwave,
/obj/structure/table,
/turf/open/floor/plasteel/freezer,
/area/space)
"ib" = (
/obj/machinery/atmospherics/components/unary/shuttle/heater{
	dir = 4
	},
/turf/open/floor/plating,
/area/space)
"ii" = (
/obj/machinery/power/shuttle/engine/electric{
	dir = 1
	},
/turf/open/floor/mineral/titanium/yellow,
/area/space)
"iz" = (
/turf/open/space/basic,
/area/space)
"iM" = (
/obj/structure/fans/tiny,
/obj/machinery/door/airlock/medical/glass,
/turf/open/floor/mineral/titanium/blue,
/area/space)
"iU" = (
/obj/structure/chair/office{
	dir = 8
	},
/turf/open/floor/carpet/nanoweave/blue,
/area/space)
"iZ" = (
/obj/machinery/power/smes/shuttle/precharged{
	dir = 1
	},
/turf/open/floor/mineral/titanium/yellow,
/area/space)
"jA" = (
/turf/open/floor/mineral/titanium/blue,
/area/space)
"kG" = (
/obj/machinery/power/smes/shuttle/precharged{
	dir = 1
	},
/turf/open/floor/carpet/nanoweave/beige,
/area/space)
"kI" = (
/obj/machinery/power/smes/shuttle/precharged{
	dir = 4
	},
/turf/open/floor/mineral/titanium/blue,
/area/space)
"kU" = (
/obj/machinery/power/smes/shuttle/precharged{
	dir = 4
	},
/turf/open/floor/plating,
/area/space)
"lg" = (
/obj/effect/turf_decal/dept/science,
/turf/open/floor/mineral/titanium,
/area/space)
"lA" = (
/obj/machinery/computer/helm{
	dir = 8
	},
/turf/open/floor/mineral/titanium/blue,
/area/space)
"lD" = (
/obj/machinery/computer/helm,
/turf/open/floor/plasteel/freezer,
/area/space)
"lH" = (
/obj/structure/table/wood,
/obj/item/paper_bin,
/obj/item/pen/fountain/solgov,
/obj/item/desk_flag/solgov{
	pixel_x = 10;
	pixel_y = 10
	},
/turf/open/floor/carpet/nanoweave/blue,
/area/space)
"lM" = (
/obj/machinery/computer/autopilot{
	dir = 8
	},
/turf/open/floor/mineral/titanium/yellow,
/area/space)
"mr" = (
/turf/open/floor/carpet/nanoweave/beige,
/area/space)
"nb" = (
/obj/machinery/power/shuttle/engine/fueled/plasma{
	dir = 1
	},
/turf/open/floor/carpet/nanoweave/beige,
/area/space)
"nn" = (
/obj/effect/turf_decal/dept/mining,
/turf/open/floor/mineral/titanium/yellow,
/area/space)
"no" = (
/turf/open/floor/carpet/nanoweave/red,
/area/space)
"nw" = (
/turf/open/floor/mineral/titanium/yellow,
/area/space)
"pP" = (
/turf/open/floor/carpet/nanoweave/blue,
/area/space)
"qo" = (
/turf/open/floor/engine/o2,
/area/space)
"qs" = (
/obj/machinery/power/shuttle/engine/electric{
	dir = 1
	},
/turf/open/floor/carpet/nanoweave/beige,
/area/space)
"qA" = (
/obj/effect/spawner/structure/window/shuttle,
/turf/open/floor/plating,
/area/space)
"qS" = (
/obj/structure/fans/tiny,
/turf/open/floor/mineral/plastitanium,
/area/space)
"qY" = (
/obj/structure/table/wood,
/obj/item/modular_computer/laptop/preset/civilian,
/turf/open/floor/carpet/nanoweave/blue,
/area/space)
"qZ" = (
/obj/machinery/power/smes/shuttle/precharged{
	dir = 4
	},
/turf/open/floor/mineral/plastitanium,
/area/space)
"rp" = (
/turf/closed/wall/mineral/titanium/nodiagonal,
/area/space)
"rt" = (
/obj/machinery/computer/autopilot{
	ship_id = "syndietest"
	},
/turf/open/floor/mineral/titanium/yellow,
/area/space)
"rA" = (
/obj/effect/turf_decal/dept/cargo,
/turf/open/floor/mineral/titanium,
/area/space)
"rU" = (
/obj/machinery/atmospherics/components/unary/shuttle/heater{
	dir = 4
	},
/turf/open/floor/mineral/titanium/blue,
/area/space)
"sa" = (
/obj/machinery/grill,
/turf/open/floor/plasteel/freezer,
/area/space)
"sR" = (
/obj/effect/turf_decal/atmos/oxygen,
/turf/open/floor/engine/o2,
/area/space)
"sU" = (
/obj/structure/fans/tiny,
/obj/machinery/door/poddoor,
/turf/open/floor/mineral/titanium/blue,
/area/space)
"sX" = (
/obj/effect/spawner/structure/window/plasma/reinforced,
/turf/open/floor/plating,
/area/space)
"tK" = (
/turf/open/floor/plating,
/area/space)
"un" = (
/obj/machinery/autolathe,
/turf/open/floor/mineral/titanium/yellow,
/area/space)
"up" = (
/obj/machinery/computer/helm{
	dir = 8
	},
/turf/open/floor/mineral/titanium/yellow,
/area/space)
"ur" = (
/obj/machinery/power/shuttle/engine/electric{
	dir = 4
	},
/turf/open/floor/plating,
/area/space)
"uB" = (
/obj/effect/turf_decal/atmos/mix,
/turf/open/floor/engine/airless,
/area/space)
"uE" = (
/obj/effect/turf_decal/atmos/air,
/turf/open/floor/engine/air,
/area/space)
"uP" = (
/obj/structure/chair/stool/bar,
/turf/open/floor/carpet/nanoweave/beige,
/area/space)
"uU" = (
/obj/machinery/door/airlock/solgov{
	name = "SolGov Mobile Consulate"
	},
/turf/open/floor/mineral/titanium,
/area/space)
"vq" = (
/obj/machinery/mineral/ore_redemption,
/turf/open/floor/mineral/titanium/yellow,
/area/space)
"vK" = (
/obj/effect/turf_decal/number/one,
/turf/open/floor/engine/airless,
/area/space)
"wl" = (
/obj/machinery/power/shuttle/engine/fueled/plasma{
	dir = 4
	},
/turf/open/floor/plating,
/area/space)
"wH" = (
/obj/effect/turf_decal/dept/medical,
/turf/open/floor/mineral/titanium,
/area/space)
"wI" = (
/turf/open/floor/mineral/titanium/white,
/area/space)
"wR" = (
/obj/structure/table/wood,
/obj/machinery/chem_dispenser/drinks/beer{
	dir = 1
	},
/turf/open/floor/carpet/nanoweave/beige,
/area/space)
"xs" = (
/obj/machinery/computer/helm,
/turf/open/floor/mineral/titanium/yellow,
/area/space)
"xA" = (
/obj/effect/turf_decal/dept/security,
/turf/open/floor/mineral/titanium,
/area/space)
"yJ" = (
/obj/effect/turf_decal/atmos/nitrous_oxide,
/turf/open/floor/engine/n2o,
/area/space)
"yV" = (
/obj/machinery/atmospherics/miner/n2o,
/turf/open/floor/engine/n2o,
/area/space)
"zj" = (
/obj/structure/reagent_dispensers/water_cooler,
/obj/item/storage/box/cups,
/turf/open/floor/carpet/nanoweave/blue,
/area/space)
"zA" = (
/obj/machinery/power/shuttle/engine/electric{
	dir = 4
	},
/turf/open/floor/mineral/titanium/blue,
/area/space)
"zG" = (
/obj/structure/chair/comfy/shuttle{
	dir = 1
	},
/turf/open/floor/mineral/plastitanium,
/area/space)
"zO" = (
/turf/open/floor/engine/n2,
/area/space)
"BX" = (
/obj/machinery/atmospherics/miner/oxygen,
/turf/open/floor/engine/o2,
/area/space)
"Cs" = (
/obj/machinery/door/airlock/external/glass,
/obj/structure/fans/tiny,
/turf/open/floor/carpet/nanoweave/red,
/area/space)
"DI" = (
/obj/effect/turf_decal/atmos/plasma,
/turf/open/floor/engine/plasma,
/area/space)
"EF" = (
/obj/effect/turf_decal/dept/bar,
/turf/open/floor/mineral/titanium,
/area/space)
"Fq" = (
/obj/structure/table/wood,
/turf/open/floor/carpet/nanoweave/beige,
/area/space)
"FF" = (
/obj/effect/turf_decal/atmos/carbon_dioxide,
/turf/open/floor/engine/co2,
/area/space)
"GP" = (
/turf/open/floor/vault,
/area/space)
"In" = (
/obj/machinery/computer/helm{
	dir = 4
	},
/turf/open/floor/carpet/nanoweave/blue,
/area/space)
"Ir" = (
/obj/machinery/door/window,
/turf/open/floor/plasteel/freezer,
/area/space)
"IF" = (
/obj/machinery/ore_silo,
/turf/open/floor/vault,
/area/space)
"Je" = (
/obj/structure/chair/comfy/shuttle{
	dir = 4
	},
/turf/open/floor/mineral/plastitanium,
/area/space)
"Jj" = (
/turf/open/floor/engine/air,
/area/space)
"Jp" = (
/obj/effect/turf_decal/number/two{
	dir = 8
	},
/turf/open/floor/mineral/titanium/white,
/area/space)
"Jx" = (
/obj/structure/fans/tiny,
/obj/machinery/door/airlock/solgov{
	name = "SolGov Mobile Consulate"
	},
/turf/open/floor/carpet/nanoweave/blue,
/area/space)
"LF" = (
/obj/effect/turf_decal/number/four{
	dir = 8
	},
/turf/open/floor/mineral/titanium/white,
/area/space)
"LJ" = (
/obj/machinery/power/shuttle/engine/fueled/plasma{
	dir = 1
	},
/turf/open/floor/mineral/titanium/yellow,
/area/space)
"Md" = (
/obj/effect/turf_decal/dept/medical,
/obj/effect/turf_decal/dept/medical,
/turf/open/floor/mineral/titanium/blue,
/area/space)
"Mg" = (
/obj/machinery/door/airlock/vault,
/turf/open/floor/mineral/titanium,
/area/space)
"MN" = (
/obj/machinery/atmospherics/miner/carbon_dioxide,
/turf/open/floor/engine/co2,
/area/space)
"Of" = (
/turf/open/floor/engine/co2,
/area/space)
"OY" = (
/turf/open/floor/mineral/plastitanium,
/area/space)
"Ph" = (
/obj/machinery/atmospherics/components/unary/shuttle/heater{
	dir = 8
	},
/turf/open/floor/carpet/nanoweave/blue,
/area/space)
"PE" = (
/obj/machinery/vending/boozeomat/all_access{
	default_price = 0;
	extra_price = 0
	},
/turf/closed/wall/mineral/titanium/nodiagonal,
/area/space)
"QP" = (
/turf/open/floor/plasteel/freezer,
/area/space)
"QY" = (
/obj/structure/chair/comfy/shuttle,
/turf/open/floor/mineral/plastitanium,
/area/space)
"Rw" = (
/obj/machinery/power/shuttle/engine/electric{
	dir = 8
	},
/turf/open/floor/mineral/titanium,
/area/space)
"SX" = (
/turf/open/floor/engine/airless,
/area/space)
"TX" = (
/obj/structure/table/wood,
/turf/open/floor/plasteel/freezer,
/area/space)
"UF" = (
/obj/machinery/door/window{
	dir = 4
	},
/turf/open/floor/carpet/nanoweave/blue,
/area/space)
"UI" = (
/obj/effect/turf_decal/dept/medical,
/turf/open/floor/mineral/titanium/blue,
/area/space)
"Vs" = (
/obj/effect/turf_decal/dept/hop,
/turf/open/floor/mineral/titanium,
/area/space)
"VT" = (
/obj/machinery/door/airlock/public/glass,
/turf/open/floor/carpet/nanoweave/red,
/area/space)
"Wa" = (
/obj/effect/turf_decal/atmos/nitrogen,
/turf/open/floor/engine/n2,
/area/space)
"Wd" = (
/obj/machinery/atmospherics/components/unary/shuttle/heater{
	dir = 1
	},
/turf/open/floor/mineral/titanium/yellow,
/area/space)
"Wo" = (
/obj/structure/table/wood,
/obj/machinery/chem_dispenser/drinks{
	dir = 1
	},
/turf/open/floor/carpet/nanoweave/beige,
/area/space)
"WK" = (
/obj/machinery/vending/dinnerware,
/turf/open/floor/carpet/nanoweave/beige,
/area/space)
"WO" = (
/obj/structure/chair/comfy/brown{
	dir = 8
	},
/turf/open/floor/carpet/nanoweave/blue,
/area/space)
"Xi" = (
/obj/machinery/computer/autopilot{
	ship_id = "syndietest"
	},
/turf/open/floor/carpet/nanoweave/blue,
/area/space)
"Xr" = (
/turf/open/floor/engine/n2o,
/area/space)
"XA" = (
/obj/machinery/power/shuttle/engine/fueled/plasma{
	dir = 4
	},
/turf/open/floor/mineral/plastitanium,
/area/space)
"XC" = (
/obj/machinery/computer/autopilot{
	dir = 8
	},
/turf/open/floor/mineral/titanium/blue,
/area/space)
"XU" = (
/obj/machinery/power/shuttle/engine/fueled/plasma{
	dir = 4
	},
/turf/open/floor/mineral/titanium/blue,
/area/space)
"YD" = (
/turf/open/floor/mineral/titanium,
/area/space)
"YX" = (
/obj/machinery/atmospherics/components/unary/shuttle/heater{
	dir = 4
	},
/turf/open/floor/mineral/plastitanium,
/area/space)
"Zk" = (
/obj/structure/table,
/turf/open/floor/plasteel/freezer,
/area/space)
"ZH" = (
/obj/structure/table,
/turf/open/floor/mineral/plastitanium,
/area/space)

(1,1,1) = {"
iz
iz
iz
iz
iz
iz
iz
iz
iz
iz
iz
iz
iz
iz
iz
iz
iz
iz
iz
iz
iz
iz
iz
iz
iz
iz
iz
iz
iz
iz
iz
iz
iz
iz
iz
iz
iz
iz
iz
iz
"}
(2,1,1) = {"
iz
iz
iz
iz
iz
iz
iz
iz
iz
iz
iz
iz
iz
iz
iz
iz
iz
iz
iz
iz
iz
iz
iz
iz
iz
iz
iz
iz
iz
iz
iz
iz
iz
iz
iz
iz
iz
iz
iz
iz
"}
(3,1,1) = {"
iz
iz
iz
iz
iz
iz
iz
iz
iz
iz
iz
iz
iz
iz
iz
iz
iz
iz
iz
iz
iz
iz
iz
iz
iz
iz
iz
iz
iz
iz
iz
iz
iz
iz
iz
iz
iz
iz
iz
iz
"}
(4,1,1) = {"
iz
iz
iz
iz
iz
iz
iz
iz
iz
iz
iz
iz
iz
iz
iz
iz
iz
iz
iz
iz
iz
iz
iz
iz
iz
iz
iz
iz
iz
iz
iz
iz
iz
iz
iz
iz
iz
iz
iz
iz
"}
(5,1,1) = {"
iz
iz
iz
iz
iz
iz
iz
iz
iz
iz
iz
iz
iz
iz
iz
iz
iz
iz
iz
iz
iz
iz
iz
iz
iz
iz
iz
iz
iz
iz
iz
iz
iz
iz
iz
iz
iz
iz
iz
iz
"}
(6,1,1) = {"
iz
iz
iz
iz
iz
iz
iz
iz
iz
iz
iz
iz
iz
iz
iz
iz
iz
iz
iz
iz
iz
iz
iz
iz
iz
iz
iz
iz
iz
iz
iz
iz
iz
iz
iz
iz
iz
iz
iz
iz
"}
(7,1,1) = {"
iz
iz
iz
iz
iz
iz
iz
iz
iz
iz
iz
iz
iz
iz
iz
iz
iz
iz
iz
tK
tK
tK
iz
iz
iz
iz
iz
iz
iz
iz
iz
iz
iz
iz
iz
iz
iz
iz
iz
iz
"}
(8,1,1) = {"
iz
iz
iz
iz
iz
iz
iz
iz
iz
iz
iz
iz
iz
iz
iz
iz
iz
iz
iz
tK
YD
tK
tK
tK
tK
iz
iz
iz
iz
iz
iz
iz
iz
iz
iz
iz
iz
iz
iz
iz
"}
(9,1,1) = {"
iz
iz
iz
iz
iz
iz
iz
iz
iz
iz
iz
iz
iz
iz
iz
iz
iz
iz
iz
tK
YD
YD
YD
YD
tK
tK
iz
iz
iz
iz
iz
iz
iz
iz
iz
iz
iz
iz
iz
iz
"}
(10,1,1) = {"
iz
iz
iz
iz
iz
iz
iz
iz
iz
iz
iz
iz
iz
iz
iz
iz
iz
iz
iz
tK
YD
YD
YD
YD
YD
tK
tK
tK
iz
iz
iz
iz
iz
iz
iz
iz
iz
iz
iz
iz
"}
(11,1,1) = {"
iz
iz
iz
iz
iz
iz
iz
iz
iz
iz
iz
iz
iz
iz
iz
iz
iz
iz
iz
tK
YD
YD
YD
YD
YD
YD
YD
tK
tK
tK
tK
iz
iz
iz
iz
iz
iz
iz
iz
iz
"}
(12,1,1) = {"
iz
iz
iz
iz
iz
iz
iz
iz
iz
iz
iz
iz
iz
iz
iz
iz
iz
iz
iz
tK
YD
YD
YD
YD
YD
YD
rp
rp
rp
rp
tK
tK
iz
iz
iz
iz
iz
iz
iz
iz
"}
(13,1,1) = {"
iz
iz
iz
iz
iz
iz
iz
iz
iz
iz
iz
iz
iz
iz
iz
iz
iz
iz
iz
tK
YD
YD
rp
rp
rp
rp
rp
mr
kG
qs
OY
tK
tK
tK
iz
iz
iz
iz
iz
iz
"}
(14,1,1) = {"
iz
iz
iz
iz
iz
iz
iz
iz
iz
iz
iz
iz
iz
iz
iz
iz
iz
iz
tK
tK
rp
rp
rp
PE
mr
mr
Wo
mr
fI
nb
YD
YD
YD
tK
tK
tK
iz
iz
iz
iz
"}
(15,1,1) = {"
iz
iz
iz
iz
iz
iz
iz
iz
iz
iz
iz
iz
iz
iz
iz
iz
iz
iz
tK
rp
rp
cg
hU
rp
dZ
Fq
wR
mr
rp
rp
rp
rp
YD
YD
YD
tK
iz
iz
iz
iz
"}
(16,1,1) = {"
iz
iz
iz
iz
iz
iz
iz
iz
iz
iz
iz
iz
iz
iz
iz
iz
iz
iz
tK
rp
lD
QP
QP
Ir
mr
mr
mr
no
VT
no
no
Cs
YD
YD
YD
tK
iz
iz
iz
iz
"}
(17,1,1) = {"
iz
iz
iz
iz
iz
iz
iz
iz
iz
iz
iz
iz
iz
iz
iz
iz
iz
iz
tK
rp
cH
QP
QP
TX
mr
mr
mr
no
VT
no
no
Cs
YD
YD
tK
tK
iz
iz
iz
iz
"}
(18,1,1) = {"
iz
iz
iz
iz
iz
iz
iz
iz
iz
iz
iz
iz
iz
iz
iz
iz
iz
iz
tK
rp
rp
sa
Zk
rp
uP
uP
uP
mr
rp
rp
rp
rp
YD
YD
tK
iz
iz
iz
iz
iz
"}
(19,1,1) = {"
iz
iz
iz
iz
iz
iz
iz
iz
iz
iz
iz
iz
iz
iz
iz
iz
iz
iz
tK
YD
rp
rp
rp
rp
Fq
Fq
Fq
mr
fI
nb
YD
YD
YD
tK
tK
iz
iz
iz
iz
iz
"}
(20,1,1) = {"
iz
iz
iz
iz
iz
iz
iz
iz
iz
iz
iz
iz
iz
iz
iz
iz
iz
tK
tK
YD
YD
YD
rp
rp
rp
rp
rp
WK
kG
qs
YD
YD
YD
tK
iz
iz
iz
iz
iz
iz
"}
(21,1,1) = {"
iz
iz
iz
iz
iz
iz
iz
iz
iz
iz
iz
iz
iz
tK
tK
tK
tK
tK
YD
YD
YD
YD
YD
YD
YD
OY
rp
rp
rp
rp
YD
YD
tK
tK
iz
iz
iz
iz
iz
iz
"}
(22,1,1) = {"
iz
iz
iz
iz
iz
iz
iz
iz
iz
iz
iz
iz
tK
tK
YD
YD
rp
gx
gx
gx
gx
rp
YD
YD
YD
OY
nw
OY
YD
YD
YD
YD
tK
iz
iz
iz
iz
iz
iz
iz
"}
(23,1,1) = {"
iz
iz
iz
iz
iz
iz
iz
iz
iz
iz
iz
iz
tK
YD
rp
rp
rp
nw
nw
nw
nw
rp
rp
YD
OY
OY
nw
OY
YD
YD
YD
YD
tK
iz
iz
iz
iz
iz
iz
iz
"}
(24,1,1) = {"
iz
iz
iz
iz
iz
iz
iz
iz
iz
iz
iz
iz
tK
rp
rp
nw
nw
nw
nw
nw
nw
iZ
ii
YD
OY
nw
nw
OY
YD
YD
YD
tK
tK
iz
iz
iz
iz
iz
iz
iz
"}
(25,1,1) = {"
iz
iz
iz
iz
iz
iz
iz
iz
iz
iz
iz
iz
tK
rp
rt
nw
nw
nw
nw
nw
nw
Wd
LJ
YD
OY
nw
OY
OY
YD
YD
YD
tK
iz
iz
iz
iz
iz
iz
iz
iz
"}
(26,1,1) = {"
iz
iz
iz
iz
iz
iz
iz
iz
iz
iz
iz
iz
tK
rp
un
nw
nw
nw
vq
nn
nw
Wd
LJ
OY
OY
nw
OY
OY
YD
YD
tK
tK
iz
iz
iz
iz
iz
iz
iz
iz
"}
(27,1,1) = {"
iz
iz
iz
iz
iz
iz
iz
iz
iz
iz
iz
iz
tK
rp
xs
nw
nw
nw
nw
nw
nw
Wd
LJ
OY
nw
nw
OY
YD
YD
tK
tK
iz
iz
iz
iz
iz
iz
iz
iz
iz
"}
(28,1,1) = {"
iz
iz
iz
iz
iz
iz
iz
iz
iz
iz
iz
iz
tK
rp
rp
nw
nw
nw
nw
nw
nw
iZ
ii
OY
nw
OY
OY
YD
YD
tK
iz
iz
iz
iz
iz
iz
iz
iz
iz
iz
"}
(29,1,1) = {"
iz
iz
iz
iz
iz
iz
iz
iz
iz
iz
iz
iz
tK
YD
rp
rp
rp
nw
nw
nw
nw
rp
rp
OY
nw
OY
YD
YD
YD
tK
iz
iz
iz
iz
iz
iz
iz
iz
iz
iz
"}
(30,1,1) = {"
iz
iz
iz
iz
iz
iz
iz
iz
iz
iz
iz
iz
iz
tK
YD
YD
rp
gx
gx
gx
gx
rp
OY
nw
nw
OY
YD
rp
rp
rp
rp
rp
rp
iz
iz
iz
iz
iz
iz
iz
"}
(31,1,1) = {"
iz
iz
iz
iz
iz
iz
iz
iz
iz
iz
iz
iz
iz
tK
tK
YD
YD
YD
YD
YD
YD
YD
OY
nw
OY
OY
rp
rp
YD
YD
YD
YD
rp
rp
iz
iz
iz
iz
iz
iz
"}
(32,1,1) = {"
iz
iz
iz
iz
iz
iz
iz
iz
iz
iz
iz
iz
iz
iz
tK
tK
YD
YD
YD
YD
YD
OY
OY
nw
OY
YD
rp
aM
YD
YD
YD
YD
YD
rp
rp
iz
iz
iz
iz
iz
"}
(33,1,1) = {"
iz
iz
iz
iz
iz
iz
iz
iz
iz
iz
iz
iz
iz
iz
iz
tK
YD
YD
YD
rp
qA
rp
nw
nw
OY
YD
rp
aM
YD
YD
YD
YD
YD
YD
rp
iz
iz
iz
iz
iz
"}
(34,1,1) = {"
iz
iz
iz
iz
iz
iz
iz
iz
iz
iz
iz
iz
iz
iz
iz
tK
YD
YD
rp
rp
In
rp
rp
OY
OY
YD
uU
YD
YD
YD
YD
YD
YD
YD
rp
iz
iz
iz
iz
iz
"}
(35,1,1) = {"
iz
iz
iz
iz
iz
iz
iz
iz
iz
iz
iz
iz
iz
iz
iz
tK
YD
YD
rp
Xi
iU
pP
rp
OY
YD
YD
uU
YD
YD
YD
YD
YD
YD
YD
rp
iz
iz
iz
iz
iz
"}
(36,1,1) = {"
iz
iz
iz
iz
iz
iz
iz
iz
iz
iz
iz
iz
iz
iz
iz
tK
YD
rp
rp
lH
qY
UF
rp
rp
YD
YD
rp
aM
YD
YD
YD
YD
YD
YD
rp
iz
iz
iz
iz
iz
"}
(37,1,1) = {"
iz
iz
iz
iz
iz
iz
iz
iz
iz
iz
iz
iz
iz
iz
iz
tK
YD
rp
zj
pP
WO
pP
an
rp
YD
YD
rp
aM
YD
YD
YD
YD
YD
rp
rp
iz
iz
iz
iz
iz
"}
(38,1,1) = {"
iz
iz
iz
iz
iz
iz
iz
iz
iz
iz
iz
iz
iz
iz
iz
tK
YD
rp
pP
pP
pP
pP
pP
rp
YD
YD
rp
rp
Mg
Mg
rp
rp
rp
rp
iz
iz
iz
iz
iz
iz
"}
(39,1,1) = {"
iz
iz
iz
iz
iz
iz
iz
iz
iz
iz
iz
iz
iz
iz
iz
tK
YD
rp
Ph
WO
pP
WO
cU
rp
YD
YD
rp
GP
GP
GP
GP
rp
rp
iz
iz
iz
iz
iz
iz
iz
"}
(40,1,1) = {"
iz
iz
iz
iz
iz
iz
iz
iz
iz
iz
iz
iz
iz
iz
iz
tK
YD
rp
eH
rp
Jx
rp
Rw
rp
YD
YD
rp
IF
GP
GP
GP
rp
iz
iz
iz
iz
iz
iz
iz
iz
"}
(41,1,1) = {"
iz
iz
iz
iz
iz
iz
iz
iz
iz
iz
iz
iz
iz
iz
iz
tK
YD
YD
OY
OY
nw
OY
YD
YD
YD
YD
rp
rp
GP
GP
rp
rp
iz
iz
iz
iz
iz
iz
iz
iz
"}
(42,1,1) = {"
iz
iz
iz
iz
iz
iz
iz
iz
iz
iz
iz
iz
iz
iz
tK
tK
YD
YD
OY
nw
nw
OY
YD
YD
YD
YD
YD
rp
rp
rp
rp
iz
iz
iz
iz
iz
iz
iz
iz
iz
"}
(43,1,1) = {"
iz
iz
iz
iz
iz
iz
iz
iz
iz
iz
iz
iz
iz
iz
tK
YD
YD
YD
OY
nw
OY
OY
YD
YD
YD
YD
YD
YD
YD
tK
iz
iz
iz
iz
iz
iz
iz
iz
iz
iz
"}
(44,1,1) = {"
iz
iz
iz
iz
iz
iz
iz
iz
iz
iz
iz
iz
iz
tK
tK
YD
YD
OY
OY
nw
OY
rp
iM
sU
sU
sU
rp
YD
YD
tK
iz
iz
iz
iz
iz
iz
iz
iz
iz
iz
"}
(45,1,1) = {"
iz
iz
iz
iz
iz
iz
iz
iz
iz
iz
iz
iz
iz
tK
YD
YD
YD
OY
nw
rp
XU
rp
jA
jA
jA
jA
rp
zA
rp
tK
iz
iz
iz
iz
iz
iz
iz
iz
iz
iz
"}
(46,1,1) = {"
iz
iz
iz
iz
iz
iz
iz
iz
iz
iz
iz
iz
iz
tK
YD
YD
YD
OY
nw
rp
rU
jA
UI
UI
UI
jA
jA
kI
rp
tK
iz
iz
iz
iz
iz
iz
iz
iz
iz
iz
"}
(47,1,1) = {"
iz
iz
iz
iz
iz
iz
iz
iz
iz
iz
iz
iz
tK
YD
YD
YD
YD
OY
nw
rp
jA
jA
UI
UI
UI
jA
jA
jA
rp
tK
iz
iz
iz
iz
iz
iz
iz
iz
iz
iz
"}
(48,1,1) = {"
iz
iz
iz
iz
iz
iz
iz
iz
iz
iz
iz
iz
tK
rp
XA
qS
bS
rp
nw
rp
jA
jA
UI
Md
UI
jA
jA
jA
rp
tK
iz
iz
iz
iz
iz
iz
iz
iz
iz
iz
"}
(49,1,1) = {"
iz
iz
iz
iz
iz
iz
iz
iz
iz
iz
iz
iz
tK
rp
YX
OY
qZ
rp
OY
rp
jA
jA
UI
UI
UI
jA
jA
jA
rp
tK
iz
iz
iz
iz
iz
iz
iz
iz
iz
iz
"}
(50,1,1) = {"
iz
iz
iz
iz
iz
iz
iz
iz
iz
iz
iz
tK
tK
rp
QY
OY
zG
rp
OY
rp
rp
rp
jA
UI
UI
jA
rp
rp
rp
tK
iz
iz
iz
iz
iz
iz
iz
iz
iz
iz
"}
(51,1,1) = {"
iz
iz
iz
iz
iz
iz
iz
iz
iz
iz
iz
tK
YD
rp
QY
OY
zG
rp
OY
YD
rp
rp
jA
jA
jA
jA
rp
rp
YD
tK
iz
iz
iz
iz
iz
iz
iz
iz
iz
iz
"}
(52,1,1) = {"
iz
iz
iz
iz
iz
iz
iz
iz
iz
iz
iz
tK
YD
rp
QY
OY
zG
rp
YD
YD
YD
rp
rp
jA
jA
rp
rp
YD
YD
tK
iz
iz
iz
iz
iz
iz
iz
iz
iz
iz
"}
(53,1,1) = {"
iz
iz
iz
iz
iz
iz
iz
iz
iz
iz
tK
tK
YD
rp
gg
Je
ZH
rp
YD
YD
YD
rp
jA
jA
jA
jA
rp
YD
YD
tK
iz
iz
iz
iz
iz
iz
iz
iz
iz
iz
"}
(54,1,1) = {"
iz
iz
iz
iz
iz
iz
iz
iz
iz
iz
tK
YD
YD
rp
rp
gR
rp
rp
YD
YD
YD
rp
jA
jA
jA
jA
rp
YD
YD
tK
iz
iz
iz
iz
iz
iz
iz
iz
iz
iz
"}
(55,1,1) = {"
iz
iz
iz
iz
iz
iz
iz
iz
iz
iz
tK
YD
YD
YD
rp
rp
rp
OY
YD
YD
YD
rp
rp
XC
lA
rp
rp
YD
YD
tK
iz
iz
iz
iz
iz
iz
iz
iz
iz
iz
"}
(56,1,1) = {"
iz
iz
iz
iz
iz
iz
iz
iz
iz
tK
tK
YD
YD
OY
OY
nw
OY
YD
YD
YD
YD
YD
rp
rp
rp
rp
YD
YD
YD
tK
iz
iz
iz
iz
iz
iz
iz
iz
iz
iz
"}
(57,1,1) = {"
iz
iz
iz
iz
iz
iz
iz
iz
iz
tK
YD
YD
YD
OY
nw
nw
OY
YD
YD
YD
YD
YD
YD
YD
YD
YD
YD
YD
YD
tK
iz
iz
iz
iz
iz
iz
iz
iz
iz
iz
"}
(58,1,1) = {"
iz
iz
iz
iz
iz
iz
iz
iz
iz
tK
YD
YD
YD
OY
nw
OY
OY
rp
ur
wl
rp
tK
tK
tK
tK
rp
wl
ur
rp
tK
iz
iz
iz
iz
iz
iz
iz
iz
iz
iz
"}
(59,1,1) = {"
iz
iz
iz
iz
iz
iz
iz
iz
iz
tK
YD
YD
OY
OY
nw
OY
YD
rp
kU
ib
rp
tK
tK
tK
tK
rp
ib
kU
rp
tK
iz
iz
iz
iz
iz
iz
iz
iz
iz
iz
"}
(60,1,1) = {"
iz
iz
iz
iz
iz
iz
iz
iz
tK
tK
YD
YD
OY
nw
nw
OY
YD
rp
tK
tK
tK
tK
tK
tK
tK
tK
tK
tK
rp
tK
iz
iz
iz
iz
iz
iz
iz
iz
iz
iz
"}
(61,1,1) = {"
iz
iz
iz
iz
iz
iz
iz
iz
tK
YD
YD
YD
OY
nw
OY
OY
YD
rp
rp
rp
rp
gx
gx
gx
gx
rp
rp
rp
rp
tK
tK
iz
iz
iz
iz
iz
iz
iz
iz
iz
"}
(62,1,1) = {"
iz
iz
iz
iz
iz
iz
iz
iz
tK
YD
YD
OY
OY
nw
OY
YD
YD
rp
Wa
zO
sX
nw
nw
nw
nw
sX
Xr
yJ
rp
YD
tK
tK
iz
iz
iz
iz
iz
iz
iz
iz
"}
(63,1,1) = {"
iz
iz
iz
iz
iz
iz
iz
iz
YD
YD
YD
OY
nw
nw
OY
YD
YD
rp
cy
zO
sX
nw
nw
nw
nw
sX
Xr
yV
rp
YD
YD
tK
tK
iz
iz
iz
iz
iz
iz
iz
"}
(64,1,1) = {"
iz
iz
iz
iz
iz
iz
iz
iz
iz
YD
YD
OY
nw
OY
OY
YD
YD
rp
rp
rp
rp
nw
nw
nw
nw
rp
rp
rp
rp
YD
YD
YD
tK
tK
iz
iz
iz
iz
iz
iz
"}
(65,1,1) = {"
iz
iz
iz
iz
iz
iz
iz
iz
iz
iz
YD
OY
nw
OY
YD
YD
YD
rp
sR
qo
sX
nw
nw
nw
nw
sX
Of
FF
rp
YD
YD
YD
YD
tK
tK
iz
iz
iz
iz
iz
"}
(66,1,1) = {"
iz
iz
iz
iz
iz
iz
iz
iz
iz
iz
iz
OY
nw
OY
YD
YD
YD
rp
BX
qo
sX
nw
nw
nw
nw
sX
Of
MN
rp
YD
YD
YD
YD
YD
tK
iz
iz
iz
iz
iz
"}
(67,1,1) = {"
iz
iz
iz
iz
iz
iz
iz
iz
iz
iz
iz
iz
nw
OY
YD
YD
YD
rp
rp
rp
rp
nw
nw
nw
nw
rp
rp
rp
rp
YD
YD
YD
YD
YD
tK
iz
iz
iz
iz
iz
"}
(68,1,1) = {"
iz
iz
iz
iz
iz
iz
iz
iz
iz
iz
iz
iz
iz
YD
YD
YD
YD
rp
uE
Jj
sX
nw
nw
nw
nw
sX
dC
DI
rp
YD
YD
YD
YD
YD
tK
iz
iz
iz
iz
iz
"}
(69,1,1) = {"
iz
iz
iz
iz
iz
iz
iz
iz
iz
iz
iz
iz
iz
iz
YD
YD
YD
rp
Jj
Jj
sX
nw
nw
nw
nw
sX
dC
dj
rp
YD
YD
YD
YD
tK
tK
iz
iz
iz
iz
iz
"}
(70,1,1) = {"
iz
iz
iz
iz
iz
iz
iz
iz
iz
iz
iz
iz
iz
iz
iz
YD
tK
rp
rp
rp
rp
nw
nw
nw
nw
rp
rp
rp
rp
YD
YD
YD
tK
tK
iz
iz
iz
iz
iz
iz
"}
(71,1,1) = {"
iz
iz
iz
iz
iz
iz
iz
iz
iz
iz
iz
iz
iz
iz
iz
iz
tK
rp
uB
SX
sX
nw
nw
nw
nw
sX
SX
uB
rp
YD
YD
tK
tK
iz
iz
iz
iz
iz
iz
iz
"}
(72,1,1) = {"
iz
iz
iz
iz
iz
iz
iz
iz
iz
iz
iz
iz
iz
iz
iz
iz
tK
rp
vK
SX
sX
nw
nw
nw
nw
sX
SX
cR
rp
tK
tK
tK
iz
iz
iz
iz
iz
iz
iz
iz
"}
(73,1,1) = {"
iz
iz
iz
iz
iz
iz
iz
iz
iz
iz
iz
iz
iz
iz
iz
iz
tK
rp
rp
rp
rp
nw
nw
nw
nw
rp
rp
rp
rp
tK
iz
iz
iz
iz
iz
iz
iz
iz
iz
iz
"}
(74,1,1) = {"
iz
iz
iz
iz
iz
iz
iz
iz
iz
iz
iz
iz
iz
iz
iz
iz
tK
YD
rp
rp
nw
nw
nw
nw
nw
nw
rp
rp
tK
tK
iz
iz
iz
iz
iz
iz
iz
iz
iz
iz
"}
(75,1,1) = {"
iz
iz
iz
iz
iz
EF
cq
iz
iz
iz
iz
iz
iz
iz
iz
iz
tK
YD
YD
rp
rp
nw
nw
nw
nw
rp
rp
YD
tK
iz
iz
iz
iz
iz
iz
iz
iz
iz
iz
iz
"}
(76,1,1) = {"
iz
iz
iz
iz
iz
rA
lg
iz
iz
iz
iz
iz
iz
iz
iz
iz
tK
tK
YD
wI
rp
rp
lM
up
rp
rp
YD
tK
tK
iz
iz
iz
iz
iz
iz
iz
iz
iz
iz
iz
"}
(77,1,1) = {"
iz
iz
iz
iz
iz
Vs
xA
iz
iz
iz
iz
iz
iz
iz
iz
iz
iz
tK
YD
wI
wI
rp
rp
rp
rp
YD
YD
tK
iz
iz
iz
iz
iz
iz
iz
iz
iz
iz
iz
iz
"}
(78,1,1) = {"
iz
iz
iz
iz
iz
wH
YD
iz
iz
iz
iz
iz
iz
iz
iz
iz
iz
tK
YD
YD
wI
YD
YD
YD
wI
YD
YD
tK
iz
iz
iz
iz
iz
iz
iz
iz
iz
iz
iz
iz
"}
(79,1,1) = {"
iz
iz
iz
iz
iz
iz
iz
iz
iz
iz
iz
iz
iz
iz
iz
iz
iz
tK
YD
YD
wI
YD
YD
YD
wI
YD
YD
tK
iz
iz
iz
iz
iz
iz
iz
iz
iz
iz
iz
iz
"}
(80,1,1) = {"
iz
iz
iz
iz
iz
iz
iz
iz
iz
iz
iz
iz
iz
iz
iz
iz
iz
tK
tK
YD
wI
YD
YD
YD
wI
YD
tK
tK
iz
iz
iz
iz
iz
iz
iz
iz
iz
iz
iz
iz
"}
(81,1,1) = {"
iz
iz
iz
iz
iz
iz
iz
iz
iz
iz
iz
iz
iz
iz
iz
iz
iz
iz
tK
YD
wI
YD
YD
YD
wI
YD
tK
iz
iz
iz
iz
iz
iz
iz
iz
iz
iz
iz
iz
iz
"}
(82,1,1) = {"
iz
iz
iz
iz
iz
iz
iz
iz
iz
iz
iz
iz
iz
iz
iz
iz
iz
iz
tK
YD
wI
wI
YD
wI
wI
YD
tK
iz
iz
iz
iz
iz
iz
iz
iz
iz
iz
iz
iz
iz
"}
(83,1,1) = {"
iz
iz
iz
iz
iz
iz
iz
iz
iz
iz
iz
iz
iz
iz
iz
iz
iz
iz
tK
YD
YD
wI
YD
wI
YD
YD
tK
iz
iz
iz
iz
iz
iz
iz
iz
iz
iz
iz
iz
iz
"}
(84,1,1) = {"
iz
iz
iz
iz
iz
iz
iz
iz
iz
iz
iz
iz
iz
iz
iz
iz
iz
iz
tK
YD
YD
wI
YD
wI
YD
YD
tK
iz
iz
iz
iz
iz
iz
iz
iz
iz
iz
iz
iz
iz
"}
(85,1,1) = {"
iz
iz
iz
iz
iz
iz
iz
iz
iz
iz
iz
iz
iz
iz
iz
iz
iz
iz
tK
tK
YD
wI
YD
wI
YD
tK
tK
iz
iz
iz
iz
iz
iz
iz
iz
iz
iz
iz
iz
iz
"}
(86,1,1) = {"
iz
iz
iz
iz
iz
iz
iz
iz
iz
iz
iz
iz
iz
iz
iz
iz
iz
iz
iz
tK
YD
wI
YD
wI
YD
tK
iz
iz
iz
iz
iz
iz
iz
iz
iz
iz
iz
iz
iz
iz
"}
(87,1,1) = {"
iz
iz
iz
iz
iz
iz
iz
iz
iz
iz
iz
iz
iz
iz
iz
iz
iz
iz
iz
tK
YD
wI
YD
wI
YD
tK
iz
iz
iz
iz
iz
iz
iz
iz
iz
iz
iz
iz
iz
iz
"}
(88,1,1) = {"
iz
iz
iz
iz
iz
iz
iz
iz
iz
iz
iz
iz
iz
iz
iz
iz
iz
iz
iz
tK
YD
wI
YD
wI
YD
tK
iz
iz
iz
iz
iz
iz
iz
iz
iz
iz
iz
iz
iz
iz
"}
(89,1,1) = {"
iz
iz
iz
iz
iz
iz
iz
iz
iz
iz
iz
iz
iz
iz
iz
iz
iz
iz
iz
tK
YD
LF
YD
Jp
YD
tK
iz
iz
iz
iz
iz
iz
iz
iz
iz
iz
iz
iz
iz
iz
"}
(90,1,1) = {"
iz
iz
iz
iz
iz
iz
iz
iz
iz
iz
iz
iz
iz
iz
iz
iz
iz
iz
iz
tK
YD
wI
YD
wI
YD
tK
iz
iz
iz
iz
iz
iz
iz
iz
iz
iz
iz
iz
iz
iz
"}
(91,1,1) = {"
iz
iz
iz
iz
iz
iz
iz
iz
iz
iz
iz
iz
iz
iz
iz
iz
iz
iz
iz
tK
YD
wI
YD
wI
YD
tK
iz
iz
iz
iz
iz
iz
iz
iz
iz
iz
iz
iz
iz
iz
"}
(92,1,1) = {"
iz
iz
iz
iz
iz
iz
iz
iz
iz
iz
iz
iz
iz
iz
iz
iz
iz
iz
iz
iz
iz
iz
iz
iz
iz
iz
iz
iz
iz
iz
iz
iz
iz
iz
iz
iz
iz
iz
iz
iz
"}
(93,1,1) = {"
iz
iz
iz
iz
iz
iz
iz
iz
iz
iz
iz
iz
iz
iz
iz
iz
iz
iz
iz
iz
iz
iz
iz
iz
iz
iz
iz
iz
iz
iz
iz
iz
iz
iz
iz
iz
iz
iz
iz
iz
"}
(94,1,1) = {"
iz
iz
iz
iz
iz
iz
iz
iz
iz
iz
iz
iz
iz
iz
iz
iz
iz
iz
iz
iz
iz
iz
iz
iz
iz
iz
iz
iz
iz
iz
iz
iz
iz
iz
iz
iz
iz
iz
iz
iz
"}
(95,1,1) = {"
iz
iz
iz
iz
iz
iz
iz
iz
iz
iz
iz
iz
iz
iz
iz
iz
iz
iz
iz
iz
iz
iz
iz
iz
iz
iz
iz
iz
iz
iz
iz
iz
iz
iz
iz
iz
iz
iz
iz
iz
"}
(96,1,1) = {"
iz
iz
iz
iz
iz
iz
iz
iz
iz
iz
iz
iz
iz
iz
iz
iz
iz
iz
iz
iz
iz
iz
iz
iz
iz
iz
iz
iz
iz
iz
iz
iz
iz
iz
iz
iz
iz
iz
iz
iz
"}
(97,1,1) = {"
iz
iz
iz
iz
iz
iz
iz
iz
iz
iz
iz
iz
iz
iz
iz
iz
iz
iz
iz
iz
iz
iz
iz
iz
iz
iz
iz
iz
iz
iz
iz
iz
iz
iz
iz
iz
iz
iz
iz
iz
"}
(98,1,1) = {"
iz
iz
iz
iz
iz
iz
iz
iz
iz
iz
iz
iz
iz
iz
iz
iz
iz
iz
iz
iz
iz
iz
iz
iz
iz
iz
iz
iz
iz
iz
iz
iz
iz
iz
iz
iz
iz
iz
iz
iz
"}
(99,1,1) = {"
iz
iz
iz
iz
iz
iz
iz
iz
iz
iz
iz
iz
iz
iz
iz
iz
iz
iz
iz
iz
iz
iz
iz
iz
iz
iz
iz
iz
iz
iz
iz
iz
iz
iz
iz
iz
iz
iz
iz
iz
"}
(100,1,1) = {"
iz
iz
iz
iz
iz
iz
iz
iz
iz
iz
iz
iz
iz
iz
iz
iz
iz
iz
iz
iz
iz
iz
iz
iz
iz
iz
iz
iz
iz
iz
iz
iz
iz
iz
iz
iz
iz
iz
iz
iz
"}
(101,1,1) = {"
iz
iz
iz
iz
iz
iz
iz
iz
iz
iz
iz
iz
iz
iz
iz
iz
iz
iz
iz
iz
iz
iz
iz
iz
iz
iz
iz
iz
iz
iz
iz
iz
iz
iz
iz
iz
iz
iz
iz
iz
"}
