//MAP CONVERTED BY dmm2tgm.py THIS HEADER COMMENT PREVENTS RECONVERSION, DO NOT REMOVE
"a" = (
/turf/closed/wall/mineral/titanium,
/area/space)
"e" = (
/obj/structure/chair/handrail,
/turf/open/floor/plasteel/mono/white,
/area/space)
"i" = (
/obj/structure/chair/handrail{
	dir = 1
	},
/turf/open/floor/plasteel/mono/white,
/area/space)
"o" = (
/obj/machinery/power/smes/shuttle/precharged{
	dir = 1
	},
/obj/structure/platform/ship_two{
	dir = 5
	},
/obj/machinery/door/poddoor/shutters{
	dir = 4;
	id = "bam2"
	},
/turf/open/floor/engine/hull/reinforced,
/area/space)
"q" = (
/obj/structure/chair/comfy/shuttle{
	dir = 8;
	name = "grav couch";
	pixel_x = -8;
	pixel_y = 3
	},
/obj/structure/railing/thin/corner{
	dir = 8
	},
/obj/structure/railing/thin/corner{
	dir = 1
	},
/obj/machinery/door/window/brigdoor/eastleft,
/turf/open/floor/plasteel/patterned/brushed,
/area/space)
"v" = (
/obj/machinery/power/shuttle/engine/electric{
	dir = 4
	},
/obj/structure/window/reinforced{
	dir = 1
	},
/obj/structure/window/reinforced,
/obj/structure/cable{
	icon_state = "0-4"
	},
/turf/open/floor/engine/hull/reinforced,
/area/space)
"A" = (
/turf/open/space/basic,
/area/space)
"C" = (
/obj/machinery/door/poddoor/shutters{
	dir = 4;
	id = "bam"
	},
/turf/open/floor/plating,
/area/space)
"E" = (
/obj/machinery/power/terminal,
/obj/machinery/power/terminal{
	dir = 1
	},
/obj/effect/turf_decal/industrial/warning/fulltile{
	color = "#FFFFFF"
	},
/obj/machinery/computer/helm{
	dir = 4;
	pixel_x = -8
	},
/obj/structure/railing/thin,
/obj/structure/railing/thin{
	dir = 1
	},
/turf/open/floor/plasteel/tech,
/area/space)
"I" = (
/obj/effect/turf_decal/trimline/opaque/cybersunteal/arrow_cw,
/obj/effect/turf_decal/trimline/opaque/cybersunteal/arrow_ccw{
	dir = 1
	},
/turf/open/floor/plasteel/mono/white,
/area/space)
"L" = (
/obj/machinery/power/smes/shuttle/precharged{
	dir = 2
	},
/obj/structure/platform/ship_two{
	dir = 6
	},
/obj/machinery/door/poddoor/shutters{
	dir = 4;
	id = "bam2"
	},
/turf/open/floor/engine/hull/reinforced,
/area/space)
"P" = (
/turf/open/floor/plasteel/mono/white,
/area/space)
"R" = (
/obj/machinery/stasis{
	dir = 1
	},
/obj/structure/platform/ship_two{
	dir = 8
	},
/obj/structure/curtain/cloth{
	dir = 4
	},
/obj/effect/turf_decal/trimline/opaque/cybersunteal/end{
	dir = 8
	},
/turf/open/floor/plasteel/mono/white,
/area/space)
"U" = (
/turf/open/floor/plasteel/stairs{
	dir = 8;
	icon = 'icons/obj/stairs.dmi'
	},
/area/space)
"X" = (
/obj/structure/railing/thin{
	dir = 8
	},
/obj/structure/window/plasma/reinforced{
	dir = 4
	},
/obj/structure/table/reinforced,
/turf/open/floor/plasteel/patterned/brushed,
/area/space)

(1,1,1) = {"
A
v
a
v
A
"}
(2,1,1) = {"
a
L
E
o
a
"}
(3,1,1) = {"
a
X
q
X
a
"}
(4,1,1) = {"
a
R
U
R
a
"}
(5,1,1) = {"
a
I
P
I
a
"}
(6,1,1) = {"
a
a
e
i
a
"}
(7,1,1) = {"
A
a
C
C
a
"}
