//MAP CONVERTED BY dmm2tgm.py THIS HEADER COMMENT PREVENTS RECONVERSION, DO NOT REMOVE
"a" = (
/obj/effect/turf_decal/techfloor{
	dir = 6
	},
/obj/structure/chair/handrail{
	dir = 1
	},
/obj/structure/cable{
	icon_state = "4-8"
	},
/turf/open/floor/plasteel/tech/grid,
/area/ship/bridge)
"b" = (
/obj/effect/turf_decal/techfloor,
/obj/effect/turf_decal/steeldecal/steel_decals_central4{
	dir = 1
	},
/obj/structure/closet/emcloset/wall/directional/south,
/obj/item/clothing/suit/space/orange,
/obj/item/clothing/suit/space/orange{
	pixel_x = 4
	},
/obj/item/clothing/head/helmet/space/fragile,
/obj/item/clothing/head/helmet/space/fragile{
	pixel_x = 4
	},
/obj/structure/cable{
	icon_state = "4-8"
	},
/turf/open/floor/plasteel/tech/grid,
/area/ship/bridge)
"c" = (
/obj/structure/catwalk/over/plated_catwalk/dark,
/obj/structure/cable{
	icon_state = "1-2"
	},
/obj/structure/cable{
	icon_state = "2-4"
	},
/obj/machinery/atmospherics/pipe/simple/yellow/hidden{
	dir = 1
	},
/obj/structure/cable{
	icon_state = "2-8"
	},
/turf/open/floor/plating,
/area/ship/bridge)
"d" = (
/obj/machinery/door/poddoor/shutters/preopen{
	dir = 4;
	id = "midwich_blast"
	},
/obj/machinery/power/shieldwallgen/atmos/roundstart{
	id = "midwich_field"
	},
/obj/effect/turf_decal/techfloor{
	dir = 1
	},
/obj/machinery/door/firedoor/border_only{
	dir = 4
	},
/obj/machinery/door/firedoor/border_only{
	dir = 8
	},
/obj/effect/turf_decal/industrial/traffic{
	dir = 8
	},
/obj/effect/turf_decal/industrial/traffic{
	dir = 4
	},
/obj/effect/turf_decal/steeldecal/steel_decals_central3{
	dir = 1
	},
/obj/structure/cable{
	icon_state = "0-4"
	},
/turf/open/floor/plasteel/tech/grid,
/area/ship/bridge)
"e" = (
/obj/effect/turf_decal/industrial/outline/red,
/turf/open/floor/plasteel/tech,
/area/ship/bridge)
"f" = (
/obj/effect/turf_decal/techfloor,
/obj/effect/turf_decal/steeldecal/steel_decals_central4{
	dir = 1
	},
/obj/effect/turf_decal/techfloor/hole,
/obj/effect/turf_decal/spline/fancy/opaque/black{
	dir = 8
	},
/obj/effect/turf_decal/techfloor/corner{
	dir = 8
	},
/turf/open/floor/plasteel/tech/grid,
/area/ship/bridge)
"g" = (
/obj/structure/grille,
/obj/structure/window/plasma/reinforced/plastitanium,
/obj/machinery/door/poddoor/shutters{
	id = "midwich_blast3"
	},
/turf/open/floor/plating,
/area/ship/bridge)
"h" = (
/obj/structure/cable{
	icon_state = "0-4"
	},
/obj/structure/window/reinforced/survival_pod{
	dir = 4
	},
/obj/effect/turf_decal/industrial/warning{
	dir = 8
	},
/obj/machinery/door/poddoor/shutters/preopen{
	dir = 4;
	id = "midwich_blast4"
	},
/obj/machinery/power/smes/shuttle/precharged{
	dir = 8
	},
/turf/open/floor/plasteel/tech/grid,
/area/ship/bridge)
"i" = (
/obj/effect/turf_decal/techfloor,
/obj/machinery/button/shieldwallgen{
	dir = 1;
	pixel_y = -18;
	pixel_x = 9;
	id = "midwich_field"
	},
/obj/machinery/button/door{
	dir = 1;
	pixel_y = -20;
	id = "midwich_blast";
	name = "dropship bay door control"
	},
/obj/structure/chair/handrail{
	dir = 1
	},
/obj/structure/cable{
	icon_state = "4-8"
	},
/obj/structure/cable{
	icon_state = "1-4"
	},
/turf/open/floor/plasteel/tech/grid,
/area/ship/bridge)
"j" = (
/obj/structure/grille,
/obj/structure/window/plasma/reinforced/plastitanium,
/obj/structure/cable{
	icon_state = "1-4"
	},
/obj/machinery/atmospherics/pipe/simple/yellow/hidden{
	dir = 1
	},
/obj/machinery/door/poddoor{
	id = "midwich_blast3"
	},
/turf/open/floor/plating,
/area/ship/bridge)
"l" = (
/obj/effect/turf_decal/techfloor{
	dir = 1
	},
/obj/effect/turf_decal/steeldecal/steel_decals_central4,
/turf/open/floor/plasteel/tech/grid,
/area/ship/bridge)
"m" = (
/obj/machinery/door/firedoor/border_only{
	dir = 8
	},
/obj/machinery/door/firedoor/border_only{
	dir = 4
	},
/obj/machinery/door/airlock/command/glass{
	dir = 4;
	name = "Cockpit"
	},
/turf/open/floor/plasteel/tech/grid,
/area/ship/bridge)
"o" = (
/obj/structure/platform/ship{
	dir = 1;
	layer = 2.6
	},
/obj/structure/crate_shelf,
/obj/effect/turf_decal/box,
/obj/structure/closet/crate/secure/exo{
	name = "away shuttle supply crate"
	},
/obj/item/pickaxe,
/obj/item/pickaxe,
/obj/item/storage/box/flares,
/obj/item/storage/box/flares,
/obj/item/radio/weather_monitor,
/obj/item/radio/weather_monitor,
/obj/item/grenade/c4,
/obj/item/grenade/c4,
/turf/open/floor/plasteel/dark,
/area/ship/bridge)
"p" = (
/obj/effect/turf_decal/techfloor{
	dir = 1
	},
/obj/effect/turf_decal/steeldecal/steel_decals_central4,
/obj/effect/turf_decal/techfloor/hole/right{
	dir = 1
	},
/obj/effect/turf_decal/spline/fancy/opaque/black{
	dir = 8
	},
/obj/effect/turf_decal/techfloor/corner{
	dir = 1
	},
/obj/docking_port/mobile{
	dir = 8;
	name = "June-class Dropship";
	preferred_direction = 8;
	port_direction = 2
	},
/turf/open/floor/plasteel/tech/grid,
/area/ship/bridge)
"q" = (
/obj/effect/turf_decal/borderfloorblack{
	dir = 4
	},
/obj/machinery/light/small/directional/north{
	pixel_x = -12
	},
/obj/item/radio/intercom/directional/south{
	pixel_x = 5
	},
/obj/machinery/button/door{
	pixel_y = -20;
	id = "midwich_blast3";
	name = "Exterior Window Control";
	dir = 1;
	pixel_x = -9
	},
/obj/item/radio/intercom/wideband/directional/north,
/obj/structure/chair/comfy/shuttle{
	dir = 8
	},
/turf/open/floor/plasteel/tech,
/area/ship/bridge)
"r" = (
/turf/template_noop,
/area/space)
"s" = (
/obj/structure/catwalk/over/plated_catwalk/dark,
/obj/machinery/atmospherics/pipe/simple/yellow/hidden{
	dir = 6
	},
/obj/structure/cable{
	icon_state = "1-2"
	},
/turf/open/floor/plating,
/area/ship/bridge)
"t" = (
/obj/effect/turf_decal/techfloor{
	dir = 5
	},
/turf/open/floor/plasteel/tech/grid,
/area/ship/bridge)
"u" = (
/obj/machinery/door/poddoor/shutters/preopen{
	dir = 4;
	id = "midwich_blast"
	},
/obj/machinery/power/shieldwallgen/atmos/roundstart{
	dir = 1;
	id = "midwich_field"
	},
/obj/effect/turf_decal/techfloor,
/obj/machinery/door/firedoor/border_only{
	dir = 4
	},
/obj/machinery/door/firedoor/border_only{
	dir = 8
	},
/obj/effect/turf_decal/industrial/traffic{
	dir = 8
	},
/obj/effect/turf_decal/industrial/traffic{
	dir = 4
	},
/obj/effect/turf_decal/steeldecal/steel_decals_central3,
/obj/structure/cable{
	icon_state = "0-4"
	},
/turf/open/floor/plasteel/tech/grid,
/area/ship/bridge)
"v" = (
/obj/effect/turf_decal/techfloor,
/obj/machinery/light/directional/south,
/obj/structure/chair/handrail{
	dir = 1
	},
/obj/structure/cable{
	icon_state = "4-8"
	},
/turf/open/floor/plasteel/tech/grid,
/area/ship/bridge)
"w" = (
/obj/structure/grille,
/obj/structure/window/plasma/reinforced/plastitanium,
/obj/structure/cable{
	icon_state = "2-8"
	},
/obj/machinery/door/poddoor{
	id = "midwich_blast3"
	},
/turf/open/floor/plating,
/area/ship/bridge)
"x" = (
/obj/machinery/power/terminal{
	dir = 4
	},
/obj/machinery/door/poddoor/shutters/preopen{
	id = "midwich_blast4"
	},
/obj/structure/cable/yellow{
	icon_state = "0-2"
	},
/obj/machinery/atmospherics/pipe/simple/yellow/hidden{
	dir = 9
	},
/obj/structure/catwalk/over/plated_catwalk/dark,
/obj/effect/turf_decal/techfloor/orange,
/turf/open/floor/plating,
/area/ship/bridge)
"y" = (
/obj/machinery/power/shuttle/engine/electric{
	dir = 8
	},
/obj/structure/cable{
	icon_state = "0-8"
	},
/turf/open/floor/plating,
/area/ship/bridge)
"z" = (
/obj/structure/window/reinforced/survival_pod{
	dir = 4
	},
/obj/effect/turf_decal/industrial/warning{
	dir = 8
	},
/obj/machinery/door/poddoor/shutters/preopen{
	dir = 4;
	id = "midwich_blast4"
	},
/obj/machinery/atmospherics/components/unary/shuttle/fire_heater{
	dir = 8
	},
/turf/open/floor/plasteel/tech/grid,
/area/ship/bridge)
"A" = (
/obj/effect/turf_decal/industrial/traffic/fulltile,
/obj/machinery/door/poddoor/shutters{
	dir = 4;
	id = "midwich_blast2"
	},
/obj/machinery/door/firedoor/border_only{
	dir = 8
	},
/obj/machinery/door/firedoor/border_only{
	dir = 4
	},
/obj/structure/cable{
	icon_state = "4-8"
	},
/turf/open/floor/plasteel/dark,
/area/ship/bridge)
"B" = (
/obj/structure/catwalk/over/plated_catwalk/dark,
/obj/structure/cable{
	icon_state = "1-2"
	},
/obj/structure/cable{
	icon_state = "1-4"
	},
/obj/structure/chair/handrail{
	dir = 4
	},
/obj/machinery/light/small/directional/west,
/turf/open/floor/plating,
/area/ship/bridge)
"C" = (
/obj/machinery/power/smes/engineering,
/obj/machinery/door/poddoor/shutters/preopen{
	id = "midwich_blast4"
	},
/obj/structure/cable,
/obj/effect/turf_decal/techfloor/orange,
/turf/open/floor/plasteel/tech/grid,
/area/ship/bridge)
"E" = (
/obj/structure/railing,
/obj/structure/railing{
	dir = 1;
	pixel_y = 7
	},
/obj/structure/cable{
	icon_state = "4-8"
	},
/turf/open/floor/plasteel/stairs/old{
	dir = 8
	},
/area/ship/bridge)
"G" = (
/obj/machinery/power/terminal{
	dir = 4
	},
/obj/structure/cable{
	icon_state = "0-8"
	},
/obj/structure/catwalk/over/plated_catwalk/dark,
/turf/open/floor/plating/airless,
/area/ship/bridge)
"H" = (
/obj/structure/railing,
/obj/structure/railing/corner{
	dir = 4;
	pixel_y = 7
	},
/obj/structure/cable{
	icon_state = "0-4"
	},
/obj/machinery/power/apc/auto_name/directional/north,
/obj/machinery/light_switch{
	pixel_x = -12;
	pixel_y = 22
	},
/obj/effect/turf_decal/steeldecal/steel_decals_central7{
	dir = 1
	},
/turf/open/floor/plasteel/dark,
/area/ship/bridge)
"I" = (
/obj/machinery/door/airlock/hatch{
	dir = 4
	},
/obj/structure/cable{
	icon_state = "4-8"
	},
/obj/machinery/door/firedoor/border_only{
	dir = 4
	},
/obj/machinery/door/firedoor/border_only{
	dir = 8
	},
/turf/open/floor/plasteel/tech/grid,
/area/ship/bridge)
"J" = (
/obj/machinery/door/poddoor/shutters/preopen{
	dir = 4;
	id = "midwich_blast4"
	},
/obj/structure/cable{
	icon_state = "0-4"
	},
/obj/structure/window/reinforced/survival_pod{
	dir = 4
	},
/obj/effect/turf_decal/industrial/warning{
	dir = 8
	},
/obj/machinery/power/smes/shuttle/precharged{
	dir = 8
	},
/turf/open/floor/plasteel/tech/grid,
/area/ship/bridge)
"K" = (
/obj/structure/railing/corner,
/obj/machinery/light/directional/north,
/obj/machinery/holopad{
	pixel_x = 1
	},
/obj/effect/turf_decal/box/white,
/turf/open/floor/plasteel/dark,
/area/ship/bridge)
"L" = (
/turf/closed/wall/mineral/plastitanium/nodiagonal,
/area/ship/bridge)
"M" = (
/obj/machinery/atmospherics/components/binary/pump{
	dir = 4;
	name = "engine fuel pump"
	},
/obj/effect/turf_decal/industrial/outline/orange,
/obj/effect/turf_decal/industrial/shutoff{
	dir = 8
	},
/turf/open/floor/plasteel/tech,
/area/ship/bridge)
"N" = (
/obj/machinery/atmospherics/components/unary/portables_connector{
	dir = 4
	},
/obj/machinery/door/poddoor/shutters/preopen{
	id = "midwich_blast4"
	},
/obj/effect/turf_decal/techfloor/orange,
/turf/open/floor/plasteel/tech/grid,
/area/ship/bridge)
"P" = (
/obj/structure/cable{
	icon_state = "2-8"
	},
/obj/machinery/button/door{
	pixel_x = -3;
	id = "midwich_blast2";
	name = "engineering bay shutter control";
	pixel_y = 23
	},
/obj/machinery/button/door{
	pixel_x = 8;
	id = "midwich_blast4";
	name = "maintenance access shutter control";
	pixel_y = 23
	},
/turf/open/floor/plasteel/tech,
/area/ship/bridge)
"Q" = (
/obj/effect/turf_decal/techfloor{
	dir = 1
	},
/obj/structure/chair/handrail,
/obj/structure/cable{
	icon_state = "2-8"
	},
/turf/open/floor/plasteel/tech/grid,
/area/ship/bridge)
"R" = (
/obj/effect/turf_decal/industrial/traffic/fulltile,
/obj/machinery/door/poddoor/shutters{
	dir = 4;
	id = "midwich_blast2"
	},
/obj/machinery/door/firedoor/border_only{
	dir = 8
	},
/obj/machinery/door/firedoor/border_only{
	dir = 4
	},
/turf/open/floor/plasteel/dark,
/area/ship/bridge)
"S" = (
/obj/effect/turf_decal/techfloor{
	dir = 1
	},
/turf/open/floor/plasteel/tech/grid,
/area/ship/bridge)
"T" = (
/obj/structure/crate_shelf,
/obj/effect/turf_decal/box,
/obj/structure/platform/ship{
	dir = 1;
	layer = 2.6
	},
/turf/open/floor/plasteel/dark,
/area/ship/bridge)
"U" = (
/obj/machinery/computer/helm{
	dir = 4
	},
/obj/effect/turf_decal/techfloor{
	dir = 8
	},
/obj/effect/turf_decal/siding/thinplating/dark{
	dir = 4
	},
/turf/open/floor/plasteel/telecomms_floor,
/area/ship/bridge)
"W" = (
/obj/structure/grille,
/obj/structure/window/plasma/reinforced/plastitanium,
/obj/machinery/door/poddoor/shutters{
	id = "midwich_blast3";
	dir = 4
	},
/turf/open/floor/plating,
/area/ship/bridge)
"X" = (
/obj/machinery/power/shuttle/engine/fire{
	dir = 8
	},
/turf/open/floor/plating,
/area/ship/bridge)
"Y" = (
/turf/closed/wall/mineral/plastitanium,
/area/ship/bridge)
"Z" = (
/obj/structure/railing{
	dir = 8
	},
/obj/structure/railing{
	dir = 4
	},
/turf/open/floor/plasteel/stairs/old,
/area/ship/bridge)

(1,1,1) = {"
g
W
g
r
r
r
r
"}
(2,1,1) = {"
g
U
g
p
f
L
r
"}
(3,1,1) = {"
L
q
L
d
u
L
r
"}
(4,1,1) = {"
L
m
L
Q
i
L
r
"}
(5,1,1) = {"
L
K
Z
l
b
L
r
"}
(6,1,1) = {"
L
H
o
S
v
L
r
"}
(7,1,1) = {"
L
E
T
t
a
L
Y
"}
(8,1,1) = {"
L
I
Y
R
A
L
N
"}
(9,1,1) = {"
L
P
B
s
c
j
x
"}
(10,1,1) = {"
L
e
G
M
G
w
C
"}
(11,1,1) = {"
Y
L
J
z
h
L
Y
"}
(12,1,1) = {"
r
L
y
X
y
L
r
"}
