//MAP CONVERTED BY dmm2tgm.py THIS HEADER COMMENT PREVENTS RECONVERSION, DO NOT REMOVE
"a" = (
/obj/structure/grille,
/obj/structure/window/reinforced/fulltile,
/turf/open/floor/plating,
/area/ship/bridge)
"b" = (
/obj/effect/turf_decal/siding/thinplating/dark{
	dir = 9
	},
/obj/machinery/light/small/directional/west,
/turf/open/floor/plasteel/dark,
/area/ship/bridge)
"c" = (
/obj/structure/chair/comfy/shuttle,
/obj/machinery/airalarm/directional/north,
/obj/machinery/button/door{
	dir = 4;
	pixel_x = -20;
	pixel_y = 7;
	id = "hestiadoor"
	},
/obj/machinery/button/shieldwallgen{
	pixel_x = -19;
	pixel_y = -4;
	dir = 4;
	id = "hestiashield"
	},
/turf/open/floor/plasteel/tech,
/area/ship/bridge)
"d" = (
/obj/structure/catwalk/over/plated_catwalk/dark,
/obj/structure/cable{
	icon_state = "1-2"
	},
/turf/open/floor/plating,
/area/ship/bridge)
"e" = (
/obj/structure/cable{
	icon_state = "0-8"
	},
/obj/machinery/power/shieldwallgen/atmos/roundstart{
	id = "hestiashield";
	dir = 1
	},
/obj/machinery/door/poddoor/preopen{
	dir = 4;
	id = "hestiadoor"
	},
/turf/open/floor/plasteel/tech/grid,
/area/ship/bridge)
"f" = (
/obj/effect/turf_decal/trimline/opaque/blue/line{
	dir = 6
	},
/obj/effect/turf_decal/trimline/transparent/blue/filled/arrow_ccw,
/obj/effect/turf_decal/siding/thinplating/dark,
/obj/structure/cable{
	icon_state = "4-8"
	},
/turf/open/floor/pod/dark,
/area/ship/bridge)
"g" = (
/obj/structure/grille,
/obj/structure/window/reinforced/fulltile,
/obj/structure/cable/yellow{
	icon_state = "5-10"
	},
/turf/open/floor/plating,
/area/ship/bridge)
"h" = (
/obj/structure/window/reinforced{
	dir = 8
	},
/obj/machinery/iv_drip,
/obj/effect/turf_decal/corner/transparent/blue/mono,
/obj/structure/cable{
	icon_state = "4-8"
	},
/turf/open/floor/plasteel/mono/white,
/area/ship/bridge)
"i" = (
/obj/machinery/power/shuttle/engine/electric,
/obj/structure/cable{
	icon_state = "0-4"
	},
/turf/open/floor/engine/hull/reinforced,
/area/ship/bridge)
"j" = (
/obj/effect/turf_decal/corner/transparent/blue/mono,
/obj/structure/cable{
	icon_state = "2-8"
	},
/obj/structure/cable{
	icon_state = "2-4"
	},
/turf/open/floor/plasteel/mono/white,
/area/ship/bridge)
"k" = (
/obj/structure/closet/wall/white/directional/south{
	name = "medical"
	},
/obj/item/storage/firstaid/brute{
	pixel_x = -8;
	pixel_y = 7
	},
/obj/item/storage/firstaid/fire{
	pixel_x = 8;
	pixel_y = 7
	},
/obj/item/storage/firstaid/toxin{
	pixel_x = -8;
	pixel_y = -5
	},
/obj/item/storage/firstaid/advanced{
	pixel_x = 8;
	pixel_y = -6
	},
/obj/item/storage/firstaid/regular{
	pixel_x = -5;
	pixel_y = 0
	},
/obj/item/storage/firstaid/regular{
	pixel_x = 5;
	pixel_y = 0
	},
/obj/structure/cable{
	icon_state = "4-8"
	},
/turf/open/floor/plasteel/dark,
/area/ship/bridge)
"l" = (
/obj/structure/table/emptycomputer{
	dir = 8;
	icon_state = "emptycomputer-left"
	},
/obj/item/radio/intercom/wideband{
	dir = 4;
	pixel_x = 3;
	pixel_y = -5
	},
/obj/effect/turf_decal/borderfloorblack{
	dir = 5
	},
/obj/effect/turf_decal/corner/opaque/blue/border{
	dir = 5;
	layer = 2.04
	},
/turf/open/floor/plasteel/dark,
/area/ship/bridge)
"m" = (
/obj/effect/turf_decal/spline/fancy/opaque/black{
	dir = 4
	},
/obj/structure/cable{
	icon_state = "2-8"
	},
/obj/structure/cable{
	icon_state = "2-4"
	},
/obj/machinery/light_switch{
	pixel_x = 11;
	pixel_y = 20
	},
/obj/machinery/button/door{
	pixel_x = 0;
	pixel_y = 21;
	id = "hestiawindow"
	},
/turf/open/floor/plasteel/tech,
/area/ship/bridge)
"n" = (
/obj/structure/chair/comfy/shuttle,
/obj/machinery/firealarm/directional/north{
	pixel_x = 6
	},
/obj/structure/extinguisher_cabinet/directional/north{
	pixel_x = -6
	},
/obj/machinery/light_switch{
	dir = 8;
	pixel_x = 20;
	pixel_y = 4
	},
/turf/open/floor/plasteel/tech,
/area/ship/bridge)
"o" = (
/obj/effect/turf_decal/siding/thinplating/dark{
	dir = 1
	},
/turf/open/floor/plasteel/dark,
/area/ship/bridge)
"p" = (
/obj/structure/closet/wall/red/directional/south{
	name = "firearms"
	},
/obj/effect/turf_decal/siding/thinplating/dark{
	dir = 8
	},
/obj/item/gun/ballistic/shotgun/cm15,
/obj/item/gun/ballistic/shotgun/cm15,
/obj/item/ammo_box/magazine/cm15_12g,
/obj/item/ammo_box/magazine/cm15_12g,
/obj/item/ammo_box/magazine/cm15_12g,
/obj/item/ammo_box/magazine/cm15_12g,
/obj/item/storage/box/ammo/a12g_buckshot,
/obj/item/storage/box/ammo/a12g_buckshot,
/obj/item/storage/box/ammo/a12g_rubbershot,
/obj/item/storage/box/ammo/a12g_rubbershot,
/obj/structure/cable{
	icon_state = "4-8"
	},
/turf/open/floor/plasteel/dark,
/area/ship/bridge)
"q" = (
/obj/machinery/power/smes/shuttle/precharged,
/obj/machinery/door/poddoor/shutters/preopen{
	dir = 4;
	id = "hestiawindow"
	},
/obj/structure/cable{
	icon_state = "0-8"
	},
/turf/open/floor/plasteel/tech/grid,
/area/ship/bridge)
"r" = (
/obj/structure/table/optable,
/obj/effect/turf_decal/corner/transparent/blue/mono,
/obj/machinery/defibrillator_mount/loaded{
	pixel_x = 0;
	pixel_y = 22
	},
/turf/open/floor/plasteel/mono/white,
/area/ship/bridge)
"s" = (
/obj/machinery/door/firedoor/heavy,
/turf/open/floor/plasteel/mono/dark,
/area/ship/bridge)
"u" = (
/obj/machinery/door/firedoor/heavy,
/obj/structure/cable{
	icon_state = "4-8"
	},
/turf/open/floor/plasteel/mono/dark,
/area/ship/bridge)
"w" = (
/obj/structure/cable/yellow{
	icon_state = "4-8"
	},
/obj/machinery/door/poddoor/preopen{
	dir = 4;
	id = "hestiadoor"
	},
/obj/docking_port/mobile{
	can_move_docking_ports = 1;
	dir = 8;
	launch_status = 0;
	preferred_direction = 4
	},
/turf/open/floor/plasteel/tech/grid,
/area/ship/bridge)
"x" = (
/obj/effect/turf_decal/trimline/opaque/blue/line{
	dir = 4
	},
/obj/structure/cable/yellow{
	icon_state = "4-10"
	},
/obj/machinery/light/floor,
/turf/open/floor/pod/dark,
/area/ship/bridge)
"y" = (
/obj/machinery/power/smes/engineering,
/obj/effect/turf_decal/spline/fancy/opaque/black{
	dir = 4
	},
/obj/structure/cable,
/turf/open/floor/plasteel/tech,
/area/ship/bridge)
"A" = (
/obj/structure/cable/yellow{
	icon_state = "4-8"
	},
/obj/machinery/door/firedoor/border_only{
	dir = 4
	},
/obj/machinery/door/firedoor/border_only{
	dir = 8
	},
/turf/open/floor/plasteel/patterned/grid/dark,
/area/ship/bridge)
"B" = (
/obj/machinery/power/terminal{
	dir = 8
	},
/obj/effect/turf_decal/spline/fancy/opaque/black,
/obj/effect/turf_decal/box,
/obj/structure/cable{
	icon_state = "0-4"
	},
/turf/open/floor/plating,
/area/ship/bridge)
"C" = (
/obj/structure/cable{
	icon_state = "4-8"
	},
/obj/structure/cable{
	icon_state = "1-4"
	},
/obj/structure/cable{
	icon_state = "2-4"
	},
/turf/open/floor/pod/dark,
/area/ship/bridge)
"D" = (
/turf/closed/wall/mineral/plastitanium/nodiagonal,
/area/ship/bridge)
"E" = (
/obj/structure/window/reinforced{
	dir = 8
	},
/obj/structure/closet/crate/freezer/blood,
/obj/effect/turf_decal/corner/transparent/blue/mono,
/turf/open/floor/plasteel/mono/white,
/area/ship/bridge)
"F" = (
/obj/structure/cable{
	icon_state = "4-8"
	},
/turf/open/floor/plasteel/dark,
/area/ship/bridge)
"H" = (
/obj/machinery/holopad,
/obj/effect/turf_decal/borderfloorblack{
	dir = 1
	},
/obj/effect/turf_decal/corner/opaque/blue/border{
	dir = 1;
	layer = 2.04
	},
/obj/structure/cable{
	icon_state = "1-8"
	},
/turf/open/floor/plasteel/dark,
/area/ship/bridge)
"I" = (
/obj/machinery/power/terminal{
	dir = 8
	},
/obj/effect/turf_decal/spline/fancy/opaque/black{
	dir = 4
	},
/obj/effect/turf_decal/box,
/obj/structure/cable{
	icon_state = "0-4"
	},
/turf/open/floor/plating,
/area/ship/bridge)
"J" = (
/obj/effect/turf_decal/corner/transparent/blue/mono,
/obj/structure/table/chem,
/obj/item/storage/case/surgery{
	pixel_x = 0;
	pixel_y = 5
	},
/obj/machinery/power/apc/auto_name/directional/east,
/obj/structure/cable{
	icon_state = "0-8"
	},
/turf/open/floor/plasteel/mono/white,
/area/ship/bridge)
"K" = (
/obj/structure/cable{
	icon_state = "0-8"
	},
/obj/machinery/power/shieldwallgen/atmos/roundstart{
	id = "hestiashield"
	},
/obj/machinery/door/poddoor/preopen{
	dir = 4;
	id = "hestiadoor"
	},
/turf/open/floor/plasteel/tech/grid,
/area/ship/bridge)
"L" = (
/obj/effect/turf_decal/trimline/opaque/blue/line{
	dir = 1
	},
/obj/effect/turf_decal/trimline/transparent/blue/filled/arrow_cw{
	dir = 1
	},
/obj/effect/turf_decal/siding/thinplating/dark{
	dir = 1
	},
/obj/structure/cable{
	icon_state = "2-4"
	},
/turf/open/floor/pod/dark,
/area/ship/bridge)
"M" = (
/obj/structure/grille,
/obj/structure/window/reinforced/fulltile,
/obj/machinery/door/poddoor/shutters/preopen{
	id = "hestiawindow"
	},
/turf/open/floor/plating,
/area/ship/bridge)
"N" = (
/obj/machinery/computer/helm{
	dir = 8;
	icon_state = "computer-right"
	},
/obj/effect/turf_decal/borderfloorblack{
	dir = 4
	},
/obj/effect/turf_decal/corner/opaque/blue/border{
	dir = 4;
	layer = 2.04
	},
/obj/structure/cable/yellow{
	icon_state = "5-8"
	},
/obj/machinery/light/directional/east,
/turf/open/floor/plasteel/dark,
/area/ship/bridge)
"O" = (
/obj/effect/turf_decal/trimline/opaque/blue/line{
	dir = 5
	},
/obj/effect/turf_decal/trimline/transparent/blue/filled/arrow_cw{
	dir = 1
	},
/obj/effect/turf_decal/siding/thinplating/dark{
	dir = 1
	},
/obj/structure/cable{
	icon_state = "4-8"
	},
/turf/open/floor/pod/dark,
/area/ship/bridge)
"P" = (
/obj/effect/turf_decal/trimline/opaque/blue/line,
/obj/effect/turf_decal/trimline/transparent/blue/filled/arrow_ccw,
/obj/effect/turf_decal/siding/thinplating/dark,
/obj/structure/cable/yellow{
	icon_state = "5-10"
	},
/obj/structure/cable{
	icon_state = "1-4"
	},
/turf/open/floor/pod/dark,
/area/ship/bridge)
"Q" = (
/obj/effect/turf_decal/corner/transparent/blue/mono,
/obj/structure/bed/roller,
/turf/open/floor/plasteel/mono/white,
/area/ship/bridge)
"R" = (
/turf/closed/wall/mineral/plastitanium,
/area/ship/bridge)
"S" = (
/obj/structure/cable{
	icon_state = "4-8"
	},
/obj/machinery/door/firedoor/border_only{
	dir = 4
	},
/obj/machinery/door/firedoor/border_only{
	dir = 8
	},
/turf/open/floor/plasteel/patterned/grid/dark,
/area/ship/bridge)
"T" = (
/obj/structure/chair/comfy/shuttle{
	dir = 4;
	name = "Helm"
	},
/obj/machinery/power/terminal{
	dir = 8
	},
/obj/effect/turf_decal/box,
/obj/structure/cable/yellow{
	icon_state = "0-4"
	},
/turf/open/floor/plasteel/dark,
/area/ship/bridge)
"U" = (
/turf/template_noop,
/area/template_noop)
"V" = (
/obj/structure/table/chem,
/obj/effect/turf_decal/corner/transparent/blue/mono,
/obj/structure/sink/chem{
	dir = 8
	},
/obj/machinery/light/directional/east,
/turf/open/floor/plasteel/mono/white,
/area/ship/bridge)
"W" = (
/obj/machinery/power/terminal{
	dir = 8
	},
/obj/effect/turf_decal/box,
/obj/effect/turf_decal/spline/fancy/opaque/black{
	dir = 4
	},
/obj/structure/cable{
	icon_state = "0-4"
	},
/obj/machinery/light/small/directional/north,
/turf/open/floor/plating,
/area/ship/bridge)
"Y" = (
/obj/structure/cable{
	icon_state = "1-2"
	},
/obj/machinery/door/firedoor/border_only{
	dir = 1
	},
/obj/machinery/door/firedoor/border_only,
/obj/machinery/door/airlock/command/glass{
	req_ship_access = 0
	},
/turf/open/floor/plasteel/tech,
/area/ship/bridge)
"Z" = (
/obj/structure/catwalk/over/plated_catwalk/dark,
/obj/structure/cable{
	icon_state = "2-4"
	},
/obj/structure/cable{
	icon_state = "1-2"
	},
/obj/structure/cable{
	icon_state = "2-8"
	},
/turf/open/floor/plating,
/area/ship/bridge)

(1,1,1) = {"
U
U
U
D
i
D
U
U
U
"}
(2,1,1) = {"
U
D
i
D
q
D
i
D
U
"}
(3,1,1) = {"
U
D
q
D
I
D
q
D
U
"}
(4,1,1) = {"
R
D
B
b
p
D
W
D
R
"}
(5,1,1) = {"
D
E
h
o
k
D
m
y
D
"}
(6,1,1) = {"
D
r
j
d
Z
Y
H
T
M
"}
(7,1,1) = {"
D
V
J
o
F
a
l
N
M
"}
(8,1,1) = {"
D
D
D
s
u
a
g
D
D
"}
(9,1,1) = {"
U
D
c
L
C
P
Q
D
U
"}
(10,1,1) = {"
U
D
n
O
x
f
Q
D
U
"}
(11,1,1) = {"
U
D
D
S
A
S
D
D
U
"}
(12,1,1) = {"
U
U
D
K
w
e
D
U
U
"}
