//MAP CONVERTED BY dmm2tgm.py THIS HEADER COMMENT PREVENTS RECONVERSION, DO NOT REMOVE
"a" = (
/obj/machinery/computer/security{
	dir = 8
	},
/obj/effect/turf_decal/techfloor{
	dir = 6
	},
/turf/open/floor/plasteel/telecomms_floor,
/area/ship/storage/eva)
"b" = (
/obj/effect/turf_decal/siding/thinplating/dark{
	dir = 1
	},
/obj/effect/turf_decal/siding/thinplating/dark,
/obj/effect/decal/cleanable/dirt,
/obj/machinery/holopad/emergency/command,
/turf/open/floor/plasteel/patterned/brushed,
/area/ship/storage/eva)
"c" = (
/obj/item/gps/computer{
	pixel_y = -20
	},
/turf/open/floor/plasteel/tech/grid,
/area/ship/storage/eva)
"d" = (
/obj/structure/chair/comfy/shuttle{
	dir = 4;
	name = "tactical chair"
	},
/obj/structure/railing{
	dir = 8;
	layer = 4.1
	},
/obj/effect/turf_decal/techfloor{
	dir = 8
	},
/obj/structure/extinguisher_cabinet/directional/south,
/obj/effect/landmark/ert_shuttle_spawn,
/turf/open/floor/plasteel,
/area/ship/storage/eva)
"e" = (
/obj/effect/turf_decal/siding/thinplating/dark{
	dir = 1
	},
/obj/effect/turf_decal/siding/thinplating/dark,
/obj/effect/decal/cleanable/dirt,
/turf/open/floor/plasteel/patterned/brushed,
/area/ship/storage/eva)
"f" = (
/obj/machinery/atmospherics/pipe/simple/orange/hidden{
	dir = 10
	},
/obj/machinery/power/smes/engineering,
/obj/structure/cable{
	icon_state = "0-10"
	},
/obj/effect/turf_decal/industrial/warning{
	dir = 10
	},
/turf/open/floor/plasteel/tech/grid,
/area/ship/storage/eva)
"g" = (
/turf/closed/wall/mineral/plastitanium,
/area/ship/storage/eva)
"h" = (
/obj/machinery/atmospherics/pipe/simple/orange/hidden/layer1{
	dir = 8
	},
/obj/machinery/atmospherics/pipe/manifold/orange/hidden{
	dir = 8
	},
/obj/machinery/power/terminal{
	dir = 1
	},
/obj/structure/cable{
	icon_state = "4-8"
	},
/obj/structure/cable/yellow{
	icon_state = "0-2"
	},
/turf/open/floor/plasteel/tech/grid,
/area/ship/storage/eva)
"i" = (
/obj/effect/turf_decal/steeldecal/steel_decals6,
/turf/open/floor/plasteel/telecomms_floor,
/area/ship/storage/eva)
"j" = (
/obj/machinery/computer/helm{
	dir = 8
	},
/obj/effect/turf_decal/techfloor{
	dir = 4
	},
/turf/open/floor/plasteel/telecomms_floor,
/area/ship/storage/eva)
"k" = (
/obj/machinery/atmospherics/pipe/layer_manifold,
/obj/machinery/power/apc/auto_name/directional/west,
/obj/structure/cable{
	icon_state = "0-2"
	},
/obj/structure/cable{
	icon_state = "1-2"
	},
/obj/machinery/camera{
	dir = 5
	},
/turf/open/floor/plasteel/patterned/cargo_one,
/area/ship/storage/eva)
"l" = (
/obj/structure/chair/comfy/shuttle{
	dir = 4;
	name = "tactical chair"
	},
/obj/effect/turf_decal/techfloor{
	dir = 1
	},
/obj/effect/turf_decal/steeldecal/steel_decals10,
/obj/effect/turf_decal/techfloor/corner{
	dir = 1;
	pixel_y = -16
	},
/obj/machinery/light_switch{
	pixel_x = -22;
	dir = 4;
	pixel_y = 8
	},
/obj/effect/landmark/ert_shuttle_spawn,
/turf/open/floor/plasteel/telecomms_floor,
/area/ship/storage/eva)
"m" = (
/obj/machinery/light/directional/north,
/turf/open/floor/plasteel/patterned/grid,
/area/ship/storage/eva)
"n" = (
/turf/closed/wall/mineral/plastitanium/nodiagonal,
/area/ship/storage/eva)
"o" = (
/obj/structure/chair/comfy/shuttle{
	dir = 8;
	name = "tactical chair"
	},
/obj/effect/turf_decal/techfloor{
	dir = 4
	},
/obj/effect/decal/cleanable/dirt,
/obj/machinery/vending/wallmed{
	pixel_y = -28
	},
/obj/effect/landmark/ert_shuttle_spawn,
/turf/open/floor/plasteel,
/area/ship/storage/eva)
"p" = (
/obj/effect/turf_decal/industrial/outline/yellow,
/obj/machinery/atmospherics/pipe/simple/orange/hidden{
	dir = 9
	},
/obj/structure/cable/yellow,
/obj/machinery/power/port_gen/pacman,
/obj/effect/turf_decal/industrial/warning{
	dir = 9
	},
/obj/machinery/light/directional/south,
/turf/open/floor/plasteel/tech/grid,
/area/ship/storage/eva)
"r" = (
/obj/structure/chair/comfy/shuttle{
	dir = 4;
	name = "tactical chair"
	},
/obj/structure/railing{
	dir = 8;
	layer = 4.1
	},
/obj/effect/turf_decal/techfloor{
	dir = 8
	},
/obj/effect/decal/cleanable/dirt,
/obj/effect/landmark/ert_shuttle_spawn,
/turf/open/floor/plasteel,
/area/ship/storage/eva)
"s" = (
/obj/structure/window/reinforced/survival_pod/spawner/west,
/obj/machinery/atmospherics/components/unary/shuttle/heater{
	dir = 4
	},
/obj/effect/turf_decal/techfloor/orange,
/turf/open/floor/plasteel/tech,
/area/ship/storage/eva)
"t" = (
/obj/effect/decal/cleanable/dirt,
/obj/machinery/light/directional/south,
/turf/open/floor/plasteel/patterned/grid,
/area/ship/storage/eva)
"v" = (
/obj/machinery/atmospherics/pipe/simple/orange/hidden/layer1{
	dir = 8
	},
/obj/machinery/atmospherics/components/binary/pump{
	dir = 8;
	name = "engine fuel pump"
	},
/obj/structure/cable{
	icon_state = "4-8"
	},
/obj/effect/turf_decal/steeldecal/steel_decals10{
	dir = 4
	},
/obj/effect/turf_decal/steeldecal/steel_decals10,
/obj/machinery/door/airlock/grunge{
	dir = 4
	},
/obj/machinery/door/firedoor/border_only{
	dir = 8
	},
/obj/machinery/door/firedoor/border_only{
	dir = 4
	},
/turf/open/floor/plasteel/tech/grid,
/area/ship/storage/eva)
"w" = (
/obj/effect/spawner/structure/window/plasma/reinforced/plastitanium,
/obj/machinery/door/poddoor{
	id = "heron_subshuttle_bridge"
	},
/turf/open/floor/plating,
/area/ship/storage/eva)
"y" = (
/obj/effect/turf_decal/industrial/traffic{
	dir = 8
	},
/obj/machinery/power/shieldwallgen/atmos{
	anchored = 1;
	dir = 4;
	id = "heron_subshuttle2";
	locked = 1
	},
/obj/structure/cable{
	icon_state = "0-1"
	},
/obj/machinery/door/firedoor/border_only,
/obj/machinery/door/poddoor/shutters{
	id = "heron_subshuttle22";
	name = "Blast Shutters"
	},
/obj/machinery/button/shieldwallgen{
	id = "heron_subshuttle2";
	pixel_x = -21;
	pixel_y = -8;
	dir = 4
	},
/obj/machinery/button/door{
	id = "heron_subshuttle22";
	name = "Access Shutters";
	pixel_x = -23;
	dir = 4
	},
/turf/open/floor/plasteel/patterned/ridged,
/area/ship/storage/eva)
"z" = (
/turf/template_noop,
/area/template_noop)
"A" = (
/obj/effect/turf_decal/industrial/traffic{
	dir = 8
	},
/obj/machinery/power/shieldwallgen/atmos{
	anchored = 1;
	dir = 4;
	id = "heron_subshuttle1";
	locked = 1
	},
/obj/structure/cable{
	icon_state = "0-2"
	},
/obj/machinery/door/firedoor/border_only{
	dir = 1
	},
/obj/machinery/atmospherics/components/binary/valve{
	dir = 1;
	name = "Shuttle Fuel Valve"
	},
/obj/machinery/door/poddoor/shutters{
	id = "heron_subshuttle11";
	name = "Blast Shutters"
	},
/obj/machinery/button/door{
	id = "heron_subshuttle11";
	name = "Access Shutters";
	pixel_x = -23;
	dir = 4
	},
/obj/machinery/button/shieldwallgen{
	id = "heron_subshuttle1";
	pixel_x = -21;
	pixel_y = 8;
	dir = 4
	},
/turf/open/floor/plasteel/patterned/ridged,
/area/ship/storage/eva)
"B" = (
/obj/structure/chair/comfy/shuttle{
	dir = 4;
	name = "tactical chair"
	},
/obj/structure/railing{
	dir = 8;
	layer = 4.1
	},
/obj/effect/turf_decal/techfloor{
	dir = 8
	},
/obj/effect/landmark/ert_shuttle_spawn,
/turf/open/floor/plasteel,
/area/ship/storage/eva)
"C" = (
/obj/structure/window/reinforced/survival_pod/spawner/west,
/obj/machinery/atmospherics/components/unary/tank/toxins{
	dir = 4;
	piping_layer = 1
	},
/obj/structure/cable{
	icon_state = "4-5"
	},
/obj/effect/turf_decal/steeldecal/steel_decals3,
/obj/effect/turf_decal/steeldecal/steel_decals3{
	dir = 6
	},
/turf/open/floor/plasteel/tech,
/area/ship/storage/eva)
"D" = (
/obj/machinery/power/shuttle/engine/fueled/plasma{
	dir = 4
	},
/obj/machinery/door/poddoor{
	id = "heron_subshuttle_engines";
	name = "Thruster Blast Door";
	dir = 4
	},
/turf/open/floor/plating,
/area/ship/storage/eva)
"E" = (
/obj/effect/spawner/structure/window/plasma/reinforced/plastitanium,
/obj/machinery/door/poddoor{
	id = "heron_subshuttle_bridge";
	dir = 8
	},
/turf/open/floor/plating,
/area/ship/storage/eva)
"F" = (
/obj/machinery/atmospherics/pipe/simple/orange/hidden,
/obj/effect/decal/cleanable/dirt,
/obj/structure/cable{
	icon_state = "2-5"
	},
/obj/structure/cable{
	icon_state = "1-2"
	},
/turf/open/floor/plasteel/patterned/cargo_one,
/area/ship/storage/eva)
"G" = (
/obj/machinery/computer/crew/syndie{
	dir = 8
	},
/obj/effect/turf_decal/techfloor{
	dir = 5
	},
/obj/machinery/light/directional/north,
/turf/open/floor/plasteel/telecomms_floor,
/area/ship/storage/eva)
"H" = (
/obj/effect/turf_decal/siding/thinplating/dark{
	dir = 1
	},
/obj/effect/turf_decal/siding/thinplating/dark,
/turf/open/floor/plasteel/patterned/brushed,
/area/ship/storage/eva)
"I" = (
/obj/structure/chair/comfy/shuttle{
	dir = 8;
	name = "tactical chair"
	},
/obj/effect/turf_decal/techfloor{
	dir = 4
	},
/obj/effect/landmark/ert_shuttle_spawn,
/turf/open/floor/plasteel,
/area/ship/storage/eva)
"J" = (
/obj/effect/decal/cleanable/dirt,
/turf/open/floor/plasteel/patterned/grid,
/area/ship/storage/eva)
"K" = (
/obj/structure/chair/comfy/shuttle{
	dir = 8;
	name = "tactical chair"
	},
/obj/effect/turf_decal/techfloor{
	dir = 4
	},
/obj/item/radio/intercom/directional/north,
/obj/effect/landmark/ert_shuttle_spawn,
/turf/open/floor/plasteel,
/area/ship/storage/eva)
"L" = (
/obj/effect/turf_decal/industrial/traffic{
	dir = 4
	},
/obj/machinery/power/shieldwallgen/atmos{
	anchored = 1;
	dir = 8;
	id = "heron_subshuttle1";
	locked = 1
	},
/obj/structure/cable{
	icon_state = "0-10"
	},
/obj/machinery/door/firedoor/border_only{
	dir = 1
	},
/obj/docking_port/mobile{
	dir = 2;
	port_direction = 8;
	preferred_direction = 4
	},
/obj/machinery/door/poddoor/shutters{
	id = "heron_subshuttle11";
	name = "Blast Shutters"
	},
/turf/open/floor/plasteel/patterned/ridged,
/area/ship/storage/eva)
"M" = (
/obj/effect/turf_decal/siding/thinplating/dark{
	dir = 1
	},
/obj/effect/turf_decal/siding/thinplating/dark,
/obj/machinery/atmospherics/pipe/simple/orange/hidden/layer1{
	dir = 9
	},
/obj/machinery/atmospherics/pipe/simple/orange/hidden{
	dir = 9
	},
/obj/structure/cable{
	icon_state = "1-8"
	},
/obj/structure/cable{
	icon_state = "1-2"
	},
/obj/effect/landmark/ert_shuttle_brief_spawn,
/turf/open/floor/plasteel/patterned/brushed,
/area/ship/storage/eva)
"N" = (
/obj/effect/decal/cleanable/dirt,
/obj/effect/decal/cleanable/plasma,
/turf/open/floor/plasteel/patterned/cargo_one,
/area/ship/storage/eva)
"O" = (
/obj/effect/decal/cleanable/dirt,
/obj/effect/decal/cleanable/glass{
	pixel_x = 8;
	pixel_y = 20
	},
/obj/structure/cable{
	icon_state = "1-6"
	},
/obj/structure/cable{
	icon_state = "1-2"
	},
/turf/open/floor/plasteel/patterned/cargo_one,
/area/ship/storage/eva)
"P" = (
/obj/structure/table/reinforced{
	color = "#c1b6a5"
	},
/obj/item/gps{
	pixel_x = -6;
	pixel_y = 3
	},
/obj/machinery/button/door{
	id = "heron_subshuttle_bridge";
	name = "Bridge Shutters";
	pixel_x = 6;
	pixel_y = 7;
	dir = 1
	},
/obj/machinery/button/door{
	id = "heron_subshuttle_engines";
	name = "Engine Shutters";
	pixel_x = 6;
	pixel_y = -1;
	dir = 1
	},
/turf/open/floor/plasteel/tech/grid,
/area/ship/storage/eva)
"Q" = (
/obj/machinery/door/firedoor/border_only{
	dir = 8
	},
/turf/open/floor/plasteel/stairs{
	icon = 'icons/obj/stairs.dmi';
	dir = 8
	},
/area/ship/storage/eva)
"R" = (
/obj/effect/turf_decal/industrial/traffic{
	dir = 4
	},
/obj/machinery/power/shieldwallgen/atmos{
	anchored = 1;
	dir = 8;
	id = "heron_subshuttle2";
	locked = 1
	},
/obj/structure/cable{
	icon_state = "0-9"
	},
/obj/machinery/door/firedoor/border_only,
/obj/machinery/door/poddoor/shutters{
	id = "heron_subshuttle22";
	name = "Blast Shutters"
	},
/turf/open/floor/plasteel/patterned/ridged,
/area/ship/storage/eva)
"S" = (
/obj/structure/window/reinforced/survival_pod/spawner/west,
/obj/machinery/atmospherics/components/unary/shuttle/heater{
	dir = 4
	},
/obj/effect/turf_decal/techfloor/orange{
	dir = 1
	},
/turf/open/floor/plasteel/tech,
/area/ship/storage/eva)
"T" = (
/obj/structure/chair/comfy/shuttle{
	dir = 4;
	name = "tactical chair"
	},
/obj/effect/turf_decal/techfloor,
/obj/effect/turf_decal/steeldecal/steel_decals10,
/obj/effect/turf_decal/techfloor/corner{
	dir = 8;
	pixel_y = 16
	},
/obj/effect/landmark/ert_shuttle_spawn,
/turf/open/floor/plasteel/telecomms_floor,
/area/ship/storage/eva)
"U" = (
/obj/structure/cable{
	icon_state = "1-2"
	},
/obj/machinery/airalarm/directional/west,
/turf/open/floor/plasteel/patterned/cargo_one,
/area/ship/storage/eva)
"X" = (
/obj/effect/decal/cleanable/dirt,
/turf/open/floor/plasteel/patterned/cargo_one,
/area/ship/storage/eva)
"Z" = (
/obj/effect/turf_decal/siding/thinplating/dark{
	dir = 1
	},
/obj/effect/turf_decal/siding/thinplating/dark,
/obj/effect/decal/cleanable/dirt,
/obj/effect/decal/cleanable/dirt,
/turf/open/floor/plasteel/patterned/brushed,
/area/ship/storage/eva)

(1,1,1) = {"
z
n
D
n
D
n
z
"}
(2,1,1) = {"
z
n
S
C
s
n
z
"}
(3,1,1) = {"
n
n
f
h
p
n
n
"}
(4,1,1) = {"
n
n
n
v
n
n
n
"}
(5,1,1) = {"
A
F
k
M
U
O
y
"}
(6,1,1) = {"
L
N
X
e
X
X
R
"}
(7,1,1) = {"
n
B
r
Z
B
d
n
"}
(8,1,1) = {"
n
m
J
b
J
t
n
"}
(9,1,1) = {"
n
K
I
H
I
o
n
"}
(10,1,1) = {"
n
n
n
Q
n
n
n
"}
(11,1,1) = {"
w
c
l
i
T
P
w
"}
(12,1,1) = {"
g
n
G
j
a
n
g
"}
(13,1,1) = {"
z
g
E
E
E
g
z
"}
