//MAP CONVERTED BY dmm2tgm.py THIS HEADER COMMENT PREVENTS RECONVERSION, DO NOT REMOVE
"a" = (
/obj/machinery/computer/helm{
	dir = 8
	},
/obj/effect/turf_decal/techfloor{
	dir = 6
	},
/turf/open/floor/plasteel/telecomms_floor,
/area/ship/bridge)
"b" = (
/obj/machinery/portable_atmospherics/canister/air,
/obj/effect/turf_decal/box,
/obj/machinery/atmospherics/components/unary/portables_connector/visible/layer2{
	dir = 8
	},
/obj/machinery/light/small/directional/east,
/turf/open/floor/plasteel/tech/grid,
/area/ship/bridge)
"c" = (
/turf/template_noop,
/area/template_noop)
"d" = (
/obj/machinery/door/firedoor/heavy,
/obj/machinery/atmospherics/components/binary/pump/layer4{
	dir = 8;
	name = "Waste to Dock";
	layer = 2.43
	},
/obj/structure/catwalk/over/plated_catwalk/dark,
/obj/machinery/power/shieldwallgen/atmos/roundstart{
	id = "nail_holo"
	},
/obj/structure/cable{
	icon_state = "4-10"
	},
/obj/structure/cable{
	icon_state = "0-2"
	},
/obj/machinery/door/poddoor/preopen{
	dir = 8;
	id = "nail_door_blast"
	},
/obj/docking_port/mobile{
	dir = 8;
	name = "Nail-Class Shuttle";
	preferred_direction = 8;
	port_direction = 2
	},
/turf/open/floor/plating,
/area/ship/bridge)
"e" = (
/obj/effect/turf_decal/techfloor/corner,
/obj/machinery/holopad/emergency,
/obj/machinery/power/terminal,
/obj/structure/cable{
	icon_state = "0-8"
	},
/turf/open/floor/plasteel/telecomms_floor,
/area/ship/bridge)
"f" = (
/obj/machinery/power/terminal{
	dir = 8
	},
/obj/structure/cable{
	icon_state = "0-2"
	},
/obj/structure/catwalk/over/plated_catwalk/dark,
/obj/machinery/button/door{
	id = "nail_port_engine_blast";
	name = "Engine Shutters";
	dir = 2;
	pixel_y = 20
	},
/turf/open/floor/plating,
/area/ship/bridge)
"g" = (
/obj/effect/turf_decal/box,
/obj/machinery/porta_turret/ship/pgf{
	dir = 6;
	id = "nail_grid"
	},
/turf/open/floor/engine/hull/reinforced/interior,
/area/ship/external/dark)
"h" = (
/obj/effect/turf_decal/techfloor/orange{
	dir = 8
	},
/obj/effect/turf_decal/techfloor/orange{
	dir = 4
	},
/obj/machinery/door/firedoor/border_only{
	dir = 8
	},
/obj/machinery/door/firedoor/border_only{
	dir = 4
	},
/obj/machinery/atmospherics/pipe/simple/scrubbers/hidden/layer4{
	dir = 4
	},
/obj/machinery/atmospherics/pipe/simple/supply/hidden/layer2{
	dir = 8
	},
/obj/structure/cable{
	icon_state = "4-8"
	},
/obj/machinery/door/airlock/maintenance/external/glass{
	dir = 4;
	req_ship_access = 0;
	name = "Cabin"
	},
/obj/structure/cable{
	icon_state = "6-9"
	},
/turf/open/floor/plasteel/tech/grid,
/area/ship/bridge)
"i" = (
/obj/structure/chair/comfy/shuttle{
	dir = 8
	},
/obj/structure/railing/thin{
	dir = 4
	},
/turf/open/floor/plasteel/dark,
/area/ship/bridge)
"j" = (
/obj/structure/chair/handrail{
	dir = 2
	},
/obj/item/radio/intercom/directional/west,
/obj/machinery/light/floor{
	pixel_x = 16;
	pixel_y = -16
	},
/turf/open/floor/engine/hull/reinforced/interior,
/area/ship/bridge)
"k" = (
/obj/machinery/power/terminal{
	dir = 8
	},
/obj/structure/catwalk/over/plated_catwalk/dark,
/obj/structure/cable{
	icon_state = "0-1"
	},
/obj/machinery/atmospherics/pipe/simple/supply/hidden/layer2{
	dir = 5
	},
/obj/machinery/button/door{
	id = "nail_starboard_engine_blast";
	name = "Engine Shutters";
	dir = 1;
	pixel_y = -20
	},
/obj/item/storage/toolbox/mechanical{
	pixel_y = -7;
	pixel_x = -4
	},
/turf/open/floor/plating,
/area/ship/bridge)
"l" = (
/obj/effect/turf_decal/siding/black,
/obj/machinery/atmospherics/components/unary/vent_scrubber/on/layer4{
	dir = 4
	},
/obj/machinery/atmospherics/pipe/simple/supply/hidden/layer2{
	dir = 8
	},
/obj/machinery/light/small/directional/south,
/obj/structure/chair/handrail{
	dir = 1;
	layer = 2.89
	},
/obj/structure/cable{
	icon_state = "4-8"
	},
/turf/open/floor/plasteel/patterned/brushed,
/area/ship/bridge)
"m" = (
/obj/structure/window/plasma/reinforced/plastitanium,
/obj/structure/grille,
/obj/machinery/door/poddoor/shutters{
	id = "nail_window_shut"
	},
/turf/open/floor/plating,
/area/ship/bridge)
"n" = (
/obj/machinery/atmospherics/components/binary/dp_vent_pump/high_volume/layer2{
	dir = 4
	},
/obj/machinery/atmospherics/pipe/simple/scrubbers/hidden/layer4{
	dir = 4
	},
/obj/structure/chair/handrail{
	dir = 1
	},
/turf/open/floor/engine/hull/reinforced/interior,
/area/ship/bridge)
"o" = (
/obj/machinery/advanced_airlock_controller/directional/east,
/obj/structure/chair/handrail{
	dir = 2
	},
/turf/open/floor/engine/hull/reinforced/interior,
/area/ship/bridge)
"p" = (
/obj/effect/turf_decal/siding/thinplating/dark{
	dir = 9
	},
/obj/machinery/atmospherics/pipe/simple/scrubbers/hidden/layer4{
	dir = 6
	},
/obj/machinery/atmospherics/pipe/simple/supply/hidden/layer2{
	dir = 6
	},
/obj/structure/cable{
	icon_state = "1-2"
	},
/turf/open/floor/plasteel/tech,
/area/ship/bridge)
"q" = (
/obj/structure/cable{
	icon_state = "0-4"
	},
/obj/machinery/power/shuttle/engine/electric,
/obj/structure/window/reinforced,
/turf/open/floor/engine/hull/reinforced,
/area/ship/bridge)
"r" = (
/obj/effect/turf_decal/siding/thinplating/dark/corner,
/obj/effect/turf_decal/siding/thinplating/dark/corner{
	dir = 4
	},
/obj/machinery/atmospherics/pipe/manifold/scrubbers/hidden/layer4,
/obj/machinery/atmospherics/pipe/manifold/supply/hidden/layer2{
	dir = 1
	},
/obj/structure/cable{
	icon_state = "4-8"
	},
/obj/structure/cable{
	icon_state = "2-4"
	},
/obj/structure/cable{
	icon_state = "2-8"
	},
/turf/open/floor/plasteel/tech,
/area/ship/bridge)
"s" = (
/obj/structure/chair/comfy/shuttle{
	dir = 4
	},
/obj/structure/railing/thin{
	dir = 8
	},
/turf/open/floor/plasteel/dark,
/area/ship/bridge)
"t" = (
/obj/machinery/door/firedoor/heavy,
/obj/machinery/atmospherics/components/binary/pump/layer2{
	dir = 4;
	name = "Distro to Shuttle";
	layer = 2.43
	},
/obj/machinery/power/shieldwallgen/atmos/roundstart{
	id = "nail_holo";
	dir = 1
	},
/obj/structure/cable{
	icon_state = "0-4"
	},
/obj/structure/cable{
	icon_state = "1-4"
	},
/obj/structure/catwalk/over/plated_catwalk/dark,
/obj/machinery/door/poddoor/preopen{
	dir = 8;
	id = "nail_door_blast"
	},
/turf/open/floor/plating,
/area/ship/bridge)
"u" = (
/obj/structure/railing/thin/corner{
	dir = 4
	},
/obj/effect/turf_decal/siding/thinplating/dark,
/obj/effect/turf_decal/siding/thinplating/dark{
	dir = 1
	},
/obj/machinery/atmospherics/pipe/simple/supply/hidden/layer2{
	dir = 8
	},
/obj/machinery/atmospherics/pipe/simple/scrubbers/hidden/layer4{
	dir = 4
	},
/obj/structure/cable{
	icon_state = "4-8"
	},
/turf/open/floor/plasteel/tech,
/area/ship/bridge)
"v" = (
/obj/effect/turf_decal/siding/thinplating/dark{
	dir = 4
	},
/obj/machinery/atmospherics/components/unary/vent_pump/on/layer2{
	dir = 1
	},
/obj/structure/extinguisher_cabinet/directional/west{
	pixel_y = -6
	},
/obj/machinery/firealarm/directional/west{
	pixel_y = 6
	},
/obj/structure/cable{
	icon_state = "4-9"
	},
/obj/structure/cable{
	icon_state = "1-2"
	},
/turf/open/floor/plasteel/tech,
/area/ship/bridge)
"w" = (
/obj/effect/turf_decal/techfloor{
	dir = 6
	},
/obj/machinery/power/smes/engineering{
	input_level = 5000;
	output_level = 15000
	},
/obj/structure/cable{
	icon_state = "0-8"
	},
/obj/machinery/light/small/directional/south,
/turf/open/floor/plasteel/telecomms_floor,
/area/ship/bridge)
"x" = (
/obj/effect/turf_decal/siding/black{
	dir = 5;
	layer = 2.139
	},
/obj/machinery/button/door{
	id = "nail_door_blast";
	name = "Nail Blast Doors";
	dir = 2;
	pixel_y = 20;
	pixel_x = 4
	},
/obj/machinery/button/shieldwallgen{
	id = "nail_holo";
	dir = 2;
	pixel_x = -6;
	pixel_y = 19;
	name = "Holofield Switch"
	},
/obj/structure/cable{
	icon_state = "6-8"
	},
/turf/open/floor/plasteel/patterned/brushed,
/area/ship/bridge)
"y" = (
/obj/structure/cable{
	icon_state = "0-4"
	},
/obj/machinery/power/shuttle/engine/electric,
/obj/structure/window/reinforced{
	dir = 1
	},
/turf/open/floor/engine/hull/reinforced,
/area/ship/bridge)
"z" = (
/obj/effect/turf_decal/siding/black{
	dir = 1
	},
/obj/structure/cable{
	icon_state = "1-2"
	},
/obj/machinery/atmospherics/pipe/simple/scrubbers/hidden/layer4{
	dir = 10
	},
/obj/machinery/atmospherics/pipe/simple/supply/hidden/layer2{
	dir = 10
	},
/obj/structure/cable{
	icon_state = "4-8"
	},
/turf/open/floor/plasteel/patterned/brushed,
/area/ship/bridge)
"A" = (
/obj/effect/turf_decal/siding/black,
/obj/structure/cable{
	icon_state = "1-2"
	},
/obj/machinery/atmospherics/pipe/manifold4w/supply/hidden/layer2,
/obj/machinery/atmospherics/pipe/manifold/scrubbers/hidden/layer4,
/obj/structure/cable{
	icon_state = "1-4"
	},
/obj/structure/cable{
	icon_state = "1-8"
	},
/turf/open/floor/plasteel/patterned/brushed,
/area/ship/bridge)
"B" = (
/obj/structure/chair/comfy/shuttle{
	dir = 8
	},
/obj/structure/railing/thin{
	dir = 4
	},
/obj/machinery/light/small/directional/north,
/turf/open/floor/plasteel/dark,
/area/ship/bridge)
"C" = (
/obj/effect/turf_decal/techfloor/orange{
	dir = 1
	},
/obj/machinery/door/firedoor/border_only{
	dir = 1
	},
/obj/machinery/door/firedoor/border_only,
/obj/effect/turf_decal/techfloor/orange,
/obj/structure/cable{
	icon_state = "1-2"
	},
/obj/machinery/door/airlock/grunge{
	name = "Port Nacelle"
	},
/turf/open/floor/plasteel/tech/grid,
/area/ship/bridge)
"D" = (
/obj/structure/chair/comfy/shuttle{
	dir = 4
	},
/obj/structure/railing/thin{
	dir = 8
	},
/obj/machinery/light/small/directional/north,
/turf/open/floor/plasteel/dark,
/area/ship/bridge)
"E" = (
/obj/effect/turf_decal/siding/thinplating/dark{
	dir = 5
	},
/obj/machinery/atmospherics/components/unary/vent_scrubber/on/layer4{
	dir = 2;
	pixel_x = 0;
	pixel_y = 0
	},
/turf/open/floor/plasteel/tech,
/area/ship/bridge)
"F" = (
/obj/effect/turf_decal/box,
/obj/machinery/light/small/directional/east,
/obj/machinery/telecomms/relay/preset/pgf,
/turf/open/floor/plasteel/tech/grid,
/area/ship/bridge)
"G" = (
/obj/structure/sign/number/random,
/turf/closed/wall/mineral/plastitanium/nodiagonal,
/area/ship/bridge)
"H" = (
/obj/effect/turf_decal/siding/black{
	dir = 9
	},
/obj/machinery/atmospherics/pipe/simple/scrubbers/hidden/layer4{
	dir = 4
	},
/obj/structure/cable{
	icon_state = "4-8"
	},
/turf/open/floor/plasteel/patterned/brushed,
/area/ship/bridge)
"I" = (
/obj/effect/turf_decal/techfloor/orange{
	dir = 1
	},
/obj/machinery/door/firedoor/border_only{
	dir = 1
	},
/obj/machinery/door/firedoor/border_only,
/obj/effect/turf_decal/techfloor/orange,
/obj/structure/cable{
	icon_state = "1-2"
	},
/obj/machinery/atmospherics/pipe/simple/supply/hidden/layer2,
/obj/machinery/door/airlock/grunge{
	name = "Starboard Nacelle"
	},
/turf/open/floor/plasteel/tech/grid,
/area/ship/bridge)
"J" = (
/obj/effect/turf_decal/siding/thinplating/dark,
/obj/effect/turf_decal/siding/thinplating/dark/corner{
	dir = 1
	},
/obj/machinery/atmospherics/pipe/simple/scrubbers/hidden/layer4{
	dir = 9
	},
/obj/machinery/atmospherics/pipe/simple/supply/hidden/layer2{
	dir = 9
	},
/obj/structure/cable{
	icon_state = "1-8"
	},
/obj/structure/closet/emcloset/wall/directional/east,
/turf/open/floor/plasteel/tech,
/area/ship/bridge)
"K" = (
/obj/effect/turf_decal/siding/black{
	dir = 10
	},
/obj/machinery/atmospherics/pipe/simple/supply/hidden/layer2{
	dir = 8
	},
/obj/structure/cable{
	icon_state = "4-8"
	},
/turf/open/floor/plasteel/patterned/brushed,
/area/ship/bridge)
"L" = (
/obj/machinery/door/airlock/external/glass{
	dir = 4
	},
/obj/machinery/atmospherics/pipe/simple/scrubbers/hidden/layer4{
	dir = 4
	},
/obj/machinery/atmospherics/pipe/simple/supply/hidden/layer2{
	dir = 8
	},
/turf/open/floor/engine/hull/reinforced/interior,
/area/ship/bridge)
"M" = (
/obj/structure/cable{
	icon_state = "0-8"
	},
/obj/machinery/power/smes/shuttle/precharged,
/obj/effect/turf_decal/industrial/warning/fulltile,
/obj/structure/window/reinforced{
	dir = 8
	},
/obj/machinery/door/poddoor{
	dir = 4;
	id = "nail_starboard_engine_blast"
	},
/turf/open/floor/engine/hull/reinforced/interior,
/area/ship/bridge)
"N" = (
/obj/structure/railing/thin/corner{
	dir = 1
	},
/obj/effect/turf_decal/siding/thinplating/dark,
/obj/effect/turf_decal/siding/thinplating/dark{
	dir = 1
	},
/obj/machinery/atmospherics/pipe/simple/supply/hidden/layer2{
	dir = 8
	},
/obj/machinery/atmospherics/pipe/simple/scrubbers/hidden/layer4{
	dir = 4
	},
/obj/structure/cable{
	icon_state = "4-8"
	},
/turf/open/floor/plasteel/tech,
/area/ship/bridge)
"O" = (
/obj/machinery/computer/helm/viewscreen/directional/west,
/obj/effect/turf_decal/corner_steel_grid{
	dir = 9
	},
/obj/machinery/airalarm/directional/north,
/turf/open/floor/plasteel/mono/dark,
/area/ship/bridge)
"P" = (
/obj/effect/turf_decal/box,
/obj/machinery/porta_turret/ship/pgf{
	dir = 5;
	id = "nail_grid"
	},
/turf/open/floor/engine/hull/reinforced/interior,
/area/ship/external/dark)
"Q" = (
/obj/machinery/door/airlock/external{
	dir = 4
	},
/obj/machinery/atmospherics/pipe/layer_manifold{
	dir = 4
	},
/turf/open/floor/engine/hull/reinforced/interior,
/area/ship/bridge)
"R" = (
/obj/effect/turf_decal/siding/thinplating/dark{
	dir = 4
	},
/obj/structure/cable{
	icon_state = "1-4"
	},
/obj/effect/turf_decal/industrial/hatch/yellow,
/obj/structure/crate_shelf,
/turf/open/floor/plasteel/tech,
/area/ship/bridge)
"S" = (
/obj/effect/turf_decal/siding/black{
	dir = 6;
	layer = 2.139
	},
/obj/machinery/atmospherics/pipe/simple/scrubbers/hidden/layer4{
	dir = 4
	},
/obj/machinery/atmospherics/pipe/simple/supply/hidden/layer2{
	dir = 8
	},
/obj/structure/cable{
	icon_state = "4-8"
	},
/turf/open/floor/plasteel/patterned/brushed,
/area/ship/bridge)
"T" = (
/obj/machinery/atmospherics/pipe/simple/scrubbers/hidden/layer4{
	dir = 4
	},
/obj/machinery/atmospherics/pipe/simple/supply/hidden/layer2{
	dir = 8
	},
/obj/structure/chair/handrail{
	dir = 1
	},
/turf/open/floor/engine/hull/reinforced/interior,
/area/ship/bridge)
"U" = (
/obj/structure/window/plasma/reinforced/plastitanium,
/obj/structure/grille,
/turf/open/floor/plating/airless,
/area/ship/bridge)
"V" = (
/obj/machinery/computer/helm/viewscreen/directional/east,
/obj/effect/turf_decal/corner_steel_grid{
	dir = 6
	},
/obj/machinery/power/apc/auto_name/directional/north,
/obj/effect/turf_decal/steeldecal/steel_decals_central7{
	dir = 8
	},
/obj/structure/cable{
	icon_state = "0-2"
	},
/obj/machinery/light_switch{
	pixel_x = -12;
	pixel_y = 22
	},
/turf/open/floor/plasteel/mono/dark,
/area/ship/bridge)
"W" = (
/turf/closed/wall/mineral/plastitanium/nodiagonal,
/area/ship/bridge)
"X" = (
/obj/structure/chair/handrail{
	dir = 2;
	layer = 2.89
	},
/obj/effect/turf_decal/siding/black{
	dir = 1
	},
/obj/machinery/atmospherics/components/unary/vent_pump/on/layer2{
	dir = 4
	},
/obj/machinery/light/small/directional/north,
/obj/machinery/atmospherics/pipe/simple/scrubbers/hidden/layer4{
	dir = 4
	},
/obj/structure/cable{
	icon_state = "4-8"
	},
/turf/open/floor/plasteel/patterned/brushed,
/area/ship/bridge)
"Y" = (
/obj/structure/chair/comfy/shuttle{
	dir = 4
	},
/obj/effect/turf_decal/techfloor,
/obj/machinery/button/door{
	id = "nail_window_shut";
	name = "Nail Window Shutters";
	dir = 1;
	pixel_y = -20;
	pixel_x = -9
	},
/obj/machinery/turretid/ship{
	pixel_y = -30;
	pixel_x = -2;
	id = "nail_grid"
	},
/obj/item/radio/intercom/wideband/directional/south{
	pixel_y = -28;
	pixel_x = 5
	},
/turf/open/floor/plasteel/telecomms_floor,
/area/ship/bridge)
"Z" = (
/obj/structure/cable{
	icon_state = "0-8"
	},
/obj/machinery/power/smes/shuttle/precharged,
/obj/effect/turf_decal/industrial/warning/fulltile,
/obj/structure/window/reinforced{
	dir = 8
	},
/obj/machinery/door/poddoor{
	dir = 4;
	id = "nail_port_engine_blast"
	},
/turf/open/floor/engine/hull/reinforced/interior,
/area/ship/bridge)

(1,1,1) = {"
c
c
W
d
t
W
c
c
"}
(2,1,1) = {"
c
y
W
H
K
W
q
c
"}
(3,1,1) = {"
G
Z
W
X
l
W
M
W
"}
(4,1,1) = {"
G
f
C
z
A
I
k
W
"}
(5,1,1) = {"
G
F
W
x
S
W
b
W
"}
(6,1,1) = {"
G
W
W
U
h
W
W
W
"}
(7,1,1) = {"
P
W
O
E
r
v
R
W
"}
(8,1,1) = {"
c
W
B
i
u
e
w
W
"}
(9,1,1) = {"
c
W
D
s
N
Y
W
W
"}
(10,1,1) = {"
c
W
V
p
J
a
m
g
"}
(11,1,1) = {"
c
W
W
L
W
m
m
c
"}
(12,1,1) = {"
c
W
j
T
W
m
c
c
"}
(13,1,1) = {"
c
W
o
n
W
c
c
c
"}
(14,1,1) = {"
c
W
W
Q
W
c
c
c
"}
