//MAP CONVERTED BY dmm2tgm.py THIS HEADER COMMENT PREVENTS RECONVERSION, DO NOT REMOVE
"a" = (
/obj/machinery/porta_turret/ship/ballistic{
	dir = 8
	},
/turf/open/floor/engine/hull,
/area/ship/external/dark)
"b" = (
/obj/structure/railing{
	dir = 8
	},
/turf/open/floor/plasteel/tech,
/area/ship/bridge)
"c" = (
/obj/machinery/power/smes/shuttle/precharged{
	dir = 8
	},
/obj/structure/railing/corner{
	dir = 8
	},
/obj/structure/cable/blue{
	icon_state = "0-4"
	},
/turf/open/floor/plasteel/tech,
/area/ship/bridge)
"d" = (
/obj/machinery/holopad/emergency,
/obj/structure/cable{
	icon_state = "4-8"
	},
/turf/open/floor/plasteel/patterned/brushed,
/area/ship/bridge)
"e" = (
/obj/structure/window/plasma/reinforced/plastitanium,
/turf/open/floor/plating,
/area/ship/bridge)
"f" = (
/obj/structure/sign/number/random,
/turf/closed/wall/mineral/plastitanium,
/area/ship/bridge)
"g" = (
/obj/structure/railing,
/obj/structure/catwalk/over/plated_catwalk/dark,
/obj/machinery/power/terminal{
	dir = 4
	},
/obj/structure/cable{
	icon_state = "0-2"
	},
/turf/open/floor/plasteel/tech,
/area/ship/bridge)
"h" = (
/obj/structure/railing/corner,
/obj/machinery/power/smes/engineering,
/obj/structure/cable{
	icon_state = "0-4"
	},
/turf/open/floor/plasteel/tech,
/area/ship/bridge)
"i" = (
/obj/structure/cable{
	icon_state = "0-8"
	},
/obj/structure/cable{
	icon_state = "0-6"
	},
/obj/machinery/power/terminal,
/obj/structure/catwalk/over/plated_catwalk/dark,
/turf/open/floor/plating,
/area/ship/bridge)
"j" = (
/obj/structure/cable{
	icon_state = "4-8"
	},
/obj/structure/chair/comfy/shuttle{
	dir = 8
	},
/turf/open/floor/plasteel/patterned/brushed,
/area/ship/bridge)
"m" = (
/obj/structure/cable{
	icon_state = "4-8"
	},
/obj/structure/cable{
	icon_state = "2-8"
	},
/obj/structure/cable{
	icon_state = "1-8"
	},
/turf/open/floor/plasteel/patterned/brushed,
/area/ship/bridge)
"n" = (
/turf/closed/wall/mineral/plastitanium/nodiagonal,
/area/ship/bridge)
"p" = (
/obj/structure/chair/comfy/shuttle{
	dir = 1
	},
/obj/structure/cable{
	icon_state = "1-2"
	},
/turf/open/floor/plasteel/dark,
/area/ship/bridge)
"q" = (
/obj/structure/chair/comfy/shuttle,
/obj/machinery/light/directional/north,
/turf/open/floor/plasteel/dark,
/area/ship/bridge)
"r" = (
/obj/structure/railing{
	dir = 4
	},
/obj/structure/closet/emcloset/wall{
	pixel_y = 28
	},
/turf/open/floor/plasteel/tech,
/area/ship/bridge)
"s" = (
/obj/structure/railing{
	dir = 1
	},
/obj/structure/catwalk/over/plated_catwalk/dark,
/obj/machinery/power/terminal{
	dir = 4
	},
/obj/structure/cable{
	icon_state = "0-1"
	},
/turf/open/floor/plasteel/tech,
/area/ship/bridge)
"u" = (
/obj/structure/sign/number/random,
/turf/closed/wall/mineral/plastitanium/nodiagonal,
/area/ship/bridge)
"v" = (
/turf/template_noop,
/area/template_noop)
"w" = (
/obj/machinery/power/apc/auto_name/directional/north,
/obj/structure/cable{
	icon_state = "0-2"
	},
/obj/structure/catwalk/over/plated_catwalk/dark,
/turf/open/floor/plating,
/area/ship/bridge)
"y" = (
/turf/closed/wall/mineral/plastitanium,
/area/ship/bridge)
"A" = (
/obj/machinery/computer/helm{
	dir = 4
	},
/turf/open/floor/plasteel/telecomms_floor,
/area/ship/bridge)
"C" = (
/obj/structure/chair/comfy/shuttle{
	dir = 1
	},
/obj/structure/railing{
	dir = 8
	},
/obj/machinery/light/directional/south,
/turf/open/floor/plasteel/dark,
/area/ship/bridge)
"E" = (
/obj/structure/cable{
	icon_state = "4-8"
	},
/obj/structure/cable{
	icon_state = "2-8"
	},
/obj/structure/cable{
	icon_state = "1-8"
	},
/obj/machinery/door/poddoor/shutters/preopen{
	dir = 8;
	id = "nail_blast"
	},
/turf/open/floor/plasteel/patterned/brushed,
/area/ship/bridge)
"G" = (
/obj/structure/chair/comfy/shuttle,
/obj/structure/cable{
	icon_state = "1-2"
	},
/turf/open/floor/plasteel/dark,
/area/ship/bridge)
"H" = (
/obj/machinery/power/shuttle/engine/electric{
	dir = 8
	},
/obj/structure/cable/blue{
	icon_state = "0-8"
	},
/turf/open/floor/plating,
/area/ship/bridge)
"J" = (
/turf/open/floor/engine/hull,
/area/ship/external/dark)
"L" = (
/obj/machinery/power/smes/shuttle/precharged{
	dir = 8
	},
/obj/structure/railing/corner{
	dir = 1
	},
/obj/structure/cable/blue{
	icon_state = "0-4"
	},
/turf/open/floor/plasteel/tech,
/area/ship/bridge)
"M" = (
/obj/structure/cable{
	icon_state = "4-8"
	},
/obj/docking_port/mobile{
	dir = 8;
	name = "nail dock";
	preferred_direction = 8;
	port_direction = 2
	},
/turf/open/floor/engine/hull,
/area/ship/external/dark)
"O" = (
/obj/structure/railing,
/obj/structure/cable{
	icon_state = "1-8"
	},
/obj/structure/cable{
	icon_state = "4-9"
	},
/obj/structure/catwalk/over/plated_catwalk/dark,
/turf/open/floor/plating,
/area/ship/bridge)
"P" = (
/obj/structure/cable{
	icon_state = "0-1"
	},
/obj/machinery/power/shieldwallgen/atmos{
	id = "nail_holo";
	dir = 1
	},
/obj/machinery/door/poddoor/shutters/preopen{
	dir = 8;
	id = "nail_blast"
	},
/turf/open/floor/plasteel/patterned/brushed,
/area/ship/bridge)
"Q" = (
/obj/structure/cable{
	icon_state = "0-2"
	},
/obj/machinery/power/shieldwallgen/atmos{
	id = "nail_holo"
	},
/obj/machinery/door/poddoor/shutters/preopen{
	dir = 8;
	id = "nail_blast"
	},
/turf/open/floor/plasteel/patterned/brushed,
/area/ship/bridge)
"R" = (
/obj/structure/cable{
	icon_state = "0-4"
	},
/obj/machinery/power/port_gen/pacman,
/obj/structure/catwalk/over/plated_catwalk/dark,
/obj/item/wrench,
/obj/machinery/light/directional/west,
/turf/open/floor/plating,
/area/ship/bridge)
"W" = (
/obj/structure/cable{
	icon_state = "4-8"
	},
/turf/open/floor/plasteel/patterned/brushed,
/area/ship/bridge)
"Y" = (
/obj/machinery/button/shieldwallgen{
	id = "nail_holo";
	dir = 1;
	pixel_x = -1;
	pixel_y = -19
	},
/obj/machinery/light_switch{
	dir = 1;
	pixel_x = -13;
	pixel_y = -19
	},
/obj/machinery/button/door{
	id = "nail_blast";
	name = "Nail Shutters";
	dir = 1;
	pixel_y = -20;
	pixel_x = 7
	},
/turf/open/floor/plasteel/telecomms_floor,
/area/ship/bridge)

(1,1,1) = {"
v
y
y
y
a
v
v
"}
(2,1,1) = {"
v
y
R
y
e
v
v
"}
(3,1,1) = {"
v
y
i
h
e
e
v
"}
(4,1,1) = {"
v
y
w
O
A
n
v
"}
(5,1,1) = {"
v
n
r
d
Y
n
v
"}
(6,1,1) = {"
y
n
q
j
C
n
f
"}
(7,1,1) = {"
y
g
G
m
p
s
f
"}
(8,1,1) = {"
y
c
b
W
b
L
f
"}
(9,1,1) = {"
n
H
Q
E
P
H
u
"}
(10,1,1) = {"
v
v
J
M
J
v
v
"}
