//MAP CONVERTED BY dmm2tgm.py THIS HEADER COMMENT PREVENTS RECONVERSION, DO NOT REMOVE
"a" = (
/turf/template_noop,
/area/template_noop)
"b" = (
/obj/effect/decal/cleanable/dirt,
/obj/effect/turf_decal/bot,
/obj/effect/turf_decal/stripes/line{
	dir = 1
	},
/obj/structure/cable,
/obj/machinery/power/terminal,
/turf/open/floor/plating,
/area/shuttle/mining)
"c" = (
/obj/item/clothing/suit/hazardvest{
	desc = "A high-visibility lifejacket complete with whistle and slot for oxygen tanks.";
	name = "emergency lifejacket"
	},
/obj/item/clothing/suit/hazardvest{
	desc = "A high-visibility lifejacket complete with whistle and slot for oxygen tanks.";
	name = "emergency lifejacket"
	},
/obj/item/tank/internals/emergency_oxygen{
	pixel_x = 3
	},
/obj/item/tank/internals/emergency_oxygen{
	pixel_x = 3
	},
/obj/item/clothing/mask/breath{
	pixel_x = -3;
	pixel_y = -3
	},
/obj/item/clothing/mask/breath{
	pixel_x = -3;
	pixel_y = -3
	},
/obj/structure/closet/crate/internals,
/obj/effect/turf_decal/box/corners{
	dir = 1
	},
/obj/item/pickaxe/emergency,
/obj/item/clothing/head/hardhat/mining,
/obj/item/clothing/head/hardhat/mining,
/obj/item/storage/overmap_ship/electric{
	pixel_x = -22
	},
/turf/open/floor/mineral/plastitanium,
/area/shuttle/mining)
"e" = (
/obj/item/crowbar/red,
/obj/item/wrench,
/obj/effect/turf_decal/bot,
/obj/effect/turf_decal/stripes/line{
	dir = 1
	},
/obj/structure/cable,
/obj/machinery/power/terminal,
/obj/structure/table,
/obj/item/storage/toolbox/emergency,
/turf/open/floor/plating,
/area/shuttle/mining)
"f" = (
/obj/effect/decal/cleanable/dirt,
/obj/item/stock_parts/cell/high,
/obj/item/screwdriver{
	pixel_y = 18
	},
/obj/structure/table,
/obj/machinery/airalarm{
	dir = 8;
	pixel_x = 24
	},
/turf/open/floor/mineral/plastitanium,
/area/shuttle/mining)
"h" = (
/turf/closed/wall/mineral/titanium/nodiagonal,
/area/shuttle/mining)
"j" = (
/obj/structure/sign/warning/vacuum/external{
	pixel_x = 32
	},
/obj/machinery/light/small{
	dir = 8
	},
/obj/structure/cable{
	icon_state = "1-2"
	},
/obj/machinery/advanced_airlock_controller/lavaland{
	pixel_x = -27
	},
/obj/machinery/atmospherics/pipe/simple/supply/hidden,
/obj/machinery/atmospherics/components/unary/vent_pump/layer1{
	dir = 1
	},
/turf/open/floor/plating,
/area/shuttle/mining)
"l" = (
/obj/effect/turf_decal/box/corners,
/obj/structure/cable{
	icon_state = "4-8"
	},
/obj/structure/sign/warning/electricshock{
	pixel_y = -32
	},
/turf/open/floor/mineral/plastitanium,
/area/shuttle/mining)
"m" = (
/obj/item/clothing/mask/gas{
	pixel_x = -4;
	pixel_y = 4
	},
/obj/item/tank/internals/emergency_oxygen{
	pixel_x = 4
	},
/obj/structure/table,
/turf/open/floor/mineral/plastitanium,
/area/shuttle/mining)
"o" = (
/obj/structure/chair/comfy/shuttle{
	dir = 1
	},
/obj/effect/turf_decal/stripes/line{
	dir = 1
	},
/turf/open/floor/mineral/titanium/yellow,
/area/shuttle/mining)
"p" = (
/obj/machinery/light/small,
/obj/effect/decal/cleanable/dirt,
/obj/effect/turf_decal/stripes/line{
	dir = 4
	},
/obj/effect/turf_decal/stripes/corner{
	dir = 8
	},
/obj/item/radio/intercom/wideband{
	pixel_y = -29
	},
/turf/open/floor/mineral/titanium/yellow,
/area/shuttle/mining)
"s" = (
/obj/structure/table,
/obj/item/stack/ore/iron{
	pixel_x = 6;
	pixel_y = 4
	},
/obj/item/stack/ore/iron{
	pixel_x = -2;
	pixel_y = -8
	},
/turf/open/floor/mineral/plastitanium,
/area/shuttle/mining)
"t" = (
/obj/effect/turf_decal/box/corners{
	dir = 4
	},
/obj/machinery/light/small{
	dir = 1
	},
/obj/machinery/atmospherics/components/unary/portables_connector/layer1{
	dir = 4
	},
/obj/machinery/portable_atmospherics/canister/air,
/turf/open/floor/mineral/plastitanium,
/area/shuttle/mining)
"v" = (
/obj/machinery/atmospherics/pipe/manifold4w/general/hidden/layer1,
/turf/open/floor/mineral/titanium/yellow,
/area/shuttle/mining)
"x" = (
/obj/structure/chair/comfy/shuttle{
	dir = 1
	},
/obj/effect/turf_decal/stripes/line{
	dir = 9
	},
/turf/open/floor/mineral/titanium/yellow,
/area/shuttle/mining)
"y" = (
/obj/effect/decal/cleanable/dirt,
/obj/machinery/computer/camera_advanced/shuttle_docker/nav,
/obj/effect/turf_decal/bot,
/turf/open/floor/mineral/plastitanium,
/area/shuttle/mining)
"z" = (
/obj/effect/turf_decal/box/corners,
/obj/structure/cable{
	icon_state = "2-8"
	},
/turf/open/floor/mineral/plastitanium,
/area/shuttle/mining)
"A" = (
/obj/machinery/light/small,
/obj/effect/turf_decal/stripes/line{
	dir = 8
	},
/obj/effect/turf_decal/stripes/corner,
/turf/open/floor/mineral/titanium/yellow,
/area/shuttle/mining)
"B" = (
/obj/machinery/power/smes/shuttle/precharged{
	dir = 1
	},
/obj/structure/cable{
	icon_state = "0-2"
	},
/obj/structure/window/reinforced,
/obj/machinery/door/window/northleft{
	name = "Engine Access"
	},
/turf/open/floor/plating,
/area/shuttle/mining)
"C" = (
/obj/effect/turf_decal/stripes/line,
/obj/machinery/atmospherics/components/unary/vent_pump/on/layer1,
/turf/open/floor/mineral/titanium/yellow,
/area/shuttle/mining)
"F" = (
/obj/structure/cable{
	icon_state = "2-4"
	},
/obj/structure/cable{
	icon_state = "2-8"
	},
/obj/machinery/atmospherics/pipe/layer_manifold,
/turf/open/floor/mineral/titanium/yellow,
/area/shuttle/mining)
"G" = (
/obj/structure/chair/comfy/shuttle{
	dir = 1
	},
/obj/effect/turf_decal/stripes/line{
	dir = 5
	},
/turf/open/floor/mineral/titanium/yellow,
/area/shuttle/mining)
"H" = (
/obj/effect/decal/cleanable/dirt,
/obj/structure/ore_box,
/obj/effect/turf_decal/box/corners{
	dir = 4
	},
/obj/structure/extinguisher_cabinet{
	pixel_x = 24
	},
/turf/open/floor/mineral/plastitanium,
/area/shuttle/mining)
"I" = (
/obj/effect/turf_decal/tile/neutral,
/obj/effect/turf_decal/tile/neutral{
	dir = 8
	},
/obj/effect/turf_decal/tile/neutral{
	dir = 4
	},
/obj/effect/turf_decal/tile/neutral{
	dir = 1
	},
/obj/machinery/door/airlock/mining{
	name = "Mining Shuttle Cockpit"
	},
/obj/machinery/atmospherics/pipe/simple/general/hidden/layer1,
/turf/open/floor/plasteel/dark,
/area/shuttle/mining)
"J" = (
/obj/machinery/status_display/shuttle{
	shuttle_id = "mining"
	},
/turf/closed/wall/mineral/titanium/nodiagonal,
/area/shuttle/mining)
"K" = (
/obj/effect/spawner/structure/window/shuttle,
/obj/machinery/door/firedoor/window,
/turf/open/floor/plating,
/area/shuttle/mining)
"L" = (
/obj/machinery/door/airlock/external{
	name = "Mining Shuttle External Airlock"
	},
/obj/effect/mapping_helpers/airlock/cyclelink_helper{
	dir = 1
	},
/obj/docking_port/mobile{
	dwidth = 3;
	height = 10;
	id = "mining";
	name = "mining shuttle";
	port_direction = 2;
	width = 7
	},
/obj/effect/turf_decal/stripes/line,
/obj/structure/cable{
	icon_state = "1-2"
	},
/obj/machinery/atmospherics/pipe/simple/supply/hidden,
/turf/open/floor/plating,
/area/shuttle/mining)
"M" = (
/obj/structure/sign/departments/cargo,
/turf/closed/wall/mineral/titanium/nodiagonal,
/area/shuttle/mining)
"O" = (
/obj/machinery/door/airlock/external{
	name = "Mining Shuttle External Airlock"
	},
/obj/effect/mapping_helpers/airlock/cyclelink_helper,
/obj/effect/turf_decal/stripes/line{
	dir = 1
	},
/obj/structure/cable{
	icon_state = "1-2"
	},
/obj/machinery/atmospherics/pipe/simple/supply/hidden,
/obj/machinery/atmospherics/components/binary/pump{
	dir = 1
	},
/obj/machinery/atmospherics/pipe/simple/general/hidden/layer1,
/turf/open/floor/plating,
/area/shuttle/mining)
"P" = (
/turf/closed/wall/mineral/titanium,
/area/shuttle/mining)
"Q" = (
/obj/effect/turf_decal/bot,
/obj/machinery/computer/helm,
/turf/open/floor/mineral/plastitanium,
/area/shuttle/mining)
"S" = (
/obj/machinery/power/shuttle/engine/electric{
	dir = 1
	},
/obj/structure/cable,
/turf/open/floor/plating/airless,
/area/shuttle/mining)
"T" = (
/obj/item/folder/yellow,
/obj/item/pen,
/obj/effect/decal/cleanable/dirt,
/obj/structure/table,
/turf/open/floor/mineral/plastitanium,
/area/shuttle/mining)
"U" = (
/obj/item/storage/firstaid/regular,
/obj/structure/table,
/turf/open/floor/mineral/plastitanium,
/area/shuttle/mining)
"V" = (
/obj/machinery/power/smes/shuttle/precharged{
	dir = 1
	},
/obj/structure/cable{
	icon_state = "0-2"
	},
/obj/structure/window/reinforced,
/obj/machinery/door/window/northright{
	name = "Engine Access"
	},
/turf/open/floor/plating,
/area/shuttle/mining)
"W" = (
/obj/effect/turf_decal/box/corners{
	dir = 8
	},
/obj/structure/cable{
	icon_state = "2-4"
	},
/turf/open/floor/mineral/plastitanium,
/area/shuttle/mining)
"X" = (
/obj/effect/turf_decal/box/corners{
	dir = 1
	},
/obj/machinery/light/small{
	dir = 1
	},
/obj/machinery/atmospherics/components/unary/vent_pump/on/layer1{
	dir = 8
	},
/turf/open/floor/mineral/plastitanium,
/area/shuttle/mining)
"Z" = (
/obj/effect/turf_decal/box/corners{
	dir = 8
	},
/obj/structure/cable{
	icon_state = "4-8"
	},
/obj/structure/sign/warning/electricshock{
	pixel_y = -32
	},
/turf/open/floor/mineral/plastitanium,
/area/shuttle/mining)

(1,1,1) = {"
a
K
K
h
h
h
K
h
P
a
"}
(2,1,1) = {"
K
K
U
T
M
c
W
e
B
S
"}
(3,1,1) = {"
K
y
x
A
J
t
l
h
h
h
"}
(4,1,1) = {"
K
Q
o
C
I
v
F
O
j
L
"}
(5,1,1) = {"
K
m
G
p
h
X
Z
h
h
h
"}
(6,1,1) = {"
K
K
s
f
h
H
z
b
V
S
"}
(7,1,1) = {"
a
K
K
h
h
h
K
h
P
a
"}
