//MAP CONVERTED BY dmm2tgm.py THIS HEADER COMMENT PREVENTS RECONVERSION, DO NOT REMOVE
"a" = (
/turf/template_noop,
/area/template_noop)
"s" = (
/turf/open/floor/plating/asteroid/moon_coarse/dark/lit,
/area/template_noop)
"G" = (
/turf/closed/mineral/random/moon/lit,
/area/template_noop)

(1,1,1) = {"
s
G
a
a
a
a
"}
(2,1,1) = {"
s
s
s
G
G
a
"}
(3,1,1) = {"
G
s
s
s
s
G
"}
(4,1,1) = {"
a
G
s
s
s
G
"}
(5,1,1) = {"
a
G
s
s
G
G
"}
(6,1,1) = {"
a
s
G
G
G
a
"}
