//MAP CONVERTED BY dmm2tgm.py THIS HEADER COMMENT PREVENTS RECONVERSION, DO NOT REMOVE
"aa" = (
/obj/item/restraints/legcuffs/beartrap,
/turf/open/space/basic,
/area/space)
"ae" = (
/obj/structure/window/reinforced{
	dir = 1
	},
/obj/structure/window/reinforced{
	dir = 4
	},
/obj/structure/window/fulltile,
/obj/structure/grille,
/turf/open/floor/plating,
/area/space)
"aw" = (
/obj/machinery/atmospherics/pipe/simple/general/visible/layer2,
/turf/open/floor/plating,
/area/space)
"az" = (
/obj/structure/window/reinforced{
	dir = 1
	},
/obj/structure/window/reinforced,
/obj/structure/window/fulltile,
/obj/structure/grille,
/obj/structure/grille,
/turf/open/floor/plating,
/area/space)
"dO" = (
/turf/open/floor/plating,
/area/overmap_encounter)
"eg" = (
/obj/structure/cable{
	icon_state = "1-2"
	},
/turf/open/floor/plating,
/area/space)
"fC" = (
/turf/open/floor/plating,
/area/ruin/powered)
"gX" = (
/turf/open/floor/plating,
/area/ruin/unpowered/ash_walkers)
"hE" = (
/obj/structure/window/reinforced,
/obj/structure/window/reinforced{
	dir = 4
	},
/obj/structure/window/fulltile,
/obj/structure/window/fulltile,
/obj/structure/grille,
/turf/open/floor/plating,
/area/space)
"hN" = (
/obj/structure/cable{
	icon_state = "4-8"
	},
/turf/open/floor/plating,
/area/space)
"is" = (
/obj/machinery/power/terminal{
	dir = 8
	},
/obj/structure/cable{
	icon_state = "0-4"
	},
/turf/open/floor/plating,
/area/space)
"it" = (
/turf/open/floor/plasteel{
	initial_gas_mix = "ICEMOON_ATMOS";
	baseturfs = /turf/open/floor/plating/ice
	},
/area/space)
"iJ" = (
/obj/effect/spawner/structure/window,
/obj/structure/cable{
	icon_state = "1-2"
	},
/turf/open/floor/plating,
/area/space)
"jd" = (
/obj/machinery/power/apc/auto_name/west,
/obj/structure/cable{
	icon_state = "0-4"
	},
/turf/open/floor/plating,
/area/space)
"kT" = (
/obj/structure/window/reinforced,
/obj/structure/window/reinforced{
	dir = 1
	},
/obj/structure/window/fulltile,
/obj/structure/window/fulltile,
/obj/structure/grille,
/turf/open/floor/plating,
/area/space)
"mh" = (
/turf/open/floor/plating,
/area/ruin/unpowered)
"nc" = (
/obj/machinery/atmospherics/pipe/manifold/general/visible/layer1{
	dir = 8
	},
/turf/open/floor/plating,
/area/space)
"nL" = (
/obj/structure/window/reinforced{
	dir = 1
	},
/obj/structure/window/reinforced{
	dir = 8
	},
/obj/structure/window/fulltile,
/obj/structure/grille,
/turf/open/floor/plating,
/area/space)
"oz" = (
/turf/open/floor/plating/asteroid/snow/icemoon,
/area/space)
"oL" = (
/turf/open/space/basic,
/area/space)
"rz" = (
/obj/machinery/power/smes,
/obj/structure/cable{
	icon_state = "0-8"
	},
/turf/open/floor/plating,
/area/space)
"rB" = (
/turf/closed/wall/mineral/iron,
/area/space)
"tH" = (
/obj/effect/spawner/structure/window/reinforced,
/obj/structure/window/reinforced{
	dir = 1
	},
/turf/open/floor/plating,
/area/space)
"uH" = (
/obj/structure/cable,
/turf/open/floor/plating,
/area/space)
"uQ" = (
/obj/effect/spawner/structure/window/reinforced,
/obj/structure/window/reinforced{
	dir = 8
	},
/turf/open/floor/plating,
/area/space)
"vl" = (
/mob/living/simple_animal/hostile/megafauna/dragon,
/turf/open/floor/plating,
/area/space)
"wa" = (
/obj/machinery/atmospherics/components/unary/tank/toxins{
	dir = 1;
	piping_layer = 2;
	volume = 250000
	},
/turf/open/floor/plating,
/area/space)
"wY" = (
/obj/machinery/door/poddoor/crusher/automatic,
/turf/open/space/basic,
/area/space)
"xb" = (
/obj/machinery/door/airlock/external,
/turf/open/space/basic,
/area/space)
"xH" = (
/obj/item/keycard/gatedrop,
/turf/open/space/basic,
/area/space)
"xV" = (
/obj/effect/spawner/structure/window/reinforced,
/obj/structure/window/reinforced,
/obj/structure/window/reinforced{
	dir = 8
	},
/turf/open/floor/plating,
/area/space)
"yx" = (
/obj/machinery/power/smes,
/obj/structure/cable{
	icon_state = "0-2"
	},
/turf/open/floor/plating,
/area/space)
"yC" = (
/obj/machinery/power/terminal{
	dir = 1
	},
/obj/structure/cable{
	icon_state = "0-2"
	},
/turf/open/floor/plating,
/area/space)
"yJ" = (
/obj/structure/window/reinforced{
	dir = 8
	},
/obj/structure/window/reinforced{
	dir = 4
	},
/obj/structure/window/fulltile,
/obj/structure/grille,
/turf/open/floor/plating,
/area/space)
"zF" = (
/obj/effect/spawner/structure/window/reinforced,
/obj/structure/window/reinforced,
/obj/structure/window/reinforced{
	dir = 4
	},
/turf/open/floor/plating,
/area/space)
"zS" = (
/obj/effect/spawner/structure/window/reinforced,
/obj/structure/window/reinforced{
	dir = 8
	},
/obj/structure/window/reinforced{
	dir = 1
	},
/turf/open/floor/plating,
/area/space)
"AE" = (
/turf/open/floor/plasteel/icemoon,
/area/space)
"BB" = (
/obj/item/storage/bag/money,
/turf/open/floor/plating,
/area/space)
"Cw" = (
/obj/machinery/door/poddoor/gates,
/turf/open/floor/plating,
/area/space)
"Eh" = (
/turf/open/floor/plating,
/area/space)
"EP" = (
/obj/effect/spawner/structure/window/reinforced,
/turf/open/floor/plating,
/area/space)
"Fi" = (
/obj/machinery/atmospherics/components/unary/portables_connector/visible/layer2{
	dir = 1
	},
/obj/machinery/portable_atmospherics/canister/toxins,
/turf/open/floor/plating,
/area/space)
"FD" = (
/obj/item/restraints/legcuffs/beartrap/energy,
/turf/open/space/basic,
/area/space)
"Gd" = (
/obj/machinery/power/apc,
/turf/closed/wall/mineral/iron,
/area/space)
"Gq" = (
/obj/machinery/power/port_gen/pacman/mrs,
/obj/structure/cable,
/turf/open/floor/plating,
/area/space)
"Gx" = (
/obj/item/keycard,
/turf/open/space/basic,
/area/space)
"GC" = (
/obj/machinery/door/airlock/maintenance_hatch,
/turf/open/space/basic,
/area/space)
"HP" = (
/obj/structure/window/reinforced{
	dir = 4
	},
/obj/structure/window/reinforced{
	dir = 8
	},
/obj/structure/window/fulltile,
/obj/structure/grille,
/turf/open/floor/plating,
/area/space)
"HQ" = (
/obj/machinery/door/airlock/maintenance_hatch,
/turf/open/floor/plating,
/area/space)
"Ih" = (
/obj/effect/spawner/trap,
/turf/open/space/basic,
/area/space)
"OW" = (
/obj/machinery/atmospherics/components/unary/tank/toxins{
	dir = 1;
	piping_layer = 2;
	volume = 250000
	},
/obj/machinery/atmospherics/components/unary/portables_connector/visible/layer2,
/turf/open/floor/plating,
/area/space)
"PO" = (
/obj/structure/cable,
/obj/machinery/power/port_gen/pacman/mrs,
/turf/open/floor/plating,
/area/space)
"PW" = (
/obj/structure/cable{
	icon_state = "1-2"
	},
/turf/closed/wall/mineral/iron,
/area/space)
"Qa" = (
/obj/effect/spawner/structure/window/reinforced,
/obj/structure/window/reinforced,
/turf/open/floor/plating,
/area/space)
"Qz" = (
/turf/open/floor/plating/ice/icemoon{
	baseturfs = s
	},
/area/space)
"RV" = (
/obj/machinery/door/keycard,
/turf/open/space/basic,
/area/space)
"RX" = (
/turf/open/floor/plating,
/area/ruin/space/has_grav/transport18fore)
"Sb" = (
/obj/structure/window/reinforced,
/obj/structure/window/reinforced{
	dir = 8
	},
/obj/structure/window/fulltile,
/obj/structure/grille,
/turf/open/floor/plating,
/area/space)
"Su" = (
/obj/effect/landmark/ruin,
/turf/open/space/basic,
/area/space)
"SF" = (
/turf/open/floor/plating/ice/icemoon,
/area/space)
"Tl" = (
/obj/structure/window/reinforced,
/obj/structure/window/reinforced{
	dir = 4
	},
/obj/structure/window/reinforced{
	dir = 8
	},
/obj/structure/window/reinforced{
	dir = 1
	},
/turf/open/floor/plating,
/area/space)
"VP" = (
/turf/open/floor/plasteel/icemoon{
	initial_gas_mix = ss;
	baseturfs = s
	},
/area/space)
"VU" = (
/obj/effect/spawner/structure/window/reinforced,
/obj/structure/window/reinforced{
	dir = 4
	},
/turf/open/floor/plating,
/area/space)
"Ws" = (
/turf/open/floor/plating,
/area/ruin/space/oldteleporter)
"XY" = (
/obj/effect/spawner/structure/window/reinforced,
/obj/structure/window/reinforced{
	dir = 4
	},
/obj/structure/window/reinforced{
	dir = 1
	},
/turf/open/floor/plating,
/area/space)
"Yn" = (
/obj/machinery/door/airlock/external,
/turf/open/floor/plating,
/area/space)
"ZR" = (
/obj/machinery/door/keycard/gates,
/turf/open/space/basic,
/area/space)

(1,1,1) = {"
oL
oL
oL
oL
oL
oL
oL
oL
oL
oL
oL
oL
oL
oL
oL
oL
oL
oL
oL
oL
rB
rB
rB
rB
rB
rB
rB
oL
oL
oL
oL
oL
oL
oL
oL
oL
oL
oL
oL
oL
"}
(2,1,1) = {"
oL
Eh
rB
Eh
oL
oL
oL
Gd
oL
oL
oL
oL
oL
nL
yJ
Sb
oL
oL
oL
oL
rB
Eh
Eh
Eh
Eh
Eh
rB
oL
oL
oL
oL
wY
oL
oL
oL
oL
oL
oL
oL
oL
"}
(3,1,1) = {"
oL
eg
PW
uH
Su
oL
oL
is
oL
Su
oL
oL
oL
az
Eh
kT
Su
oL
oL
oL
rB
Eh
Eh
vl
Eh
Eh
HQ
oL
oL
oL
oL
aa
oL
oL
oL
oL
oL
oL
oL
oL
"}
(4,1,1) = {"
oL
Eh
rB
Eh
oL
oL
oL
hN
oL
oL
oL
oL
oL
ae
HP
hE
oL
oL
oL
oL
rB
Eh
Eh
Eh
Eh
Eh
rB
oL
oL
oL
oL
FD
oL
oL
oL
oL
oL
oL
oL
oL
"}
(5,1,1) = {"
oL
oL
oL
oL
oL
oL
oL
yx
eg
eg
Gq
oL
oL
oL
oL
oL
oL
oL
oL
oL
rB
Eh
Eh
Eh
Eh
Eh
rB
oL
oL
oL
oL
Ih
oL
oL
oL
oL
oL
oL
oL
oL
"}
(6,1,1) = {"
oL
Eh
rB
Eh
oL
oL
oL
oL
oL
oL
oL
oL
oL
zS
uQ
xV
oL
oL
oL
oL
rB
rB
rB
HQ
rB
rB
rB
oL
oL
oL
oL
oL
oL
oL
oL
oL
oL
oL
oL
oL
"}
(7,1,1) = {"
oL
eg
iJ
uH
oL
oL
oL
rB
oL
oL
oL
oL
oL
tH
Tl
Qa
oL
oL
oL
oL
oL
oL
rB
Eh
rB
oL
oL
oL
oL
oL
oL
Gx
RV
oL
oL
oL
oL
oL
oL
oL
"}
(8,1,1) = {"
oL
Eh
rB
Eh
oL
oL
oL
jd
oL
oL
oL
oL
oL
XY
VU
zF
oL
oL
oL
oL
oL
oL
rB
Eh
rB
oL
Su
oL
oL
oL
oL
xH
ZR
oL
oL
oL
oL
oL
oL
oL
"}
(9,1,1) = {"
oL
oL
oL
oL
oL
oL
oL
hN
oL
oL
oL
oL
oL
oL
oL
oL
oL
oL
oL
oL
oL
oL
rB
Eh
rB
oL
oL
oL
oL
oL
oL
oL
oL
oL
oL
oL
oL
oL
oL
oL
"}
(10,1,1) = {"
oL
oL
oL
oL
oL
oL
oL
rz
yC
eg
PO
oL
oL
EP
EP
EP
oL
oL
oL
oL
rB
rB
rB
HQ
rB
rB
rB
oL
oL
oL
oL
oL
oL
oL
oL
oL
oL
oL
oL
oL
"}
(11,1,1) = {"
oL
oL
oL
oL
oL
oL
oL
oL
oL
oL
oL
oL
oL
EP
Eh
EP
oL
oL
oL
oL
rB
Eh
Eh
BB
Eh
Eh
rB
oL
oL
oL
oL
oL
oz
it
it
SF
oL
oL
oL
oL
"}
(12,1,1) = {"
oL
Eh
rB
Eh
oL
oL
oL
oL
oL
oL
oL
oL
oL
EP
EP
EP
oL
oL
oL
oL
rB
Eh
Eh
Eh
BB
Eh
rB
oL
oL
oL
oL
Su
oz
it
it
SF
oL
oL
oL
oL
"}
(13,1,1) = {"
oL
Eh
xb
Eh
Su
oL
oL
oL
oL
oL
oL
oL
oL
oL
oL
oL
oL
oL
oL
oL
rB
BB
Eh
BB
Eh
Eh
HQ
oL
oL
oL
oL
oL
oz
it
it
Qz
oL
oL
oL
oL
"}
(14,1,1) = {"
oL
Eh
rB
Eh
oL
oL
oL
OW
nc
Fi
oL
oL
oL
oL
oL
oL
oL
oL
oL
oL
rB
Eh
Eh
Eh
BB
Eh
rB
oL
oL
oL
oL
oL
oz
oz
SF
SF
oL
oL
oL
oL
"}
(15,1,1) = {"
oL
oL
oL
oL
oL
oL
oL
oL
oL
oL
oL
oL
oL
oL
oL
oL
oL
oL
oL
oL
rB
rB
rB
rB
rB
rB
rB
oL
oL
oL
oL
oL
oL
oL
oL
oL
oL
oL
oL
oL
"}
(16,1,1) = {"
oL
Eh
rB
Eh
oL
oL
oL
wa
aw
Fi
oL
oL
oL
oL
oL
oL
oL
oL
oL
oL
oL
oL
oL
oL
oL
oL
oL
oL
oL
oL
oL
oL
oz
VP
AE
SF
oL
oL
oL
oL
"}
(17,1,1) = {"
oL
Eh
Yn
Eh
oL
oL
oL
oL
oL
oL
oL
oL
oL
oL
oL
oL
oL
oL
oL
oL
oL
oL
oL
oL
oL
oL
oL
oL
oL
oL
oL
oL
oz
AE
AE
SF
oL
oL
oL
oL
"}
(18,1,1) = {"
oL
Eh
rB
Eh
oL
oL
oL
oL
oL
oL
oL
oL
dO
RX
Ws
gX
Su
oL
oL
oL
rB
rB
rB
rB
rB
rB
rB
rB
rB
oL
oL
oL
oz
AE
AE
SF
oL
oL
oL
oL
"}
(19,1,1) = {"
oL
oL
oL
oL
oL
oL
oL
oL
oL
oL
oL
oL
dO
RX
Ws
gX
oL
oL
oL
oL
rB
Eh
Eh
BB
Eh
BB
Eh
Eh
rB
oL
oL
oL
oz
oz
SF
SF
oL
oL
oL
oL
"}
(20,1,1) = {"
oL
oL
oL
oL
oL
oL
oL
oL
oL
oL
oL
oL
dO
RX
Ws
gX
oL
oL
oL
oL
rB
BB
BB
Eh
BB
Eh
Eh
BB
rB
oL
oL
oL
oL
oL
oL
oL
oL
oL
oL
oL
"}
(21,1,1) = {"
oL
oL
oL
oL
oL
oL
oL
oL
oL
oL
oL
oL
oL
oL
oL
oL
oL
oL
oL
oL
rB
Cw
Cw
Cw
Cw
Cw
Cw
Cw
rB
oL
oL
oL
oL
oL
oL
oL
oL
oL
oL
oL
"}
(22,1,1) = {"
oL
oL
oL
oL
oL
oL
oL
oL
oL
oL
oL
oL
fC
fC
mh
mh
oL
oL
oL
oL
rB
Eh
Eh
Eh
Eh
Eh
Eh
Eh
rB
oL
oL
oL
oL
rB
rB
oL
oL
oL
oL
oL
"}
(23,1,1) = {"
oL
rB
rB
rB
rB
rB
rB
rB
oL
oL
oL
oL
fC
fC
mh
mh
oL
oL
oL
oL
rB
Eh
Eh
Eh
vl
Eh
Eh
Eh
rB
oL
oL
oL
rB
Eh
Eh
rB
oL
oL
oL
oL
"}
(24,1,1) = {"
oL
HQ
Eh
Eh
Eh
Eh
Eh
rB
oL
oL
oL
oL
fC
fC
mh
mh
oL
oL
oL
oL
rB
Eh
Eh
Eh
Eh
Eh
Eh
Eh
rB
oL
oL
oL
GC
Eh
Eh
rB
oL
Su
oL
oL
"}
(25,1,1) = {"
oL
rB
rB
rB
rB
rB
Eh
rB
Su
oL
oL
oL
oL
oL
oL
oL
oL
oL
oL
oL
rB
Eh
Eh
Eh
Eh
Eh
Eh
Eh
rB
oL
oL
oL
oL
rB
rB
oL
oL
oL
oL
oL
"}
(26,1,1) = {"
oL
oL
oL
oL
oL
rB
Eh
rB
oL
oL
oL
oL
oL
oL
oL
oL
oL
oL
oL
oL
rB
rB
rB
rB
HQ
rB
rB
rB
rB
oL
oL
oL
oL
oL
oL
oL
oL
oL
oL
oL
"}
(27,1,1) = {"
oL
oL
oL
oL
oL
rB
Eh
rB
oL
oL
oL
oL
oL
oL
oL
oL
oL
oL
oL
oL
oL
oL
oL
rB
Eh
rB
oL
oL
oL
oL
oL
oL
oL
oL
oL
oL
oL
oL
oL
oL
"}
(28,1,1) = {"
oL
oL
oL
oL
oL
rB
HQ
rB
oL
oL
oL
oL
oL
oL
oL
oL
oL
oL
oL
oL
oL
oL
oL
rB
Eh
rB
oL
oL
oL
oL
oL
oL
rB
rB
rB
rB
oL
oL
oL
oL
"}
(29,1,1) = {"
rB
rB
rB
oL
oL
oL
oL
oL
oL
oL
oL
rB
rB
rB
rB
rB
oL
oL
rB
rB
rB
rB
rB
rB
HQ
rB
rB
oL
oL
oL
oL
oL
oL
Eh
Eh
rB
oL
Su
oL
oL
"}
(30,1,1) = {"
Eh
Eh
rB
rB
rB
rB
rB
rB
oL
oL
oL
rB
Eh
Eh
BB
rB
oL
oL
Eh
Eh
Eh
Eh
rB
Eh
Eh
Eh
rB
oL
oL
oL
oL
oL
oL
Eh
Eh
rB
oL
oL
oL
oL
"}
(31,1,1) = {"
Eh
Eh
HQ
Eh
HQ
Eh
Eh
rB
oL
oL
oL
rB
BB
Eh
Eh
rB
oL
oL
Eh
Eh
Eh
Eh
HQ
Eh
Eh
Eh
rB
oL
oL
oL
oL
oL
rB
rB
rB
rB
oL
oL
oL
oL
"}
(32,1,1) = {"
Eh
Eh
rB
rB
rB
Eh
Eh
rB
oL
oL
oL
rB
BB
Eh
vl
HQ
oL
oL
Eh
Eh
Eh
Eh
rB
Eh
Eh
Eh
rB
oL
oL
oL
oL
oL
oL
oL
oL
oL
oL
oL
oL
oL
"}
(33,1,1) = {"
rB
rB
rB
oL
rB
rB
HQ
rB
oL
oL
oL
rB
Eh
Eh
BB
rB
oL
oL
rB
rB
rB
rB
rB
rB
rB
rB
rB
oL
oL
oL
oL
oL
rB
rB
rB
rB
oL
oL
oL
oL
"}
(34,1,1) = {"
oL
oL
oL
oL
oL
rB
Eh
rB
oL
oL
oL
rB
Eh
BB
Eh
rB
oL
oL
oL
oL
oL
oL
oL
oL
oL
oL
oL
oL
oL
oL
oL
oL
rB
Eh
Eh
rB
oL
oL
oL
oL
"}
(35,1,1) = {"
oL
oL
oL
oL
rB
rB
HQ
rB
rB
oL
oL
rB
rB
rB
rB
rB
oL
oL
oL
oL
oL
oL
oL
oL
oL
oL
oL
oL
oL
oL
oL
oL
HQ
Eh
Eh
rB
oL
oL
oL
oL
"}
(36,1,1) = {"
oL
oL
oL
oL
rB
Eh
Eh
Eh
rB
oL
oL
oL
oL
Su
oL
oL
oL
oL
oL
oL
oL
oL
oL
oL
oL
oL
oL
oL
oL
oL
oL
oL
rB
rB
rB
rB
oL
oL
oL
oL
"}
(37,1,1) = {"
oL
oL
oL
oL
rB
Eh
Eh
Eh
rB
oL
oL
oL
oL
oL
oL
oL
oL
oL
oL
oL
oL
oL
oL
oL
oL
oL
oL
oL
oL
oL
oL
oL
oL
oL
oL
oL
oL
oL
oL
oL
"}
(38,1,1) = {"
oL
oL
oL
oL
rB
Eh
Eh
Eh
rB
oL
oL
oL
oL
oL
oL
oL
oL
oL
oL
oL
oL
oL
oL
oL
oL
oL
oL
oL
oL
oL
oL
oL
oL
oL
oL
oL
oL
oL
oL
oL
"}
(39,1,1) = {"
oL
oL
oL
oL
oL
oL
oL
oL
oL
oL
oL
oL
oL
oL
oL
oL
oL
oL
oL
oL
oL
oL
oL
oL
oL
oL
oL
oL
oL
oL
oL
oL
oL
oL
oL
oL
oL
oL
oL
oL
"}
(40,1,1) = {"
oL
oL
oL
oL
oL
oL
oL
oL
oL
oL
oL
oL
oL
oL
oL
oL
oL
oL
oL
oL
oL
oL
oL
oL
oL
oL
oL
oL
oL
oL
oL
oL
oL
oL
oL
oL
oL
oL
oL
oL
"}
