//MAP CONVERTED BY dmm2tgm.py THIS HEADER COMMENT PREVENTS RECONVERSION, DO NOT REMOVE
"bu" = (
/obj/machinery/atmospherics/pipe/simple/supply/hidden/layer2,
/obj/machinery/atmospherics/pipe/manifold/scrubbers/hidden/layer4{
	dir = 4
	},
/turf/open/floor/plasteel,
/area/ruin/unpowered/ted/reception)
"ct" = (
/obj/machinery/door/airlock/vault,
/obj/structure/cable/pink{
	icon_state = "1-2"
	},
/obj/machinery/atmospherics/pipe/simple/supply/hidden/layer2,
/obj/machinery/atmospherics/pipe/simple/scrubbers/hidden/layer4,
/turf/open/floor/plasteel,
/area/ruin/unpowered/ted/halls)
"em" = (
/mob/living/simple_animal/hostile/megafauna/dragon/tedtalk,
/obj/structure/cable/pink{
	icon_state = "1-2"
	},
/obj/machinery/atmospherics/pipe/simple/supply/hidden/layer2{
	dir = 9
	},
/obj/machinery/atmospherics/pipe/simple/scrubbers/hidden/layer4{
	dir = 9
	},
/turf/open/floor/plasteel,
/area/ruin/unpowered/ted/halls)
"fb" = (
/obj/machinery/atmospherics/components/unary/vent_pump/on/layer2{
	dir = 4
	},
/turf/open/floor/plasteel,
/area/ruin/unpowered/ted/reception)
"fo" = (
/obj/machinery/atmospherics/pipe/simple/supply/hidden/layer2,
/obj/machinery/atmospherics/pipe/simple/scrubbers/hidden/layer4,
/turf/open/floor/plasteel,
/area/ruin/unpowered/ted/reception)
"gi" = (
/obj/machinery/power/apc/auto_name/north,
/obj/structure/cable/pink{
	icon_state = "0-4"
	},
/obj/machinery/atmospherics/pipe/simple/supply/hidden/layer2{
	dir = 4
	},
/obj/machinery/atmospherics/pipe/simple/scrubbers/hidden/layer4{
	dir = 4
	},
/turf/open/floor/plasteel,
/area/ruin/unpowered/ted/reception)
"gx" = (
/obj/machinery/atmospherics/components/unary/outlet_injector/on/layer4,
/turf/open/floor/plasteel/icemoon,
/area/ruin/unpowered)
"gC" = (
/turf/open/floor/plasteel,
/area/ruin/unpowered/ted/halls)
"gU" = (
/obj/structure/cable/pink{
	icon_state = "1-8"
	},
/obj/machinery/atmospherics/pipe/simple/supply/hidden/layer2{
	dir = 9
	},
/obj/machinery/atmospherics/pipe/manifold/scrubbers/hidden/layer4{
	dir = 4
	},
/turf/open/floor/plasteel,
/area/ruin/unpowered/ted/halls)
"hi" = (
/obj/machinery/atmospherics/components/unary/vent_scrubber/on/layer4{
	dir = 4
	},
/turf/open/floor/plasteel,
/area/ruin/unpowered/ted/reception)
"hQ" = (
/obj/machinery/door/keycard/tedtalk/guard,
/obj/structure/cable/pink{
	icon_state = "1-2"
	},
/obj/machinery/atmospherics/pipe/simple/supply/hidden/layer2,
/obj/machinery/atmospherics/pipe/simple/scrubbers/hidden/layer4,
/turf/open/floor/plasteel,
/area/ruin/unpowered/ted/halls)
"hT" = (
/obj/structure/cable/pink{
	icon_state = "1-2"
	},
/obj/machinery/atmospherics/pipe/simple/supply/hidden/layer2,
/obj/machinery/atmospherics/pipe/simple/scrubbers/hidden/layer4,
/turf/open/floor/plasteel,
/area/ruin/unpowered/ted/halls)
"id" = (
/obj/machinery/atmospherics/pipe/simple/scrubbers/hidden/layer4{
	dir = 5
	},
/turf/open/floor/plasteel,
/area/ruin/unpowered/ted/reception)
"iF" = (
/obj/structure/cable/pink{
	icon_state = "1-2"
	},
/obj/machinery/atmospherics/pipe/manifold/supply/hidden/layer2{
	dir = 4
	},
/obj/machinery/atmospherics/pipe/simple/scrubbers/hidden/layer4,
/turf/open/floor/plasteel,
/area/ruin/unpowered/ted/halls)
"jd" = (
/obj/structure/table/abductor,
/obj/machinery/atmospherics/pipe/simple/supply/hidden/layer2{
	dir = 10
	},
/obj/machinery/atmospherics/pipe/manifold/supply/hidden/layer2{
	dir = 1
	},
/obj/machinery/atmospherics/pipe/manifold/scrubbers/hidden/layer4{
	dir = 1
	},
/turf/open/floor/plasteel,
/area/ruin/unpowered/ted/reception)
"kY" = (
/turf/open/floor/plasteel,
/area/ruin/unpowered/ted/reception)
"li" = (
/obj/structure/chair/comfy{
	dir = 1
	},
/turf/open/floor/plasteel,
/area/ruin/unpowered/ted/reception)
"ly" = (
/obj/machinery/power/smes/magical,
/obj/structure/cable/pink{
	icon_state = "0-8"
	},
/turf/open/floor/plasteel,
/area/ruin/unpowered/ted/halls)
"mz" = (
/turf/open/floor/plasteel/icemoon,
/area/ruin/unpowered)
"mL" = (
/obj/machinery/power/apc/auto_name/north,
/obj/structure/cable/pink{
	icon_state = "0-4"
	},
/turf/open/floor/vault,
/area/ruin/unpowered/ted/vault)
"mN" = (
/obj/structure/cable/pink{
	icon_state = "1-2"
	},
/turf/open/floor/plasteel,
/area/ruin/unpowered/ted/halls)
"nT" = (
/obj/machinery/door/keycard/gates/tedtalk/dragon,
/turf/open/floor/vault,
/area/ruin/unpowered/ted/vault)
"pa" = (
/obj/structure/cable/pink{
	icon_state = "4-8"
	},
/obj/structure/cable/pink{
	icon_state = "1-4"
	},
/obj/machinery/atmospherics/pipe/simple/supply/hidden/layer2{
	dir = 10
	},
/obj/machinery/atmospherics/pipe/simple/scrubbers/hidden/layer4{
	dir = 9
	},
/turf/open/floor/plasteel,
/area/ruin/unpowered/ted/halls)
"pD" = (
/obj/structure/cable/pink{
	icon_state = "1-2"
	},
/obj/machinery/atmospherics/pipe/simple/supply/hidden/layer2,
/obj/machinery/atmospherics/pipe/simple/scrubbers/hidden/layer4,
/turf/open/floor/vault,
/area/ruin/unpowered/ted/vault)
"qq" = (
/obj/structure/table/abductor,
/turf/open/floor/vault,
/area/ruin/unpowered/ted/vault)
"qT" = (
/turf/closed/indestructible/riveted/plastinum,
/area/ruin/unpowered/ted/vault)
"sJ" = (
/obj/structure/closet/emcloset/wall{
	pixel_y = 28
	},
/obj/machinery/atmospherics/pipe/simple/scrubbers/hidden/layer4{
	dir = 10
	},
/turf/open/floor/plasteel,
/area/ruin/unpowered/ted/reception)
"sO" = (
/obj/machinery/door/airlock/grunge{
	id_tag = "testerman1"
	},
/obj/structure/cable/pink{
	icon_state = "4-8"
	},
/obj/machinery/atmospherics/pipe/simple/supply/hidden/layer2{
	dir = 4
	},
/obj/machinery/atmospherics/pipe/simple/scrubbers/hidden/layer4{
	dir = 4
	},
/turf/open/floor/plasteel,
/area/ruin/unpowered/ted/reception)
"sW" = (
/obj/machinery/atmospherics/pipe/layer_manifold/visible,
/turf/open/floor/plasteel,
/area/ruin/unpowered/ted/reception)
"tf" = (
/obj/machinery/atmospherics/pipe/manifold/supply/hidden/layer2,
/obj/machinery/atmospherics/pipe/manifold/scrubbers/hidden/layer4{
	dir = 8
	},
/turf/open/floor/plasteel,
/area/ruin/unpowered/ted/halls)
"tg" = (
/obj/structure/cable/pink{
	icon_state = "2-8"
	},
/obj/machinery/atmospherics/pipe/simple/supply/hidden/layer2{
	dir = 10
	},
/turf/open/floor/vault,
/area/ruin/unpowered/ted/vault)
"tP" = (
/obj/structure/closet/firecloset/full{
	anchored = 1
	},
/obj/machinery/atmospherics/pipe/simple/scrubbers/hidden/layer4{
	dir = 9
	},
/turf/open/floor/plasteel,
/area/ruin/unpowered/ted/reception)
"wn" = (
/obj/machinery/atmospherics/pipe/manifold/supply/hidden/layer2{
	dir = 4
	},
/obj/machinery/atmospherics/pipe/simple/scrubbers/hidden/layer4,
/turf/open/floor/plasteel,
/area/ruin/unpowered/ted/reception)
"wz" = (
/obj/structure/cable/pink{
	icon_state = "4-8"
	},
/obj/structure/cable/pink{
	icon_state = "2-4"
	},
/obj/machinery/atmospherics/pipe/manifold/supply/hidden/layer2{
	dir = 1
	},
/obj/machinery/atmospherics/pipe/manifold4w/scrubbers/visible/layer4,
/turf/open/floor/plasteel,
/area/ruin/unpowered/ted/halls)
"wF" = (
/obj/machinery/atmospherics/pipe/simple/supply/hidden/layer2,
/obj/machinery/atmospherics/pipe/simple/scrubbers/hidden/layer4{
	dir = 10
	},
/turf/open/floor/plasteel,
/area/ruin/unpowered/ted/reception)
"wM" = (
/obj/machinery/atmospherics/components/unary/vent_scrubber/on/layer4{
	dir = 4
	},
/turf/open/floor/plasteel,
/area/ruin/unpowered/ted/halls)
"wO" = (
/obj/item/gun/energy/beam_rifle,
/turf/open/floor/vault,
/area/ruin/unpowered/ted/vault)
"wV" = (
/obj/machinery/atmospherics/components/unary/vent_pump/on/layer2{
	dir = 4
	},
/turf/open/floor/plasteel,
/area/ruin/unpowered/ted/halls)
"xC" = (
/obj/machinery/door/keycard/tedtalk/guard,
/obj/structure/cable/pink{
	icon_state = "4-8"
	},
/obj/machinery/atmospherics/pipe/simple/supply/hidden/layer2{
	dir = 4
	},
/obj/machinery/atmospherics/pipe/simple/scrubbers/hidden/layer4{
	dir = 4
	},
/turf/open/floor/plasteel,
/area/ruin/unpowered/ted/halls)
"xL" = (
/mob/living/simple_animal/hostile/nanotrasen{
	desc = "An officer part of Nanotrasen's private security force, he seems rath"
	},
/obj/machinery/atmospherics/pipe/simple/supply/hidden/layer2{
	dir = 5
	},
/obj/machinery/atmospherics/pipe/simple/scrubbers/hidden/layer4{
	dir = 5
	},
/turf/open/floor/plasteel,
/area/ruin/unpowered/ted/reception)
"yy" = (
/obj/structure/cable/pink{
	icon_state = "1-2"
	},
/obj/machinery/atmospherics/pipe/simple/supply/hidden/layer2,
/obj/machinery/atmospherics/pipe/manifold/scrubbers/hidden/layer4{
	dir = 4
	},
/turf/open/floor/plasteel,
/area/ruin/unpowered/ted/halls)
"zC" = (
/obj/machinery/door/airlock/external,
/obj/machinery/atmospherics/pipe/simple/supply/hidden/layer2{
	dir = 9
	},
/obj/machinery/atmospherics/pipe/simple/scrubbers/hidden/layer4,
/turf/open/floor/plasteel,
/area/ruin/unpowered/ted/reception)
"zJ" = (
/obj/machinery/advanced_airlock_controller{
	pixel_x = -26
	},
/obj/machinery/atmospherics/pipe/simple/supply/visible/layer4{
	dir = 5
	},
/turf/open/floor/plasteel,
/area/ruin/unpowered/ted/reception)
"Bw" = (
/obj/effect/spawner/structure/window/reinforced,
/turf/open/floor/plasteel,
/area/ruin/unpowered/ted/reception)
"BH" = (
/obj/machinery/door/airlock/external,
/turf/open/floor/plasteel,
/area/ruin/unpowered/ted/reception)
"BK" = (
/obj/item/stock_parts/cell/gun,
/turf/open/floor/vault,
/area/ruin/unpowered/ted/vault)
"BP" = (
/obj/machinery/atmospherics/pipe/simple/supply/hidden/layer2{
	dir = 10
	},
/turf/open/floor/plasteel,
/area/ruin/unpowered/ted/reception)
"Dh" = (
/obj/machinery/atmospherics/pipe/simple/supply/hidden/layer2{
	dir = 4
	},
/obj/machinery/atmospherics/pipe/simple/scrubbers/hidden/layer4{
	dir = 4
	},
/turf/open/floor/plasteel,
/area/ruin/unpowered/ted/reception)
"Eo" = (
/obj/machinery/atmospherics/pipe/simple/scrubbers/hidden/layer4{
	dir = 9
	},
/turf/open/floor/plasteel,
/area/ruin/unpowered/ted/halls)
"Ez" = (
/obj/machinery/atmospherics/components/unary/vent_scrubber/on/layer4{
	dir = 4
	},
/turf/open/floor/vault,
/area/ruin/unpowered/ted/vault)
"FP" = (
/obj/structure/cable/pink{
	icon_state = "1-2"
	},
/obj/machinery/atmospherics/pipe/simple/supply/hidden/layer2,
/obj/machinery/atmospherics/pipe/simple/scrubbers/hidden/layer4{
	dir = 10
	},
/turf/open/floor/vault,
/area/ruin/unpowered/ted/vault)
"FV" = (
/obj/machinery/atmospherics/components/binary/pump/on/layer2{
	dir = 1
	},
/turf/open/floor/plasteel,
/area/ruin/unpowered/ted/halls)
"FX" = (
/obj/item/firing_pin,
/turf/open/floor/vault,
/area/ruin/unpowered/ted/vault)
"Gj" = (
/obj/machinery/door/keycard/gates/tedtalk/dragon,
/obj/structure/cable/pink{
	icon_state = "1-2"
	},
/obj/machinery/atmospherics/pipe/simple/supply/hidden/layer2,
/obj/machinery/atmospherics/pipe/simple/scrubbers/hidden/layer4,
/turf/open/floor/vault,
/area/ruin/unpowered/ted/vault)
"Gm" = (
/obj/structure/cable/pink{
	icon_state = "4-8"
	},
/obj/machinery/atmospherics/pipe/simple/supply/hidden/layer2{
	dir = 4
	},
/turf/open/floor/vault,
/area/ruin/unpowered/ted/vault)
"JA" = (
/obj/structure/cable/pink{
	icon_state = "4-8"
	},
/obj/machinery/atmospherics/pipe/simple/supply/hidden/layer2{
	dir = 4
	},
/obj/machinery/atmospherics/pipe/simple/scrubbers/hidden/layer4{
	dir = 4
	},
/turf/open/floor/plasteel,
/area/ruin/unpowered/ted/reception)
"JY" = (
/obj/machinery/atmospherics/components/unary/tank/air{
	piping_layer = 2
	},
/turf/open/floor/plasteel,
/area/ruin/unpowered/ted/halls)
"KP" = (
/obj/machinery/power/apc/auto_name/north,
/obj/structure/cable/pink{
	icon_state = "0-2"
	},
/obj/machinery/atmospherics/pipe/simple/scrubbers/hidden/layer4{
	dir = 6
	},
/turf/open/floor/plasteel,
/area/ruin/unpowered/ted/halls)
"KR" = (
/turf/closed/wall/mineral/titanium/nodiagonal,
/area/ruin/unpowered/ted/halls)
"KW" = (
/obj/structure/table/abductor,
/obj/machinery/atmospherics/pipe/simple/supply/hidden/layer2,
/obj/machinery/atmospherics/pipe/simple/scrubbers/hidden/layer4,
/turf/open/floor/plasteel,
/area/ruin/unpowered/ted/reception)
"Ls" = (
/obj/machinery/atmospherics/pipe/layer_manifold/visible,
/turf/open/floor/plasteel,
/area/ruin/unpowered/ted/halls)
"MY" = (
/obj/structure/table/abductor,
/turf/open/floor/plasteel,
/area/ruin/unpowered/ted/reception)
"NA" = (
/obj/machinery/power/port_gen/pacman,
/obj/item/stack/sheet/mineral/plasma/twenty,
/obj/item/wrench,
/obj/structure/cable/pink,
/turf/open/floor/plasteel,
/area/ruin/unpowered/ted/halls)
"NS" = (
/obj/structure/cable/pink{
	icon_state = "1-4"
	},
/obj/machinery/atmospherics/pipe/simple/supply/hidden/layer2{
	dir = 4
	},
/obj/machinery/atmospherics/pipe/simple/scrubbers/hidden/layer4{
	dir = 4
	},
/turf/open/floor/plasteel,
/area/ruin/unpowered/ted/halls)
"Or" = (
/obj/machinery/atmospherics/components/binary/dp_vent_pump/high_volume/layer4{
	dir = 4
	},
/turf/open/floor/plasteel,
/area/ruin/unpowered/ted/reception)
"Ou" = (
/obj/machinery/power/terminal{
	dir = 1
	},
/obj/structure/cable/pink{
	icon_state = "0-2"
	},
/turf/open/floor/plasteel,
/area/ruin/unpowered/ted/halls)
"Oy" = (
/obj/structure/cable/pink{
	icon_state = "4-8"
	},
/obj/machinery/atmospherics/pipe/simple/supply/hidden/layer2{
	dir = 4
	},
/obj/machinery/atmospherics/pipe/simple/scrubbers/hidden/layer4{
	dir = 4
	},
/turf/open/floor/plasteel,
/area/ruin/unpowered/ted/halls)
"OS" = (
/obj/structure/table/abductor,
/obj/item/dragons_blood,
/turf/open/floor/vault,
/area/ruin/unpowered/ted/vault)
"Po" = (
/obj/structure/cable/pink{
	icon_state = "4-8"
	},
/obj/machinery/atmospherics/components/unary/vent_pump/on/layer2{
	dir = 4
	},
/turf/open/floor/vault,
/area/ruin/unpowered/ted/vault)
"PN" = (
/turf/closed/wall/mineral/titanium/nodiagonal,
/area/ruin/unpowered/ted/reception)
"Rq" = (
/obj/structure/sign/poster/official/nanotrasen_logo{
	pixel_y = 31
	},
/obj/machinery/atmospherics/pipe/simple/scrubbers/hidden/layer4{
	dir = 10
	},
/turf/open/floor/plasteel,
/area/ruin/unpowered/ted/halls)
"RK" = (
/obj/structure/cable/pink{
	icon_state = "1-2"
	},
/obj/machinery/atmospherics/pipe/simple/supply/hidden/layer2,
/obj/machinery/atmospherics/pipe/simple/scrubbers/hidden/layer4,
/obj/machinery/atmospherics/pipe/simple/cyan{
	dir = 4
	},
/turf/open/floor/plasteel,
/area/ruin/unpowered/ted/halls)
"Sg" = (
/turf/template_noop,
/area/template_noop)
"SE" = (
/obj/effect/spawner/structure/window/reinforced,
/obj/machinery/atmospherics/pipe/simple/supply/hidden/layer2{
	dir = 6
	},
/turf/open/floor/plasteel,
/area/ruin/unpowered/ted/reception)
"SV" = (
/obj/item/keycard/tedtalk/first,
/turf/open/floor/plasteel,
/area/ruin/unpowered/ted/reception)
"Ti" = (
/obj/machinery/atmospherics/pipe/simple/cyan{
	dir = 9
	},
/turf/open/floor/plasteel,
/area/ruin/unpowered/ted/halls)
"TH" = (
/obj/effect/spawner/structure/window/reinforced,
/obj/machinery/atmospherics/pipe/simple/scrubbers/hidden/layer4,
/turf/open/floor/plasteel,
/area/ruin/unpowered/ted/halls)
"TZ" = (
/turf/open/floor/vault,
/area/ruin/unpowered/ted/vault)
"Vz" = (
/obj/machinery/button{
	dir = 8;
	pixel_x = 23;
	pixel_y = 6;
	id = "testerman1";
	req_access = "10000020312312";
	req_one_access = "10000020312312"
	},
/turf/open/floor/plasteel,
/area/ruin/unpowered/ted/reception)
"WU" = (
/obj/machinery/atmospherics/pipe/simple/supply/hidden/layer2{
	dir = 6
	},
/obj/machinery/atmospherics/pipe/simple/scrubbers/hidden/layer4{
	dir = 6
	},
/turf/open/floor/plasteel,
/area/ruin/unpowered/ted/halls)
"Ye" = (
/obj/machinery/door/window,
/turf/open/floor/plasteel,
/area/ruin/unpowered/ted/reception)
"Yx" = (
/obj/machinery/atmospherics/pipe/simple/scrubbers/hidden/layer4{
	dir = 4
	},
/turf/open/floor/vault,
/area/ruin/unpowered/ted/vault)

(1,1,1) = {"
Sg
Sg
Sg
Sg
Sg
Sg
Sg
Sg
Sg
Sg
Sg
Sg
Sg
Sg
Sg
Sg
Sg
Sg
Sg
Sg
Sg
Sg
Sg
Sg
Sg
Sg
PN
PN
PN
PN
Sg
Sg
Sg
Sg
Sg
Sg
Sg
Sg
Sg
Sg
"}
(2,1,1) = {"
Sg
Sg
Sg
Sg
Sg
Sg
Sg
Sg
Sg
Sg
Sg
Sg
Sg
Sg
Sg
Sg
Sg
Sg
Sg
Sg
Sg
Sg
Sg
Sg
Sg
Sg
PN
kY
kY
PN
Sg
Sg
Sg
Sg
Sg
Sg
Sg
Sg
Sg
Sg
"}
(3,1,1) = {"
Sg
Sg
Sg
Sg
Sg
Sg
Sg
Sg
Sg
Sg
Sg
Sg
Sg
Sg
Sg
Sg
Sg
Sg
Sg
Sg
Sg
Sg
Sg
Sg
Sg
Sg
PN
kY
kY
PN
Sg
Sg
Sg
Sg
Sg
Sg
Sg
Sg
Sg
Sg
"}
(4,1,1) = {"
Sg
Sg
Sg
Sg
Sg
Sg
Sg
Sg
Sg
Sg
Sg
Sg
Sg
Sg
Sg
Sg
Sg
Sg
Sg
Sg
Sg
Sg
Sg
Sg
Sg
Sg
PN
kY
kY
PN
Sg
Sg
Sg
Sg
Sg
Sg
Sg
Sg
Sg
Sg
"}
(5,1,1) = {"
Sg
Sg
Sg
Sg
Sg
Sg
Sg
Sg
Sg
Sg
Sg
Sg
Sg
Sg
Sg
Sg
Sg
Sg
Sg
Sg
Sg
Sg
Sg
Sg
Sg
Sg
PN
kY
kY
PN
PN
PN
PN
PN
PN
Sg
Sg
Sg
Sg
Sg
"}
(6,1,1) = {"
Sg
Sg
Sg
Sg
Sg
qT
qT
qT
qT
Sg
Sg
Sg
Sg
Sg
Sg
Sg
Sg
Sg
Sg
Sg
Sg
Sg
Sg
Sg
Sg
Sg
PN
fb
hi
kY
SV
Ye
kY
li
PN
Sg
Sg
Sg
Sg
Sg
"}
(7,1,1) = {"
Sg
Sg
Sg
Sg
Sg
qT
qq
qq
qT
qT
Sg
Sg
Sg
Sg
Sg
Sg
Sg
Sg
Sg
Sg
Sg
Sg
Sg
Sg
Sg
Sg
PN
BP
wF
fo
xL
MY
kY
li
PN
PN
PN
PN
Sg
Sg
"}
(8,1,1) = {"
Sg
Sg
qT
qT
qT
qT
mL
TZ
qq
qT
Sg
Sg
Sg
Sg
Sg
Sg
Sg
KR
KR
KR
KR
KR
KR
Sg
Sg
Sg
PN
kY
kY
kY
Dh
MY
hi
fb
SE
sW
zJ
Bw
mz
Sg
"}
(9,1,1) = {"
Sg
Sg
qT
TZ
TZ
nT
Po
Ez
qq
qT
KR
KR
KR
KR
KR
KR
KR
KR
gC
gC
wV
wM
KR
Sg
Sg
Sg
PN
PN
PN
PN
jd
KW
bu
wn
zC
id
Or
BH
mz
Sg
"}
(10,1,1) = {"
Sg
Sg
qT
BK
TZ
nT
Gm
Yx
TZ
nT
gC
gC
gC
wM
wV
gC
gC
KR
gC
WU
tf
Eo
KR
Sg
Sg
Sg
Sg
Sg
Sg
PN
Dh
kY
kY
kY
PN
sJ
tP
PN
mz
Sg
"}
(11,1,1) = {"
Sg
Sg
qT
FX
TZ
nT
tg
FP
pD
Gj
hT
hT
hT
yy
iF
hT
hT
ct
hT
em
NS
gC
KR
Sg
Sg
Sg
Sg
Sg
Sg
PN
gi
kY
kY
li
PN
PN
PN
PN
Sg
Sg
"}
(12,1,1) = {"
Sg
Sg
qT
wO
TZ
nT
TZ
TZ
TZ
nT
gC
gC
gC
gC
gC
gC
gC
KR
gC
gC
Oy
gC
KR
Sg
Sg
Sg
Sg
Sg
Sg
PN
JA
kY
kY
li
PN
Sg
Sg
Sg
Sg
Sg
"}
(13,1,1) = {"
Sg
Sg
qT
TZ
TZ
nT
TZ
TZ
qq
qT
KR
KR
KR
KR
KR
KR
KR
KR
gC
gC
Oy
gC
KR
Sg
Sg
Sg
Sg
Sg
Sg
PN
JA
Vz
kY
li
PN
Sg
Sg
Sg
Sg
Sg
"}
(14,1,1) = {"
Sg
Sg
qT
qT
qT
qT
TZ
TZ
qq
qT
Sg
Sg
Sg
Sg
Sg
Sg
Sg
KR
KR
KR
xC
KR
KR
Sg
Sg
Sg
Sg
Sg
Sg
PN
sO
PN
PN
PN
PN
Sg
Sg
Sg
Sg
Sg
"}
(15,1,1) = {"
Sg
Sg
Sg
Sg
Sg
qT
OS
qq
qT
qT
Sg
Sg
Sg
Sg
Sg
Sg
Sg
Sg
Sg
KR
Oy
KR
Sg
Sg
Sg
Sg
Sg
Sg
Sg
KR
Oy
KR
Sg
Sg
Sg
Sg
Sg
Sg
Sg
Sg
"}
(16,1,1) = {"
Sg
Sg
Sg
Sg
Sg
qT
qT
qT
qT
Sg
Sg
Sg
Sg
Sg
Sg
Sg
Sg
Sg
Sg
KR
Oy
KR
Sg
Sg
Sg
Sg
Sg
Sg
Sg
KR
Oy
KR
Sg
Sg
Sg
Sg
Sg
Sg
Sg
Sg
"}
(17,1,1) = {"
Sg
Sg
Sg
Sg
Sg
Sg
Sg
Sg
Sg
Sg
Sg
Sg
Sg
Sg
Sg
Sg
Sg
Sg
KR
KR
xC
KR
KR
KR
KR
Sg
Sg
Sg
KR
KR
xC
KR
KR
Sg
Sg
Sg
Sg
Sg
Sg
Sg
"}
(18,1,1) = {"
Sg
Sg
Sg
Sg
Sg
Sg
Sg
Sg
Sg
Sg
Sg
Sg
Sg
Sg
Sg
Sg
Sg
Sg
KR
wM
Oy
wV
gC
JY
KR
KR
KR
KR
KR
wV
Oy
wM
KR
Sg
Sg
Sg
Sg
Sg
Sg
Sg
"}
(19,1,1) = {"
Sg
Sg
Sg
Sg
Sg
Sg
Sg
Sg
Sg
Sg
Sg
Sg
Sg
Sg
Sg
Sg
Sg
Sg
KR
Rq
wz
iF
hT
RK
hQ
hT
hT
hT
hQ
iF
gU
Eo
KR
Sg
Sg
Sg
Sg
Sg
Sg
Sg
"}
(20,1,1) = {"
Sg
Sg
Sg
Sg
Sg
Sg
Sg
Sg
Sg
Sg
Sg
Sg
Sg
Sg
Sg
Sg
Sg
Sg
KR
KP
pa
FV
Ls
Ti
KR
KR
KR
KR
KR
gC
gC
gC
KR
Sg
Sg
Sg
Sg
Sg
Sg
Sg
"}
(21,1,1) = {"
Sg
Sg
Sg
Sg
Sg
Sg
Sg
Sg
Sg
Sg
Sg
Sg
Sg
Sg
Sg
Sg
Sg
gx
TH
Eo
ly
Ou
mN
NA
KR
Sg
Sg
Sg
KR
KR
KR
KR
KR
Sg
Sg
Sg
Sg
Sg
Sg
Sg
"}
(22,1,1) = {"
Sg
Sg
Sg
Sg
Sg
Sg
Sg
Sg
Sg
Sg
Sg
Sg
Sg
Sg
Sg
Sg
Sg
Sg
KR
KR
KR
KR
KR
KR
KR
Sg
Sg
Sg
Sg
Sg
Sg
Sg
Sg
Sg
Sg
Sg
Sg
Sg
Sg
Sg
"}
(23,1,1) = {"
Sg
Sg
Sg
Sg
Sg
Sg
Sg
Sg
Sg
Sg
Sg
Sg
Sg
Sg
Sg
Sg
Sg
Sg
Sg
Sg
Sg
Sg
Sg
Sg
Sg
Sg
Sg
Sg
Sg
Sg
Sg
Sg
Sg
Sg
Sg
Sg
Sg
Sg
Sg
Sg
"}
(24,1,1) = {"
Sg
Sg
Sg
Sg
Sg
Sg
Sg
Sg
Sg
Sg
Sg
Sg
Sg
Sg
Sg
Sg
Sg
Sg
Sg
Sg
Sg
Sg
Sg
Sg
Sg
Sg
Sg
Sg
Sg
Sg
Sg
Sg
Sg
Sg
Sg
Sg
Sg
Sg
Sg
Sg
"}
