//MAP CONVERTED BY dmm2tgm.py THIS HEADER COMMENT PREVENTS RECONVERSION, DO NOT REMOVE
"aO" = (
/obj/machinery/atmospherics/pipe/simple/supply/hidden/layer2{
	dir = 9
	},
/turf/open/floor/plasteel,
/area/ruin/unpowered/ted/halls)
"bm" = (
/obj/structure/cable/pink{
	icon_state = "1-2"
	},
/obj/machinery/atmospherics/pipe/simple/supply/hidden/layer2,
/obj/machinery/atmospherics/pipe/simple/scrubbers/hidden/layer4,
/turf/open/floor/vault,
/area/ruin/unpowered/ted/vault)
"bx" = (
/obj/structure/table/abductor,
/obj/machinery/atmospherics/pipe/simple/supply/hidden/layer2{
	dir = 10
	},
/obj/machinery/atmospherics/pipe/manifold/supply/hidden/layer2{
	dir = 1
	},
/obj/machinery/atmospherics/pipe/manifold/scrubbers/hidden/layer4{
	dir = 1
	},
/turf/open/floor/plasteel,
/area/ruin/unpowered/ted/reception)
"ce" = (
/obj/machinery/atmospherics/pipe/simple/scrubbers/hidden/layer4{
	dir = 4
	},
/turf/open/floor/vault,
/area/ruin/unpowered/ted/vault)
"dy" = (
/obj/structure/closet/emcloset/wall{
	pixel_y = 28
	},
/obj/machinery/atmospherics/pipe/simple/scrubbers/hidden/layer4{
	dir = 10
	},
/turf/open/floor/plasteel,
/area/ruin/unpowered/ted/reception)
"ea" = (
/obj/machinery/power/port_gen/pacman,
/obj/item/stack/sheet/mineral/plasma/twenty,
/obj/item/wrench,
/obj/structure/cable/pink,
/turf/open/floor/plasteel,
/area/ruin/unpowered/ted/halls)
"eb" = (
/obj/effect/spawner/structure/window/reinforced,
/turf/open/floor/plasteel,
/area/ruin/unpowered/ted/reception)
"eq" = (
/obj/machinery/atmospherics/components/unary/vent_pump/on/layer2{
	dir = 4
	},
/turf/open/floor/plasteel,
/area/ruin/unpowered/ted/halls)
"er" = (
/obj/machinery/atmospherics/components/unary/outlet_injector/on/layer4,
/turf/open/floor/plasteel/icemoon,
/area/ruin/unpowered)
"eB" = (
/obj/structure/cable/pink{
	icon_state = "1-2"
	},
/obj/machinery/atmospherics/pipe/simple/supply/hidden/layer2,
/obj/machinery/atmospherics/pipe/simple/scrubbers/hidden/layer4,
/turf/open/floor/plasteel,
/area/ruin/unpowered/ted/halls)
"fq" = (
/obj/machinery/atmospherics/components/unary/vent_scrubber/on/layer4{
	dir = 4
	},
/turf/open/floor/plasteel,
/area/ruin/unpowered/ted/halls)
"fS" = (
/obj/structure/cable/pink{
	icon_state = "1-8"
	},
/obj/machinery/atmospherics/pipe/simple/supply/hidden/layer2{
	dir = 9
	},
/obj/machinery/atmospherics/pipe/manifold/scrubbers/hidden/layer4{
	dir = 4
	},
/turf/open/floor/plasteel,
/area/ruin/unpowered/ted/halls)
"ga" = (
/obj/machinery/atmospherics/components/binary/dp_vent_pump/high_volume/layer4{
	dir = 4
	},
/turf/open/floor/plasteel,
/area/ruin/unpowered/ted/reception)
"gr" = (
/obj/machinery/atmospherics/pipe/manifold/supply/hidden/layer2{
	dir = 4
	},
/obj/machinery/atmospherics/pipe/simple/scrubbers/hidden/layer4,
/turf/open/floor/plasteel,
/area/ruin/unpowered/ted/reception)
"gZ" = (
/obj/structure/table/abductor,
/turf/open/floor/plasteel,
/area/ruin/unpowered/ted/reception)
"hA" = (
/obj/machinery/door/keycard/gates/tedtalk/dragon,
/obj/structure/cable/pink{
	icon_state = "1-2"
	},
/obj/machinery/atmospherics/pipe/simple/supply/hidden/layer2,
/obj/machinery/atmospherics/pipe/simple/scrubbers/hidden/layer4,
/turf/open/floor/vault,
/area/ruin/unpowered/ted/vault)
"hD" = (
/obj/machinery/atmospherics/components/unary/vent_scrubber/on/layer4{
	dir = 4
	},
/turf/open/floor/vault,
/area/ruin/unpowered/ted/vault)
"iW" = (
/obj/machinery/power/apc/auto_name/north,
/obj/structure/cable/pink{
	icon_state = "0-4"
	},
/obj/machinery/atmospherics/pipe/simple/supply/hidden/layer2{
	dir = 4
	},
/obj/machinery/atmospherics/pipe/simple/scrubbers/hidden/layer4{
	dir = 4
	},
/turf/open/floor/plasteel,
/area/ruin/unpowered/ted/reception)
"jm" = (
/obj/machinery/power/smes/magical,
/obj/structure/cable/pink{
	icon_state = "0-8"
	},
/turf/open/floor/plasteel,
/area/ruin/unpowered/ted/halls)
"jA" = (
/obj/structure/cable/pink{
	icon_state = "4-8"
	},
/obj/machinery/atmospherics/pipe/simple/supply/hidden/layer2{
	dir = 4
	},
/turf/open/floor/vault,
/area/ruin/unpowered/ted/vault)
"ko" = (
/obj/machinery/atmospherics/pipe/simple/supply/hidden/layer2,
/obj/machinery/atmospherics/pipe/simple/scrubbers/hidden/layer4,
/turf/open/floor/plasteel,
/area/ruin/unpowered/ted/reception)
"lO" = (
/obj/machinery/atmospherics/pipe/simple/supply/hidden/layer2,
/obj/machinery/atmospherics/pipe/manifold/scrubbers/hidden/layer4{
	dir = 4
	},
/turf/open/floor/plasteel,
/area/ruin/unpowered/ted/reception)
"mI" = (
/obj/machinery/atmospherics/pipe/simple/supply/hidden/layer2{
	dir = 4
	},
/obj/machinery/atmospherics/pipe/simple/scrubbers/hidden/layer4{
	dir = 4
	},
/turf/open/floor/plasteel,
/area/ruin/unpowered/ted/reception)
"nk" = (
/obj/machinery/atmospherics/pipe/simple/supply/hidden/layer2{
	dir = 10
	},
/turf/open/floor/plasteel,
/area/ruin/unpowered/ted/reception)
"nZ" = (
/turf/open/floor/vault,
/area/ruin/unpowered/ted/vault)
"oj" = (
/obj/item/firing_pin,
/turf/open/floor/vault,
/area/ruin/unpowered/ted/vault)
"os" = (
/turf/closed/indestructible/riveted/plastinum,
/area/ruin/unpowered/ted/vault)
"pt" = (
/turf/closed/wall/mineral/titanium/nodiagonal,
/area/ruin/unpowered/ted/reception)
"pB" = (
/obj/machinery/atmospherics/components/binary/pump/on/layer2{
	dir = 1
	},
/turf/open/floor/plasteel,
/area/ruin/unpowered/ted/halls)
"qU" = (
/turf/open/floor/plasteel/icemoon,
/area/ruin/unpowered)
"rX" = (
/obj/machinery/atmospherics/pipe/simple/supply/hidden/layer2,
/obj/machinery/atmospherics/pipe/simple/scrubbers/hidden/layer4{
	dir = 10
	},
/turf/open/floor/plasteel,
/area/ruin/unpowered/ted/reception)
"sj" = (
/obj/machinery/atmospherics/pipe/simple/scrubbers/hidden/layer4{
	dir = 9
	},
/turf/open/floor/plasteel,
/area/ruin/unpowered/ted/halls)
"sS" = (
/obj/machinery/door/airlock/external,
/obj/machinery/atmospherics/pipe/simple/supply/hidden/layer2{
	dir = 9
	},
/obj/machinery/atmospherics/pipe/simple/scrubbers/hidden/layer4,
/turf/open/floor/plasteel,
/area/ruin/unpowered/ted/reception)
"tE" = (
/obj/machinery/door/keycard/gates/tedtalk/dragon,
/turf/open/floor/vault,
/area/ruin/unpowered/ted/vault)
"ud" = (
/obj/item/keycard/tedtalk/first,
/turf/open/floor/plasteel,
/area/ruin/unpowered/ted/reception)
"uR" = (
/obj/machinery/power/apc/auto_name/north,
/obj/structure/cable/pink{
	icon_state = "0-4"
	},
/turf/open/floor/vault,
/area/ruin/unpowered/ted/vault)
"uU" = (
/obj/machinery/door/airlock/vault,
/obj/structure/cable/pink{
	icon_state = "1-2"
	},
/obj/machinery/atmospherics/pipe/simple/supply/hidden/layer2,
/obj/machinery/atmospherics/pipe/simple/scrubbers/hidden/layer4,
/turf/open/floor/plasteel,
/area/ruin/unpowered/ted/halls)
"vg" = (
/obj/structure/cable/pink{
	icon_state = "1-2"
	},
/obj/machinery/atmospherics/pipe/simple/supply/hidden/layer2{
	dir = 4
	},
/obj/machinery/atmospherics/pipe/simple/supply/hidden/layer2,
/obj/machinery/atmospherics/pipe/simple/scrubbers/hidden/layer4,
/turf/open/floor/plasteel,
/area/ruin/unpowered/ted/halls)
"vN" = (
/obj/structure/closet/firecloset/full{
	anchored = 1
	},
/obj/machinery/atmospherics/pipe/simple/scrubbers/hidden/layer4{
	dir = 9
	},
/turf/open/floor/plasteel,
/area/ruin/unpowered/ted/reception)
"wg" = (
/obj/structure/cable/pink{
	icon_state = "4-8"
	},
/obj/machinery/atmospherics/components/unary/vent_pump/on/layer2{
	dir = 4
	},
/turf/open/floor/vault,
/area/ruin/unpowered/ted/vault)
"wN" = (
/obj/machinery/atmospherics/components/unary/vent_scrubber/on/layer4{
	dir = 4
	},
/turf/open/floor/plasteel,
/area/ruin/unpowered/ted/reception)
"wT" = (
/obj/machinery/door/airlock/grunge{
	id_tag = "testerman1"
	},
/obj/structure/cable/pink{
	icon_state = "4-8"
	},
/obj/machinery/atmospherics/pipe/simple/supply/hidden/layer2{
	dir = 4
	},
/obj/machinery/atmospherics/pipe/simple/scrubbers/hidden/layer4{
	dir = 4
	},
/turf/open/floor/plasteel,
/area/ruin/unpowered/ted/reception)
"xu" = (
/obj/machinery/door/keycard/tedtalk/guard,
/obj/structure/cable/pink{
	icon_state = "4-8"
	},
/obj/machinery/atmospherics/pipe/simple/supply/hidden/layer2{
	dir = 4
	},
/obj/machinery/atmospherics/pipe/simple/scrubbers/hidden/layer4{
	dir = 4
	},
/turf/open/floor/plasteel,
/area/ruin/unpowered/ted/halls)
"yu" = (
/obj/machinery/power/terminal{
	dir = 1
	},
/obj/structure/cable/pink{
	icon_state = "0-2"
	},
/turf/open/floor/plasteel,
/area/ruin/unpowered/ted/halls)
"zv" = (
/obj/item/gun/energy/beam_rifle,
/turf/open/floor/vault,
/area/ruin/unpowered/ted/vault)
"zJ" = (
/obj/machinery/power/apc/auto_name/north,
/obj/structure/cable/pink{
	icon_state = "0-2"
	},
/obj/machinery/atmospherics/pipe/simple/scrubbers/hidden/layer4{
	dir = 6
	},
/turf/open/floor/plasteel,
/area/ruin/unpowered/ted/halls)
"Ar" = (
/obj/machinery/atmospherics/components/unary/tank/air,
/turf/open/floor/plasteel,
/area/ruin/unpowered/ted/halls)
"AE" = (
/obj/machinery/atmospherics/pipe/manifold/supply/hidden/layer2,
/obj/machinery/atmospherics/pipe/manifold/scrubbers/hidden/layer4{
	dir = 8
	},
/turf/open/floor/plasteel,
/area/ruin/unpowered/ted/halls)
"BI" = (
/obj/structure/cable/pink{
	icon_state = "4-8"
	},
/obj/structure/cable/pink{
	icon_state = "2-4"
	},
/obj/machinery/atmospherics/pipe/manifold/supply/hidden/layer2{
	dir = 1
	},
/obj/machinery/atmospherics/pipe/manifold4w/scrubbers/visible/layer4,
/turf/open/floor/plasteel,
/area/ruin/unpowered/ted/halls)
"BR" = (
/obj/effect/spawner/structure/window/reinforced,
/obj/machinery/atmospherics/pipe/simple/scrubbers/hidden/layer4,
/turf/open/floor/plasteel,
/area/ruin/unpowered/ted/halls)
"Cy" = (
/obj/structure/cable/pink{
	icon_state = "4-8"
	},
/obj/machinery/atmospherics/pipe/simple/supply/hidden/layer2{
	dir = 4
	},
/obj/machinery/atmospherics/pipe/simple/scrubbers/hidden/layer4{
	dir = 4
	},
/turf/open/floor/plasteel,
/area/ruin/unpowered/ted/reception)
"CC" = (
/obj/structure/sign/poster/official/nanotrasen_logo{
	pixel_y = 31
	},
/obj/machinery/atmospherics/pipe/simple/scrubbers/hidden/layer4{
	dir = 10
	},
/turf/open/floor/plasteel,
/area/ruin/unpowered/ted/halls)
"Fe" = (
/turf/open/floor/plasteel,
/area/ruin/unpowered/ted/reception)
"FG" = (
/obj/machinery/atmospherics/pipe/simple/supply/hidden/layer2,
/turf/open/floor/plasteel,
/area/ruin/unpowered/ted/halls)
"FM" = (
/obj/structure/cable/pink{
	icon_state = "1-2"
	},
/obj/machinery/atmospherics/pipe/manifold/supply/hidden/layer2{
	dir = 4
	},
/obj/machinery/atmospherics/pipe/simple/scrubbers/hidden/layer4,
/turf/open/floor/plasteel,
/area/ruin/unpowered/ted/halls)
"GZ" = (
/obj/machinery/door/airlock/external,
/turf/open/floor/plasteel,
/area/ruin/unpowered/ted/reception)
"HN" = (
/obj/structure/cable/pink{
	icon_state = "1-2"
	},
/obj/machinery/atmospherics/pipe/simple/supply/hidden/layer2,
/obj/machinery/atmospherics/pipe/manifold/scrubbers/hidden/layer4{
	dir = 4
	},
/turf/open/floor/plasteel,
/area/ruin/unpowered/ted/halls)
"IV" = (
/obj/machinery/advanced_airlock_controller{
	pixel_x = -26
	},
/obj/machinery/atmospherics/pipe/simple/supply/visible/layer4{
	dir = 5
	},
/turf/open/floor/plasteel,
/area/ruin/unpowered/ted/reception)
"IW" = (
/obj/effect/spawner/structure/window/reinforced,
/obj/machinery/atmospherics/pipe/simple/supply/hidden/layer2{
	dir = 6
	},
/turf/open/floor/plasteel,
/area/ruin/unpowered/ted/reception)
"Jk" = (
/obj/structure/cable/pink{
	icon_state = "1-4"
	},
/obj/machinery/atmospherics/pipe/simple/supply/hidden/layer2{
	dir = 4
	},
/obj/machinery/atmospherics/pipe/simple/scrubbers/hidden/layer4{
	dir = 4
	},
/turf/open/floor/plasteel,
/area/ruin/unpowered/ted/halls)
"Kg" = (
/turf/template_noop,
/area/template_noop)
"Kx" = (
/obj/structure/table/abductor,
/turf/open/floor/vault,
/area/ruin/unpowered/ted/vault)
"Lm" = (
/obj/machinery/door/window,
/turf/open/floor/plasteel,
/area/ruin/unpowered/ted/reception)
"Lt" = (
/obj/item/stock_parts/cell/gun,
/turf/open/floor/vault,
/area/ruin/unpowered/ted/vault)
"Me" = (
/obj/structure/cable/pink{
	icon_state = "1-2"
	},
/turf/open/floor/plasteel,
/area/ruin/unpowered/ted/halls)
"MS" = (
/obj/structure/cable/pink{
	icon_state = "1-2"
	},
/obj/machinery/atmospherics/pipe/simple/supply/hidden/layer2,
/obj/machinery/atmospherics/pipe/simple/scrubbers/hidden/layer4{
	dir = 10
	},
/turf/open/floor/vault,
/area/ruin/unpowered/ted/vault)
"Nn" = (
/obj/machinery/atmospherics/pipe/layer_manifold/visible,
/turf/open/floor/plasteel,
/area/ruin/unpowered/ted/reception)
"Nu" = (
/turf/closed/wall/mineral/titanium/nodiagonal,
/area/ruin/unpowered/ted/halls)
"NG" = (
/obj/structure/cable/pink{
	icon_state = "2-8"
	},
/obj/machinery/atmospherics/pipe/simple/supply/hidden/layer2{
	dir = 10
	},
/turf/open/floor/vault,
/area/ruin/unpowered/ted/vault)
"Ok" = (
/obj/machinery/atmospherics/components/unary/vent_pump/on/layer2{
	dir = 4
	},
/turf/open/floor/plasteel,
/area/ruin/unpowered/ted/reception)
"Pl" = (
/obj/machinery/atmospherics/pipe/simple/supply/hidden/layer2{
	dir = 6
	},
/obj/machinery/atmospherics/pipe/simple/scrubbers/hidden/layer4{
	dir = 6
	},
/turf/open/floor/plasteel,
/area/ruin/unpowered/ted/halls)
"QG" = (
/obj/structure/table/abductor,
/obj/machinery/atmospherics/pipe/simple/supply/hidden/layer2,
/obj/machinery/atmospherics/pipe/simple/scrubbers/hidden/layer4,
/turf/open/floor/plasteel,
/area/ruin/unpowered/ted/reception)
"Rv" = (
/obj/machinery/atmospherics/pipe/simple/scrubbers/hidden/layer4{
	dir = 5
	},
/turf/open/floor/plasteel,
/area/ruin/unpowered/ted/reception)
"TC" = (
/obj/structure/chair/comfy{
	dir = 1
	},
/turf/open/floor/plasteel,
/area/ruin/unpowered/ted/reception)
"TH" = (
/obj/machinery/button{
	dir = 8;
	pixel_x = 23;
	pixel_y = 6;
	id = "testerman1";
	req_access = "10000020312312";
	req_one_access = "10000020312312"
	},
/turf/open/floor/plasteel,
/area/ruin/unpowered/ted/reception)
"TK" = (
/mob/living/simple_animal/hostile/nanotrasen{
	name = "\improper Nanotrasen Private Security Officer;
	desc = "An officer part of Nanotrasen's private security force, he seems rath
	},
/obj/machinery/atmospherics/pipe/simple/supply/hidden/layer2{
	dir = 5
	},
/obj/machinery/atmospherics/pipe/simple/scrubbers/hidden/layer4{
	dir = 5
	},
/turf/open/floor/plasteel,
/area/ruin/unpowered/ted/reception)
"Wb" = (
/obj/structure/table/abductor,
/obj/item/dragons_blood,
/turf/open/floor/vault,
/area/ruin/unpowered/ted/vault)
"Wr" = (
/mob/living/simple_animal/hostile/megafauna/dragon/tedtalk,
/obj/structure/cable/pink{
	icon_state = "1-2"
	},
/obj/machinery/atmospherics/pipe/simple/supply/hidden/layer2{
	dir = 9
	},
/obj/machinery/atmospherics/pipe/simple/scrubbers/hidden/layer4{
	dir = 9
	},
/turf/open/floor/plasteel,
/area/ruin/unpowered/ted/halls)
"Wv" = (
/turf/open/floor/plasteel,
/area/ruin/unpowered/ted/halls)
"Xr" = (
/obj/structure/cable/pink{
	icon_state = "4-8"
	},
/obj/structure/cable/pink{
	icon_state = "1-4"
	},
/obj/machinery/atmospherics/pipe/simple/supply/hidden/layer2{
	dir = 10
	},
/obj/machinery/atmospherics/pipe/simple/scrubbers/hidden/layer4{
	dir = 9
	},
/turf/open/floor/plasteel,
/area/ruin/unpowered/ted/halls)
"YQ" = (
/obj/machinery/door/keycard/tedtalk/guard,
/obj/structure/cable/pink{
	icon_state = "1-2"
	},
/obj/machinery/atmospherics/pipe/simple/supply/hidden/layer2,
/obj/machinery/atmospherics/pipe/simple/scrubbers/hidden/layer4,
/turf/open/floor/plasteel,
/area/ruin/unpowered/ted/halls)
"ZQ" = (
/obj/structure/cable/pink{
	icon_state = "4-8"
	},
/obj/machinery/atmospherics/pipe/simple/supply/hidden/layer2{
	dir = 4
	},
/obj/machinery/atmospherics/pipe/simple/scrubbers/hidden/layer4{
	dir = 4
	},
/turf/open/floor/plasteel,
/area/ruin/unpowered/ted/halls)

(1,1,1) = {"
Kg
Kg
Kg
Kg
Kg
Kg
Kg
Kg
Kg
Kg
Kg
Kg
Kg
Kg
Kg
Kg
Kg
Kg
Kg
Kg
Kg
Kg
Kg
Kg
Kg
Kg
pt
pt
pt
pt
Kg
Kg
Kg
Kg
Kg
Kg
Kg
Kg
Kg
Kg
"}
(2,1,1) = {"
Kg
Kg
Kg
Kg
Kg
Kg
Kg
Kg
Kg
Kg
Kg
Kg
Kg
Kg
Kg
Kg
Kg
Kg
Kg
Kg
Kg
Kg
Kg
Kg
Kg
Kg
pt
Fe
Fe
pt
Kg
Kg
Kg
Kg
Kg
Kg
Kg
Kg
Kg
Kg
"}
(3,1,1) = {"
Kg
Kg
Kg
Kg
Kg
Kg
Kg
Kg
Kg
Kg
Kg
Kg
Kg
Kg
Kg
Kg
Kg
Kg
Kg
Kg
Kg
Kg
Kg
Kg
Kg
Kg
pt
Fe
Fe
pt
Kg
Kg
Kg
Kg
Kg
Kg
Kg
Kg
Kg
Kg
"}
(4,1,1) = {"
Kg
Kg
Kg
Kg
Kg
Kg
Kg
Kg
Kg
Kg
Kg
Kg
Kg
Kg
Kg
Kg
Kg
Kg
Kg
Kg
Kg
Kg
Kg
Kg
Kg
Kg
pt
Fe
Fe
pt
Kg
Kg
Kg
Kg
Kg
Kg
Kg
Kg
Kg
Kg
"}
(5,1,1) = {"
Kg
Kg
Kg
Kg
Kg
Kg
Kg
Kg
Kg
Kg
Kg
Kg
Kg
Kg
Kg
Kg
Kg
Kg
Kg
Kg
Kg
Kg
Kg
Kg
Kg
Kg
pt
Fe
Fe
pt
pt
pt
pt
pt
pt
Kg
Kg
Kg
Kg
Kg
"}
(6,1,1) = {"
Kg
Kg
Kg
Kg
Kg
os
os
os
os
Kg
Kg
Kg
Kg
Kg
Kg
Kg
Kg
Kg
Kg
Kg
Kg
Kg
Kg
Kg
Kg
Kg
pt
Ok
wN
Fe
ud
Lm
Fe
TC
pt
Kg
Kg
Kg
Kg
Kg
"}
(7,1,1) = {"
Kg
Kg
Kg
Kg
Kg
os
Kx
Kx
os
os
Kg
Kg
Kg
Kg
Kg
Kg
Kg
Kg
Kg
Kg
Kg
Kg
Kg
Kg
Kg
Kg
pt
nk
rX
ko
TK
gZ
Fe
TC
pt
pt
pt
pt
Kg
Kg
"}
(8,1,1) = {"
Kg
Kg
os
os
os
os
uR
nZ
Kx
os
Kg
Kg
Kg
Kg
Kg
Kg
Kg
Nu
Nu
Nu
Nu
Nu
Nu
Kg
Kg
Kg
pt
Fe
Fe
Fe
mI
gZ
wN
Ok
IW
Nn
IV
eb
qU
Kg
"}
(9,1,1) = {"
Kg
Kg
os
nZ
nZ
tE
wg
hD
Kx
os
Nu
Nu
Nu
Nu
Nu
Nu
Nu
Nu
Wv
Wv
eq
fq
Nu
Kg
Kg
Kg
pt
pt
pt
pt
bx
QG
lO
gr
sS
Rv
ga
GZ
qU
Kg
"}
(10,1,1) = {"
Kg
Kg
os
Lt
nZ
tE
jA
ce
nZ
tE
Wv
Wv
Wv
fq
eq
Wv
Wv
Nu
Wv
Pl
AE
sj
Nu
Kg
Kg
Kg
Kg
Kg
Kg
pt
mI
Fe
Fe
Fe
pt
dy
vN
pt
qU
Kg
"}
(11,1,1) = {"
Kg
Kg
os
oj
nZ
tE
NG
MS
bm
hA
eB
eB
eB
HN
FM
eB
eB
uU
eB
Wr
Jk
Wv
Nu
Kg
Kg
Kg
Kg
Kg
Kg
pt
iW
Fe
Fe
TC
pt
pt
pt
pt
Kg
Kg
"}
(12,1,1) = {"
Kg
Kg
os
zv
nZ
tE
nZ
nZ
nZ
tE
Wv
Wv
Wv
Wv
Wv
Wv
Wv
Nu
Wv
Wv
ZQ
Wv
Nu
Kg
Kg
Kg
Kg
Kg
Kg
pt
Cy
Fe
Fe
TC
pt
Kg
Kg
Kg
Kg
Kg
"}
(13,1,1) = {"
Kg
Kg
os
nZ
nZ
tE
nZ
nZ
Kx
os
Nu
Nu
Nu
Nu
Nu
Nu
Nu
Nu
Wv
Wv
ZQ
Wv
Nu
Kg
Kg
Kg
Kg
Kg
Kg
pt
Cy
TH
Fe
TC
pt
Kg
Kg
Kg
Kg
Kg
"}
(14,1,1) = {"
Kg
Kg
os
os
os
os
nZ
nZ
Kx
os
Kg
Kg
Kg
Kg
Kg
Kg
Kg
Nu
Nu
Nu
xu
Nu
Nu
Kg
Kg
Kg
Kg
Kg
Kg
pt
wT
pt
pt
pt
pt
Kg
Kg
Kg
Kg
Kg
"}
(15,1,1) = {"
Kg
Kg
Kg
Kg
Kg
os
Wb
Kx
os
os
Kg
Kg
Kg
Kg
Kg
Kg
Kg
Kg
Kg
Nu
ZQ
Nu
Kg
Kg
Kg
Kg
Kg
Kg
Kg
Nu
ZQ
Nu
Kg
Kg
Kg
Kg
Kg
Kg
Kg
Kg
"}
(16,1,1) = {"
Kg
Kg
Kg
Kg
Kg
os
os
os
os
Kg
Kg
Kg
Kg
Kg
Kg
Kg
Kg
Kg
Kg
Nu
ZQ
Nu
Kg
Kg
Kg
Kg
Kg
Kg
Kg
Nu
ZQ
Nu
Kg
Kg
Kg
Kg
Kg
Kg
Kg
Kg
"}
(17,1,1) = {"
Kg
Kg
Kg
Kg
Kg
Kg
Kg
Kg
Kg
Kg
Kg
Kg
Kg
Kg
Kg
Kg
Kg
Kg
Nu
Nu
xu
Nu
Nu
Nu
Nu
Kg
Kg
Kg
Nu
Nu
xu
Nu
Nu
Kg
Kg
Kg
Kg
Kg
Kg
Kg
"}
(18,1,1) = {"
Kg
Kg
Kg
Kg
Kg
Kg
Kg
Kg
Kg
Kg
Kg
Kg
Kg
Kg
Kg
Kg
Kg
Kg
Nu
fq
ZQ
eq
Wv
Ar
Nu
Nu
Nu
Nu
Nu
eq
ZQ
fq
Nu
Kg
Kg
Kg
Kg
Kg
Kg
Kg
"}
(19,1,1) = {"
Kg
Kg
Kg
Kg
Kg
Kg
Kg
Kg
Kg
Kg
Kg
Kg
Kg
Kg
Kg
Kg
Kg
Kg
Nu
CC
BI
FM
eB
vg
YQ
eB
eB
eB
YQ
FM
fS
sj
Nu
Kg
Kg
Kg
Kg
Kg
Kg
Kg
"}
(20,1,1) = {"
Kg
Kg
Kg
Kg
Kg
Kg
Kg
Kg
Kg
Kg
Kg
Kg
Kg
Kg
Kg
Kg
Kg
Kg
Nu
zJ
Xr
pB
FG
aO
Nu
Nu
Nu
Nu
Nu
Wv
Wv
Wv
Nu
Kg
Kg
Kg
Kg
Kg
Kg
Kg
"}
(21,1,1) = {"
Kg
Kg
Kg
Kg
Kg
Kg
Kg
Kg
Kg
Kg
Kg
Kg
Kg
Kg
Kg
Kg
Kg
er
BR
sj
jm
yu
Me
ea
Nu
Kg
Kg
Kg
Nu
Nu
Nu
Nu
Nu
Kg
Kg
Kg
Kg
Kg
Kg
Kg
"}
(22,1,1) = {"
Kg
Kg
Kg
Kg
Kg
Kg
Kg
Kg
Kg
Kg
Kg
Kg
Kg
Kg
Kg
Kg
Kg
Kg
Nu
Nu
Nu
Nu
Nu
Nu
Nu
Kg
Kg
Kg
Kg
Kg
Kg
Kg
Kg
Kg
Kg
Kg
Kg
Kg
Kg
Kg
"}
(23,1,1) = {"
Kg
Kg
Kg
Kg
Kg
Kg
Kg
Kg
Kg
Kg
Kg
Kg
Kg
Kg
Kg
Kg
Kg
Kg
Kg
Kg
Kg
Kg
Kg
Kg
Kg
Kg
Kg
Kg
Kg
Kg
Kg
Kg
Kg
Kg
Kg
Kg
Kg
Kg
Kg
Kg
"}
(24,1,1) = {"
Kg
Kg
Kg
Kg
Kg
Kg
Kg
Kg
Kg
Kg
Kg
Kg
Kg
Kg
Kg
Kg
Kg
Kg
Kg
Kg
Kg
Kg
Kg
Kg
Kg
Kg
Kg
Kg
Kg
Kg
Kg
Kg
Kg
Kg
Kg
Kg
Kg
Kg
Kg
Kg
"}
