//MAP CONVERTED BY dmm2tgm.py THIS HEADER COMMENT PREVENTS RECONVERSION, DO NOT REMOVE
"ao" = (
/obj/structure/cable/pink{
	icon_state = "4-8"
	},
/obj/machinery/atmospherics/pipe/simple/supply/hidden/layer2{
	dir = 4
	},
/obj/machinery/atmospherics/pipe/simple/scrubbers/hidden/layer4{
	dir = 4
	},
/turf/open/floor/plasteel,
/area/ruin/unpowered/ted/reception)
"bu" = (
/obj/machinery/door/keycard/gates/tedtalk/dragon,
/turf/open/floor/vault,
/area/ruin/unpowered/ted/vault)
"cd" = (
/obj/effect/spawner/structure/window/reinforced,
/obj/machinery/atmospherics/pipe/simple/scrubbers/hidden/layer4,
/turf/open/floor/plasteel,
/area/ruin/unpowered/ted/halls)
"cW" = (
/obj/structure/table/abductor,
/turf/open/floor/plasteel,
/area/ruin/unpowered/ted/reception)
"dp" = (
/obj/machinery/atmospherics/components/unary/tank/air{
	piping_layer = 2
	},
/turf/open/floor/plasteel,
/area/ruin/unpowered/ted/halls)
"dx" = (
/obj/machinery/power/port_gen/pacman,
/obj/item/stack/sheet/mineral/plasma/twenty,
/obj/item/wrench,
/obj/structure/cable/pink,
/turf/open/floor/plasteel,
/area/ruin/unpowered/ted/halls)
"dD" = (
/obj/machinery/door/airlock/vault,
/obj/structure/cable/pink{
	icon_state = "1-2"
	},
/obj/machinery/atmospherics/pipe/simple/supply/hidden/layer2,
/obj/machinery/atmospherics/pipe/simple/scrubbers/hidden/layer4,
/turf/open/floor/plasteel,
/area/ruin/unpowered/ted/halls)
"em" = (
/obj/machinery/power/apc/auto_name/north,
/obj/structure/cable/pink{
	icon_state = "0-4"
	},
/obj/machinery/atmospherics/pipe/simple/supply/hidden/layer2{
	dir = 4
	},
/obj/machinery/atmospherics/pipe/simple/scrubbers/hidden/layer4{
	dir = 4
	},
/turf/open/floor/plasteel,
/area/ruin/unpowered/ted/reception)
"eB" = (
/obj/structure/cable/pink{
	icon_state = "1-2"
	},
/obj/machinery/atmospherics/pipe/simple/supply/hidden/layer2,
/obj/machinery/atmospherics/pipe/simple/scrubbers/hidden/layer4,
/turf/open/floor/vault,
/area/ruin/unpowered/ted/vault)
"eZ" = (
/obj/structure/cable/pink{
	icon_state = "1-2"
	},
/obj/machinery/atmospherics/pipe/simple/supply/hidden/layer2,
/obj/machinery/atmospherics/pipe/manifold/scrubbers/hidden/layer4{
	dir = 4
	},
/turf/open/floor/plasteel,
/area/ruin/unpowered/ted/halls)
"gi" = (
/obj/item/firing_pin,
/turf/open/floor/vault,
/area/ruin/unpowered/ted/vault)
"gv" = (
/obj/machinery/atmospherics/pipe/manifold/supply/hidden/layer2{
	dir = 4
	},
/obj/machinery/atmospherics/pipe/simple/scrubbers/hidden/layer4,
/turf/open/floor/plasteel,
/area/ruin/unpowered/ted/reception)
"hY" = (
/mob/living/simple_animal/hostile/megafauna/dragon/tedtalk,
/obj/structure/cable/pink{
	icon_state = "1-2"
	},
/obj/machinery/atmospherics/pipe/simple/supply/hidden/layer2{
	dir = 9
	},
/obj/machinery/atmospherics/pipe/simple/scrubbers/hidden/layer4{
	dir = 9
	},
/turf/open/floor/plasteel,
/area/ruin/unpowered/ted/halls)
"jN" = (
/turf/open/floor/plasteel,
/area/ruin/unpowered/ted/reception)
"kA" = (
/obj/structure/cable/pink{
	icon_state = "4-8"
	},
/obj/structure/cable/pink{
	icon_state = "1-4"
	},
/obj/machinery/atmospherics/pipe/simple/supply/hidden/layer2{
	dir = 10
	},
/obj/machinery/atmospherics/pipe/simple/scrubbers/hidden/layer4{
	dir = 9
	},
/turf/open/floor/plasteel,
/area/ruin/unpowered/ted/halls)
"mY" = (
/obj/structure/cable/pink{
	icon_state = "1-2"
	},
/obj/machinery/atmospherics/pipe/manifold/supply/hidden/layer2{
	dir = 4
	},
/obj/machinery/atmospherics/pipe/simple/scrubbers/hidden/layer4,
/turf/open/floor/plasteel,
/area/ruin/unpowered/ted/halls)
"nE" = (
/obj/machinery/atmospherics/pipe/manifold/supply/hidden/layer2,
/obj/machinery/atmospherics/pipe/manifold/scrubbers/hidden/layer4{
	dir = 8
	},
/turf/open/floor/plasteel,
/area/ruin/unpowered/ted/halls)
"oy" = (
/obj/item/gun/energy/beam_rifle,
/turf/open/floor/vault,
/area/ruin/unpowered/ted/vault)
"pr" = (
/obj/structure/closet/emcloset/wall{
	pixel_y = 28
	},
/obj/machinery/atmospherics/pipe/simple/scrubbers/hidden/layer4{
	dir = 10
	},
/turf/open/floor/plasteel,
/area/ruin/unpowered/ted/reception)
"pC" = (
/obj/structure/table/abductor,
/obj/item/dragons_blood,
/turf/open/floor/vault,
/area/ruin/unpowered/ted/vault)
"pQ" = (
/obj/machinery/button{
	dir = 8;
	pixel_x = 23;
	pixel_y = 6;
	id = "testerman1";
	req_access = "10000020312312";
	req_one_access = "10000020312312"
	},
/turf/open/floor/plasteel,
/area/ruin/unpowered/ted/reception)
"pZ" = (
/obj/structure/cable/pink{
	icon_state = "2-8"
	},
/obj/machinery/atmospherics/pipe/simple/supply/hidden/layer2{
	dir = 10
	},
/turf/open/floor/vault,
/area/ruin/unpowered/ted/vault)
"qd" = (
/obj/structure/cable/pink{
	icon_state = "1-2"
	},
/obj/machinery/atmospherics/pipe/simple/supply/hidden/layer2,
/obj/machinery/atmospherics/pipe/simple/scrubbers/hidden/layer4,
/turf/open/floor/plasteel,
/area/ruin/unpowered/ted/halls)
"qC" = (
/obj/machinery/door/airlock/external,
/obj/machinery/atmospherics/pipe/simple/supply/hidden/layer2{
	dir = 9
	},
/obj/machinery/atmospherics/pipe/simple/scrubbers/hidden/layer4,
/turf/open/floor/plasteel,
/area/ruin/unpowered/ted/reception)
"qI" = (
/obj/item/stock_parts/cell/gun,
/turf/open/floor/vault,
/area/ruin/unpowered/ted/vault)
"qP" = (
/turf/open/floor/plasteel,
/area/ruin/unpowered/ted/halls)
"qT" = (
/turf/closed/wall/mineral/titanium/nodiagonal,
/area/ruin/unpowered/ted/reception)
"rr" = (
/obj/effect/spawner/structure/window/reinforced,
/turf/open/floor/plasteel,
/area/ruin/unpowered/ted/reception)
"rR" = (
/obj/machinery/power/terminal{
	dir = 1
	},
/obj/structure/cable/pink{
	icon_state = "0-2"
	},
/turf/open/floor/plasteel,
/area/ruin/unpowered/ted/halls)
"sY" = (
/obj/machinery/power/smes/magical,
/obj/structure/cable/pink{
	icon_state = "0-8"
	},
/turf/open/floor/plasteel,
/area/ruin/unpowered/ted/halls)
"tp" = (
/obj/structure/cable/pink{
	icon_state = "1-2"
	},
/obj/machinery/atmospherics/pipe/simple/supply/hidden/layer2,
/obj/machinery/atmospherics/pipe/simple/scrubbers/hidden/layer4,
/obj/machinery/atmospherics/pipe/simple/cyan{
	dir = 4
	},
/turf/open/floor/plasteel,
/area/ruin/unpowered/ted/halls)
"tG" = (
/obj/machinery/atmospherics/pipe/simple/supply/hidden/layer2{
	dir = 10
	},
/turf/open/floor/plasteel,
/area/ruin/unpowered/ted/reception)
"tI" = (
/obj/structure/chair/comfy{
	dir = 1
	},
/turf/open/floor/plasteel,
/area/ruin/unpowered/ted/reception)
"ul" = (
/obj/machinery/atmospherics/pipe/simple/supply/hidden/layer2,
/obj/machinery/atmospherics/pipe/simple/scrubbers/hidden/layer4{
	dir = 10
	},
/turf/open/floor/plasteel,
/area/ruin/unpowered/ted/reception)
"uO" = (
/obj/structure/closet/firecloset/full{
	anchored = 1
	},
/obj/machinery/atmospherics/pipe/simple/scrubbers/hidden/layer4{
	dir = 9
	},
/turf/open/floor/plasteel,
/area/ruin/unpowered/ted/reception)
"vI" = (
/mob/living/simple_animal/hostile/nanotrasen{
	name = "\improper Nanotrasen Private Security Officer;
	desc = "An officer part of Nanotrasen's private security force, he seems rath
	},
/obj/machinery/atmospherics/pipe/simple/supply/hidden/layer2{
	dir = 5
	},
/obj/machinery/atmospherics/pipe/simple/scrubbers/hidden/layer4{
	dir = 5
	},
/turf/open/floor/plasteel,
/area/ruin/unpowered/ted/reception)
"wo" = (
/turf/closed/wall/mineral/titanium/nodiagonal,
/area/ruin/unpowered/ted/halls)
"yO" = (
/obj/machinery/power/apc/auto_name/north,
/obj/structure/cable/pink{
	icon_state = "0-2"
	},
/obj/machinery/atmospherics/pipe/simple/scrubbers/hidden/layer4{
	dir = 6
	},
/turf/open/floor/plasteel,
/area/ruin/unpowered/ted/halls)
"zo" = (
/obj/machinery/atmospherics/components/unary/vent_pump/on/layer2{
	dir = 4
	},
/turf/open/floor/plasteel,
/area/ruin/unpowered/ted/reception)
"zQ" = (
/obj/machinery/atmospherics/pipe/simple/cyan{
	dir = 9
	},
/turf/open/floor/plasteel,
/area/ruin/unpowered/ted/halls)
"AL" = (
/turf/open/floor/plasteel/icemoon,
/area/ruin/unpowered)
"AU" = (
/obj/machinery/atmospherics/pipe/simple/supply/hidden/layer2{
	dir = 4
	},
/obj/machinery/atmospherics/pipe/simple/scrubbers/hidden/layer4{
	dir = 4
	},
/turf/open/floor/plasteel,
/area/ruin/unpowered/ted/reception)
"Bf" = (
/obj/machinery/door/airlock/grunge{
	id_tag = "testerman1"
	},
/obj/structure/cable/pink{
	icon_state = "4-8"
	},
/obj/machinery/atmospherics/pipe/simple/supply/hidden/layer2{
	dir = 4
	},
/obj/machinery/atmospherics/pipe/simple/scrubbers/hidden/layer4{
	dir = 4
	},
/turf/open/floor/plasteel,
/area/ruin/unpowered/ted/reception)
"CS" = (
/obj/structure/cable/pink{
	icon_state = "4-8"
	},
/obj/structure/cable/pink{
	icon_state = "2-4"
	},
/obj/machinery/atmospherics/pipe/manifold/supply/hidden/layer2{
	dir = 1
	},
/obj/machinery/atmospherics/pipe/manifold4w/scrubbers/visible/layer4,
/turf/open/floor/plasteel,
/area/ruin/unpowered/ted/halls)
"EE" = (
/obj/effect/spawner/structure/window/reinforced,
/obj/machinery/atmospherics/pipe/simple/supply/hidden/layer2{
	dir = 6
	},
/turf/open/floor/plasteel,
/area/ruin/unpowered/ted/reception)
"ER" = (
/obj/machinery/atmospherics/components/unary/vent_pump/on/layer2{
	dir = 4
	},
/turf/open/floor/plasteel,
/area/ruin/unpowered/ted/halls)
"Fn" = (
/obj/machinery/atmospherics/components/unary/vent_scrubber/on/layer4{
	dir = 4
	},
/turf/open/floor/plasteel,
/area/ruin/unpowered/ted/reception)
"Fp" = (
/obj/machinery/advanced_airlock_controller{
	pixel_x = -26
	},
/obj/machinery/atmospherics/pipe/simple/supply/visible/layer4{
	dir = 5
	},
/turf/open/floor/plasteel,
/area/ruin/unpowered/ted/reception)
"Hu" = (
/obj/machinery/door/keycard/tedtalk/guard,
/obj/structure/cable/pink{
	icon_state = "1-2"
	},
/obj/machinery/atmospherics/pipe/simple/supply/hidden/layer2,
/obj/machinery/atmospherics/pipe/simple/scrubbers/hidden/layer4,
/turf/open/floor/plasteel,
/area/ruin/unpowered/ted/halls)
"HU" = (
/obj/machinery/door/airlock/external,
/turf/open/floor/plasteel,
/area/ruin/unpowered/ted/reception)
"HX" = (
/obj/machinery/atmospherics/pipe/layer_manifold/visible,
/turf/open/floor/plasteel,
/area/ruin/unpowered/ted/reception)
"Ks" = (
/obj/machinery/atmospherics/components/unary/vent_scrubber/on/layer4{
	dir = 4
	},
/turf/open/floor/plasteel,
/area/ruin/unpowered/ted/halls)
"Ku" = (
/obj/structure/cable/pink{
	icon_state = "1-4"
	},
/obj/machinery/atmospherics/pipe/simple/supply/hidden/layer2{
	dir = 4
	},
/obj/machinery/atmospherics/pipe/simple/scrubbers/hidden/layer4{
	dir = 4
	},
/turf/open/floor/plasteel,
/area/ruin/unpowered/ted/halls)
"KL" = (
/obj/structure/cable/pink{
	icon_state = "4-8"
	},
/obj/machinery/atmospherics/pipe/simple/supply/hidden/layer2{
	dir = 4
	},
/turf/open/floor/vault,
/area/ruin/unpowered/ted/vault)
"KN" = (
/obj/machinery/atmospherics/pipe/simple/supply/hidden/layer2,
/obj/machinery/atmospherics/pipe/simple/scrubbers/hidden/layer4,
/turf/open/floor/plasteel,
/area/ruin/unpowered/ted/reception)
"KQ" = (
/obj/machinery/door/keycard/tedtalk/guard,
/obj/structure/cable/pink{
	icon_state = "4-8"
	},
/obj/machinery/atmospherics/pipe/simple/supply/hidden/layer2{
	dir = 4
	},
/obj/machinery/atmospherics/pipe/simple/scrubbers/hidden/layer4{
	dir = 4
	},
/turf/open/floor/plasteel,
/area/ruin/unpowered/ted/halls)
"Lm" = (
/obj/machinery/atmospherics/pipe/simple/scrubbers/hidden/layer4{
	dir = 4
	},
/turf/open/floor/vault,
/area/ruin/unpowered/ted/vault)
"LE" = (
/obj/structure/table/abductor,
/turf/open/floor/vault,
/area/ruin/unpowered/ted/vault)
"Mj" = (
/obj/machinery/atmospherics/pipe/simple/scrubbers/hidden/layer4{
	dir = 5
	},
/turf/open/floor/plasteel,
/area/ruin/unpowered/ted/reception)
"Mv" = (
/obj/structure/cable/pink{
	icon_state = "4-8"
	},
/obj/machinery/atmospherics/components/unary/vent_pump/on/layer2{
	dir = 4
	},
/turf/open/floor/vault,
/area/ruin/unpowered/ted/vault)
"MS" = (
/obj/structure/table/abductor,
/obj/machinery/atmospherics/pipe/simple/supply/hidden/layer2,
/obj/machinery/atmospherics/pipe/simple/scrubbers/hidden/layer4,
/turf/open/floor/plasteel,
/area/ruin/unpowered/ted/reception)
"Nz" = (
/obj/structure/cable/pink{
	icon_state = "1-2"
	},
/obj/machinery/atmospherics/pipe/simple/supply/hidden/layer2,
/obj/machinery/atmospherics/pipe/simple/scrubbers/hidden/layer4{
	dir = 10
	},
/turf/open/floor/vault,
/area/ruin/unpowered/ted/vault)
"NN" = (
/obj/machinery/atmospherics/pipe/simple/supply/hidden/layer2,
/obj/machinery/atmospherics/pipe/manifold/scrubbers/hidden/layer4{
	dir = 4
	},
/turf/open/floor/plasteel,
/area/ruin/unpowered/ted/reception)
"Of" = (
/obj/machinery/atmospherics/pipe/simple/scrubbers/hidden/layer4{
	dir = 9
	},
/turf/open/floor/plasteel,
/area/ruin/unpowered/ted/halls)
"OZ" = (
/obj/structure/cable/pink{
	icon_state = "1-8"
	},
/obj/machinery/atmospherics/pipe/simple/supply/hidden/layer2{
	dir = 9
	},
/obj/machinery/atmospherics/pipe/manifold/scrubbers/hidden/layer4{
	dir = 4
	},
/turf/open/floor/plasteel,
/area/ruin/unpowered/ted/halls)
"Ps" = (
/obj/machinery/door/keycard/gates/tedtalk/dragon,
/obj/structure/cable/pink{
	icon_state = "1-2"
	},
/obj/machinery/atmospherics/pipe/simple/supply/hidden/layer2,
/obj/machinery/atmospherics/pipe/simple/scrubbers/hidden/layer4,
/turf/open/floor/vault,
/area/ruin/unpowered/ted/vault)
"PD" = (
/obj/machinery/atmospherics/components/unary/vent_scrubber/on/layer4{
	dir = 4
	},
/turf/open/floor/vault,
/area/ruin/unpowered/ted/vault)
"Qm" = (
/obj/machinery/atmospherics/pipe/layer_manifold/visible,
/turf/open/floor/plasteel,
/area/ruin/unpowered/ted/halls)
"QT" = (
/obj/structure/cable/pink{
	icon_state = "4-8"
	},
/obj/machinery/atmospherics/pipe/simple/supply/hidden/layer2{
	dir = 4
	},
/obj/machinery/atmospherics/pipe/simple/scrubbers/hidden/layer4{
	dir = 4
	},
/turf/open/floor/plasteel,
/area/ruin/unpowered/ted/halls)
"RV" = (
/obj/machinery/power/apc/auto_name/north,
/obj/structure/cable/pink{
	icon_state = "0-4"
	},
/turf/open/floor/vault,
/area/ruin/unpowered/ted/vault)
"Vl" = (
/obj/structure/cable/pink{
	icon_state = "1-2"
	},
/turf/open/floor/plasteel,
/area/ruin/unpowered/ted/halls)
"Vv" = (
/obj/item/keycard/tedtalk/first,
/turf/open/floor/plasteel,
/area/ruin/unpowered/ted/reception)
"VD" = (
/obj/machinery/atmospherics/pipe/simple/supply/hidden/layer2{
	dir = 6
	},
/obj/machinery/atmospherics/pipe/simple/scrubbers/hidden/layer4{
	dir = 6
	},
/turf/open/floor/plasteel,
/area/ruin/unpowered/ted/halls)
"VK" = (
/obj/structure/table/abductor,
/obj/machinery/atmospherics/pipe/simple/supply/hidden/layer2{
	dir = 10
	},
/obj/machinery/atmospherics/pipe/manifold/supply/hidden/layer2{
	dir = 1
	},
/obj/machinery/atmospherics/pipe/manifold/scrubbers/hidden/layer4{
	dir = 1
	},
/turf/open/floor/plasteel,
/area/ruin/unpowered/ted/reception)
"Wm" = (
/obj/machinery/door/window,
/turf/open/floor/plasteel,
/area/ruin/unpowered/ted/reception)
"Xl" = (
/obj/machinery/atmospherics/components/binary/pump/on/layer2{
	dir = 1
	},
/turf/open/floor/plasteel,
/area/ruin/unpowered/ted/halls)
"Xv" = (
/turf/template_noop,
/area/template_noop)
"YR" = (
/obj/machinery/atmospherics/components/binary/dp_vent_pump/high_volume/layer4{
	dir = 4
	},
/turf/open/floor/plasteel,
/area/ruin/unpowered/ted/reception)
"Zg" = (
/turf/open/floor/vault,
/area/ruin/unpowered/ted/vault)
"Zh" = (
/turf/closed/indestructible/riveted/plastinum,
/area/ruin/unpowered/ted/vault)
"Zt" = (
/obj/machinery/atmospherics/components/unary/outlet_injector/on/layer4,
/turf/open/floor/plasteel/icemoon,
/area/ruin/unpowered)
"ZS" = (
/obj/structure/sign/poster/official/nanotrasen_logo{
	pixel_y = 31
	},
/obj/machinery/atmospherics/pipe/simple/scrubbers/hidden/layer4{
	dir = 10
	},
/turf/open/floor/plasteel,
/area/ruin/unpowered/ted/halls)

(1,1,1) = {"
Xv
Xv
Xv
Xv
Xv
Xv
Xv
Xv
Xv
Xv
Xv
Xv
Xv
Xv
Xv
Xv
Xv
Xv
Xv
Xv
Xv
Xv
Xv
Xv
Xv
Xv
qT
qT
qT
qT
Xv
Xv
Xv
Xv
Xv
Xv
Xv
Xv
Xv
Xv
"}
(2,1,1) = {"
Xv
Xv
Xv
Xv
Xv
Xv
Xv
Xv
Xv
Xv
Xv
Xv
Xv
Xv
Xv
Xv
Xv
Xv
Xv
Xv
Xv
Xv
Xv
Xv
Xv
Xv
qT
jN
jN
qT
Xv
Xv
Xv
Xv
Xv
Xv
Xv
Xv
Xv
Xv
"}
(3,1,1) = {"
Xv
Xv
Xv
Xv
Xv
Xv
Xv
Xv
Xv
Xv
Xv
Xv
Xv
Xv
Xv
Xv
Xv
Xv
Xv
Xv
Xv
Xv
Xv
Xv
Xv
Xv
qT
jN
jN
qT
Xv
Xv
Xv
Xv
Xv
Xv
Xv
Xv
Xv
Xv
"}
(4,1,1) = {"
Xv
Xv
Xv
Xv
Xv
Xv
Xv
Xv
Xv
Xv
Xv
Xv
Xv
Xv
Xv
Xv
Xv
Xv
Xv
Xv
Xv
Xv
Xv
Xv
Xv
Xv
qT
jN
jN
qT
Xv
Xv
Xv
Xv
Xv
Xv
Xv
Xv
Xv
Xv
"}
(5,1,1) = {"
Xv
Xv
Xv
Xv
Xv
Xv
Xv
Xv
Xv
Xv
Xv
Xv
Xv
Xv
Xv
Xv
Xv
Xv
Xv
Xv
Xv
Xv
Xv
Xv
Xv
Xv
qT
jN
jN
qT
qT
qT
qT
qT
qT
Xv
Xv
Xv
Xv
Xv
"}
(6,1,1) = {"
Xv
Xv
Xv
Xv
Xv
Zh
Zh
Zh
Zh
Xv
Xv
Xv
Xv
Xv
Xv
Xv
Xv
Xv
Xv
Xv
Xv
Xv
Xv
Xv
Xv
Xv
qT
zo
Fn
jN
Vv
Wm
jN
tI
qT
Xv
Xv
Xv
Xv
Xv
"}
(7,1,1) = {"
Xv
Xv
Xv
Xv
Xv
Zh
LE
LE
Zh
Zh
Xv
Xv
Xv
Xv
Xv
Xv
Xv
Xv
Xv
Xv
Xv
Xv
Xv
Xv
Xv
Xv
qT
tG
ul
KN
vI
cW
jN
tI
qT
qT
qT
qT
Xv
Xv
"}
(8,1,1) = {"
Xv
Xv
Zh
Zh
Zh
Zh
RV
Zg
LE
Zh
Xv
Xv
Xv
Xv
Xv
Xv
Xv
wo
wo
wo
wo
wo
wo
Xv
Xv
Xv
qT
jN
jN
jN
AU
cW
Fn
zo
EE
HX
Fp
rr
AL
Xv
"}
(9,1,1) = {"
Xv
Xv
Zh
Zg
Zg
bu
Mv
PD
LE
Zh
wo
wo
wo
wo
wo
wo
wo
wo
qP
qP
ER
Ks
wo
Xv
Xv
Xv
qT
qT
qT
qT
VK
MS
NN
gv
qC
Mj
YR
HU
AL
Xv
"}
(10,1,1) = {"
Xv
Xv
Zh
qI
Zg
bu
KL
Lm
Zg
bu
qP
qP
qP
Ks
ER
qP
qP
wo
qP
VD
nE
Of
wo
Xv
Xv
Xv
Xv
Xv
Xv
qT
AU
jN
jN
jN
qT
pr
uO
qT
AL
Xv
"}
(11,1,1) = {"
Xv
Xv
Zh
gi
Zg
bu
pZ
Nz
eB
Ps
qd
qd
qd
eZ
mY
qd
qd
dD
qd
hY
Ku
qP
wo
Xv
Xv
Xv
Xv
Xv
Xv
qT
em
jN
jN
tI
qT
qT
qT
qT
Xv
Xv
"}
(12,1,1) = {"
Xv
Xv
Zh
oy
Zg
bu
Zg
Zg
Zg
bu
qP
qP
qP
qP
qP
qP
qP
wo
qP
qP
QT
qP
wo
Xv
Xv
Xv
Xv
Xv
Xv
qT
ao
jN
jN
tI
qT
Xv
Xv
Xv
Xv
Xv
"}
(13,1,1) = {"
Xv
Xv
Zh
Zg
Zg
bu
Zg
Zg
LE
Zh
wo
wo
wo
wo
wo
wo
wo
wo
qP
qP
QT
qP
wo
Xv
Xv
Xv
Xv
Xv
Xv
qT
ao
pQ
jN
tI
qT
Xv
Xv
Xv
Xv
Xv
"}
(14,1,1) = {"
Xv
Xv
Zh
Zh
Zh
Zh
Zg
Zg
LE
Zh
Xv
Xv
Xv
Xv
Xv
Xv
Xv
wo
wo
wo
KQ
wo
wo
Xv
Xv
Xv
Xv
Xv
Xv
qT
Bf
qT
qT
qT
qT
Xv
Xv
Xv
Xv
Xv
"}
(15,1,1) = {"
Xv
Xv
Xv
Xv
Xv
Zh
pC
LE
Zh
Zh
Xv
Xv
Xv
Xv
Xv
Xv
Xv
Xv
Xv
wo
QT
wo
Xv
Xv
Xv
Xv
Xv
Xv
Xv
wo
QT
wo
Xv
Xv
Xv
Xv
Xv
Xv
Xv
Xv
"}
(16,1,1) = {"
Xv
Xv
Xv
Xv
Xv
Zh
Zh
Zh
Zh
Xv
Xv
Xv
Xv
Xv
Xv
Xv
Xv
Xv
Xv
wo
QT
wo
Xv
Xv
Xv
Xv
Xv
Xv
Xv
wo
QT
wo
Xv
Xv
Xv
Xv
Xv
Xv
Xv
Xv
"}
(17,1,1) = {"
Xv
Xv
Xv
Xv
Xv
Xv
Xv
Xv
Xv
Xv
Xv
Xv
Xv
Xv
Xv
Xv
Xv
Xv
wo
wo
KQ
wo
wo
wo
wo
Xv
Xv
Xv
wo
wo
KQ
wo
wo
Xv
Xv
Xv
Xv
Xv
Xv
Xv
"}
(18,1,1) = {"
Xv
Xv
Xv
Xv
Xv
Xv
Xv
Xv
Xv
Xv
Xv
Xv
Xv
Xv
Xv
Xv
Xv
Xv
wo
Ks
QT
ER
qP
dp
wo
wo
wo
wo
wo
ER
QT
Ks
wo
Xv
Xv
Xv
Xv
Xv
Xv
Xv
"}
(19,1,1) = {"
Xv
Xv
Xv
Xv
Xv
Xv
Xv
Xv
Xv
Xv
Xv
Xv
Xv
Xv
Xv
Xv
Xv
Xv
wo
ZS
CS
mY
qd
tp
Hu
qd
qd
qd
Hu
mY
OZ
Of
wo
Xv
Xv
Xv
Xv
Xv
Xv
Xv
"}
(20,1,1) = {"
Xv
Xv
Xv
Xv
Xv
Xv
Xv
Xv
Xv
Xv
Xv
Xv
Xv
Xv
Xv
Xv
Xv
Xv
wo
yO
kA
Xl
Qm
zQ
wo
wo
wo
wo
wo
qP
qP
qP
wo
Xv
Xv
Xv
Xv
Xv
Xv
Xv
"}
(21,1,1) = {"
Xv
Xv
Xv
Xv
Xv
Xv
Xv
Xv
Xv
Xv
Xv
Xv
Xv
Xv
Xv
Xv
Xv
Zt
cd
Of
sY
rR
Vl
dx
wo
Xv
Xv
Xv
wo
wo
wo
wo
wo
Xv
Xv
Xv
Xv
Xv
Xv
Xv
"}
(22,1,1) = {"
Xv
Xv
Xv
Xv
Xv
Xv
Xv
Xv
Xv
Xv
Xv
Xv
Xv
Xv
Xv
Xv
Xv
Xv
wo
wo
wo
wo
wo
wo
wo
Xv
Xv
Xv
Xv
Xv
Xv
Xv
Xv
Xv
Xv
Xv
Xv
Xv
Xv
Xv
"}
(23,1,1) = {"
Xv
Xv
Xv
Xv
Xv
Xv
Xv
Xv
Xv
Xv
Xv
Xv
Xv
Xv
Xv
Xv
Xv
Xv
Xv
Xv
Xv
Xv
Xv
Xv
Xv
Xv
Xv
Xv
Xv
Xv
Xv
Xv
Xv
Xv
Xv
Xv
Xv
Xv
Xv
Xv
"}
(24,1,1) = {"
Xv
Xv
Xv
Xv
Xv
Xv
Xv
Xv
Xv
Xv
Xv
Xv
Xv
Xv
Xv
Xv
Xv
Xv
Xv
Xv
Xv
Xv
Xv
Xv
Xv
Xv
Xv
Xv
Xv
Xv
Xv
Xv
Xv
Xv
Xv
Xv
Xv
Xv
Xv
Xv
"}
