//MAP CONVERTED BY dmm2tgm.py THIS HEADER COMMENT PREVENTS RECONVERSION, DO NOT REMOVE
"ap" = (
/obj/structure/lattice,
/turf/open/space,
/area/space/nearstation)
"aQ" = (
/obj/machinery/atmospherics/pipe/manifold/scrubbers/hidden{
	dir = 1
	},
/turf/open/floor/plasteel,
/area/engine/engineering)
"bn" = (
/obj/structure/cable{
	icon_state = "4-8"
	},
/obj/machinery/atmospherics/pipe/simple/scrubbers/hidden{
	dir = 5
	},
/turf/open/floor/plasteel,
/area/engine/engineering)
"bu" = (
/obj/machinery/door/firedoor/border_only{
	dir = 8
	},
/obj/machinery/door/firedoor/border_only{
	dir = 4
	},
/obj/machinery/door/airlock/engineering/glass{
	name = "Supermatter Engine Room";
	req_access_txt = "10"
	},
/obj/structure/cable{
	icon_state = "4-8"
	},
/turf/open/floor/plasteel/dark,
/area/engine/engineering)
"cy" = (
/obj/machinery/atmospherics/pipe/simple/scrubbers/hidden,
/obj/structure/closet/radiation,
/turf/open/floor/plasteel,
/area/engine/engineering)
"cN" = (
/obj/structure/sign/poster/official/safety_eye_protection,
/turf/closed/wall/r_wall,
/area/engine/engineering)
"cQ" = (
/obj/machinery/atmospherics/pipe/simple/scrubbers/hidden{
	dir = 4
	},
/obj/structure/cable/yellow{
	icon_state = "4-8"
	},
/obj/structure/cable/yellow{
	icon_state = "0-8"
	},
/obj/machinery/power/smes,
/turf/open/floor/plasteel,
/area/engine/engineering)
"df" = (
/turf/closed/wall/r_wall,
/area/space/nearstation)
"dr" = (
/obj/machinery/atmospherics/components/unary/vent_scrubber/on{
	dir = 8
	},
/turf/open/floor/plasteel,
/area/engine/engineering)
"dI" = (
/obj/machinery/atmospherics/pipe/simple/supply/hidden{
	dir = 4
	},
/obj/structure/cable{
	icon_state = "0-8"
	},
/obj/machinery/power/port_gen/pacman,
/obj/effect/turf_decal/box,
/turf/open/floor/plasteel,
/area/engine/engineering)
"dP" = (
/obj/machinery/atmospherics/pipe/simple/scrubbers/hidden{
	dir = 4
	},
/obj/structure/sign/poster/official/safety_eye_protection,
/turf/closed/wall/r_wall,
/area/engine/engineering)
"dS" = (
/obj/machinery/atmospherics/pipe/simple/scrubbers/hidden{
	dir = 4
	},
/obj/structure/cable/yellow{
	icon_state = "0-8"
	},
/obj/machinery/power/smes,
/turf/open/floor/plasteel,
/area/engine/engineering)
"eC" = (
/obj/structure/lattice,
/turf/open/space/basic,
/area/space/nearstation)
"eE" = (
/turf/template_noop,
/area/template_noop)
"eR" = (
/obj/machinery/atmospherics/pipe/simple/supply/hidden{
	dir = 4
	},
/obj/structure/cable/yellow{
	icon_state = "2-8"
	},
/turf/open/floor/plasteel,
/area/engine/engineering)
"eW" = (
/obj/machinery/atmospherics/pipe/simple/scrubbers/hidden{
	dir = 9
	},
/obj/effect/spawner/structure/window/plasma/reinforced,
/turf/open/floor/plating,
/area/engine/engineering)
"fc" = (
/obj/machinery/firealarm{
	dir = 8;
	pixel_x = 24
	},
/turf/open/floor/plasteel,
/area/engine/engineering)
"fq" = (
/obj/structure/table,
/obj/item/clothing/gloves/color/yellow,
/obj/item/storage/toolbox/electrical{
	pixel_y = 5
	},
/turf/open/floor/plasteel,
/area/engine/engineering)
"gK" = (
/obj/machinery/atmospherics/pipe/simple/supply/hidden{
	dir = 4
	},
/turf/open/floor/plasteel,
/area/engine/engineering)
"ha" = (
/obj/machinery/atmospherics/pipe/simple/scrubbers/hidden{
	dir = 4
	},
/obj/structure/cable/yellow{
	icon_state = "1-8"
	},
/obj/structure/cable/yellow{
	icon_state = "1-2"
	},
/obj/structure/cable/yellow{
	icon_state = "1-4"
	},
/turf/open/floor/plasteel,
/area/engine/engineering)
"ho" = (
/obj/structure/cable/yellow{
	icon_state = "1-8"
	},
/obj/structure/cable/yellow{
	icon_state = "1-4"
	},
/obj/structure/cable/yellow{
	icon_state = "1-2"
	},
/turf/open/floor/plasteel,
/area/engine/engineering)
"hx" = (
/obj/machinery/atmospherics/components/unary/vent_pump/on{
	dir = 1
	},
/turf/open/floor/plasteel,
/area/engine/engineering)
"hH" = (
/obj/machinery/atmospherics/pipe/manifold/supply/hidden{
	dir = 1
	},
/obj/effect/spawner/structure/window/plasma/reinforced,
/turf/open/floor/plating,
/area/engine/engineering)
"iM" = (
/obj/machinery/atmospherics/pipe/simple/supply/hidden{
	dir = 4
	},
/obj/machinery/atmospherics/pipe/simple/scrubbers/hidden,
/obj/effect/spawner/structure/window/plasma/reinforced,
/obj/structure/cable/yellow{
	icon_state = "4-8"
	},
/turf/open/floor/plating,
/area/engine/engineering)
"jG" = (
/obj/machinery/atmospherics/pipe/simple/supply/hidden,
/turf/open/floor/plasteel,
/area/engine/engineering)
"kk" = (
/obj/machinery/atmospherics/pipe/simple/supply/hidden{
	dir = 4
	},
/obj/structure/cable/yellow{
	icon_state = "4-8"
	},
/turf/open/floor/plasteel,
/area/engine/engineering)
"kv" = (
/obj/machinery/atmospherics/pipe/simple/supply/hidden{
	dir = 4
	},
/obj/structure/cable{
	icon_state = "4-8"
	},
/obj/structure/cable{
	icon_state = "0-8"
	},
/obj/machinery/power/terminal{
	dir = 1
	},
/turf/open/floor/plasteel,
/area/engine/engineering)
"kJ" = (
/obj/machinery/atmospherics/pipe/simple/orange/visible{
	dir = 10
	},
/turf/open/floor/plasteel,
/area/engine/engineering)
"kQ" = (
/obj/machinery/atmospherics/components/unary/vent_scrubber/on{
	dir = 4
	},
/turf/open/floor/plasteel,
/area/engine/engineering)
"lM" = (
/obj/machinery/atmospherics/pipe/simple/scrubbers/hidden{
	dir = 4
	},
/obj/structure/cable/yellow{
	icon_state = "4-8"
	},
/obj/structure/cable/yellow{
	icon_state = "0-4"
	},
/obj/machinery/power/smes,
/turf/open/floor/plasteel,
/area/engine/engineering)
"mr" = (
/obj/machinery/atmospherics/pipe/simple/supply/hidden,
/obj/structure/cable/yellow{
	icon_state = "4-8"
	},
/turf/open/floor/plasteel,
/area/engine/engineering)
"nm" = (
/obj/machinery/atmospherics/components/unary/vent_pump/on{
	dir = 4
	},
/turf/open/floor/plasteel,
/area/engine/engineering)
"nB" = (
/obj/machinery/camera{
	c_tag = "Engineering Engine Port";
	dir = 4;
	network = list("ss13","engine")
	},
/turf/open/floor/plasteel,
/area/engine/engineering)
"oc" = (
/obj/machinery/atmospherics/pipe/simple/scrubbers/hidden{
	dir = 4
	},
/obj/machinery/atmospherics/pipe/simple/supply/hidden,
/obj/structure/cable/yellow{
	icon_state = "4-8"
	},
/turf/open/floor/plasteel,
/area/engine/engineering)
"oq" = (
/turf/closed/wall/r_wall,
/area/engine/engineering)
"oT" = (
/obj/machinery/atmospherics/pipe/simple/orange/visible{
	dir = 4
	},
/turf/open/floor/plasteel,
/area/engine/engineering)
"pb" = (
/obj/machinery/atmospherics/components/unary/vent_pump/on{
	dir = 8
	},
/turf/open/floor/plasteel,
/area/engine/engineering)
"pW" = (
/turf/open/space,
/area/space/nearstation)
"rX" = (
/obj/structure/cable{
	icon_state = "4-8"
	},
/obj/structure/cable{
	icon_state = "0-4"
	},
/obj/machinery/power/terminal{
	dir = 1
	},
/turf/open/floor/plasteel,
/area/engine/engineering)
"sz" = (
/obj/machinery/light{
	dir = 4
	},
/obj/structure/closet/crate,
/obj/item/stack/sheet/mineral/plasma{
	amount = 10
	},
/obj/item/stack/sheet/mineral/plasma{
	amount = 10
	},
/turf/open/floor/plasteel,
/area/engine/engineering)
"sL" = (
/turf/open/space,
/area/space)
"sS" = (
/obj/machinery/atmospherics/pipe/simple/supply/hidden{
	dir = 4
	},
/obj/structure/cable{
	icon_state = "0-4"
	},
/obj/machinery/power/port_gen/pacman,
/obj/effect/turf_decal/box,
/turf/open/floor/plasteel,
/area/engine/engineering)
"tl" = (
/obj/structure/table,
/obj/item/storage/toolbox/mechanical{
	pixel_y = 5
	},
/obj/item/flashlight{
	pixel_x = 1;
	pixel_y = 5
	},
/obj/item/flashlight{
	pixel_x = 1;
	pixel_y = 5
	},
/turf/open/floor/plasteel,
/area/engine/engineering)
"tw" = (
/obj/structure/cable/yellow{
	icon_state = "0-4"
	},
/obj/machinery/power/smes,
/turf/open/floor/plasteel,
/area/engine/engineering)
"tU" = (
/obj/machinery/atmospherics/pipe/simple/orange/visible{
	dir = 5
	},
/turf/open/floor/plasteel,
/area/engine/engineering)
"vG" = (
/obj/structure/cable/yellow{
	icon_state = "4-8"
	},
/obj/structure/cable/yellow{
	icon_state = "0-8"
	},
/obj/machinery/power/smes,
/turf/open/floor/plasteel,
/area/engine/engineering)
"wb" = (
/obj/machinery/atmospherics/pipe/simple/supply/hidden{
	dir = 4
	},
/obj/structure/cable/yellow{
	icon_state = "1-2"
	},
/turf/open/floor/plasteel,
/area/engine/engineering)
"we" = (
/obj/machinery/atmospherics/pipe/simple/scrubbers/hidden{
	dir = 4
	},
/obj/structure/cable/yellow{
	icon_state = "4-8"
	},
/turf/open/floor/plasteel,
/area/engine/engineering)
"wT" = (
/obj/machinery/door/airlock/engineering/glass{
	name = "Supermatter Engine Room";
	req_access_txt = "10"
	},
/obj/machinery/atmospherics/pipe/simple/scrubbers/hidden{
	dir = 9
	},
/obj/machinery/door/firedoor/border_only{
	dir = 4
	},
/obj/machinery/door/firedoor/border_only{
	dir = 8
	},
/turf/open/floor/plasteel/dark,
/area/engine/engineering)
"xv" = (
/obj/machinery/atmospherics/pipe/simple/supply/hidden{
	dir = 4
	},
/obj/structure/cable{
	icon_state = "0-8"
	},
/obj/machinery/power/terminal{
	dir = 1
	},
/turf/open/floor/plasteel,
/area/engine/engineering)
"yy" = (
/obj/structure/cable{
	icon_state = "4-8"
	},
/obj/structure/cable{
	icon_state = "0-8"
	},
/obj/machinery/power/terminal{
	dir = 1
	},
/turf/open/floor/plasteel,
/area/engine/engineering)
"yJ" = (
/obj/structure/lattice/catwalk,
/turf/open/space/basic,
/area/space/nearstation)
"zH" = (
/obj/effect/mapping_helpers/airlock/cyclelink_helper{
	dir = 1
	},
/obj/machinery/door/airlock/external{
	name = "Engineering External Access";
	req_access_txt = "10;13"
	},
/turf/open/floor/plating,
/area/engine/engineering)
"zK" = (
/obj/machinery/atmospherics/pipe/simple/supply/hidden{
	dir = 4
	},
/obj/effect/spawner/structure/window/plasma/reinforced,
/obj/structure/cable/yellow{
	icon_state = "4-8"
	},
/turf/open/floor/plating,
/area/engine/engineering)
"An" = (
/obj/structure/cable/yellow{
	icon_state = "0-8"
	},
/obj/machinery/power/smes,
/turf/open/floor/plasteel,
/area/engine/engineering)
"AW" = (
/obj/structure/cable{
	icon_state = "0-8"
	},
/obj/machinery/power/port_gen/pacman,
/obj/effect/turf_decal/box,
/turf/open/floor/plasteel,
/area/engine/engineering)
"Bs" = (
/obj/structure/cable/yellow{
	icon_state = "1-8"
	},
/obj/structure/cable/yellow{
	icon_state = "1-2"
	},
/obj/structure/cable/yellow{
	icon_state = "1-4"
	},
/turf/open/floor/plasteel,
/area/engine/engineering)
"By" = (
/obj/machinery/atmospherics/pipe/simple/scrubbers/hidden,
/obj/machinery/atmospherics/pipe/simple/supply/hidden{
	dir = 4
	},
/obj/effect/spawner/structure/window/plasma/reinforced,
/turf/open/floor/plating,
/area/engine/engineering)
"BN" = (
/obj/machinery/atmospherics/pipe/simple/scrubbers/hidden{
	dir = 4
	},
/obj/structure/cable/yellow{
	icon_state = "0-4"
	},
/obj/machinery/power/smes,
/turf/open/floor/plasteel,
/area/engine/engineering)
"CK" = (
/obj/effect/spawner/structure/window/plasma/reinforced,
/turf/open/floor/plating,
/area/engine/engineering)
"DJ" = (
/obj/structure/lattice,
/obj/structure/grille,
/turf/open/space,
/area/space/nearstation)
"Et" = (
/obj/machinery/light{
	dir = 4
	},
/turf/open/floor/plasteel,
/area/engine/engineering)
"Ez" = (
/obj/machinery/atmospherics/pipe/manifold4w/scrubbers/hidden,
/obj/structure/cable/yellow{
	icon_state = "4-8"
	},
/turf/open/floor/plasteel,
/area/engine/engineering)
"EL" = (
/obj/structure/cable{
	icon_state = "0-4"
	},
/obj/machinery/power/port_gen/pacman,
/obj/effect/turf_decal/box,
/turf/open/floor/plasteel,
/area/engine/engineering)
"EO" = (
/turf/open/space/basic,
/area/space)
"EV" = (
/obj/structure/closet/crate,
/obj/item/stack/sheet/mineral/plasma{
	amount = 10
	},
/obj/item/stack/sheet/mineral/plasma{
	amount = 10
	},
/turf/open/floor/plasteel,
/area/engine/engineering)
"Fz" = (
/obj/machinery/camera{
	c_tag = "Engineering Engine Starboard";
	dir = 8;
	network = list("ss13","engine")
	},
/turf/open/floor/plasteel,
/area/engine/engineering)
"FF" = (
/obj/machinery/atmospherics/components/unary/vent_scrubber/on{
	dir = 1
	},
/turf/open/floor/plasteel,
/area/engine/engineering)
"HT" = (
/obj/structure/cable{
	icon_state = "4-8"
	},
/obj/machinery/atmospherics/pipe/simple/scrubbers/hidden{
	dir = 4
	},
/obj/machinery/atmospherics/pipe/simple/supply/hidden,
/turf/open/floor/plasteel,
/area/engine/engineering)
"Ix" = (
/obj/machinery/atmospherics/pipe/simple/supply/hidden,
/obj/structure/cable{
	icon_state = "1-4"
	},
/turf/open/floor/plasteel,
/area/engine/engineering)
"IN" = (
/obj/structure/lattice,
/obj/structure/grille,
/turf/open/space/basic,
/area/space/nearstation)
"Jf" = (
/obj/structure/cable/yellow{
	icon_state = "4-8"
	},
/obj/machinery/atmospherics/pipe/simple/supply/hidden{
	dir = 4
	},
/turf/open/floor/plasteel,
/area/engine/engineering)
"JL" = (
/obj/machinery/atmospherics/pipe/simple/supply/hidden{
	dir = 4
	},
/obj/structure/cable/yellow{
	icon_state = "4-8"
	},
/obj/machinery/light{
	dir = 1
	},
/turf/open/floor/plasteel,
/area/engine/engineering)
"JT" = (
/obj/machinery/atmospherics/pipe/simple/scrubbers/hidden{
	dir = 4
	},
/obj/structure/cable/yellow{
	icon_state = "1-2"
	},
/turf/open/floor/plasteel,
/area/engine/engineering)
"Ko" = (
/turf/closed/wall,
/area/engine/engineering)
"KH" = (
/obj/structure/cable/yellow{
	icon_state = "1-8"
	},
/obj/structure/cable/yellow{
	icon_state = "1-4"
	},
/turf/open/floor/plasteel,
/area/engine/engineering)
"Np" = (
/obj/machinery/atmospherics/pipe/simple/supply/hidden,
/obj/effect/spawner/structure/window/plasma/reinforced,
/turf/open/floor/plating,
/area/engine/engineering)
"Nq" = (
/obj/machinery/atmospherics/pipe/simple/scrubbers/hidden{
	dir = 4
	},
/turf/open/floor/plasteel,
/area/engine/engineering)
"Nr" = (
/obj/machinery/atmospherics/pipe/manifold/supply/hidden,
/obj/structure/cable/yellow{
	icon_state = "4-8"
	},
/turf/open/floor/plasteel,
/area/engine/engineering)
"Nz" = (
/obj/structure/cable/yellow{
	icon_state = "1-2"
	},
/turf/open/floor/plasteel,
/area/engine/engineering)
"Ok" = (
/obj/machinery/light{
	dir = 8
	},
/turf/open/floor/plasteel,
/area/engine/engineering)
"Ol" = (
/obj/machinery/door/airlock/engineering/glass{
	name = "Supermatter Engine Room";
	req_access_txt = "10"
	},
/obj/machinery/door/firedoor/border_only,
/obj/machinery/door/firedoor/border_only{
	dir = 1
	},
/turf/open/floor/plasteel/dark,
/area/engine/engineering)
"OL" = (
/obj/structure/cable{
	icon_state = "0-8"
	},
/obj/machinery/power/terminal{
	dir = 1
	},
/turf/open/floor/plasteel,
/area/engine/engineering)
"Pp" = (
/obj/machinery/atmospherics/pipe/simple/orange/visible{
	dir = 4
	},
/obj/machinery/meter,
/turf/open/floor/plasteel,
/area/engine/engineering)
"Qd" = (
/obj/effect/spawner/structure/window/plasma/reinforced/shutters,
/turf/open/floor/plating,
/area/engine/engineering)
"Qw" = (
/obj/effect/spawner/structure/window/plasma/reinforced,
/obj/machinery/atmospherics/pipe/simple/orange/visible{
	dir = 4
	},
/turf/open/floor/plating,
/area/engine/engineering)
"RT" = (
/obj/machinery/atmospherics/pipe/simple/supply/hidden{
	dir = 4
	},
/obj/machinery/light{
	dir = 1
	},
/turf/open/floor/plasteel,
/area/engine/engineering)
"Sc" = (
/obj/machinery/atmospherics/pipe/manifold4w/supply/hidden,
/turf/open/floor/plasteel,
/area/engine/engineering)
"SJ" = (
/obj/machinery/airalarm{
	dir = 4;
	pixel_x = -24
	},
/turf/open/floor/plasteel,
/area/engine/engineering)
"SK" = (
/obj/machinery/atmospherics/pipe/manifold/supply/hidden{
	dir = 1
	},
/obj/structure/cable/yellow{
	icon_state = "4-8"
	},
/turf/open/floor/plasteel,
/area/engine/engineering)
"Te" = (
/obj/machinery/atmospherics/pipe/simple/supply/hidden{
	dir = 4
	},
/obj/structure/cable{
	icon_state = "0-4"
	},
/obj/machinery/power/terminal{
	dir = 1
	},
/turf/open/floor/plasteel,
/area/engine/engineering)
"Ti" = (
/obj/effect/mapping_helpers/airlock/cyclelink_helper,
/obj/machinery/door/airlock/external{
	name = "Engineering External Access";
	req_access_txt = "10;13"
	},
/obj/machinery/door/firedoor/border_only,
/obj/machinery/door/firedoor/border_only{
	dir = 1
	},
/obj/machinery/atmospherics/pipe/simple/supply/hidden,
/turf/open/floor/plating,
/area/engine/engineering)
"TA" = (
/obj/machinery/atmospherics/pipe/manifold/scrubbers/hidden{
	dir = 1
	},
/obj/effect/spawner/structure/window/plasma/reinforced,
/turf/open/floor/plating,
/area/engine/engineering)
"Vd" = (
/obj/machinery/light/small{
	dir = 8
	},
/obj/structure/closet/emcloset/anchored,
/obj/machinery/advanced_airlock_controller{
	dir = 1;
	pixel_y = -24
	},
/turf/open/floor/plating,
/area/engine/engineering)
"VD" = (
/obj/structure/cable{
	icon_state = "0-8"
	},
/obj/machinery/power/port_gen/pacman,
/obj/machinery/light,
/obj/effect/turf_decal/box,
/turf/open/floor/plasteel,
/area/engine/engineering)
"WW" = (
/obj/machinery/door/airlock/engineering/glass{
	name = "Supermatter Engine Room";
	req_access_txt = "10"
	},
/obj/machinery/door/firedoor/border_only{
	dir = 1
	},
/obj/machinery/door/firedoor/border_only,
/turf/open/floor/plasteel/dark,
/area/engine/engineering)
"Xm" = (
/obj/machinery/camera{
	c_tag = "Engineering Engine Aft";
	dir = 1;
	network = list("ss13","engine");
	pixel_x = 23
	},
/obj/structure/cable{
	icon_state = "0-4"
	},
/obj/machinery/power/port_gen/pacman,
/obj/machinery/light,
/obj/effect/turf_decal/box,
/turf/open/floor/plasteel,
/area/engine/engineering)
"XE" = (
/obj/machinery/light,
/turf/open/floor/plasteel,
/area/engine/engineering)
"XG" = (
/obj/structure/cable{
	icon_state = "4-8"
	},
/obj/machinery/atmospherics/pipe/simple/scrubbers/hidden{
	dir = 4
	},
/turf/open/floor/plasteel,
/area/engine/engineering)
"Yo" = (
/obj/structure/sign/warning/vacuum/external{
	pixel_x = 32
	},
/obj/machinery/atmospherics/components/unary/vent_pump{
	dir = 1
	},
/turf/open/floor/plating,
/area/engine/engineering)
"Yy" = (
/obj/machinery/atmospherics/pipe/simple/scrubbers/hidden,
/obj/structure/cable/yellow{
	icon_state = "4-8"
	},
/turf/open/floor/plasteel,
/area/engine/engineering)
"YB" = (
/obj/machinery/atmospherics/pipe/simple/supply/hidden{
	dir = 4
	},
/obj/structure/cable{
	icon_state = "4-8"
	},
/obj/structure/cable{
	icon_state = "0-4"
	},
/obj/machinery/power/terminal{
	dir = 1
	},
/turf/open/floor/plasteel,
/area/engine/engineering)
"YF" = (
/obj/machinery/atmospherics/pipe/simple/scrubbers/hidden,
/turf/open/floor/plasteel,
/area/engine/engineering)
"YU" = (
/obj/structure/cable{
	icon_state = "0-4"
	},
/obj/machinery/power/terminal{
	dir = 1
	},
/turf/open/floor/plasteel,
/area/engine/engineering)
"Ze" = (
/obj/structure/cable/yellow{
	icon_state = "4-8"
	},
/turf/open/floor/plasteel,
/area/engine/engineering)
"Zl" = (
/obj/structure/rack,
/obj/item/clothing/mask/gas{
	pixel_x = 3;
	pixel_y = 3
	},
/obj/item/clothing/mask/gas,
/obj/item/clothing/mask/gas{
	pixel_x = -3;
	pixel_y = -3
	},
/turf/open/floor/plasteel,
/area/engine/engineering)
"ZC" = (
/turf/open/floor/plasteel,
/area/engine/engineering)
"ZG" = (
/obj/machinery/atmospherics/pipe/simple/scrubbers/hidden,
/obj/machinery/atmospherics/pipe/simple/supply/hidden{
	dir = 4
	},
/turf/open/floor/plasteel,
/area/engine/engineering)
"ZH" = (
/obj/structure/cable/yellow{
	icon_state = "4-8"
	},
/obj/structure/cable/yellow{
	icon_state = "0-4"
	},
/obj/machinery/power/smes,
/turf/open/floor/plasteel,
/area/engine/engineering)

(1,1,1) = {"
eE
eE
eE
eE
eE
eE
eE
EO
ap
EO
EO
ap
EO
EO
ap
EO
EO
EO
DJ
DJ
DJ
eE
eE
eE
eE
eE
"}
(2,1,1) = {"
eE
eE
eE
eE
eE
eE
eE
EO
eC
EO
EO
eC
EO
EO
eC
EO
EO
EO
DJ
df
DJ
eE
eE
eE
eE
eE
"}
(3,1,1) = {"
eE
eE
eE
eE
eE
eE
eE
eC
eC
eC
eC
eC
eC
eC
eC
eC
ap
ap
DJ
df
DJ
eE
eE
eE
eE
eE
"}
(4,1,1) = {"
eE
eE
eE
eE
eE
eE
eE
yJ
eC
yJ
yJ
eC
yJ
yJ
eC
yJ
yJ
yJ
DJ
df
DJ
eE
eE
eE
eE
eE
"}
(5,1,1) = {"
eE
eE
eE
eE
eE
eE
eE
eC
eC
eC
eC
eC
eC
eC
eC
eC
ap
ap
DJ
df
DJ
eE
eE
eE
eE
eE
"}
(6,1,1) = {"
eE
eE
eE
eE
eE
eE
eE
yJ
eC
yJ
yJ
eC
yJ
yJ
eC
yJ
yJ
yJ
DJ
df
DJ
eE
eE
eE
eE
eE
"}
(7,1,1) = {"
eE
eE
eE
eE
Ko
Ko
oq
eC
eC
eC
eC
eC
eC
eC
eC
eC
ap
ap
DJ
df
DJ
EO
EO
EO
EO
EO
"}
(8,1,1) = {"
eE
eE
fq
tl
Ko
Vd
oq
yJ
eC
yJ
yJ
eC
yJ
yJ
eC
yJ
yJ
yJ
DJ
df
DJ
EO
EO
sL
EO
EO
"}
(9,1,1) = {"
eE
eE
Ix
jG
Ti
Yo
zH
eC
eC
eC
eC
eC
eC
eC
eC
eC
ap
ap
DJ
DJ
DJ
eC
sL
sL
sL
EO
"}
(10,1,1) = {"
eE
zK
bu
CK
oq
oq
oq
oq
oq
Qd
oq
Qd
Qd
oq
eC
EO
eC
EO
sL
eC
EO
EO
EO
sL
EO
EO
"}
(11,1,1) = {"
TA
iM
bn
ZC
ZC
Ok
nB
ZC
SJ
ZC
Ok
ZC
ZC
oq
eC
eC
eC
eC
IN
DJ
IN
EO
EO
EO
EO
EO
"}
(12,1,1) = {"
dP
kk
XG
ZC
nm
ZC
ZC
kQ
ZC
ZC
nm
ZC
ZC
oq
eC
EO
eC
EO
DJ
df
DJ
EO
EO
EO
EO
EO
"}
(13,1,1) = {"
eW
kk
XG
tw
Te
tw
YU
BN
YU
tw
Te
tw
YU
Qd
eC
EO
eC
EO
DJ
df
DJ
EO
EO
EO
EO
EO
"}
(14,1,1) = {"
Np
Nr
XG
ZH
YB
ZH
rX
lM
rX
ZH
YB
ZH
rX
Qd
eC
eC
eC
eC
DJ
df
DJ
ap
EO
EO
EO
sL
"}
(15,1,1) = {"
oq
Jf
XG
ZH
YB
ZH
rX
lM
rX
ZH
YB
ZH
rX
Qd
eC
EO
eC
EO
DJ
df
DJ
EO
EO
EO
EO
EO
"}
(16,1,1) = {"
oq
JL
XG
Ze
dI
Ze
AW
we
AW
Ze
dI
Ze
VD
oq
eC
eC
eC
eC
DJ
df
DJ
sL
EO
EO
EO
EO
"}
(17,1,1) = {"
Ol
SK
HT
mr
Sc
mr
jG
oc
jG
mr
Sc
mr
hx
Qd
eC
EO
eC
EO
DJ
df
DJ
EO
EO
EO
EO
EO
"}
(18,1,1) = {"
CK
eR
JT
ho
wb
Bs
Nz
ha
Nz
Bs
wb
KH
ZC
Qd
eC
EO
eC
EO
DJ
df
DJ
EO
EO
EO
EO
EO
"}
(19,1,1) = {"
WW
gK
aQ
Yy
ZG
Yy
YF
Ez
YF
Yy
ZG
Yy
FF
Qd
eC
eC
eC
eC
DJ
df
DJ
sL
EO
EO
EO
EO
"}
(20,1,1) = {"
oq
RT
Nq
Ze
sS
Ze
EL
we
EL
Ze
sS
Ze
Xm
oq
eC
eC
eC
eC
DJ
df
DJ
sL
EO
EO
EO
EO
"}
(21,1,1) = {"
oq
gK
Nq
vG
kv
vG
yy
cQ
yy
vG
kv
vG
yy
Qd
eC
EO
eC
EO
DJ
df
DJ
EO
EO
EO
EO
EO
"}
(22,1,1) = {"
CK
gK
Nq
vG
kv
vG
yy
cQ
yy
vG
kv
vG
yy
Qd
eC
eC
eC
eC
DJ
df
DJ
ap
EO
EO
EO
sL
"}
(23,1,1) = {"
CK
gK
Nq
An
xv
An
OL
dS
OL
An
xv
An
OL
Qd
eC
eC
eC
eC
DJ
df
DJ
sL
EO
EO
EO
EO
"}
(24,1,1) = {"
cN
gK
Nq
ZC
pb
ZC
ZC
dr
ZC
ZC
pb
ZC
ZC
oq
eC
eC
eC
eC
DJ
df
DJ
sL
EO
EO
EO
EO
"}
(25,1,1) = {"
CK
hH
Nq
ZC
fc
Et
Fz
ZC
ZC
ZC
ZC
ZC
ZC
Qd
eC
EO
eC
EO
DJ
DJ
DJ
EO
EO
EO
EO
EO
"}
(26,1,1) = {"
cy
By
wT
Qw
oq
oq
oq
ZC
ZC
ZC
ZC
ZC
ZC
Qd
eC
EO
eC
EO
sL
eC
EO
EO
EO
sL
EO
EO
"}
(27,1,1) = {"
eE
eE
eE
oT
Zl
CK
ZC
ZC
ZC
ZC
ZC
ZC
XE
Qd
ap
pW
ap
ap
ap
ap
ap
eC
sL
sL
sL
sL
"}
(28,1,1) = {"
eE
eE
eE
Pp
ZC
WW
fc
ZC
sz
EV
EV
EV
EV
oq
eC
EO
ap
EO
ap
df
DJ
EO
EO
sL
EO
EO
"}
(29,1,1) = {"
eE
eE
eE
kJ
tU
oq
oq
oq
oq
oq
Qd
Qd
Qd
oq
ap
ap
ap
ap
ap
df
DJ
EO
EO
sL
EO
EO
"}
