//MAP CONVERTED BY dmm2tgm.py THIS HEADER COMMENT PREVENTS RECONVERSION, DO NOT REMOVE
"ak" = (
/obj/effect/spawner/structure/window/plasma/reinforced,
/obj/machinery/atmospherics/pipe/simple/orange/visible{
	dir = 4
	},
/turf/open/floor/plating,
/area/engine/engineering)
"aK" = (
/obj/structure/lattice,
/obj/structure/grille,
/turf/open/space/basic,
/area/space/nearstation)
"bS" = (
/obj/machinery/light/small{
	dir = 8
	},
/obj/structure/closet/emcloset/anchored,
/obj/machinery/advanced_airlock_controller{
	dir = 1;
	pixel_y = -24
	},
/turf/open/floor/plating,
/area/engine/engineering)
"cd" = (
/obj/structure/cable{
	icon_state = "0-8"
	},
/turf/open/floor/plasteel,
/area/engine/engineering)
"ci" = (
/obj/machinery/atmospherics/pipe/manifold/supply/hidden{
	dir = 1
	},
/obj/effect/spawner/structure/window/plasma/reinforced,
/turf/open/floor/plating,
/area/engine/engineering)
"cy" = (
/obj/machinery/atmospherics/pipe/simple/orange/visible{
	dir = 10
	},
/turf/open/floor/plasteel,
/area/engine/engineering)
"cD" = (
/obj/effect/spawner/structure/window/plasma/reinforced/shutters,
/turf/open/floor/plating,
/area/engine/engineering)
"cP" = (
/obj/machinery/atmospherics/pipe/simple/orange/visible{
	dir = 4
	},
/obj/machinery/meter,
/turf/open/floor/plasteel,
/area/engine/engineering)
"cY" = (
/obj/machinery/door/airlock/engineering/glass{
	name = "Supermatter Engine Room";
	req_access_txt = "10"
	},
/obj/machinery/atmospherics/pipe/simple/scrubbers/hidden{
	dir = 9
	},
/obj/machinery/door/firedoor/border_only{
	dir = 4
	},
/obj/machinery/door/firedoor/border_only{
	dir = 8
	},
/turf/open/floor/plasteel/dark,
/area/engine/engineering)
"hs" = (
/obj/structure/sign/warning/vacuum/external{
	pixel_x = 32
	},
/obj/machinery/atmospherics/components/unary/vent_pump{
	dir = 1
	},
/turf/open/floor/plating,
/area/engine/engineering)
"ht" = (
/obj/structure/sign/poster/official/safety_eye_protection,
/turf/closed/wall/r_wall,
/area/engine/engineering)
"iV" = (
/obj/effect/spawner/structure/window/plasma/reinforced,
/turf/open/floor/plating,
/area/engine/engineering)
"jg" = (
/obj/machinery/camera{
	c_tag = "Engineering Supermatter Aft";
	dir = 1;
	network = list("ss13","engine");
	pixel_x = 23
	},
/turf/open/floor/plasteel,
/area/engine/engineering)
"kh" = (
/obj/machinery/camera{
	c_tag = "Engineering Engine Starboard";
	dir = 8;
	network = list("ss13","engine")
	},
/turf/open/floor/plasteel,
/area/engine/engineering)
"ls" = (
/turf/closed/wall,
/area/engine/engineering)
"lx" = (
/obj/machinery/light,
/turf/open/floor/plasteel,
/area/engine/engineering)
"lV" = (
/obj/structure/lattice/catwalk,
/turf/open/space/basic,
/area/space/nearstation)
"pR" = (
/obj/machinery/atmospherics/pipe/simple/scrubbers/visible,
/turf/open/floor/plating/airless,
/area/engine/engineering)
"qp" = (
/turf/open/space/basic,
/area/space)
"qx" = (
/obj/machinery/door/airlock/engineering/glass{
	name = "Supermatter Engine Room";
	req_access_txt = "10"
	},
/obj/machinery/door/firedoor/border_only{
	dir = 1
	},
/obj/machinery/door/firedoor/border_only,
/turf/open/floor/plasteel/dark,
/area/engine/engineering)
"tr" = (
/turf/closed/wall/r_wall,
/area/engine/engineering)
"tW" = (
/obj/effect/mapping_helpers/airlock/cyclelink_helper{
	dir = 1
	},
/obj/machinery/door/airlock/external{
	name = "Engineering External Access";
	req_access_txt = "10;13"
	},
/turf/open/floor/plating,
/area/engine/engineering)
"vY" = (
/obj/machinery/firealarm{
	dir = 8;
	pixel_x = 24
	},
/turf/open/floor/plasteel,
/area/engine/engineering)
"wn" = (
/obj/machinery/atmospherics/pipe/simple/supply/hidden,
/obj/structure/cable{
	icon_state = "1-4"
	},
/turf/open/floor/plasteel,
/area/engine/engineering)
"wQ" = (
/obj/machinery/atmospherics/pipe/simple/supply/hidden{
	dir = 4
	},
/obj/machinery/atmospherics/pipe/simple/scrubbers/hidden,
/obj/effect/spawner/structure/window/plasma/reinforced,
/obj/structure/cable/yellow{
	icon_state = "4-8"
	},
/turf/open/floor/plating,
/area/engine/engineering)
"xE" = (
/obj/machinery/light{
	dir = 1
	},
/turf/open/floor/plasteel,
/area/engine/engineering)
"yC" = (
/obj/machinery/atmospherics/pipe/simple/orange/visible{
	dir = 5
	},
/turf/open/floor/plasteel,
/area/engine/engineering)
"zh" = (
/obj/machinery/door/airlock/engineering/glass{
	name = "Supermatter Engine Room";
	req_access_txt = "10"
	},
/obj/machinery/door/firedoor/border_only,
/obj/machinery/door/firedoor/border_only{
	dir = 1
	},
/turf/open/floor/plasteel/dark,
/area/engine/engineering)
"zU" = (
/obj/machinery/atmospherics/pipe/simple/supply/hidden,
/obj/effect/spawner/structure/window/plasma/reinforced,
/turf/open/floor/plating,
/area/engine/engineering)
"zY" = (
/obj/machinery/atmospherics/components/unary/outlet_injector/atmos/engine_waste{
	dir = 1
	},
/turf/open/floor/plating/airless,
/area/engine/engineering)
"BV" = (
/obj/machinery/atmospherics/pipe/simple/scrubbers/hidden{
	dir = 4
	},
/obj/structure/sign/poster/official/safety_eye_protection,
/turf/closed/wall/r_wall,
/area/engine/engineering)
"BW" = (
/obj/machinery/atmospherics/pipe/simple/scrubbers/hidden,
/obj/machinery/atmospherics/pipe/simple/supply/hidden{
	dir = 4
	},
/obj/effect/spawner/structure/window/plasma/reinforced,
/turf/open/floor/plating,
/area/engine/engineering)
"Cp" = (
/obj/effect/mapping_helpers/airlock/cyclelink_helper,
/obj/machinery/door/airlock/external{
	name = "Engineering External Access";
	req_access_txt = "10;13"
	},
/obj/machinery/door/firedoor/border_only,
/obj/machinery/door/firedoor/border_only{
	dir = 1
	},
/obj/machinery/atmospherics/pipe/simple/supply/hidden,
/turf/open/floor/plating,
/area/engine/engineering)
"Iv" = (
/obj/structure/table,
/obj/item/clothing/gloves/color/yellow,
/obj/item/storage/toolbox/electrical{
	pixel_y = 5
	},
/turf/open/floor/plasteel,
/area/engine/engineering)
"Ix" = (
/obj/structure/cable/yellow{
	icon_state = "0-8"
	},
/turf/open/floor/plasteel,
/area/engine/engineering)
"Jc" = (
/turf/open/floor/plasteel,
/area/engine/engineering)
"JG" = (
/turf/closed/wall/r_wall,
/area/space/nearstation)
"Kr" = (
/obj/structure/lattice,
/turf/open/space,
/area/space/nearstation)
"Ku" = (
/obj/machinery/atmospherics/pipe/simple/scrubbers/hidden,
/obj/structure/closet/radiation,
/turf/open/floor/plasteel,
/area/engine/engineering)
"Kw" = (
/obj/machinery/light{
	dir = 4
	},
/turf/open/floor/plasteel,
/area/engine/engineering)
"Lp" = (
/obj/machinery/atmospherics/pipe/simple/supply/hidden{
	dir = 4
	},
/obj/effect/spawner/structure/window/plasma/reinforced,
/obj/structure/cable/yellow{
	icon_state = "4-8"
	},
/turf/open/floor/plating,
/area/engine/engineering)
"Lr" = (
/obj/machinery/atmospherics/pipe/simple/scrubbers/hidden{
	dir = 9
	},
/obj/effect/spawner/structure/window/plasma/reinforced,
/turf/open/floor/plating,
/area/engine/engineering)
"Ls" = (
/obj/structure/table,
/obj/item/storage/toolbox/mechanical{
	pixel_y = 5
	},
/obj/item/flashlight{
	pixel_x = 1;
	pixel_y = 5
	},
/obj/item/flashlight{
	pixel_x = 1;
	pixel_y = 5
	},
/turf/open/floor/plasteel,
/area/engine/engineering)
"Om" = (
/obj/machinery/light{
	dir = 8
	},
/turf/open/floor/plasteel,
/area/engine/engineering)
"Oo" = (
/obj/machinery/atmospherics/pipe/manifold/scrubbers/hidden{
	dir = 1
	},
/obj/effect/spawner/structure/window/plasma/reinforced,
/turf/open/floor/plating,
/area/engine/engineering)
"PQ" = (
/obj/effect/spawner/structure/window/plasma/reinforced/shutters,
/obj/machinery/atmospherics/pipe/simple/scrubbers/visible,
/turf/open/floor/plating,
/area/engine/engineering)
"RI" = (
/obj/machinery/atmospherics/pipe/simple/supply/hidden,
/turf/open/floor/plasteel,
/area/engine/engineering)
"SD" = (
/turf/template_noop,
/area/template_noop)
"Ui" = (
/obj/structure/lattice,
/turf/open/space/basic,
/area/space/nearstation)
"Uv" = (
/obj/machinery/atmospherics/pipe/simple/orange/visible{
	dir = 4
	},
/turf/open/floor/plasteel,
/area/engine/engineering)
"UK" = (
/obj/structure/rack,
/obj/item/clothing/mask/gas{
	pixel_x = 3;
	pixel_y = 3
	},
/obj/item/clothing/mask/gas,
/obj/item/clothing/mask/gas{
	pixel_x = -3;
	pixel_y = -3
	},
/turf/open/floor/plasteel,
/area/engine/engineering)
"Ve" = (
/obj/machinery/camera{
	c_tag = "Engineering Engine Port";
	dir = 4;
	network = list("ss13","engine")
	},
/turf/open/floor/plasteel,
/area/engine/engineering)
"Vy" = (
/turf/open/space,
/area/space)
"XA" = (
/obj/structure/lattice,
/obj/structure/grille,
/turf/open/space,
/area/space/nearstation)
"Zq" = (
/obj/machinery/door/firedoor/border_only{
	dir = 8
	},
/obj/machinery/door/firedoor/border_only{
	dir = 4
	},
/obj/machinery/door/airlock/engineering/glass{
	name = "Supermatter Engine Room";
	req_access_txt = "10"
	},
/obj/structure/cable{
	icon_state = "4-8"
	},
/turf/open/floor/plasteel/dark,
/area/engine/engineering)

(1,1,1) = {"
SD
SD
SD
SD
SD
SD
SD
qp
Kr
qp
qp
Kr
qp
qp
Kr
qp
qp
qp
XA
XA
XA
SD
SD
SD
SD
SD
"}
(2,1,1) = {"
SD
SD
SD
SD
SD
SD
SD
qp
Ui
qp
qp
Ui
qp
qp
Ui
qp
qp
qp
XA
JG
XA
SD
SD
SD
SD
SD
"}
(3,1,1) = {"
SD
SD
SD
SD
SD
SD
SD
Ui
Ui
Ui
Ui
Ui
Ui
Ui
Ui
Ui
Kr
Kr
XA
JG
XA
SD
SD
SD
SD
SD
"}
(4,1,1) = {"
SD
SD
SD
SD
SD
SD
SD
lV
Ui
lV
lV
Ui
lV
lV
Ui
lV
lV
lV
XA
JG
XA
SD
SD
SD
SD
SD
"}
(5,1,1) = {"
SD
SD
SD
SD
SD
SD
SD
Ui
Ui
Ui
Ui
Ui
Ui
Ui
Ui
Ui
Kr
Kr
XA
JG
XA
SD
SD
SD
SD
SD
"}
(6,1,1) = {"
SD
SD
SD
SD
SD
SD
SD
lV
Ui
lV
lV
Ui
lV
lV
Ui
lV
lV
lV
XA
JG
XA
SD
SD
SD
SD
SD
"}
(7,1,1) = {"
SD
SD
SD
SD
ls
ls
tr
Ui
Ui
Ui
Ui
Ui
Ui
Ui
Ui
Ui
Kr
Kr
XA
JG
XA
qp
qp
qp
qp
qp
"}
(8,1,1) = {"
SD
SD
Iv
Ls
ls
bS
tr
lV
Ui
lV
lV
Ui
lV
lV
Ui
lV
lV
lV
XA
JG
XA
qp
qp
Kr
qp
qp
"}
(9,1,1) = {"
SD
SD
wn
RI
Cp
hs
tW
Ui
Ui
Ui
Ui
Ui
Ui
Ui
Ui
Ui
Kr
Kr
XA
XA
XA
Ui
Kr
Kr
Kr
qp
"}
(10,1,1) = {"
SD
Lp
Zq
iV
tr
tr
tr
tr
tr
tr
tr
tr
tr
tr
Ui
qp
qp
qp
Vy
Ui
qp
qp
qp
Kr
qp
qp
"}
(11,1,1) = {"
Oo
wQ
cd
Jc
Jc
Om
Ve
Jc
Jc
Jc
Om
Jc
Jc
tr
tr
tr
tr
tr
tr
tr
tr
qp
aK
XA
aK
qp
"}
(12,1,1) = {"
BV
Ix
Jc
Jc
Jc
Jc
Jc
Jc
Jc
Jc
Jc
Jc
Jc
Jc
Jc
Jc
Jc
Jc
Jc
Jc
tr
qp
XA
JG
XA
qp
"}
(13,1,1) = {"
Lr
Jc
Jc
Jc
Jc
Jc
Jc
Jc
Jc
Jc
Jc
Jc
Jc
Jc
Jc
Jc
Jc
Jc
Jc
Jc
tr
qp
XA
JG
XA
qp
"}
(14,1,1) = {"
zU
Jc
Jc
Jc
Jc
Jc
Jc
Jc
Jc
Jc
Jc
Jc
Jc
Jc
Jc
Jc
Jc
Jc
Jc
Jc
tr
Kr
XA
JG
XA
Kr
"}
(15,1,1) = {"
tr
Jc
Jc
Jc
Jc
Jc
Jc
Jc
Jc
Jc
Jc
Jc
Jc
Jc
Jc
Jc
Jc
Jc
Jc
Jc
tr
qp
XA
JG
XA
qp
"}
(16,1,1) = {"
tr
xE
Jc
Jc
Jc
Jc
Jc
Jc
Jc
Jc
Jc
Jc
Jc
Jc
Jc
Jc
Jc
Jc
Jc
lx
tr
Kr
XA
JG
XA
qp
"}
(17,1,1) = {"
zh
Jc
Jc
Jc
Jc
Jc
Jc
Jc
Jc
Jc
Jc
Jc
Jc
Jc
Jc
Jc
Jc
Jc
Jc
Jc
tr
qp
XA
JG
XA
qp
"}
(18,1,1) = {"
iV
Jc
Jc
Jc
Jc
Jc
Jc
Jc
Jc
Jc
Jc
Jc
Jc
Jc
Jc
Jc
Jc
Jc
Jc
jg
tr
qp
XA
JG
XA
qp
"}
(19,1,1) = {"
qx
Jc
Jc
Jc
Jc
Jc
Jc
Jc
Jc
Jc
Jc
Jc
Jc
Jc
Jc
Jc
Jc
Jc
Jc
lx
tr
Kr
XA
JG
XA
qp
"}
(20,1,1) = {"
tr
xE
Jc
Jc
Jc
Jc
Jc
Jc
Jc
Jc
Jc
Jc
Jc
Jc
Jc
Jc
Jc
Jc
Jc
Jc
tr
Kr
XA
JG
XA
qp
"}
(21,1,1) = {"
tr
Jc
Jc
Jc
Jc
Jc
Jc
Jc
Jc
Jc
Jc
Jc
Jc
Jc
Jc
Jc
Jc
Jc
Jc
Jc
tr
qp
XA
JG
XA
qp
"}
(22,1,1) = {"
iV
Jc
Jc
Jc
Jc
Jc
Jc
Jc
Jc
Jc
Jc
Jc
Jc
Jc
Jc
Jc
Jc
Jc
Jc
Jc
tr
Kr
XA
JG
XA
Kr
"}
(23,1,1) = {"
iV
Jc
Jc
Jc
Jc
Jc
Jc
Jc
Jc
Jc
Jc
Jc
Jc
Jc
Jc
Jc
Jc
Jc
Jc
Jc
tr
Kr
XA
JG
XA
qp
"}
(24,1,1) = {"
ht
Jc
Jc
Jc
Jc
Jc
Jc
Jc
Jc
Jc
Jc
Jc
Jc
Jc
Jc
Jc
Jc
Jc
Jc
Jc
tr
Kr
XA
JG
XA
qp
"}
(25,1,1) = {"
iV
ci
Jc
Jc
vY
Kw
kh
Jc
Jc
Jc
Jc
Jc
Jc
tr
tr
tr
tr
tr
tr
tr
tr
qp
XA
XA
XA
qp
"}
(26,1,1) = {"
Ku
BW
cY
ak
tr
tr
tr
Jc
Jc
Jc
Jc
Jc
Jc
PQ
pR
zY
lV
qp
Kr
qp
qp
qp
qp
Kr
qp
qp
"}
(27,1,1) = {"
SD
SD
SD
Uv
UK
iV
Jc
Jc
Jc
Jc
Jc
Jc
lx
tr
lV
lV
lV
Ui
Kr
Kr
Kr
Ui
Kr
Kr
Kr
Kr
"}
(28,1,1) = {"
SD
SD
SD
cP
Jc
qx
vY
Jc
Kw
Jc
Jc
Jc
Jc
tr
Ui
qp
Kr
qp
Kr
JG
XA
qp
qp
Kr
qp
qp
"}
(29,1,1) = {"
SD
SD
SD
cy
yC
tr
tr
tr
tr
tr
cD
cD
cD
tr
Kr
Kr
Kr
Kr
Kr
JG
XA
qp
qp
Kr
qp
qp
"}
