//MAP CONVERTED BY dmm2tgm.py THIS HEADER COMMENT PREVENTS RECONVERSION, DO NOT REMOVE
"aU" = (
/obj/effect/turf_decal/stripes/corner{
	dir = 8
	},
/turf/open/floor/plasteel,
/area/engine/engineering)
"cC" = (
/obj/effect/turf_decal/stripes/line{
	dir = 4
	},
/obj/machinery/button/door{
	id = "SupermatterExternal";
	name = "Shutters Control";
	pixel_x = 25;
	req_access_txt = "11"
	},
/turf/open/floor/plating,
/area/engine/engineering)
"dk" = (
/turf/open/space/basic,
/area/space)
"dO" = (
/obj/structure/lattice/catwalk,
/turf/open/space/basic,
/area/space/nearstation)
"eB" = (
/obj/effect/turf_decal/stripes/line{
	dir = 1
	},
/obj/machinery/atmospherics/pipe/simple/supply/hidden{
	dir = 4
	},
/obj/structure/cable/yellow{
	icon_state = "4-8"
	},
/turf/open/floor/plating,
/area/engine/engineering)
"fe" = (
/obj/effect/turf_decal/stripes/line{
	dir = 6
	},
/obj/structure/reagent_dispensers/watertank,
/turf/open/floor/engine,
/area/engine/engineering)
"ff" = (
/obj/machinery/light/small{
	dir = 8
	},
/obj/structure/closet/emcloset/anchored,
/obj/machinery/advanced_airlock_controller{
	dir = 1;
	pixel_y = -24
	},
/turf/open/floor/plating,
/area/engine/engineering)
"fP" = (
/obj/structure/lattice,
/turf/open/space/basic,
/area/space/nearstation)
"gc" = (
/obj/machinery/atmospherics/pipe/simple/supply/hidden{
	dir = 4
	},
/turf/closed/wall/r_wall,
/area/engine/engineering)
"gD" = (
/obj/machinery/door/airlock/external{
	name = "Engineering External Access";
	req_access_txt = "10;13"
	},
/obj/effect/mapping_helpers/airlock/cyclelink_helper{
	dir = 1
	},
/turf/open/floor/plating,
/area/engine/engineering)
"hs" = (
/obj/effect/turf_decal/stripes/line{
	dir = 10
	},
/obj/effect/turf_decal/box/red,
/turf/open/floor/engine,
/area/engine/engineering)
"hv" = (
/obj/effect/turf_decal/stripes/line,
/turf/open/floor/plating,
/area/engine/engineering)
"hR" = (
/obj/machinery/atmospherics/pipe/simple/orange/visible{
	dir = 4
	},
/obj/machinery/door/airlock/external{
	name = "Engineering External Access";
	req_access_txt = "10;13"
	},
/obj/effect/mapping_helpers/airlock/cyclelink_helper,
/obj/machinery/atmospherics/pipe/simple/supply/hidden,
/obj/machinery/door/firedoor/border_only,
/obj/machinery/door/firedoor/border_only{
	dir = 1
	},
/turf/open/floor/plating,
/area/engine/engineering)
"ix" = (
/obj/machinery/atmospherics/pipe/simple/scrubbers/hidden{
	dir = 9
	},
/turf/open/floor/plasteel,
/area/engine/engineering)
"iA" = (
/obj/machinery/atmospherics/pipe/simple/supply/hidden{
	dir = 10
	},
/turf/open/floor/plasteel,
/area/engine/engineering)
"jj" = (
/obj/machinery/door/firedoor/border_only{
	dir = 8
	},
/obj/machinery/door/firedoor/border_only{
	dir = 4
	},
/obj/effect/turf_decal/bot,
/obj/machinery/door/poddoor/shutters/preopen{
	id = "SupermatterExternal";
	name = "radiation shutters"
	},
/turf/open/floor/plasteel/dark,
/area/engine/engineering)
"jm" = (
/obj/machinery/atmospherics/pipe/simple/supply/hidden{
	dir = 4
	},
/turf/open/floor/plasteel,
/area/engine/engineering)
"jt" = (
/obj/machinery/atmospherics/pipe/simple/supply/hidden{
	dir = 5
	},
/obj/effect/turf_decal/stripes/corner,
/turf/open/floor/plasteel,
/area/engine/engineering)
"jv" = (
/obj/effect/spawner/structure/window/plasma/reinforced,
/turf/open/floor/plating,
/area/engine/engineering)
"kc" = (
/obj/machinery/atmospherics/pipe/simple/scrubbers/hidden,
/turf/open/floor/plasteel,
/area/engine/engineering)
"kn" = (
/obj/effect/turf_decal/stripes/line{
	dir = 4
	},
/obj/effect/turf_decal/box/red,
/obj/item/multitool,
/turf/open/floor/engine,
/area/engine/engineering)
"ko" = (
/obj/machinery/atmospherics/pipe/simple/supply/hidden{
	dir = 4
	},
/obj/machinery/light,
/obj/effect/turf_decal/stripes/line,
/turf/open/floor/plasteel,
/area/engine/engineering)
"kA" = (
/obj/structure/table,
/obj/item/clothing/gloves/color/yellow,
/obj/item/storage/toolbox/electrical{
	pixel_y = 5
	},
/turf/open/floor/plasteel,
/area/engine/engineering)
"mN" = (
/obj/effect/turf_decal/stripes/line{
	dir = 4
	},
/obj/machinery/light{
	dir = 4;
	light_color = "#e8eaff"
	},
/turf/open/floor/plating,
/area/engine/engineering)
"nJ" = (
/obj/effect/turf_decal/stripes/line{
	dir = 4
	},
/obj/effect/turf_decal/box/red,
/turf/open/floor/engine,
/area/engine/engineering)
"op" = (
/obj/effect/turf_decal/stripes/line{
	dir = 9
	},
/obj/effect/turf_decal/box/red,
/turf/open/floor/engine,
/area/engine/engineering)
"oN" = (
/obj/effect/turf_decal/stripes/line,
/turf/open/floor/engine,
/area/engine/engineering)
"pF" = (
/obj/effect/turf_decal/stripes/line,
/obj/effect/turf_decal/box/red,
/turf/open/floor/engine,
/area/engine/engineering)
"pI" = (
/obj/machinery/atmospherics/pipe/manifold/supply/hidden{
	dir = 1
	},
/obj/structure/table,
/obj/item/book/manual/wiki/engineering_singulo_tesla,
/obj/item/geiger_counter,
/turf/open/floor/plasteel,
/area/engine/engineering)
"pR" = (
/obj/machinery/atmospherics/pipe/manifold/supply/hidden{
	dir = 1
	},
/turf/open/floor/plasteel,
/area/engine/engineering)
"pT" = (
/obj/machinery/atmospherics/pipe/simple/orange/visible{
	dir = 4
	},
/turf/closed/wall,
/area/engine/engineering)
"qc" = (
/obj/machinery/atmospherics/pipe/simple/supply/hidden{
	dir = 4
	},
/obj/machinery/atmospherics/pipe/simple/scrubbers/hidden,
/obj/structure/cable/yellow{
	icon_state = "4-8"
	},
/turf/open/floor/plasteel,
/area/engine/engineering)
"qD" = (
/obj/machinery/atmospherics/pipe/simple/supply/hidden{
	dir = 4
	},
/obj/structure/cable/yellow{
	icon_state = "4-8"
	},
/obj/structure/table,
/obj/item/storage/toolbox/mechanical,
/obj/item/flashlight,
/obj/item/pipe_dispenser,
/turf/open/floor/plasteel,
/area/engine/engineering)
"re" = (
/obj/effect/turf_decal/stripes/line{
	dir = 5
	},
/obj/machinery/atmospherics/pipe/simple/supply/hidden{
	dir = 4
	},
/obj/structure/closet/crate/engineering{
	name = "Antimatter Engine Crate"
	},
/obj/item/am_shielding_container,
/obj/item/am_shielding_container,
/obj/item/am_shielding_container,
/obj/item/am_shielding_container,
/obj/item/am_shielding_container,
/obj/item/am_shielding_container,
/obj/item/am_shielding_container,
/obj/item/am_shielding_container,
/obj/item/am_shielding_container,
/obj/item/am_shielding_container,
/obj/item/am_shielding_container,
/obj/item/am_containment,
/obj/item/am_containment,
/obj/item/am_containment,
/obj/item/am_containment,
/obj/machinery/power/am_control_unit,
/turf/open/floor/plating,
/area/engine/engineering)
"ri" = (
/obj/effect/turf_decal/stripes/line{
	dir = 4
	},
/obj/machinery/door/poddoor/shutters/preopen{
	id = "SupermatterExternal";
	name = "radiation shutters"
	},
/turf/open/floor/plasteel,
/area/engine/engineering)
"rq" = (
/obj/effect/turf_decal/stripes/line{
	dir = 10
	},
/turf/open/floor/plating,
/area/engine/engineering)
"rz" = (
/obj/machinery/light,
/obj/effect/turf_decal/stripes/line,
/turf/open/floor/plasteel,
/area/engine/engineering)
"sb" = (
/obj/effect/turf_decal/stripes/line{
	dir = 8
	},
/turf/open/floor/plating,
/area/engine/engineering)
"sg" = (
/turf/closed/wall/r_wall,
/area/engine/engineering)
"tM" = (
/turf/closed/wall/r_wall,
/area/space/nearstation)
"wd" = (
/turf/closed/wall,
/area/engine/engineering)
"wW" = (
/obj/effect/turf_decal/stripes/line{
	dir = 8
	},
/obj/machinery/button/door{
	id = "SupermatterExternal";
	name = "Shutters Control";
	pixel_x = -25;
	req_access_txt = "11"
	},
/turf/open/floor/plating,
/area/engine/engineering)
"xA" = (
/obj/effect/turf_decal/stripes/line{
	dir = 8
	},
/obj/effect/turf_decal/box/red,
/turf/open/floor/engine,
/area/engine/engineering)
"xT" = (
/obj/effect/turf_decal/stripes/line{
	dir = 6
	},
/turf/open/floor/plating,
/area/engine/engineering)
"yH" = (
/obj/structure/lattice,
/obj/structure/grille,
/turf/open/space/basic,
/area/space/nearstation)
"zQ" = (
/obj/effect/turf_decal/stripes/line{
	dir = 8
	},
/obj/machinery/door/poddoor/shutters/preopen{
	id = "SupermatterExternal";
	name = "radiation shutters"
	},
/turf/open/floor/plasteel,
/area/engine/engineering)
"Al" = (
/obj/structure/sign/warning/radiation/rad_area,
/turf/closed/wall/r_wall,
/area/engine/engineering)
"Bq" = (
/obj/machinery/atmospherics/pipe/manifold/scrubbers/hidden{
	dir = 1
	},
/turf/open/floor/plasteel,
/area/engine/engineering)
"Bz" = (
/obj/structure/table,
/obj/item/storage/toolbox/mechanical{
	pixel_y = 5
	},
/obj/item/flashlight{
	pixel_x = 1;
	pixel_y = 5
	},
/obj/item/flashlight{
	pixel_x = 1;
	pixel_y = 5
	},
/obj/effect/turf_decal/stripes/line,
/turf/open/floor/plasteel,
/area/engine/engineering)
"BG" = (
/obj/structure/sign/warning/radiation/rad_area,
/obj/machinery/atmospherics/pipe/simple/orange/visible{
	dir = 6
	},
/turf/closed/wall/r_wall,
/area/engine/engineering)
"BN" = (
/obj/effect/turf_decal/stripes/line{
	dir = 6
	},
/obj/effect/turf_decal/box/red,
/turf/open/floor/engine,
/area/engine/engineering)
"Cd" = (
/obj/machinery/atmospherics/pipe/simple/supply/hidden,
/obj/machinery/button/door{
	id = "SupermatterExternal";
	name = "Shutters Control";
	pixel_x = -25;
	req_access_txt = "11"
	},
/turf/open/floor/plasteel,
/area/engine/engineering)
"CU" = (
/obj/machinery/atmospherics/components/unary/vent_pump{
	dir = 1
	},
/obj/structure/sign/warning/vacuum/external{
	pixel_x = -32
	},
/turf/open/floor/plating,
/area/engine/engineering)
"Dj" = (
/obj/machinery/atmospherics/components/unary/vent_pump/on{
	dir = 1
	},
/obj/machinery/door/poddoor/shutters/preopen{
	id = "SupermatterExternal";
	name = "radiation shutters"
	},
/turf/open/floor/plasteel,
/area/engine/engineering)
"Fa" = (
/obj/effect/turf_decal/stripes/line{
	dir = 5
	},
/obj/effect/turf_decal/box/red,
/turf/open/floor/engine,
/area/engine/engineering)
"Fi" = (
/obj/machinery/atmospherics/pipe/simple/orange/visible,
/turf/closed/wall/r_wall,
/area/engine/engineering)
"He" = (
/obj/structure/table,
/obj/item/clothing/suit/radiation,
/obj/item/clothing/head/radiation,
/obj/item/clothing/glasses/meson,
/turf/open/floor/plasteel,
/area/engine/engineering)
"HA" = (
/obj/machinery/door/poddoor/shutters/preopen{
	id = "SupermatterExternal";
	name = "radiation shutters"
	},
/turf/open/floor/plasteel,
/area/engine/engineering)
"Ir" = (
/obj/structure/lattice,
/obj/structure/grille,
/turf/open/space,
/area/space/nearstation)
"IL" = (
/obj/machinery/door/poddoor/shutters/preopen{
	id = "SupermatterExternal";
	name = "radiation shutters"
	},
/obj/effect/turf_decal/bot,
/obj/machinery/door/firedoor/border_only{
	dir = 1
	},
/obj/machinery/door/firedoor/border_only,
/turf/open/floor/plasteel/dark,
/area/engine/engineering)
"Jg" = (
/obj/machinery/atmospherics/components/unary/vent_scrubber/on{
	dir = 1
	},
/obj/machinery/door/poddoor/shutters/preopen{
	id = "SupermatterExternal";
	name = "radiation shutters"
	},
/turf/open/floor/plasteel,
/area/engine/engineering)
"JQ" = (
/obj/machinery/camera/emp_proof{
	c_tag = "Engine - North East";
	network = list("ss13","engine")
	},
/obj/machinery/atmospherics/components/unary/outlet_injector/atmos/engine_waste{
	dir = 1
	},
/turf/open/floor/plating/airless,
/area/engine/engineering)
"LV" = (
/obj/machinery/atmospherics/pipe/simple/scrubbers/hidden{
	dir = 4
	},
/obj/structure/table,
/obj/item/tank/internals/emergency_oxygen/engi,
/obj/item/clothing/gloves/color/black,
/obj/item/clothing/glasses/meson/engine,
/turf/open/floor/plasteel,
/area/engine/engineering)
"LZ" = (
/obj/structure/lattice,
/turf/open/space,
/area/space/nearstation)
"Ma" = (
/obj/machinery/light{
	dir = 1
	},
/obj/effect/turf_decal/stripes/line{
	dir = 1
	},
/obj/machinery/camera/emp_proof{
	c_tag = "Engine - Antimatter";
	dir = 6;
	network = list("ss13","engine")
	},
/obj/machinery/atmospherics/pipe/simple/supply/hidden{
	dir = 4
	},
/obj/structure/cable/yellow{
	icon_state = "2-8"
	},
/obj/machinery/button/door{
	id = "SupermatterExternal";
	name = "Shutters Control";
	pixel_y = 30;
	req_access_txt = "11"
	},
/turf/open/floor/plating,
/area/engine/engineering)
"MQ" = (
/obj/effect/turf_decal/stripes/line{
	dir = 10
	},
/obj/structure/reagent_dispensers/fueltank,
/turf/open/floor/engine,
/area/engine/engineering)
"MS" = (
/obj/effect/turf_decal/stripes/line{
	dir = 4
	},
/turf/open/floor/plating,
/area/engine/engineering)
"Ok" = (
/obj/effect/turf_decal/stripes/line{
	dir = 1
	},
/obj/effect/turf_decal/box,
/obj/structure/cable/yellow,
/turf/open/floor/engine,
/area/engine/engineering)
"Pr" = (
/obj/machinery/light/small{
	dir = 4
	},
/obj/machinery/advanced_airlock_controller{
	dir = 1;
	pixel_y = -24
	},
/obj/structure/closet/emcloset/anchored,
/turf/open/floor/plating,
/area/engine/engineering)
"PE" = (
/obj/machinery/atmospherics/pipe/simple/supply/hidden,
/turf/open/floor/plasteel,
/area/engine/engineering)
"PM" = (
/obj/machinery/atmospherics/pipe/manifold4w/supply/hidden,
/obj/structure/cable/yellow{
	icon_state = "4-8"
	},
/turf/open/floor/plasteel,
/area/engine/engineering)
"PY" = (
/obj/machinery/atmospherics/pipe/simple/scrubbers/hidden{
	dir = 6
	},
/turf/open/floor/plasteel,
/area/engine/engineering)
"Qw" = (
/obj/effect/turf_decal/box/red,
/turf/open/floor/engine,
/area/engine/engineering)
"QA" = (
/turf/open/floor/plasteel,
/area/engine/engineering)
"Sg" = (
/obj/effect/mapping_helpers/airlock/cyclelink_helper,
/obj/machinery/door/airlock/external{
	name = "Engineering External Access";
	req_access_txt = "10;13"
	},
/obj/machinery/door/firedoor/border_only,
/obj/machinery/door/firedoor/border_only{
	dir = 1
	},
/obj/machinery/atmospherics/pipe/simple/supply/hidden,
/turf/open/floor/plating,
/area/engine/engineering)
"SA" = (
/obj/machinery/atmospherics/pipe/simple/supply/hidden{
	dir = 4
	},
/obj/structure/cable/yellow{
	icon_state = "4-8"
	},
/turf/open/floor/plasteel,
/area/engine/engineering)
"TD" = (
/turf/template_noop,
/area/template_noop)
"Us" = (
/obj/effect/turf_decal/stripes/line{
	dir = 9
	},
/obj/machinery/atmospherics/pipe/simple/supply/hidden{
	dir = 4
	},
/obj/structure/cable/yellow{
	icon_state = "4-8"
	},
/turf/open/floor/plating,
/area/engine/engineering)
"Uw" = (
/obj/item/wrench,
/obj/effect/turf_decal/box/red,
/turf/open/floor/engine,
/area/engine/engineering)
"VA" = (
/obj/effect/turf_decal/stripes/line{
	dir = 1
	},
/obj/machinery/atmospherics/pipe/simple/supply/hidden{
	dir = 4
	},
/turf/open/floor/plating,
/area/engine/engineering)
"VR" = (
/obj/structure/sign/warning/vacuum/external{
	pixel_x = 32
	},
/obj/machinery/atmospherics/components/unary/vent_pump{
	dir = 1
	},
/turf/open/floor/plating,
/area/engine/engineering)
"WH" = (
/obj/machinery/atmospherics/pipe/simple/supply/hidden,
/obj/machinery/button/door{
	id = "SupermatterExternal";
	name = "Shutters Control";
	pixel_x = 25;
	req_access_txt = "11"
	},
/turf/open/floor/plasteel,
/area/engine/engineering)
"WV" = (
/obj/machinery/atmospherics/pipe/simple/scrubbers/hidden{
	dir = 4
	},
/obj/machinery/atmospherics/pipe/simple/supply/hidden,
/turf/open/floor/plasteel,
/area/engine/engineering)
"Xf" = (
/obj/effect/spawner/structure/window/plasma/reinforced/shutters,
/turf/open/floor/plating,
/area/engine/engineering)
"Xy" = (
/obj/machinery/light{
	dir = 8
	},
/obj/effect/turf_decal/stripes/line{
	dir = 8
	},
/turf/open/floor/plating,
/area/engine/engineering)
"Yk" = (
/obj/machinery/atmospherics/pipe/simple/scrubbers/hidden,
/obj/machinery/atmospherics/pipe/simple/supply/hidden{
	dir = 4
	},
/turf/open/floor/plasteel,
/area/engine/engineering)
"YE" = (
/obj/effect/mapping_helpers/airlock/cyclelink_helper{
	dir = 1
	},
/obj/machinery/door/airlock/external{
	name = "Engineering External Access";
	req_access_txt = "10;13"
	},
/turf/open/floor/plating,
/area/engine/engineering)
"Zq" = (
/obj/machinery/atmospherics/pipe/simple/supply/hidden{
	dir = 4
	},
/obj/structure/cable/yellow{
	icon_state = "4-8"
	},
/turf/closed/wall/r_wall,
/area/engine/engineering)

(1,1,1) = {"
TD
TD
TD
TD
TD
TD
TD
dk
LZ
dk
dk
LZ
dk
dk
LZ
dk
dk
dk
Ir
Ir
Ir
TD
TD
TD
TD
TD
"}
(2,1,1) = {"
TD
TD
TD
TD
TD
TD
TD
dk
fP
dk
dk
fP
dk
dk
fP
dk
dk
dk
Ir
tM
Ir
TD
TD
TD
TD
TD
"}
(3,1,1) = {"
TD
TD
TD
TD
TD
TD
TD
fP
fP
fP
fP
fP
fP
fP
fP
fP
LZ
LZ
Ir
tM
Ir
TD
TD
TD
TD
TD
"}
(4,1,1) = {"
TD
TD
TD
TD
TD
TD
TD
dO
fP
dO
dO
fP
dO
dO
fP
dO
dO
dO
Ir
tM
Ir
TD
TD
TD
TD
TD
"}
(5,1,1) = {"
TD
TD
TD
TD
TD
TD
TD
fP
fP
fP
fP
fP
fP
fP
fP
fP
LZ
LZ
Ir
tM
Ir
TD
TD
TD
TD
TD
"}
(6,1,1) = {"
TD
TD
TD
TD
TD
TD
TD
dO
fP
dO
dO
fP
dO
dO
fP
dO
dO
dO
Ir
tM
Ir
TD
TD
TD
TD
TD
"}
(7,1,1) = {"
TD
TD
TD
TD
wd
wd
sg
fP
fP
fP
fP
fP
fP
fP
fP
fP
LZ
LZ
Ir
tM
Ir
dk
dk
dk
dk
dk
"}
(8,1,1) = {"
TD
TD
kA
Bz
wd
ff
sg
dO
fP
dO
dO
fP
dO
dO
fP
dO
dO
dO
Ir
tM
Ir
dk
dk
dk
dk
dk
"}
(9,1,1) = {"
TD
TD
PE
PE
Sg
VR
YE
dO
fP
fP
fP
fP
fP
fP
fP
fP
LZ
LZ
Ir
Ir
Ir
dk
dk
dk
dk
dk
"}
(10,1,1) = {"
TD
SA
QA
rz
Al
sg
sg
dO
dk
dk
dk
dk
dk
dk
dk
dk
dk
dk
dk
fP
dk
dk
dk
dk
dk
dk
"}
(11,1,1) = {"
LV
qD
QA
aU
zQ
MQ
sg
dk
dk
dk
dk
dk
dk
dk
dk
dk
dk
dk
yH
Ir
yH
dk
dk
dk
dk
dk
"}
(12,1,1) = {"
Bq
qc
kc
kc
Jg
oN
Xf
dk
dk
dk
dk
dk
dk
dk
dk
dk
dk
dk
Ir
tM
Ir
dk
dk
dk
dk
dk
"}
(13,1,1) = {"
ix
SA
QA
QA
HA
oN
Xf
dk
dk
dk
dk
dk
dk
dk
dk
dk
dk
dk
Ir
tM
Ir
dk
dk
dk
dk
dk
"}
(14,1,1) = {"
PE
PM
WH
PE
Dj
oN
Xf
Xf
dk
dk
dk
dk
dk
dk
dk
dk
dk
LZ
Ir
tM
Ir
LZ
dk
dk
dk
dk
"}
(15,1,1) = {"
Al
Zq
sg
jj
sg
jv
jv
Xf
dk
dk
dk
dk
dk
dk
dk
dk
dk
dk
Ir
tM
Ir
dk
dk
dk
dk
dk
"}
(16,1,1) = {"
sg
Us
sb
Xy
wW
sb
rq
Xf
dk
dk
dk
dk
dk
dk
dk
dk
dk
LZ
Ir
tM
Ir
dk
dk
dk
dk
dk
"}
(17,1,1) = {"
IL
eB
op
xA
xA
hs
hv
Xf
dk
dk
dk
dk
dk
dk
dk
dk
dk
dk
Ir
tM
Ir
dk
dk
dk
dk
dk
"}
(18,1,1) = {"
sg
Ma
Ok
Uw
Qw
pF
hv
Xf
dk
dk
dk
dk
dk
dk
dk
dk
dk
dk
Ir
tM
Ir
dk
dk
dk
dk
dk
"}
(19,1,1) = {"
IL
VA
Fa
kn
nJ
BN
hv
Xf
dk
dk
dk
dk
dk
dk
dk
dk
dk
LZ
Ir
tM
Ir
dk
dk
dk
dk
dk
"}
(20,1,1) = {"
sg
re
MS
mN
cC
MS
xT
Xf
dk
dk
dk
dk
dk
dk
dk
dk
dk
LZ
Ir
tM
Ir
dk
dk
dk
dk
dk
"}
(21,1,1) = {"
Al
gc
sg
jj
sg
jv
jv
Xf
dk
dk
dk
dk
dk
dk
dk
dk
dk
dk
Ir
tM
Ir
dk
dk
dk
dk
dk
"}
(22,1,1) = {"
QA
pR
Cd
PE
Dj
oN
Xf
Xf
dk
dk
dk
dk
dk
dk
dk
dk
dk
LZ
Ir
tM
Ir
LZ
dk
dk
dk
dk
"}
(23,1,1) = {"
QA
jm
QA
QA
HA
oN
Xf
dk
dk
dk
dk
dk
dk
dk
dk
dk
dk
LZ
Ir
tM
Ir
dk
dk
dk
dk
dk
"}
(24,1,1) = {"
QA
jm
PY
kc
Jg
oN
Xf
dk
dk
dk
dk
dk
dk
dk
dk
dk
dk
LZ
Ir
tM
Ir
dk
dk
dk
dk
dk
"}
(25,1,1) = {"
He
pI
WV
jt
ri
fe
sg
dk
dk
dk
dk
dk
dk
dk
dk
dk
dk
dk
Ir
Ir
Ir
dk
dk
dk
dk
dk
"}
(26,1,1) = {"
kc
Yk
ix
ko
BG
Fi
Fi
JQ
dk
dk
dk
dk
dk
dk
dk
dk
dk
dk
dk
fP
dk
dk
dk
dk
dk
dk
"}
(27,1,1) = {"
TD
TD
TD
iA
hR
CU
gD
dO
dk
dk
dk
dk
dk
dk
dk
dk
dk
LZ
LZ
LZ
LZ
fP
dk
dk
dk
dk
"}
(28,1,1) = {"
TD
TD
TD
QA
pT
Pr
sg
dO
dk
dk
dk
dk
dk
dk
dk
dk
LZ
dk
LZ
tM
Ir
dk
dk
dk
dk
dk
"}
(29,1,1) = {"
TD
TD
TD
QA
pT
wd
sg
sg
sg
sg
dk
dk
dk
dk
LZ
LZ
LZ
LZ
LZ
tM
Ir
dk
dk
dk
dk
dk
"}
