//MAP CONVERTED BY dmm2tgm.py THIS HEADER COMMENT PREVENTS RECONVERSION, DO NOT REMOVE
"at" = (
/turf/closed/mineral,
/area/asteroid)
"aA" = (
/obj/structure/chair/office/light{
	dir = 4
	},
/turf/open/floor/plasteel,
/area/ruin)
"aU" = (
/obj/effect/decal/cleanable/oil/slippery,
/obj/structure/closet/crate,
/turf/open/floor/plasteel,
/area/ruin)
"bn" = (
/obj/structure/chair/office/light{
	dir = 4
	},
/turf/open/floor/wood,
/area/ruin)
"bW" = (
/obj/effect/decal/cleanable/oil/slippery,
/obj/item/trash/sosjerky,
/turf/open/floor/plasteel,
/area/ruin)
"cm" = (
/obj/effect/mob_spawn/human/miner/explorer,
/turf/open/floor/holofloor/asteroid,
/area/asteroid)
"df" = (
/obj/effect/spawner/structure/window/reinforced,
/turf/open/floor/plasteel,
/area/ruin)
"dN" = (
/obj/structure/sink/puddle,
/turf/closed/mineral,
/area/asteroid)
"es" = (
/obj/structure/closet/secure_closet/engineering_personal,
/turf/open/floor/plasteel,
/area/ruin)
"eZ" = (
/obj/effect/decal/cleanable/oil/slippery,
/obj/machinery/modular_computer/console{
	dir = 8
	},
/turf/open/floor/plasteel,
/area/ruin)
"fg" = (
/obj/structure/table,
/turf/open/floor/plasteel,
/area/ruin)
"ga" = (
/obj/structure/bed,
/obj/item/bedsheet/syndie,
/turf/open/floor/wood,
/area/ruin)
"gh" = (
/obj/structure/closet/crate,
/obj/item/stack/ore/titanium,
/obj/item/stack/ore/titanium,
/turf/open/floor/plasteel,
/area/ruin)
"gi" = (
/obj/structure/sign/poster/contraband/power,
/turf/closed/wall/r_wall,
/area/ruin)
"gu" = (
/obj/effect/mob_spawn/human/miner/explorer,
/obj/effect/decal/cleanable/blood/gibs,
/turf/open/floor/plasteel,
/area/ruin)
"gx" = (
/obj/item/rollingpaper,
/turf/open/floor/plasteel,
/area/ruin)
"gO" = (
/obj/machinery/door/airlock{
	name = "Room 3"
	},
/turf/open/floor/plasteel,
/area/ruin)
"hA" = (
/obj/item/stack/ore/uranium,
/turf/open/floor/holofloor/asteroid,
/area/asteroid)
"ib" = (
/obj/structure/closet/crate{
	icon_state = "crateopen"
	},
/obj/item/stack/sheet/mineral/plasma/twenty,
/obj/item/stack/ore/diamond,
/obj/item/stack/ore/diamond,
/turf/open/floor/plasteel,
/area/ruin)
"id" = (
/turf/closed/mineral,
/area/space)
"im" = (
/obj/effect/mob_spawn/human/miner/explorer,
/obj/effect/decal/cleanable/blood/splatter,
/turf/open/floor/wood,
/area/ruin)
"io" = (
/obj/item/trash/sosjerky,
/turf/open/floor/plasteel,
/area/ruin)
"is" = (
/obj/item/pickaxe/drill,
/obj/effect/decal/cleanable/blood/old,
/turf/open/floor/holofloor/asteroid,
/area/asteroid)
"iD" = (
/obj/machinery/door/airlock/alarmlock{
	name = "Cargo"
	},
/turf/open/floor/plasteel,
/area/ruin)
"iV" = (
/turf/open/space/basic,
/area/space)
"jg" = (
/obj/item/stack/ore/uranium,
/turf/open/floor/plasteel,
/area/ruin)
"jP" = (
/turf/open/floor/plasteel,
/area/ruin)
"li" = (
/obj/effect/decal/cleanable/blood/tracks{
	dir = 1
	},
/turf/open/floor/holofloor/asteroid,
/area/asteroid)
"mu" = (
/obj/structure/closet/secure_closet/miner,
/turf/open/floor/plating,
/area/ruin)
"mN" = (
/turf/open/floor/wood,
/area/ruin)
"mR" = (
/obj/structure/table,
/obj/item/folder/blue,
/turf/open/floor/plasteel,
/area/ruin)
"nK" = (
/obj/structure/chair/office/light{
	dir = 1
	},
/turf/open/floor/wood,
/area/ruin)
"on" = (
/obj/effect/mob_spawn/human/miner/explorer,
/obj/effect/decal/cleanable/blood/tracks{
	dir = 1
	},
/obj/effect/decal/cleanable/blood/gibs/bubblegum,
/turf/open/floor/holofloor/asteroid,
/area/asteroid)
"oG" = (
/obj/item/trash/can,
/turf/open/floor/plasteel,
/area/ruin)
"oR" = (
/obj/effect/landmark/ore_vein,
/turf/closed/mineral,
/area/asteroid)
"pa" = (
/obj/structure/closet/crate/engineering,
/turf/open/floor/plasteel,
/area/ruin)
"pl" = (
/obj/machinery/door/airlock{
	name = "Preparations"
	},
/obj/structure/barricade/wooden/crude,
/turf/open/floor/plasteel,
/area/ruin)
"pH" = (
/obj/structure/sign/poster/ripped,
/turf/closed/wall/rust,
/area/ruin)
"pU" = (
/obj/item/stack/ore/plasma,
/turf/open/floor/holofloor/asteroid,
/area/asteroid)
"pW" = (
/obj/structure/sign/poster/retro/radio,
/turf/closed/wall/rust,
/area/ruin)
"qa" = (
/obj/structure/closet/crate,
/turf/open/floor/plasteel,
/area/ruin)
"qg" = (
/obj/structure/bed/roller,
/turf/open/floor/plasteel,
/area/ruin)
"rC" = (
/obj/machinery/modular_computer/console/preset/engineering,
/turf/open/floor/plasteel,
/area/ruin)
"si" = (
/obj/machinery/door/airlock{
	name = "Room 1"
	},
/obj/effect/decal/cleanable/blood/tracks{
	dir = 1
	},
/turf/open/floor/plasteel,
/area/ruin)
"sp" = (
/turf/closed/wall/r_wall,
/area/ruin)
"ua" = (
/turf/closed/wall,
/area/ruin)
"um" = (
/obj/structure/lattice,
/turf/open/space/basic,
/area/ruin)
"vq" = (
/obj/effect/decal/cleanable/blood/tracks,
/turf/open/floor/plasteel,
/area/ruin)
"vB" = (
/obj/machinery/vending/cigarette,
/turf/open/floor/plasteel,
/area/ruin)
"wg" = (
/obj/item/stack/ore/uranium,
/obj/item/stack/ore/uranium,
/turf/open/floor/holofloor/asteroid,
/area/asteroid)
"wj" = (
/obj/effect/decal/cleanable/blood/tracks{
	dir = 4
	},
/turf/open/floor/plasteel,
/area/ruin)
"wE" = (
/obj/machinery/mineral/equipment_vendor,
/turf/open/floor/plasteel,
/area/ruin)
"wK" = (
/obj/machinery/door/airlock/wood{
	locked = 1;
	name = "Corporate Bedroom"
	},
/turf/open/floor/wood,
/area/ruin)
"xa" = (
/obj/structure/table/wood,
/obj/item/flashlight/lamp/green,
/turf/open/floor/wood,
/area/ruin)
"xG" = (
/obj/effect/mob_spawn/human/miner/explorer,
/obj/effect/decal/cleanable/blood/old,
/turf/open/floor/holofloor/asteroid,
/area/asteroid)
"xU" = (
/obj/machinery/door/airlock/command{
	name = "Bridge"
	},
/turf/open/floor/plasteel,
/area/ruin)
"yF" = (
/obj/item/trash/popcorn,
/turf/open/floor/wood,
/area/ruin)
"yH" = (
/obj/machinery/door/airlock/external,
/turf/open/floor/plasteel,
/area/ruin)
"Ag" = (
/obj/machinery/power/floodlight,
/obj/structure/cable{
	icon_state = "0-8"
	},
/turf/open/floor/holofloor/asteroid,
/area/asteroid)
"At" = (
/obj/effect/landmark/ore_vein,
/turf/closed/mineral/gold,
/area/asteroid)
"Au" = (
/turf/closed/wall/rust,
/area/ruin)
"AA" = (
/obj/structure/chair/stool/bar{
	dir = 4
	},
/turf/open/floor/plasteel,
/area/ruin)
"BP" = (
/obj/structure/table,
/obj/item/storage/toolbox/mechanical,
/obj/item/multitool,
/turf/open/floor/plasteel,
/area/ruin)
"Cf" = (
/obj/machinery/roulette,
/turf/open/floor/plasteel,
/area/ruin)
"Cl" = (
/obj/structure/closet/crate{
	icon_state = "crateopen"
	},
/obj/item/flashlight,
/obj/item/reagent_containers/food/drinks/soda_cans/plasma,
/obj/item/stack/ore/bluespace_crystal,
/turf/open/floor/plasteel,
/area/ruin)
"Dv" = (
/obj/item/trash/waffles,
/turf/open/floor/plasteel,
/area/ruin)
"EI" = (
/obj/effect/decal/cleanable/oil/slippery,
/obj/machinery/door/airlock/alarmlock{
	name = "Cargo"
	},
/turf/open/floor/plasteel,
/area/ruin)
"EM" = (
/obj/effect/decal/cleanable/oil/slippery,
/obj/structure/girder/reinforced,
/turf/open/floor/plating,
/area/ruin)
"EP" = (
/obj/machinery/modular_computer/console{
	dir = 8
	},
/turf/open/floor/plasteel,
/area/ruin)
"EU" = (
/obj/machinery/suit_storage_unit/mining/eva,
/turf/open/floor/plasteel,
/area/ruin)
"Fy" = (
/obj/structure/grille/broken,
/obj/item/shard,
/turf/open/floor/plasteel,
/area/ruin)
"Gg" = (
/turf/open/floor/holofloor/asteroid,
/area/asteroid)
"Hh" = (
/obj/structure/closet/secure_closet/personal,
/turf/open/floor/plasteel,
/area/ruin)
"Hm" = (
/obj/effect/decal/cleanable/blood/tracks{
	dir = 1
	},
/turf/open/floor/plasteel,
/area/ruin)
"Hz" = (
/obj/structure/sign/poster/retro/smile,
/turf/closed/wall/rust,
/area/ruin)
"Ii" = (
/obj/item/trash/syndi_cakes,
/turf/open/floor/plasteel,
/area/ruin)
"Jj" = (
/turf/closed/wall/r_wall/rust,
/area/ruin)
"Jn" = (
/obj/item/trash/candy,
/turf/open/floor/plasteel,
/area/ruin)
"Jt" = (
/obj/effect/decal/cleanable/oil/slippery,
/obj/structure/closet/crate{
	icon_state = "crateopen"
	},
/obj/item/flashlight/glowstick/blue,
/obj/item/flashlight/glowstick/pink,
/obj/item/flashlight/glowstick/orange,
/obj/item/flashlight/glowstick/yellow,
/obj/item/trash/syndi_cakes,
/obj/item/storage/bag/ore,
/turf/open/floor/plasteel,
/area/ruin)
"JQ" = (
/obj/machinery/door/airlock/wood/glass{
	name = "Corporate's Office"
	},
/turf/open/floor/wood,
/area/ruin)
"JS" = (
/obj/structure/sign/poster/official/space_cops,
/turf/closed/wall,
/area/ruin)
"KA" = (
/obj/structure/table/wood/poker,
/obj/effect/holodeck_effect/cards,
/turf/open/floor/plasteel,
/area/ruin)
"KI" = (
/obj/structure/mecha_wreckage/ripley/mkii,
/turf/open/floor/holofloor/asteroid,
/area/asteroid)
"KR" = (
/obj/item/trash/candy,
/turf/open/floor/wood,
/area/ruin)
"Lu" = (
/obj/effect/decal/cleanable/oil/slippery,
/obj/machinery/vending/coffee,
/turf/open/floor/plasteel,
/area/ruin)
"Lv" = (
/obj/structure/closet/cabinet,
/turf/open/floor/wood,
/area/ruin)
"Lx" = (
/obj/effect/landmark/ore_vein,
/obj/effect/landmark/ore_vein,
/turf/closed/mineral,
/area/asteroid)
"ML" = (
/obj/effect/decal/cleanable/oil/slippery,
/turf/open/floor/plasteel,
/area/ruin)
"MX" = (
/obj/structure/girder/reinforced,
/turf/open/floor/plating,
/area/ruin)
"Nb" = (
/turf/closed/mineral/gold,
/area/asteroid)
"NB" = (
/obj/structure/bed,
/obj/item/bedsheet/dorms,
/turf/open/floor/plasteel,
/area/ruin)
"NJ" = (
/obj/effect/decal/cleanable/oil/slippery,
/obj/structure/chair/stool/bar{
	dir = 8
	},
/turf/open/floor/plasteel,
/area/ruin)
"NY" = (
/obj/structure/closet/crate,
/obj/item/stack/ore/gold,
/obj/item/stack/ore/gold,
/turf/open/floor/plasteel,
/area/ruin)
"NZ" = (
/obj/machinery/power/smes,
/turf/open/floor/plasteel,
/area/ruin)
"Of" = (
/obj/structure/closet/crate/bin,
/obj/item/trash/can/food/beans,
/turf/open/floor/plasteel,
/area/ruin)
"Ox" = (
/obj/effect/mob_spawn/human/miner/explorer,
/obj/item/storage/bag/ore,
/obj/effect/decal/cleanable/blood/tracks,
/turf/open/floor/plasteel,
/area/ruin)
"OL" = (
/obj/structure/sign/departments/engineering,
/turf/closed/wall,
/area/ruin)
"Pa" = (
/obj/machinery/power/port_gen/pacman,
/obj/structure/cable{
	icon_state = "0-4"
	},
/turf/open/floor/holofloor/asteroid,
/area/asteroid)
"PH" = (
/obj/machinery/door/airlock/engineering{
	name = "Engineering"
	},
/turf/open/floor/plasteel,
/area/ruin)
"PQ" = (
/obj/structure/table/wood,
/obj/item/paper{
	info = "date: *unintelligible*[br/]time: 11:07[br/]This is Mark, the operation went to shit basically! Adam gone mad and killed Josh! I locked myself in the Corporate Bedroom with my handy gun, but I am not a killer! Please help me god.";
	name = "Old Note"
	},
/turf/open/floor/wood,
/area/ruin)
"Qu" = (
/turf/open/floor/plating,
/area/ruin)
"Rm" = (
/obj/effect/decal/cleanable/blood/gibs/torso,
/turf/open/floor/plasteel,
/area/ruin)
"Rn" = (
/obj/structure/closet/crate,
/obj/item/stack/ore/iron,
/obj/item/stack/ore/iron,
/obj/item/stack/ore/iron,
/turf/open/floor/plasteel,
/area/ruin)
"RI" = (
/obj/effect/decal/cleanable/blood/gibs/old,
/turf/open/floor/plasteel,
/area/ruin)
"Se" = (
/obj/effect/decal/cleanable/oil/slippery,
/obj/item/trash/can/food/peaches/maint,
/turf/open/floor/plasteel,
/area/ruin)
"Tr" = (
/obj/effect/decal/cleanable/oil/slippery,
/obj/effect/decal/cleanable/blood/tracks{
	dir = 9
	},
/turf/open/floor/plasteel,
/area/ruin)
"TQ" = (
/obj/effect/decal/cleanable/blood/splatter,
/turf/open/floor/wood,
/area/ruin)
"Us" = (
/obj/effect/decal/cleanable/blood/splatter,
/turf/open/floor/plasteel,
/area/ruin)
"Uw" = (
/obj/item/flashlight/flare,
/obj/effect/decal/cleanable/blood/tracks,
/turf/open/floor/plasteel,
/area/ruin)
"Vz" = (
/obj/structure/table/wood,
/obj/machinery/computer/pod/old/syndicate,
/turf/open/floor/wood,
/area/ruin)
"WZ" = (
/obj/effect/mob_spawn/human/miner/explorer,
/turf/open/floor/plasteel,
/area/ruin)
"Xv" = (
/obj/item/stack/sheet/mineral/plasma/five,
/obj/effect/decal/cleanable/blood/gibs/bubblegum,
/turf/open/floor/holofloor/asteroid,
/area/asteroid)
"Xw" = (
/obj/structure/table/wood,
/obj/item/gun/ballistic/automatic/pistol/suppressed,
/turf/open/floor/wood,
/area/ruin)
"Yh" = (
/obj/machinery/door/airlock{
	name = "Room 2"
	},
/turf/open/floor/plasteel,
/area/ruin)
"YG" = (
/obj/structure/table,
/obj/item/paper_bin,
/obj/item/pen,
/obj/item/stamp,
/turf/open/floor/plasteel,
/area/ruin)
"Za" = (
/obj/item/shard,
/turf/open/floor/plating,
/area/ruin)
"ZM" = (
/obj/effect/decal/cleanable/oil/slippery,
/obj/structure/closet/crate{
	icon_state = "crateopen"
	},
/obj/item/flashlight,
/turf/open/floor/plasteel,
/area/ruin)

(1,1,1) = {"
iV
iV
iV
iV
iV
iV
iV
iV
iV
iV
iV
iV
iV
iV
iV
iV
iV
iV
iV
iV
iV
iV
iV
iV
iV
iV
iV
iV
iV
iV
at
at
at
at
at
iV
iV
iV
iV
iV
iV
iV
iV
iV
iV
iV
iV
iV
iV
iV
"}
(2,1,1) = {"
iV
iV
iV
iV
iV
iV
iV
iV
iV
iV
iV
iV
iV
iV
iV
iV
iV
iV
iV
iV
iV
iV
iV
iV
iV
iV
iV
iV
at
at
at
at
at
at
oR
at
iV
iV
iV
iV
iV
iV
iV
iV
iV
iV
iV
iV
iV
iV
"}
(3,1,1) = {"
iV
iV
iV
iV
iV
iV
iV
iV
iV
iV
iV
iV
iV
iV
Gg
Gg
iV
iV
iV
at
iV
iV
iV
iV
iV
at
at
at
oR
at
at
at
oR
at
at
at
oR
iV
iV
iV
iV
iV
iV
iV
iV
iV
iV
iV
iV
iV
"}
(4,1,1) = {"
iV
iV
iV
iV
iV
iV
iV
iV
iV
iV
iV
iV
iV
at
at
Gg
Gg
Gg
at
at
at
iV
iV
iV
oR
oR
oR
at
Gg
Gg
Gg
Gg
Gg
at
Nb
at
at
at
iV
iV
iV
iV
iV
iV
iV
iV
iV
iV
iV
iV
"}
(5,1,1) = {"
iV
iV
iV
iV
iV
iV
iV
iV
iV
iV
iV
iV
iV
at
at
at
Gg
Gg
Gg
oR
at
at
at
at
at
at
at
Gg
Gg
Gg
on
li
li
Gg
At
at
at
at
at
iV
iV
iV
iV
iV
iV
iV
iV
iV
iV
iV
"}
(6,1,1) = {"
iV
iV
iV
iV
iV
iV
iV
iV
iV
iV
iV
iV
id
at
at
oR
at
Gg
Gg
Gg
at
oR
at
oR
at
at
Gg
Gg
Gg
Gg
Gg
pU
Gg
Gg
Gg
Gg
wg
at
oR
at
iV
iV
iV
iV
iV
iV
iV
iV
iV
iV
"}
(7,1,1) = {"
iV
iV
iV
iV
iV
iV
iV
iV
iV
iV
at
at
at
at
at
at
at
Gg
Gg
Gg
Gg
Gg
at
at
Gg
Gg
Gg
Gg
Gg
Gg
pU
pU
Gg
Gg
Gg
hA
hA
Gg
at
at
iV
iV
iV
iV
iV
iV
iV
iV
iV
iV
"}
(8,1,1) = {"
iV
iV
iV
iV
iV
iV
iV
iV
iV
at
at
at
at
oR
at
at
oR
at
at
Gg
Gg
Gg
Gg
Gg
Gg
Gg
Gg
Gg
at
at
at
at
at
Gg
Gg
Gg
Gg
Gg
Gg
at
at
iV
iV
iV
iV
iV
iV
iV
iV
iV
"}
(9,1,1) = {"
iV
iV
iV
iV
iV
iV
iV
iV
at
at
at
oR
oR
oR
oR
oR
at
at
Gg
Gg
Gg
Gg
Gg
Gg
Gg
at
at
at
at
at
at
oR
Nb
at
Nb
Gg
Gg
Gg
Gg
oR
at
at
iV
iV
iV
at
at
iV
iV
iV
"}
(10,1,1) = {"
iV
iV
iV
iV
iV
iV
iV
iV
iV
at
at
oR
oR
at
at
at
Gg
Gg
Gg
Gg
Gg
Gg
at
at
at
at
at
at
At
at
at
at
at
at
at
at
Gg
Gg
Gg
at
at
at
at
at
oR
at
iV
iV
iV
iV
"}
(11,1,1) = {"
iV
iV
iV
iV
iV
iV
iV
iV
iV
iV
at
at
at
oR
at
Gg
Gg
KI
Gg
Gg
Gg
at
at
at
oR
at
sp
sp
sp
Jj
Jj
sp
sp
sp
Jj
oR
at
Gg
Gg
Gg
at
oR
at
oR
at
at
at
iV
iV
iV
"}
(12,1,1) = {"
iV
iV
iV
iV
iV
iV
iV
iV
iV
iV
iV
at
at
at
at
at
Gg
Gg
Gg
Gg
at
At
at
at
at
at
sp
Vz
nK
mN
wK
TQ
bn
mN
Jj
at
at
Gg
Gg
Gg
Gg
at
Gg
Gg
Gg
Gg
Gg
Gg
iV
iV
"}
(13,1,1) = {"
iV
iV
iV
iV
iV
iV
iV
iV
iV
iV
iV
at
at
at
at
at
Gg
Gg
Gg
Nb
at
at
sp
sp
sp
Jj
sp
Xw
yF
mN
sp
xa
PQ
mN
sp
at
oR
at
Gg
Gg
Gg
Gg
Gg
Gg
Gg
Gg
Gg
Gg
iV
iV
"}
(14,1,1) = {"
iV
iV
iV
iV
iV
iV
iV
iV
iV
iV
iV
iV
at
at
at
Gg
Gg
Gg
cm
Nb
at
at
Jj
NZ
ML
jP
Jj
Lv
im
ga
sp
mN
TQ
KR
sp
at
at
at
Gg
Gg
Gg
Gg
Gg
Gg
Gg
Gg
Gg
iV
iV
iV
"}
(15,1,1) = {"
iV
iV
iV
iV
iV
iV
iV
iV
iV
iV
iV
iV
iV
at
Gg
Gg
Gg
Xv
Gg
Gg
at
oR
gi
NZ
jP
jP
Jj
Jj
sp
sp
Jj
sp
JQ
Jj
sp
Jj
sp
at
Gg
Gg
Gg
Gg
Gg
Gg
at
Gg
iV
iV
iV
iV
"}
(16,1,1) = {"
iV
iV
iV
iV
iV
iV
iV
iV
iV
iV
iV
iV
iV
iV
Gg
Gg
Pa
Gg
Gg
Gg
at
at
Jj
rC
Us
ML
PH
jP
jP
jP
jP
ML
jg
jg
yH
jP
yH
Gg
Gg
Gg
Gg
Gg
Gg
at
at
at
iV
iV
iV
iV
"}
(17,1,1) = {"
iV
iV
iV
iV
iV
iV
iV
iV
iV
iV
iV
iV
iV
iV
Gg
Gg
Ag
Gg
Gg
Gg
at
at
sp
pa
jP
es
OL
jP
Tr
vq
Uw
Ox
jg
jP
yH
jP
yH
Gg
Gg
Gg
Gg
Gg
at
at
iV
iV
iV
iV
iV
iV
"}
(18,1,1) = {"
iV
iV
iV
iV
iV
iV
iV
iV
iV
iV
iV
iV
iV
iV
iV
Gg
Gg
Gg
is
Gg
at
at
sp
ua
ua
Au
pH
qg
wj
ua
Au
iD
EI
Au
Au
ua
sp
at
Gg
Gg
Gg
at
at
iV
iV
iV
iV
iV
iV
iV
"}
(19,1,1) = {"
iV
iV
iV
iV
iV
iV
iV
iV
iV
iV
iV
iV
iV
iV
iV
Gg
xG
Gg
Gg
at
at
oR
sp
Hh
jP
NB
Au
jP
jP
Au
ib
jP
jP
qa
Rn
ZM
Jj
at
at
at
at
at
at
at
iV
iV
iV
iV
iV
iV
"}
(20,1,1) = {"
iV
iV
iV
iV
iV
iV
iV
iV
iV
iV
iV
iV
iV
iV
iV
Gg
Gg
Gg
Gg
at
at
at
df
jP
ML
jP
gO
ML
gx
Hz
jP
jP
jP
ML
jP
jP
sp
at
Nb
at
oR
oR
at
iV
iV
iV
iV
iV
iV
iV
"}
(21,1,1) = {"
iV
iV
iV
iV
iV
iV
iV
iV
iV
iV
iV
iV
iV
iV
iV
iV
Gg
Gg
Gg
at
at
at
sp
Hh
io
NB
ua
jP
jP
ua
gh
aU
Cl
NY
Jt
qa
Jj
at
oR
at
at
at
iV
iV
iV
iV
iV
iV
iV
iV
"}
(22,1,1) = {"
iV
iV
iV
iV
iV
iV
iV
iV
iV
iV
iV
iV
iV
iV
iV
at
Gg
at
at
at
Nb
at
sp
ua
Au
Au
JS
jP
jP
ua
ua
Au
Au
Au
ua
sp
sp
Nb
at
oR
at
at
at
at
iV
iV
iV
iV
iV
iV
"}
(23,1,1) = {"
iV
iV
iV
iV
iV
iV
iV
iV
iV
iV
iV
iV
iV
iV
at
at
at
at
at
at
oR
at
sp
Hh
jP
NB
ua
jP
ML
Of
ua
EU
jP
jP
wE
sp
Nb
Nb
oR
at
oR
at
at
iV
iV
iV
iV
iV
iV
iV
"}
(24,1,1) = {"
iV
iV
iV
iV
iV
iV
iV
iV
iV
iV
iV
iV
iV
iV
at
at
at
at
at
at
at
at
df
jP
jP
ML
Yh
jP
jP
vB
ua
EU
bW
gu
mu
Jj
Nb
at
at
at
at
at
iV
iV
iV
iV
iV
iV
iV
iV
"}
(25,1,1) = {"
iV
iV
iV
iV
iV
iV
iV
iV
iV
iV
iV
iV
iV
at
at
at
at
at
oR
at
at
at
Jj
Hh
Ii
NB
ua
jP
oG
Lu
Au
EU
jP
Za
Qu
EM
iV
iV
iV
at
iV
iV
iV
iV
iV
iV
iV
iV
iV
iV
"}
(26,1,1) = {"
iV
iV
iV
iV
iV
iV
iV
iV
iV
iV
iV
iV
iV
at
at
at
at
at
at
at
Nb
at
sp
ua
ua
Au
pW
WZ
jP
Au
Au
df
Fy
Qu
MX
Qu
um
iV
iV
iV
iV
iV
iV
iV
iV
iV
iV
iV
iV
iV
"}
(27,1,1) = {"
iV
iV
iV
iV
iV
iV
iV
iV
iV
iV
iV
iV
at
at
at
at
at
at
at
oR
at
at
sp
jP
AA
jP
Au
jP
jP
ua
RI
jP
Za
Qu
um
um
um
iV
iV
iV
iV
iV
iV
iV
iV
iV
iV
iV
iV
iV
"}
(28,1,1) = {"
iV
iV
iV
iV
iV
iV
iV
iV
iV
iV
iV
at
at
at
at
at
oR
at
at
at
at
at
df
Cf
KA
Hm
si
Hm
jP
pl
Dv
Qu
Qu
um
um
iV
iV
iV
iV
iV
iV
iV
iV
iV
iV
iV
iV
iV
iV
iV
"}
(29,1,1) = {"
iV
iV
iV
iV
iV
iV
iV
iV
iV
iV
iV
at
at
at
at
oR
at
oR
at
at
oR
at
sp
jP
NJ
jP
ua
jP
jP
ua
jP
ML
Qu
MX
um
iV
um
iV
iV
iV
iV
iV
iV
iV
iV
iV
iV
iV
iV
iV
"}
(30,1,1) = {"
iV
iV
iV
iV
iV
iV
iV
iV
iV
iV
at
at
at
at
at
at
at
at
at
at
at
at
sp
Jj
Jj
ua
ua
xU
Au
ua
sp
Jj
Qu
Qu
um
um
iV
iV
iV
iV
iV
iV
iV
iV
iV
iV
iV
iV
iV
iV
"}
(31,1,1) = {"
iV
iV
iV
iV
iV
iV
iV
iV
iV
iV
at
at
oR
at
at
at
at
at
at
at
at
at
at
at
sp
BP
Se
jP
jP
jP
Jj
iV
iV
iV
um
iV
iV
iV
iV
iV
iV
iV
iV
iV
iV
iV
iV
iV
iV
iV
"}
(32,1,1) = {"
iV
iV
iV
iV
iV
iV
iV
iV
iV
iV
iV
at
at
at
at
at
at
at
at
oR
dN
at
at
oR
sp
YG
jP
jP
Rm
jP
Jj
iV
iV
um
iV
um
um
um
iV
iV
iV
iV
iV
iV
iV
iV
iV
iV
iV
iV
"}
(33,1,1) = {"
iV
iV
iV
iV
iV
iV
iV
iV
iV
iV
iV
at
at
at
at
at
Lx
oR
at
at
at
at
at
at
Jj
mR
jP
aA
ML
Jn
Jj
iV
um
um
iV
um
iV
iV
iV
iV
iV
iV
iV
iV
iV
iV
iV
iV
iV
iV
"}
(34,1,1) = {"
iV
iV
iV
iV
iV
iV
iV
iV
iV
iV
iV
iV
at
at
at
at
at
at
at
at
oR
oR
at
at
df
fg
eZ
EP
EP
jP
df
iV
iV
iV
iV
iV
iV
iV
iV
iV
iV
iV
iV
iV
iV
iV
iV
iV
iV
iV
"}
(35,1,1) = {"
iV
iV
iV
iV
iV
iV
iV
iV
iV
iV
iV
iV
iV
iV
at
at
at
at
at
at
at
at
at
at
df
df
df
df
df
df
df
iV
iV
iV
iV
iV
iV
iV
iV
iV
iV
iV
iV
iV
iV
iV
iV
iV
iV
iV
"}
(36,1,1) = {"
iV
iV
iV
iV
iV
iV
iV
iV
iV
iV
iV
iV
iV
iV
iV
iV
at
at
at
at
at
at
at
iV
iV
iV
iV
iV
iV
iV
iV
iV
iV
iV
iV
iV
iV
iV
iV
iV
iV
iV
iV
iV
iV
iV
iV
iV
iV
iV
"}
(37,1,1) = {"
iV
iV
iV
iV
iV
iV
iV
iV
iV
iV
iV
iV
iV
iV
iV
iV
at
at
oR
at
at
iV
iV
iV
iV
iV
iV
iV
iV
iV
iV
iV
iV
iV
iV
iV
iV
iV
iV
iV
iV
iV
iV
iV
iV
iV
iV
iV
iV
iV
"}
(38,1,1) = {"
iV
iV
iV
iV
iV
iV
iV
iV
iV
iV
iV
iV
iV
iV
iV
iV
iV
at
at
at
iV
iV
iV
iV
iV
iV
iV
iV
iV
iV
iV
iV
iV
iV
iV
iV
iV
iV
iV
iV
iV
iV
iV
iV
iV
iV
iV
iV
iV
iV
"}
(39,1,1) = {"
iV
iV
iV
iV
iV
iV
iV
iV
iV
iV
iV
iV
iV
iV
iV
iV
iV
iV
iV
at
iV
iV
iV
iV
iV
iV
iV
iV
iV
iV
iV
iV
iV
iV
iV
iV
iV
iV
iV
iV
iV
iV
iV
iV
iV
iV
iV
iV
iV
iV
"}
(40,1,1) = {"
iV
iV
iV
iV
iV
iV
iV
iV
iV
iV
iV
iV
iV
iV
iV
iV
iV
iV
iV
iV
iV
iV
iV
iV
iV
iV
iV
iV
iV
iV
iV
iV
iV
iV
iV
iV
iV
iV
iV
iV
iV
iV
iV
iV
iV
iV
iV
iV
iV
iV
"}
(41,1,1) = {"
iV
iV
iV
iV
iV
iV
iV
iV
iV
iV
iV
iV
iV
iV
iV
iV
iV
iV
iV
iV
iV
iV
iV
iV
iV
iV
iV
iV
iV
iV
iV
iV
iV
iV
iV
iV
iV
iV
iV
iV
iV
iV
iV
iV
iV
iV
iV
iV
iV
iV
"}
(42,1,1) = {"
iV
iV
iV
iV
iV
iV
iV
iV
iV
iV
iV
iV
iV
iV
iV
iV
iV
iV
iV
iV
iV
iV
iV
iV
iV
iV
iV
iV
iV
iV
iV
iV
iV
iV
iV
iV
iV
iV
iV
iV
iV
iV
iV
iV
iV
iV
iV
iV
iV
iV
"}
(43,1,1) = {"
iV
iV
iV
iV
iV
iV
iV
iV
iV
iV
iV
iV
iV
iV
iV
iV
iV
iV
iV
iV
iV
iV
iV
iV
iV
iV
iV
iV
iV
iV
iV
iV
iV
iV
iV
iV
iV
iV
iV
iV
iV
iV
iV
iV
iV
iV
iV
iV
iV
iV
"}
(44,1,1) = {"
iV
iV
iV
iV
iV
iV
iV
iV
iV
iV
iV
iV
iV
iV
iV
iV
iV
iV
iV
iV
iV
iV
iV
iV
iV
iV
iV
iV
iV
iV
iV
iV
iV
iV
iV
iV
iV
iV
iV
iV
iV
iV
iV
iV
iV
iV
iV
iV
iV
iV
"}
(45,1,1) = {"
iV
iV
iV
iV
iV
iV
iV
iV
iV
iV
iV
iV
iV
iV
iV
iV
iV
iV
iV
iV
iV
iV
iV
iV
iV
iV
iV
iV
iV
iV
iV
iV
iV
iV
iV
iV
iV
iV
iV
iV
iV
iV
iV
iV
iV
iV
iV
iV
iV
iV
"}
(46,1,1) = {"
iV
iV
iV
iV
iV
iV
iV
iV
iV
iV
iV
iV
iV
iV
iV
iV
iV
iV
iV
iV
iV
iV
iV
iV
iV
iV
iV
iV
iV
iV
iV
iV
iV
iV
iV
iV
iV
iV
iV
iV
iV
iV
iV
iV
iV
iV
iV
iV
iV
iV
"}
(47,1,1) = {"
iV
iV
iV
iV
iV
iV
iV
iV
iV
iV
iV
iV
iV
iV
iV
iV
iV
iV
iV
iV
iV
iV
iV
iV
iV
iV
iV
iV
iV
iV
iV
iV
iV
iV
iV
iV
iV
iV
iV
iV
iV
iV
iV
iV
iV
iV
iV
iV
iV
iV
"}
(48,1,1) = {"
iV
iV
iV
iV
iV
iV
iV
iV
iV
iV
iV
iV
iV
iV
iV
iV
iV
iV
iV
iV
iV
iV
iV
iV
iV
iV
iV
iV
iV
iV
iV
iV
iV
iV
iV
iV
iV
iV
iV
iV
iV
iV
iV
iV
iV
iV
iV
iV
iV
iV
"}
(49,1,1) = {"
iV
iV
iV
iV
iV
iV
iV
iV
iV
iV
iV
iV
iV
iV
iV
iV
iV
iV
iV
iV
iV
iV
iV
iV
iV
iV
iV
iV
iV
iV
iV
iV
iV
iV
iV
iV
iV
iV
iV
iV
iV
iV
iV
iV
iV
iV
iV
iV
iV
iV
"}
(50,1,1) = {"
iV
iV
iV
iV
iV
iV
iV
iV
iV
iV
iV
iV
iV
iV
iV
iV
iV
iV
iV
iV
iV
iV
iV
iV
iV
iV
iV
iV
iV
iV
iV
iV
iV
iV
iV
iV
iV
iV
iV
iV
iV
iV
iV
iV
iV
iV
iV
iV
iV
iV
"}
