//MAP CONVERTED BY dmm2tgm.py THIS HEADER COMMENT PREVENTS RECONVERSION, DO NOT REMOVE
"am" = (
/obj/structure/sign/poster/contraband/power,
/turf/closed/wall/r_wall,
/area/ruin)
"aE" = (
/obj/item/trash/candy,
/turf/open/floor/wood,
/area/ruin)
"bn" = (
/obj/effect/decal/cleanable/blood/splatter,
/turf/open/floor/wood,
/area/ruin)
"bY" = (
/obj/effect/decal/cleanable/oil/slippery,
/obj/structure/girder/reinforced,
/turf/open/floor/plating,
/area/ruin)
"ch" = (
/obj/machinery/power/port_gen/pacman,
/obj/structure/cable{
	icon_state = "0-4"
	},
/turf/open/floor/plating/asteroid/airless,
/area/asteroid)
"cq" = (
/obj/effect/decal/cleanable/dirt/dust,
/turf/open/floor/plating,
/area/ruin)
"cr" = (
/obj/machinery/door/airlock/engineering{
	name = "Engineering"
	},
/obj/machinery/door/firedoor/border_only,
/obj/machinery/door/firedoor/border_only{
	dir = 1
	},
/turf/open/floor/plasteel,
/area/ruin)
"dd" = (
/obj/item/stack/ore/uranium,
/turf/open/floor/plating/asteroid/airless,
/area/asteroid)
"dr" = (
/obj/effect/decal/cleanable/oil/slippery,
/obj/item/trash/sosjerky,
/turf/open/floor/plasteel,
/area/ruin)
"dz" = (
/obj/effect/decal/cleanable/oil/slippery,
/obj/machinery/modular_computer/console{
	dir = 8
	},
/turf/open/floor/plasteel,
/area/ruin)
"dI" = (
/obj/structure/table/wood,
/obj/machinery/photocopier/faxmachine,
/turf/open/floor/wood,
/area/ruin)
"em" = (
/turf/closed/wall/r_wall,
/area/ruin)
"en" = (
/obj/effect/decal/cleanable/oil/slippery,
/obj/structure/closet/crate,
/turf/open/floor/plasteel,
/area/ruin)
"eH" = (
/obj/structure/mecha_wreckage/ripley/mkii,
/turf/open/floor/plating/asteroid/airless,
/area/asteroid)
"eX" = (
/mob/living/simple_animal/hostile/asteroid/hivelord,
/turf/open/floor/plating/asteroid/airless,
/area/asteroid)
"fg" = (
/obj/effect/decal/cleanable/blood/tracks{
	dir = 1
	},
/turf/open/floor/plating/asteroid/airless,
/area/asteroid)
"fv" = (
/obj/effect/decal/cleanable/blood/splatter,
/turf/open/floor/plating/asteroid/airless,
/area/asteroid)
"fD" = (
/obj/effect/decal/cleanable/oil/slippery,
/turf/open/floor/plasteel,
/area/ruin)
"fE" = (
/obj/item/stack/sheet/mineral/plasma/five,
/obj/effect/decal/cleanable/blood/gibs/bubblegum,
/turf/open/floor/plating/asteroid/airless,
/area/asteroid)
"fU" = (
/obj/structure/bed,
/obj/item/bedsheet/dorms,
/turf/open/floor/plasteel,
/area/ruin)
"fW" = (
/obj/machinery/door/airlock{
	name = "Room 1"
	},
/obj/machinery/door/firedoor/border_only,
/obj/machinery/door/firedoor/border_only{
	dir = 1
	},
/turf/open/floor/plasteel,
/area/ruin)
"gW" = (
/obj/structure/table,
/obj/item/folder/blue,
/turf/open/floor/plasteel,
/area/ruin)
"hc" = (
/obj/effect/decal/cleanable/oil/slippery,
/obj/structure/closet/crate{
	icon_state = "crateopen"
	},
/obj/item/flashlight/glowstick/blue,
/obj/item/flashlight/glowstick/pink,
/obj/item/flashlight/glowstick/orange,
/obj/item/flashlight/glowstick/yellow,
/obj/item/trash/syndi_cakes,
/obj/item/storage/bag/ore,
/turf/open/floor/plasteel,
/area/ruin)
"hD" = (
/obj/structure/table,
/turf/open/floor/plasteel,
/area/ruin)
"ik" = (
/obj/structure/sign/poster/retro/smile,
/turf/closed/wall/rust,
/area/ruin)
"in" = (
/obj/effect/landmark/ore_vein,
/obj/effect/landmark/ore_vein,
/turf/closed/mineral,
/area/asteroid)
"iy" = (
/obj/structure/closet/crate/engineering,
/turf/open/floor/plasteel,
/area/ruin)
"iA" = (
/obj/item/stack/ore/uranium,
/turf/open/floor/plasteel,
/area/ruin)
"iY" = (
/obj/item/trash/candy,
/turf/open/floor/plasteel,
/area/ruin)
"kd" = (
/obj/structure/sink/puddle,
/turf/closed/mineral,
/area/asteroid)
"kl" = (
/obj/machinery/door/airlock{
	name = "Room 3"
	},
/obj/machinery/door/firedoor/border_only,
/obj/machinery/door/firedoor/border_only{
	dir = 1
	},
/turf/open/floor/plasteel,
/area/ruin)
"kS" = (
/obj/item/trash/can,
/turf/open/floor/plasteel,
/area/ruin)
"ld" = (
/obj/structure/girder/reinforced,
/obj/effect/decal/cleanable/dirt/dust,
/turf/open/floor/plating,
/area/ruin)
"lE" = (
/turf/closed/wall,
/area/ruin)
"lQ" = (
/obj/item/trash/waffles,
/turf/open/floor/plasteel,
/area/ruin)
"mx" = (
/obj/machinery/vending/cigarette,
/turf/open/floor/plasteel,
/area/ruin)
"nG" = (
/obj/structure/closet/crate,
/obj/item/stack/ore/iron,
/obj/item/stack/ore/iron,
/obj/item/stack/ore/iron,
/turf/open/floor/plasteel,
/area/ruin)
"op" = (
/obj/structure/sign/poster/retro/radio,
/turf/closed/wall/rust,
/area/ruin)
"or" = (
/obj/structure/table/wood/poker,
/obj/effect/holodeck_effect/cards,
/turf/open/floor/plasteel,
/area/ruin)
"oC" = (
/obj/machinery/door/airlock/external,
/obj/machinery/atmospherics/pipe/layer_manifold,
/turf/open/floor/plating,
/area/ruin)
"pd" = (
/obj/structure/table/wood,
/obj/item/flashlight/lamp/green,
/turf/open/floor/wood,
/area/ruin)
"qb" = (
/obj/machinery/door/airlock/wood/glass{
	name = "Corporate's Office"
	},
/obj/machinery/door/firedoor/border_only{
	dir = 8
	},
/obj/machinery/door/firedoor/border_only{
	dir = 4
	},
/turf/open/floor/wood,
/area/ruin)
"qx" = (
/obj/structure/bed,
/obj/item/bedsheet/syndie,
/turf/open/floor/wood,
/area/ruin)
"qz" = (
/obj/item/stack/ore/uranium,
/obj/item/stack/ore/uranium,
/turf/open/floor/plating/asteroid/airless,
/area/asteroid)
"qX" = (
/turf/closed/mineral,
/area/asteroid)
"re" = (
/turf/closed/mineral/gold,
/area/asteroid)
"rW" = (
/obj/effect/mob_spawn/human/miner/rig,
/obj/effect/decal/cleanable/blood,
/obj/item/gun/energy/kinetic_accelerator,
/turf/open/floor/plating/asteroid/airless,
/area/asteroid)
"sc" = (
/obj/machinery/door/airlock{
	name = "Preparations"
	},
/obj/structure/barricade/wooden/crude,
/turf/open/floor/plasteel,
/area/ruin)
"sw" = (
/turf/closed/wall/r_wall/rust,
/area/ruin)
"sR" = (
/obj/machinery/power/apc/auto_name/west,
/turf/open/floor/plasteel,
/area/ruin)
"tu" = (
/obj/machinery/vending/mining_equipment,
/turf/open/floor/plasteel,
/area/ruin)
"tS" = (
/obj/effect/decal/cleanable/blood/splatter,
/obj/machinery/atmospherics/pipe/layer_manifold{
	dir = 1
	},
/turf/open/floor/plasteel,
/area/ruin)
"ub" = (
/obj/structure/closet/secure_closet/engineering_personal,
/turf/open/floor/plasteel,
/area/ruin)
"vf" = (
/obj/machinery/door/airlock/command{
	name = "Bridge"
	},
/obj/machinery/door/firedoor/border_only{
	dir = 8
	},
/obj/machinery/door/firedoor/border_only{
	dir = 4
	},
/turf/open/floor/plasteel,
/area/ruin)
"vh" = (
/obj/effect/decal/cleanable/blood/tracks{
	dir = 1
	},
/obj/effect/decal/cleanable/blood/gibs/bubblegum,
/obj/effect/mob_spawn/human/miner/rig,
/turf/open/floor/plating/asteroid/airless,
/area/asteroid)
"wj" = (
/obj/machinery/roulette,
/turf/open/floor/plasteel,
/area/ruin)
"wD" = (
/obj/effect/decal/cleanable/blood/tracks{
	dir = 4
	},
/turf/open/floor/plasteel,
/area/ruin)
"wF" = (
/obj/structure/lattice,
/turf/open/space/basic,
/area/ruin)
"xv" = (
/obj/effect/decal/cleanable/blood/gibs/torso,
/turf/open/floor/plasteel,
/area/ruin)
"yk" = (
/obj/structure/sign/poster/ripped,
/turf/closed/wall/rust,
/area/ruin)
"yN" = (
/obj/structure/chair/office/light{
	dir = 4
	},
/turf/open/floor/plasteel,
/area/ruin)
"zF" = (
/obj/structure/chair/office/light{
	dir = 4
	},
/turf/open/floor/wood,
/area/ruin)
"At" = (
/obj/structure/table,
/obj/item/storage/toolbox/mechanical,
/obj/item/multitool,
/turf/open/floor/plasteel,
/area/ruin)
"AV" = (
/obj/item/stack/ore/plasma,
/turf/open/floor/plating/asteroid/airless,
/area/asteroid)
"Bx" = (
/obj/machinery/power/floodlight,
/obj/structure/cable{
	icon_state = "0-8"
	},
/turf/open/floor/plating/asteroid/airless,
/area/asteroid)
"Cc" = (
/obj/effect/decal/cleanable/oil/slippery,
/obj/structure/chair/stool/bar{
	dir = 8
	},
/turf/open/floor/plasteel,
/area/ruin)
"CE" = (
/obj/structure/closet/crate,
/obj/item/stack/ore/titanium,
/obj/item/stack/ore/titanium,
/turf/open/floor/plasteel,
/area/ruin)
"CJ" = (
/obj/effect/decal/cleanable/oil/slippery,
/obj/effect/decal/cleanable/blood/tracks{
	dir = 9
	},
/turf/open/floor/plasteel,
/area/ruin)
"CO" = (
/turf/open/floor/plating,
/area/asteroid)
"Di" = (
/obj/structure/bed/roller,
/turf/open/floor/plasteel,
/area/ruin)
"Dv" = (
/obj/structure/chair/office/light{
	dir = 1
	},
/turf/open/floor/wood,
/area/ruin)
"DP" = (
/obj/item/shard,
/obj/effect/decal/cleanable/dirt/dust,
/turf/open/floor/plating,
/area/ruin)
"Eg" = (
/obj/structure/closet/crate,
/obj/item/stack/ore/gold,
/obj/item/stack/ore/gold,
/turf/open/floor/plasteel,
/area/ruin)
"Er" = (
/obj/effect/decal/cleanable/blood/tracks,
/turf/open/floor/plating/asteroid/airless,
/area/asteroid)
"ES" = (
/obj/structure/table/wood,
/obj/machinery/computer/pod/old/syndicate,
/turf/open/floor/wood,
/area/ruin)
"Ft" = (
/obj/structure/sign/departments/engineering,
/obj/machinery/door/firedoor/border_only{
	dir = 1
	},
/turf/closed/wall,
/area/ruin)
"FW" = (
/obj/machinery/suit_storage_unit/mining/eva,
/turf/open/floor/plasteel,
/area/ruin)
"GD" = (
/obj/effect/decal/cleanable/blood/gibs/old,
/turf/open/floor/plasteel,
/area/ruin)
"Ho" = (
/obj/effect/mob_spawn/human/miner/rig,
/turf/open/floor/plating/asteroid/airless,
/area/asteroid)
"HL" = (
/obj/machinery/power/smes,
/turf/open/floor/plasteel,
/area/ruin)
"It" = (
/obj/effect/landmark/ore_vein,
/turf/closed/mineral/gold,
/area/asteroid)
"Iy" = (
/obj/effect/decal/cleanable/blood/tracks{
	dir = 8
	},
/turf/open/floor/plating/asteroid/airless,
/area/asteroid)
"IR" = (
/obj/machinery/door/airlock/external,
/turf/open/floor/plasteel,
/area/ruin)
"Jg" = (
/obj/item/pickaxe/drill,
/obj/effect/decal/cleanable/blood/old,
/turf/open/floor/plating/asteroid/airless,
/area/asteroid)
"Jn" = (
/obj/structure/closet/crate{
	icon_state = "crateopen"
	},
/obj/item/stack/sheet/mineral/plasma/twenty,
/obj/item/stack/ore/diamond,
/obj/item/stack/ore/diamond,
/turf/open/floor/plasteel,
/area/ruin)
"JT" = (
/obj/effect/spawner/structure/window/reinforced,
/turf/open/floor/plasteel,
/area/ruin)
"Lz" = (
/turf/open/space/basic,
/area/space)
"LB" = (
/obj/effect/decal/cleanable/blood/gibs,
/turf/open/floor/plasteel,
/area/ruin)
"LD" = (
/obj/machinery/atmospherics/components/binary/dp_vent_pump/layer2,
/turf/open/floor/plating,
/area/ruin)
"LI" = (
/obj/structure/closet/secure_closet/personal,
/turf/open/floor/plasteel,
/area/ruin)
"LU" = (
/obj/effect/decal/cleanable/blood/tracks,
/turf/open/floor/plasteel,
/area/ruin)
"MO" = (
/obj/item/trash/syndi_cakes,
/turf/open/floor/plasteel,
/area/ruin)
"Nt" = (
/obj/structure/sign/poster/official/space_cops,
/turf/closed/wall,
/area/ruin)
"NM" = (
/obj/structure/spawner/mining/hivelord,
/turf/open/floor/plating/asteroid/airless,
/area/asteroid)
"Ov" = (
/turf/open/floor/wood,
/area/ruin)
"Oz" = (
/turf/closed/wall/rust,
/area/ruin)
"OE" = (
/obj/effect/decal/cleanable/blood,
/obj/effect/decal/cleanable/blood/tracks{
	dir = 8
	},
/turf/open/floor/plating/asteroid/airless,
/area/asteroid)
"OX" = (
/obj/effect/decal/cleanable/oil/slippery,
/obj/machinery/vending/coffee,
/turf/open/floor/plasteel,
/area/ruin)
"Pk" = (
/obj/effect/decal/cleanable/blood/old,
/obj/effect/mob_spawn/human/miner/rig,
/turf/open/floor/plating/asteroid/airless,
/area/asteroid)
"Px" = (
/obj/structure/closet/secure_closet/miner,
/turf/open/floor/plating,
/area/ruin)
"Py" = (
/obj/item/rollingpaper,
/turf/open/floor/plasteel,
/area/ruin)
"Pz" = (
/obj/structure/chair/stool/bar{
	dir = 4
	},
/turf/open/floor/plasteel,
/area/ruin)
"PS" = (
/obj/effect/decal/cleanable/blood/tracks{
	dir = 6
	},
/obj/effect/decal/cleanable/blood/tracks{
	dir = 8
	},
/turf/open/floor/plating/asteroid/airless,
/area/asteroid)
"Qn" = (
/obj/structure/closet/cabinet,
/obj/item/gun/ballistic/automatic/pistol/suppressed,
/turf/open/floor/wood,
/area/ruin)
"QK" = (
/obj/machinery/power/apc/auto_name/south,
/turf/open/floor/plasteel,
/area/ruin)
"Rb" = (
/turf/open/floor/plasteel,
/area/ruin)
"Rw" = (
/obj/item/trash/popcorn,
/turf/open/floor/wood,
/area/ruin)
"Sp" = (
/obj/structure/grille/broken,
/obj/item/shard,
/turf/open/floor/plasteel,
/area/ruin)
"Ss" = (
/obj/structure/table,
/obj/item/paper_bin,
/obj/item/pen,
/obj/item/stamp,
/turf/open/floor/plasteel,
/area/ruin)
"SI" = (
/obj/machinery/door/airlock/alarmlock{
	name = "Cargo"
	},
/obj/machinery/door/firedoor/border_only{
	dir = 4
	},
/obj/machinery/door/firedoor/border_only{
	dir = 8
	},
/turf/open/floor/plasteel,
/area/ruin)
"SK" = (
/obj/structure/table/wood,
/obj/item/paper_bin,
/obj/item/pen/fountain,
/turf/open/floor/wood,
/area/ruin)
"SV" = (
/obj/item/gibtonite,
/turf/open/floor/plating/asteroid/airless,
/area/asteroid)
"Tl" = (
/obj/item/trash/sosjerky,
/turf/open/floor/plasteel,
/area/ruin)
"Tn" = (
/obj/machinery/door/airlock/wood{
	locked = 1;
	name = "Corporate Bedroom"
	},
/turf/open/floor/wood,
/area/ruin)
"TE" = (
/turf/open/floor/holofloor/asteroid,
/area/asteroid)
"Ur" = (
/obj/effect/decal/cleanable/oil/slippery,
/obj/item/trash/can/food/peaches/maint,
/turf/open/floor/plasteel,
/area/ruin)
"UP" = (
/turf/open/floor/plating,
/area/ruin)
"UZ" = (
/obj/structure/closet/crate/bin,
/obj/item/trash/can/food/beans,
/turf/open/floor/plasteel,
/area/ruin)
"Vd" = (
/obj/machinery/modular_computer/console/preset/engineering,
/turf/open/floor/plasteel,
/area/ruin)
"VE" = (
/obj/structure/girder/reinforced,
/turf/open/floor/plating,
/area/ruin)
"Wk" = (
/obj/effect/landmark/ore_vein,
/turf/closed/mineral,
/area/asteroid)
"Wp" = (
/turf/open/floor/plating/asteroid/airless,
/area/asteroid)
"Wz" = (
/obj/structure/closet/crate,
/turf/open/floor/plasteel,
/area/ruin)
"WH" = (
/obj/machinery/modular_computer/console{
	dir = 8
	},
/turf/open/floor/plasteel,
/area/ruin)
"WN" = (
/obj/effect/mob_spawn/human/miner/explorer,
/obj/item/storage/bag/ore,
/obj/effect/decal/cleanable/blood/tracks,
/turf/open/floor/plasteel,
/area/ruin)
"WR" = (
/obj/machinery/power/apc/auto_name/west,
/turf/open/floor/wood,
/area/ruin)
"Xo" = (
/obj/effect/decal/cleanable/oil/slippery,
/obj/structure/closet/crate{
	icon_state = "crateopen"
	},
/obj/item/flashlight,
/turf/open/floor/plasteel,
/area/ruin)
"Xy" = (
/obj/machinery/door/airlock{
	name = "Room 2"
	},
/obj/machinery/door/firedoor/border_only,
/obj/machinery/door/firedoor/border_only{
	dir = 1
	},
/turf/open/floor/plasteel,
/area/ruin)
"XN" = (
/obj/structure/closet/crate{
	icon_state = "crateopen"
	},
/obj/item/flashlight,
/obj/item/reagent_containers/food/drinks/soda_cans/plasma,
/obj/item/stack/ore/bluespace_crystal,
/turf/open/floor/plasteel,
/area/ruin)
"XP" = (
/obj/item/flashlight/flare,
/obj/effect/decal/cleanable/blood/tracks,
/turf/open/floor/plasteel,
/area/ruin)
"Yc" = (
/obj/effect/decal/cleanable/oil/slippery,
/obj/machinery/door/airlock/alarmlock{
	name = "Cargo"
	},
/obj/machinery/door/firedoor/border_only{
	dir = 4
	},
/obj/machinery/door/firedoor/border_only{
	dir = 8
	},
/turf/open/floor/plasteel,
/area/ruin)

(1,1,1) = {"
Lz
Lz
Lz
Lz
Lz
Lz
Lz
Lz
Lz
Lz
Lz
Lz
Lz
Lz
Lz
Lz
Lz
Lz
Lz
Lz
Lz
Lz
Lz
Lz
Lz
Lz
Lz
Lz
Lz
Lz
qX
qX
qX
qX
qX
Lz
Lz
Lz
Lz
Lz
Lz
Lz
Lz
Lz
Lz
Lz
Lz
Lz
Lz
Lz
"}
(2,1,1) = {"
Lz
Lz
Lz
Lz
Lz
Lz
Lz
Lz
Lz
Lz
Lz
Lz
Lz
Lz
Lz
Lz
Lz
Lz
Lz
Lz
Lz
Lz
Lz
Lz
Lz
Lz
Lz
Lz
qX
qX
qX
qX
qX
qX
Wk
qX
Lz
Lz
Lz
Lz
Lz
Lz
Lz
Lz
Lz
Lz
Lz
Lz
Lz
Lz
"}
(3,1,1) = {"
Lz
Lz
Lz
Lz
Lz
Lz
Lz
Lz
Lz
Lz
Lz
Lz
Lz
Lz
Wp
Wp
Lz
Lz
Lz
qX
Lz
Lz
Lz
Lz
Lz
qX
qX
qX
Wk
qX
qX
qX
Wk
qX
qX
qX
Wk
Lz
Lz
Lz
Lz
Lz
Lz
Lz
Lz
Lz
Lz
Lz
Lz
Lz
"}
(4,1,1) = {"
Lz
Lz
Lz
Lz
Lz
Lz
Lz
Lz
Lz
Lz
Lz
Lz
Lz
qX
qX
Wp
Wp
Wp
qX
qX
qX
Lz
Lz
Lz
Wk
Wk
Wk
qX
Wp
Wp
Wp
Wp
Wp
qX
re
qX
qX
qX
Lz
Lz
Lz
Lz
Lz
Lz
Lz
Lz
Lz
Lz
Lz
Lz
"}
(5,1,1) = {"
Lz
Lz
Lz
Lz
Lz
Lz
Lz
Lz
Lz
Lz
Lz
Lz
Lz
qX
qX
qX
Wp
Wp
Wp
Wk
qX
qX
qX
qX
qX
qX
qX
Wp
Wp
eX
vh
fg
fg
Wp
It
qX
qX
qX
qX
Lz
Lz
Lz
Lz
Lz
Lz
Lz
Lz
Lz
Lz
Lz
"}
(6,1,1) = {"
Lz
Lz
Lz
Lz
Lz
Lz
Lz
Lz
Lz
Lz
Lz
Lz
qX
qX
qX
Wk
qX
Wp
Wp
Wp
qX
Wk
qX
Wk
qX
qX
Wp
Wp
Wp
Wp
Wp
AV
Wp
Wp
Wp
Wp
qz
qX
Wk
qX
Lz
Lz
Lz
Lz
Lz
Lz
Lz
Lz
Lz
Lz
"}
(7,1,1) = {"
Lz
Lz
Lz
Lz
Lz
Lz
Lz
Lz
Lz
Lz
qX
qX
qX
qX
qX
qX
qX
Wp
Wp
Wp
Wp
Wp
qX
qX
Wp
Wp
Wp
Wp
Wp
Wp
AV
AV
Wp
Wp
Wp
dd
dd
Wp
qX
qX
Lz
Lz
Lz
Lz
Lz
Lz
Lz
Lz
Lz
Lz
"}
(8,1,1) = {"
Lz
Lz
Lz
Lz
Lz
Lz
Lz
Lz
Lz
qX
qX
qX
qX
Wk
qX
qX
Wk
qX
qX
Wp
Wp
Wp
Wp
Wp
Wp
Wp
Wp
Wp
qX
qX
qX
qX
qX
Wp
Wp
Wp
Wp
Wp
Wp
qX
qX
Lz
Lz
Lz
Lz
Lz
Lz
Lz
Lz
Lz
"}
(9,1,1) = {"
Lz
Lz
Lz
Lz
Lz
Lz
Lz
Lz
qX
qX
qX
Wk
Wk
Wk
Wk
Wk
qX
qX
Wp
ch
Wp
Wp
Wp
Wp
Wp
qX
qX
qX
qX
qX
qX
Wk
re
qX
re
Wp
Wp
Wp
Wp
Wk
qX
qX
Lz
Lz
Lz
qX
qX
Lz
Lz
Lz
"}
(10,1,1) = {"
Lz
Lz
Lz
Lz
Lz
Lz
Lz
Lz
Lz
qX
qX
Wk
Wk
qX
qX
qX
Wp
Wp
Wp
Bx
Wp
Wp
qX
qX
qX
qX
qX
qX
It
qX
qX
qX
qX
qX
qX
qX
Wp
Wp
Wp
qX
qX
qX
qX
qX
Wk
qX
Lz
Lz
Lz
Lz
"}
(11,1,1) = {"
Lz
Lz
Lz
Lz
Lz
Lz
Lz
Lz
Lz
qX
qX
qX
qX
Wk
qX
TE
Wp
eH
Wp
Wp
Wp
qX
qX
qX
Wk
qX
em
em
em
sw
sw
em
em
em
sw
Wk
qX
Wp
Wp
Wp
qX
Wk
qX
Wk
qX
qX
qX
Lz
Lz
Lz
"}
(12,1,1) = {"
Lz
Lz
Lz
Lz
Lz
Lz
Lz
qX
qX
Wk
Wk
qX
qX
qX
qX
qX
Wp
Wp
Wp
Wp
qX
It
qX
qX
qX
qX
em
ES
Dv
Ov
Tn
bn
zF
WR
sw
qX
qX
Wp
Wp
Wp
Wp
qX
Wp
Wp
Wp
Wp
Wp
Wp
Lz
Lz
"}
(13,1,1) = {"
Lz
Lz
Lz
Lz
Lz
Lz
qX
qX
Wk
qX
qX
qX
qX
qX
qX
qX
Wp
Wp
Wp
re
qX
qX
em
em
em
sw
em
dI
Rw
Ov
em
pd
SK
Ov
em
qX
Wk
qX
Wp
Wp
Wp
Wp
Wp
Wp
Wp
Wp
Wp
Wp
Lz
Lz
"}
(14,1,1) = {"
Lz
Lz
Lz
Lz
Lz
Lz
qX
qX
qX
qX
Wp
Wp
qX
qX
qX
Wp
Wp
Wp
Ho
re
qX
qX
sw
Rb
fD
Rb
sw
Qn
bn
qx
em
Ov
bn
aE
em
qX
qX
qX
Wp
Wp
Wp
Wp
Wp
Wp
Wp
Wp
Wp
Lz
Lz
Lz
"}
(15,1,1) = {"
Lz
Lz
Lz
Lz
Lz
qX
qX
qX
Wp
Wp
Wp
Wp
NM
qX
Wp
fv
Wp
fE
Wp
Wp
qX
Wk
am
HL
Rb
QK
sw
sw
em
em
sw
em
qb
sw
em
sw
em
qX
Wp
Wp
Wp
Wp
Wp
Wp
qX
Wp
Lz
Lz
Lz
Lz
"}
(16,1,1) = {"
Lz
Lz
Lz
Lz
Lz
qX
Wk
qX
Wp
Wp
Wp
Wp
Wp
Wp
Wp
Wp
qX
Wp
Wp
Wp
qX
qX
sw
Vd
tS
fD
cr
Rb
Rb
Rb
Rb
fD
iA
iA
IR
LD
oC
CO
Wp
Wp
Wp
Wp
Wp
qX
qX
qX
Lz
Lz
Lz
Lz
"}
(17,1,1) = {"
Lz
Lz
Lz
Lz
Lz
qX
Wk
qX
Wp
Wp
Wp
Wp
fv
Wp
Wp
OE
qX
Wp
Wp
fv
qX
qX
em
iy
Rb
ub
Ft
Rb
CJ
LU
XP
WN
iA
Rb
IR
LD
oC
CO
Wp
Wp
Wp
Wp
qX
qX
Lz
Lz
Lz
Lz
Lz
Lz
"}
(18,1,1) = {"
Lz
Lz
Lz
Lz
Lz
qX
qX
qX
Wp
Wp
Wp
Wp
Wp
Wp
Wp
Iy
Wp
Wp
Jg
Wp
qX
qX
em
lE
lE
Oz
yk
Di
wD
lE
Oz
SI
Yc
Oz
Oz
lE
em
qX
Wp
Wp
Wp
qX
qX
Lz
Lz
Lz
Lz
Lz
Lz
Lz
"}
(19,1,1) = {"
Lz
Lz
Lz
Lz
Lz
qX
qX
NM
Wp
Wp
Wp
SV
rW
Er
Er
PS
Pk
Wp
Wp
qX
qX
Wk
em
LI
Rb
fU
Oz
Rb
Rb
Oz
Jn
Rb
Rb
Wz
nG
Xo
sw
qX
qX
qX
qX
qX
qX
qX
Lz
Lz
Lz
Lz
Lz
Lz
"}
(20,1,1) = {"
Lz
Lz
Lz
Lz
Lz
qX
qX
Wp
Wp
Wp
Wp
Wp
Wp
Wp
Wp
Wp
Wp
Wp
Wp
qX
qX
qX
JT
Rb
fD
Rb
kl
fD
Py
ik
Rb
Rb
Rb
fD
Rb
Rb
em
qX
re
qX
Wk
Wk
qX
Lz
Lz
Lz
Lz
Lz
Lz
Lz
"}
(21,1,1) = {"
Lz
Lz
Lz
Lz
Lz
qX
Wk
qX
Wp
Wp
Wp
Wp
Wp
Wp
Wp
Wp
Wp
fv
Wp
qX
qX
qX
em
LI
Tl
fU
lE
Rb
Rb
lE
CE
en
XN
Eg
hc
Wz
sw
qX
Wk
qX
qX
qX
Lz
Lz
Lz
Lz
Lz
Lz
Lz
Lz
"}
(22,1,1) = {"
Lz
Lz
Lz
Lz
Lz
qX
qX
Wk
qX
qX
Wp
Wp
Wp
Wp
Wp
Wp
Wp
qX
qX
qX
re
qX
em
lE
Oz
Oz
Nt
Rb
QK
lE
lE
Oz
Oz
Oz
lE
em
em
re
qX
Wk
qX
qX
qX
qX
Lz
Lz
Lz
Lz
Lz
Lz
"}
(23,1,1) = {"
Lz
Lz
Lz
Lz
Lz
qX
qX
Wk
qX
qX
Wp
Wp
Wp
Wp
Wp
NM
qX
qX
qX
qX
Wk
qX
em
LI
Rb
fU
lE
Rb
fD
UZ
lE
FW
Rb
Rb
tu
em
re
re
Wk
qX
Wk
qX
qX
Lz
Lz
Lz
Lz
Lz
Lz
Lz
"}
(24,1,1) = {"
Lz
Lz
Lz
Lz
Lz
qX
qX
qX
Wk
Wp
Wp
Wp
Wp
Wp
qX
qX
qX
qX
qX
qX
qX
qX
JT
Rb
Rb
fD
Xy
Rb
Rb
mx
lE
FW
dr
LB
Px
sw
re
qX
qX
qX
qX
qX
Lz
Lz
Lz
Lz
Lz
Lz
Lz
Lz
"}
(25,1,1) = {"
Lz
Lz
Lz
Lz
Lz
Lz
Lz
qX
qX
Wp
Wp
Wp
Wp
qX
qX
qX
qX
qX
Wk
qX
qX
qX
sw
LI
MO
fU
lE
Rb
kS
OX
Oz
FW
Rb
DP
cq
bY
Lz
Lz
Lz
qX
Lz
Lz
Lz
Lz
Lz
Lz
Lz
Lz
Lz
Lz
"}
(26,1,1) = {"
Lz
Lz
Lz
Lz
Lz
qX
qX
qX
qX
Wk
qX
qX
qX
qX
qX
qX
qX
qX
qX
qX
re
qX
em
lE
lE
Oz
op
Rb
Rb
Oz
Oz
JT
Sp
cq
VE
cq
wF
Lz
Lz
Lz
Lz
Lz
Lz
Lz
Lz
Lz
Lz
Lz
Lz
Lz
"}
(27,1,1) = {"
Lz
Lz
Lz
Lz
Lz
Lz
qX
qX
qX
Wk
qX
Wk
Wk
Wk
qX
qX
qX
qX
qX
Wk
qX
qX
em
sR
Pz
Rb
Oz
Rb
Rb
lE
GD
Rb
DP
cq
wF
wF
wF
Lz
Lz
Lz
Lz
Lz
Lz
Lz
Lz
Lz
Lz
Lz
Lz
Lz
"}
(28,1,1) = {"
Lz
Lz
Lz
Lz
Lz
Lz
Lz
qX
qX
qX
qX
qX
qX
qX
qX
qX
Wk
qX
qX
qX
qX
qX
JT
wj
or
Rb
fW
Rb
Rb
sc
lQ
UP
cq
wF
wF
Lz
Lz
Lz
Lz
Lz
Lz
Lz
Lz
Lz
Lz
Lz
Lz
Lz
Lz
Lz
"}
(29,1,1) = {"
Lz
Lz
Lz
Lz
Lz
Lz
Lz
qX
qX
qX
qX
Wk
Wk
qX
qX
Wk
qX
Wk
qX
qX
Wk
qX
em
Rb
Cc
Rb
lE
Rb
Rb
lE
Rb
fD
cq
ld
wF
Lz
wF
Lz
Lz
Lz
Lz
Lz
Lz
Lz
Lz
Lz
Lz
Lz
Lz
Lz
"}
(30,1,1) = {"
Lz
Lz
Lz
Lz
Lz
Lz
Lz
qX
qX
qX
qX
qX
qX
qX
qX
qX
qX
qX
qX
qX
qX
qX
em
sw
sw
lE
lE
vf
Oz
lE
em
sw
cq
cq
wF
wF
qX
qX
qX
Lz
Lz
Lz
Lz
Lz
Lz
Lz
Lz
Lz
Lz
Lz
"}
(31,1,1) = {"
Lz
Lz
Lz
Lz
Lz
Lz
Lz
Lz
Lz
Lz
qX
qX
Wk
qX
qX
qX
qX
qX
qX
qX
qX
qX
qX
qX
em
At
Ur
Rb
Rb
sR
sw
Lz
Lz
Lz
wF
qX
qX
qX
qX
Lz
Lz
Lz
Lz
Lz
Lz
Lz
Lz
Lz
Lz
Lz
"}
(32,1,1) = {"
Lz
Lz
Lz
Lz
Lz
Lz
Lz
Lz
Lz
Lz
Lz
qX
qX
qX
qX
qX
qX
qX
qX
Wk
kd
qX
qX
Wk
em
Ss
Rb
Rb
xv
Rb
sw
Lz
Lz
wF
Lz
wF
wF
wF
qX
qX
Lz
Lz
Lz
Lz
Lz
Lz
Lz
Lz
Lz
Lz
"}
(33,1,1) = {"
Lz
Lz
Lz
Lz
Lz
Lz
Lz
Lz
Lz
Lz
Lz
qX
qX
qX
qX
qX
in
Wk
qX
qX
qX
qX
qX
qX
sw
gW
Rb
yN
fD
iY
sw
Lz
wF
wF
Lz
wF
qX
qX
qX
qX
qX
Lz
Lz
Lz
Lz
Lz
Lz
Lz
Lz
Lz
"}
(34,1,1) = {"
Lz
Lz
Lz
Lz
Lz
Lz
Lz
Lz
Lz
Lz
Lz
Lz
qX
qX
qX
qX
qX
qX
qX
qX
Wk
Wk
qX
qX
JT
hD
dz
WH
WH
Rb
JT
Lz
Lz
Lz
Lz
Lz
Lz
qX
qX
qX
Lz
Lz
Lz
Lz
Lz
Lz
Lz
Lz
Lz
Lz
"}
(35,1,1) = {"
Lz
Lz
Lz
Lz
Lz
Lz
Lz
Lz
Lz
Lz
Lz
Lz
Lz
Lz
qX
qX
qX
qX
qX
qX
qX
qX
qX
qX
JT
JT
JT
JT
JT
JT
JT
Lz
Lz
Lz
Lz
Lz
Lz
Lz
qX
Lz
Lz
Lz
Lz
Lz
Lz
Lz
Lz
Lz
Lz
Lz
"}
(36,1,1) = {"
Lz
Lz
Lz
Lz
Lz
Lz
Lz
Lz
Lz
Lz
Lz
Lz
Lz
Lz
Lz
Lz
qX
qX
qX
qX
qX
qX
qX
Lz
Lz
Lz
Lz
Lz
Lz
Lz
Lz
Lz
Lz
Lz
Lz
Lz
Lz
Lz
Lz
Lz
Lz
Lz
Lz
Lz
Lz
Lz
Lz
Lz
Lz
Lz
"}
(37,1,1) = {"
Lz
Lz
Lz
Lz
Lz
Lz
Lz
Lz
Lz
Lz
Lz
Lz
Lz
Lz
Lz
Lz
qX
qX
Wk
qX
qX
Lz
Lz
Lz
Lz
Lz
Lz
Lz
Lz
Lz
Lz
Lz
Lz
Lz
Lz
Lz
Lz
Lz
Lz
Lz
Lz
Lz
Lz
Lz
Lz
Lz
Lz
Lz
Lz
Lz
"}
(38,1,1) = {"
Lz
Lz
Lz
Lz
Lz
Lz
Lz
Lz
Lz
Lz
Lz
Lz
Lz
Lz
Lz
Lz
Lz
qX
qX
qX
Lz
Lz
Lz
Lz
Lz
Lz
Lz
Lz
Lz
Lz
Lz
Lz
Lz
Lz
Lz
Lz
Lz
Lz
Lz
Lz
Lz
Lz
Lz
Lz
Lz
Lz
Lz
Lz
Lz
Lz
"}
(39,1,1) = {"
Lz
Lz
Lz
Lz
Lz
Lz
Lz
Lz
Lz
Lz
Lz
Lz
Lz
Lz
Lz
Lz
Lz
Lz
Lz
qX
Lz
Lz
Lz
Lz
Lz
Lz
Lz
Lz
Lz
Lz
Lz
Lz
Lz
Lz
Lz
Lz
Lz
Lz
Lz
Lz
Lz
Lz
Lz
Lz
Lz
Lz
Lz
Lz
Lz
Lz
"}
(40,1,1) = {"
Lz
Lz
Lz
Lz
Lz
Lz
Lz
Lz
Lz
Lz
Lz
Lz
Lz
Lz
Lz
Lz
Lz
Lz
Lz
Lz
Lz
Lz
Lz
Lz
Lz
Lz
Lz
Lz
Lz
Lz
Lz
Lz
Lz
Lz
Lz
Lz
Lz
Lz
Lz
Lz
Lz
Lz
Lz
Lz
Lz
Lz
Lz
Lz
Lz
Lz
"}
(41,1,1) = {"
Lz
Lz
Lz
Lz
Lz
Lz
Lz
Lz
Lz
Lz
Lz
Lz
Lz
Lz
Lz
Lz
Lz
Lz
Lz
Lz
Lz
Lz
Lz
Lz
Lz
Lz
Lz
Lz
Lz
Lz
Lz
Lz
Lz
Lz
Lz
Lz
Lz
Lz
Lz
Lz
Lz
Lz
Lz
Lz
Lz
Lz
Lz
Lz
Lz
Lz
"}
(42,1,1) = {"
Lz
Lz
Lz
Lz
Lz
Lz
Lz
Lz
Lz
Lz
Lz
Lz
Lz
Lz
Lz
Lz
Lz
Lz
Lz
Lz
Lz
Lz
Lz
Lz
Lz
Lz
Lz
Lz
Lz
Lz
Lz
Lz
Lz
Lz
Lz
Lz
Lz
Lz
Lz
Lz
Lz
Lz
Lz
Lz
Lz
Lz
Lz
Lz
Lz
Lz
"}
(43,1,1) = {"
Lz
Lz
Lz
Lz
Lz
Lz
Lz
Lz
Lz
Lz
Lz
Lz
Lz
Lz
Lz
Lz
Lz
Lz
Lz
Lz
Lz
Lz
Lz
Lz
Lz
Lz
Lz
Lz
Lz
Lz
Lz
Lz
Lz
Lz
Lz
Lz
Lz
Lz
Lz
Lz
Lz
Lz
Lz
Lz
Lz
Lz
Lz
Lz
Lz
Lz
"}
(44,1,1) = {"
Lz
Lz
Lz
Lz
Lz
Lz
Lz
Lz
Lz
Lz
Lz
Lz
Lz
Lz
Lz
Lz
Lz
Lz
Lz
Lz
Lz
Lz
Lz
Lz
Lz
Lz
Lz
Lz
Lz
Lz
Lz
Lz
Lz
Lz
Lz
Lz
Lz
Lz
Lz
Lz
Lz
Lz
Lz
Lz
Lz
Lz
Lz
Lz
Lz
Lz
"}
(45,1,1) = {"
Lz
Lz
Lz
Lz
Lz
Lz
Lz
Lz
Lz
Lz
Lz
Lz
Lz
Lz
Lz
Lz
Lz
Lz
Lz
Lz
Lz
Lz
Lz
Lz
Lz
Lz
Lz
Lz
Lz
Lz
Lz
Lz
Lz
Lz
Lz
Lz
Lz
Lz
Lz
Lz
Lz
Lz
Lz
Lz
Lz
Lz
Lz
Lz
Lz
Lz
"}
(46,1,1) = {"
Lz
Lz
Lz
Lz
Lz
Lz
Lz
Lz
Lz
Lz
Lz
Lz
Lz
Lz
Lz
Lz
Lz
Lz
Lz
Lz
Lz
Lz
Lz
Lz
Lz
Lz
Lz
Lz
Lz
Lz
Lz
Lz
Lz
Lz
Lz
Lz
Lz
Lz
Lz
Lz
Lz
Lz
Lz
Lz
Lz
Lz
Lz
Lz
Lz
Lz
"}
(47,1,1) = {"
Lz
Lz
Lz
Lz
Lz
Lz
Lz
Lz
Lz
Lz
Lz
Lz
Lz
Lz
Lz
Lz
Lz
Lz
Lz
Lz
Lz
Lz
Lz
Lz
Lz
Lz
Lz
Lz
Lz
Lz
Lz
Lz
Lz
Lz
Lz
Lz
Lz
Lz
Lz
Lz
Lz
Lz
Lz
Lz
Lz
Lz
Lz
Lz
Lz
Lz
"}
(48,1,1) = {"
Lz
Lz
Lz
Lz
Lz
Lz
Lz
Lz
Lz
Lz
Lz
Lz
Lz
Lz
Lz
Lz
Lz
Lz
Lz
Lz
Lz
Lz
Lz
Lz
Lz
Lz
Lz
Lz
Lz
Lz
Lz
Lz
Lz
Lz
Lz
Lz
Lz
Lz
Lz
Lz
Lz
Lz
Lz
Lz
Lz
Lz
Lz
Lz
Lz
Lz
"}
(49,1,1) = {"
Lz
Lz
Lz
Lz
Lz
Lz
Lz
Lz
Lz
Lz
Lz
Lz
Lz
Lz
Lz
Lz
Lz
Lz
Lz
Lz
Lz
Lz
Lz
Lz
Lz
Lz
Lz
Lz
Lz
Lz
Lz
Lz
Lz
Lz
Lz
Lz
Lz
Lz
Lz
Lz
Lz
Lz
Lz
Lz
Lz
Lz
Lz
Lz
Lz
Lz
"}
(50,1,1) = {"
Lz
Lz
Lz
Lz
Lz
Lz
Lz
Lz
Lz
Lz
Lz
Lz
Lz
Lz
Lz
Lz
Lz
Lz
Lz
Lz
Lz
Lz
Lz
Lz
Lz
Lz
Lz
Lz
Lz
Lz
Lz
Lz
Lz
Lz
Lz
Lz
Lz
Lz
Lz
Lz
Lz
Lz
Lz
Lz
Lz
Lz
Lz
Lz
Lz
Lz
"}
