"ab" = (/obj/machinery/atmospherics/pipe/simple/general{dir = 4},/obj/structure/cable{icon_state = "4-8"},/obj/structure/cable{icon_state = "1-8"},/turf/open/floor/plating/airless,/area/ruin/unpowered)
"al" = (/obj/structure/cable{icon_state = "4-8"},/obj/machinery/atmospherics/pipe/simple/scrubbers/hidden/layer4{dir = 4},/obj/machinery/atmospherics/pipe/simple/supply/hidden/layer2{dir = 4},/turf/open/floor/plating/airless,/area/ruin/unpowered)
"bm" = (/obj/structure/table/reinforced,/obj/machinery/button/door{id = "cryocontainshutter"; name = "Window Shutter Control"; pixel_x = 8; pixel_y = -4},/turf/open/floor/plasteel/airless/dark,/area/ruin/unpowered)
"bp" = (/turf/open/floor/plating/airless{icon_state = "platingdmg1"},/area/ruin/unpowered)
"bK" = (/obj/effect/decal/cleanable/blood,/turf/open/floor/plating/airless,/area/ruin/unpowered)
"bW" = (/obj/structure/table/reinforced,/obj/machinery/button{name = "Explosive Decoupler Control"; pixel_x = 8; pixel_y = -4},/obj/machinery/button/door{id = "cryocontainmentlockdown"; name = "Containment Lockdown Control"; pixel_x = -8; pixel_y = -4},/turf/open/floor/plasteel/airless/dark,/area/ruin/unpowered)
"cy" = (/turf/closed/wall/r_wall,/area/ruin/unpowered)
"dt" = (/obj/machinery/door/airlock/security,/obj/machinery/door/poddoor{id = "cryocontainmentlockdown"},/obj/effect/decal/cleanable/blood/footprints{dir = 8},/obj/machinery/atmospherics/pipe/simple/scrubbers/hidden/layer4{dir = 4},/obj/machinery/atmospherics/pipe/simple/supply/hidden/layer2{dir = 4},/turf/open/floor/plating/airless,/area/ruin/unpowered)
"eN" = (/obj/effect/decal/cleanable/blood/gibs,/obj/machinery/atmospherics/components/unary/vent_pump/layer2,/turf/open/floor/plating/airless,/area/ruin/unpowered)
"eT" = (/obj/effect/decal/cleanable/blood/gibs/down,/obj/effect/decal/cleanable/blood/gibs,/obj/machinery/atmospherics/pipe/manifold/supply/hidden/layer2{dir = 8},/turf/open/floor/plating/airless,/area/ruin/unpowered)
"eU" = (/obj/effect/decal/cleanable/blood/tracks,/obj/machinery/atmospherics/pipe/simple/supply/hidden/layer2{dir = 4},/turf/open/floor/plating/airless,/area/ruin/unpowered)
"eZ" = (/obj/machinery/atmospherics/pipe/simple/general{dir = 5},/obj/structure/cable{icon_state = "2-4"},/obj/structure/cable{icon_state = "2-8"},/turf/open/floor/plating/airless,/area/ruin/unpowered)
"fE" = (/obj/structure/cable{icon_state = "1-2"},/obj/machinery/atmospherics/pipe/simple/scrubbers/hidden/layer4{dir = 4},/turf/open/floor/plating/airless,/area/ruin/unpowered)
"fL" = (/obj/structure/cable{icon_state = "4-8"},/obj/structure/cable{icon_state = "1-4"},/turf/open/floor/plating/airless,/area/ruin/unpowered)
"fY" = (/obj/structure/table/optable,/obj/structure/cable{icon_state = "1-2"},/turf/open/floor/plating/airless,/area/ruin/unpowered)
"gd" = (/obj/effect/decal/cleanable/blood/drip,/obj/machinery/atmospherics/pipe/simple/scrubbers/hidden/layer4{dir = 4},/obj/machinery/atmospherics/pipe/manifold/supply/hidden/layer2{dir = 4},/turf/open/floor/plating/airless,/area/ruin/unpowered)
"gm" = (/obj/item/clothing/suit/toggle/labcoat,/turf/open/floor/plating/airless,/area/ruin/unpowered)
"gC" = (/obj/machinery/atmospherics/pipe/simple/general{dir = 5},/mob/living/simple_animal/hostile/carp,/turf/open/floor/plasteel/airless/white,/area/ruin/unpowered)
"gG" = (/obj/machinery/atmospherics/components/unary/vent_pump/layer2,/turf/open/floor/plating/airless,/area/ruin/unpowered)
"ha" = (/obj/structure/table/reinforced,/obj/machinery/light{dir = 1},/turf/open/floor/plasteel/airless/white,/area/ruin/unpowered)
"hw" = (/obj/machinery/atmospherics/components/unary/thermomachine/freezer{dir = 8},/turf/open/floor/plasteel/airless/white,/area/ruin/unpowered)
"ih" = (/obj/effect/decal/cleanable/blood/gibs/limb,/obj/machinery/light/built,/obj/item/light/tube/broken,/obj/structure/cable{icon_state = "1-8"},/obj/machinery/atmospherics/pipe/simple/scrubbers/hidden/layer4{dir = 9},/obj/machinery/atmospherics/pipe/simple/supply/hidden/layer2{dir = 4},/turf/open/floor/plating/airless,/area/ruin/unpowered)
"jd" = (/obj/effect/decal/cleanable/blood/splatter,/turf/open/floor/plating/airless,/area/ruin/unpowered)
"jq" = (/obj/structure/lattice,/obj/structure/lattice,/turf/open/space/basic,/area/space)
"jN" = (/obj/effect/decal/cleanable/blood,/obj/machinery/atmospherics/pipe/simple/scrubbers/hidden/layer4{dir = 4},/obj/machinery/atmospherics/pipe/simple/supply/hidden/layer2{dir = 4},/turf/open/floor/plating/airless,/area/ruin/unpowered)
"kl" = (/obj/machinery/computer{desc = "A computer long since rendered non-functional due to lack of maintenance. Spitting out error messages."; dir = 4; name = "Broken Computer"},/obj/item/paper{name = "console log"; text = "SPECIMIN BREACH, ACTIVATING LOCKDOWN PRTOCOLS, ACTIVATING EXPLOSIVE DECOUPLE CHARGES."},/turf/open/floor/plasteel/airless/dark,/area/ruin/unpowered)
"km" = (/obj/effect/decal/cleanable/blood/drip,/obj/machinery/atmospherics/pipe/simple/supply/hidden/layer2{dir = 9},/turf/open/floor/plating/airless,/area/ruin/unpowered)
"kH" = (/obj/item/scalpel,/obj/machinery/atmospherics/pipe/simple/scrubbers/hidden/layer4,/turf/open/floor/plating/airless,/area/ruin/unpowered)
"kW" = (/obj/structure/table_frame,/obj/item/shard,/turf/open/floor/plating/airless,/area/ruin/unpowered)
"nh" = (/obj/machinery/smartfridge/organ,/turf/open/floor/plasteel/airless/white,/area/ruin/unpowered)
"nl" = (/obj/machinery/chem_master,/turf/open/floor/plasteel/airless/white,/area/ruin/unpowered)
"nt" = (/obj/structure/cable{icon_state = "4-8"},/obj/machinery/atmospherics/pipe/simple/scrubbers/hidden/layer4{dir = 4},/obj/machinery/atmospherics/pipe/manifold/supply/hidden/layer2,/turf/open/floor/plating/airless,/area/ruin/unpowered)
"nY" = (/obj/machinery/atmospherics/pipe/simple/general{dir = 4},/turf/open/floor/plasteel/airless/white,/area/ruin/unpowered)
"oD" = (/obj/machinery/atmospherics/pipe/simple/scrubbers/hidden/layer4{dir = 5},/turf/open/floor/plating/airless,/area/ruin/unpowered)
"qa" = (/obj/machinery/atmospherics/pipe/simple/general,/turf/open/floor/engine/airless,/area/ruin/unpowered)
"qf" = (/obj/machinery/door/airlock/public/glass,/obj/machinery/door/poddoor{id = "cryocontainmentlockdown"},/obj/machinery/atmospherics/pipe/simple/scrubbers/hidden/layer4{dir = 4},/turf/open/floor/plating/airless,/area/ruin/unpowered)
"qk" = (/obj/structure/cable{icon_state = "0-4"},/obj/machinery/power/apc/away{pixel_x = -24; start_charge = 0},/obj/item/ammo_casing/spent{pixel_x = -9; pixel_y = 11},/obj/item/ammo_casing/spent{dir = 10; pixel_y = 5},/obj/item/ammo_casing/spent{dir = 4; pixel_x = 1; pixel_y = 10},/turf/open/floor/plating/airless,/area/ruin/unpowered)
"qC" = (/obj/structure/grille,/obj/structure/window/reinforced/fulltile,/turf/open/floor/plating/airless,/area/ruin/unpowered)
"ra" = (/obj/machinery/atmospherics/pipe/simple/supply/hidden/layer2{dir = 4},/turf/open/floor/plating/airless,/area/ruin/unpowered)
"sJ" = (/obj/item/reagent_containers/syringe,/turf/open/floor/plasteel/airless/white,/area/ruin/unpowered)
"tm" = (/obj/structure/door_assembly/door_assembly_research,/obj/machinery/door/poddoor{id = "cryocontainmentlockdown"},/obj/structure/cable{icon_state = "4-8"},/obj/machinery/atmospherics/pipe/simple/scrubbers/hidden/layer4{dir = 4},/obj/machinery/atmospherics/pipe/simple/supply/hidden/layer2{dir = 4},/turf/open/floor/plating/airless,/area/ruin/unpowered)
"tn" = (/obj/structure/table/reinforced,/obj/item/reagent_containers/glass/beaker/cryoxadone{cap_on = 1; pixel_x = -6},/obj/item/reagent_containers/glass/beaker/cryoxadone{cap_on = 1; pixel_x = 6},/turf/open/floor/plasteel/airless/white,/area/ruin/unpowered)
"ts" = (/obj/structure/grille,/turf/open/floor/plating/airless,/area/ruin/unpowered)
"uc" = (/obj/item/shard,/obj/structure/grille/broken,/turf/open/floor/plating/airless,/area/ruin/unpowered)
"un" = (/obj/machinery/door/poddoor/shutters/preopen{id = "cryocontainshutter"},/obj/structure/grille,/obj/structure/window/reinforced/fulltile,/turf/open/floor/plasteel/airless/dark,/area/ruin/unpowered)
"ve" = (/obj/structure/table/greyscale,/obj/item/storage/fancy/cigarettes/cigpack_carp,/obj/machinery/light/small{dir = 8},/obj/machinery/atmospherics/components/unary/vent_pump/layer2{dir = 8},/turf/open/floor/plating/airless,/area/ruin/unpowered)
"wr" = (/obj/machinery/atmospherics/components/unary/vent_scrubber/layer4,/turf/open/floor/plating/airless,/area/ruin/unpowered)
"xB" = (/mob/living/simple_animal/hostile/carp,/turf/open/space/basic,/area/space)
"ye" = (/obj/machinery/light{dir = 1},/obj/structure/chair/greyscale{dir = 8},/obj/effect/mob_spawn/human/corpse/damaged,/obj/effect/decal/cleanable/blood,/obj/machinery/atmospherics/components/unary/vent_pump/layer2{dir = 4},/turf/open/floor/plasteel/airless/dark,/area/ruin/unpowered)
"yM" = (/obj/item/stack/rods,/turf/open/space/basic,/area/space)
"zI" = (/obj/effect/decal/cleanable/blood/drip,/obj/effect/decal/cleanable/blood/footprints{dir = 8},/obj/machinery/atmospherics/pipe/simple/scrubbers/hidden/layer4{dir = 4},/obj/machinery/atmospherics/pipe/simple/supply/hidden/layer2{dir = 4},/turf/open/floor/plating/airless,/area/ruin/unpowered)
"Ax" = (/obj/structure/grille/broken,/obj/effect/decal/cleanable/glass,/obj/item/shard,/turf/open/floor/plating/airless,/area/ruin/unpowered)
"Bl" = (/obj/structure/girder/displaced,/turf/open/space/basic,/area/space)
"BV" = (/turf/open/floor/plating/airless{icon_state = "platingdmg2"},/area/ruin/unpowered)
"Cq" = (/turf/closed/wall/r_wall/rust,/area/ruin/unpowered)
"Cs" = (/obj/item/stack/cable_coil/cut/red,/turf/open/floor/plating/airless{icon_state = "platingdmg2"},/area/ruin/unpowered)
"CD" = (/obj/effect/decal/cleanable/blood/tracks,/turf/open/floor/plating/airless,/area/ruin/unpowered)
"CI" = (/mob/living/simple_animal/hostile/carp,/obj/machinery/atmospherics/pipe/simple/scrubbers/hidden/layer4{dir = 4},/turf/open/floor/plating/airless,/area/ruin/unpowered)
"DL" = (/obj/structure/cable{icon_state = "4-8"},/turf/open/floor/plating/airless,/area/ruin/unpowered)
"Ej" = (/obj/item/shard,/obj/item/stack/rods,/turf/open/space/basic,/area/space)
"EH" = (/obj/machinery/atmospherics/pipe/simple/general,/obj/structure/door_assembly/door_assembly_vault,/obj/machinery/door/poddoor/preopen{id = "cryocontainmentblastdoors"},/turf/open/floor/engine/airless,/area/ruin/unpowered)
"Fb" = (/obj/structure/table/reinforced,/obj/item/ammo_box/magazine/co9mm,/turf/open/floor/plasteel/airless/dark,/area/ruin/unpowered)
"Fk" = (/obj/machinery/smartfridge/chemistry,/obj/machinery/light{dir = 4},/turf/open/floor/plasteel/airless/white,/area/ruin/unpowered)
"Fq" = (/obj/structure/grille,/obj/effect/decal/cleanable/glass,/turf/open/floor/plating/airless,/area/ruin/unpowered)
"FW" = (/obj/machinery/atmospherics/pipe/simple/scrubbers/hidden/layer4,/obj/structure/cable{icon_state = "1-2"},/turf/open/floor/plating/airless,/area/ruin/unpowered)
"Gj" = (/obj/effect/decal/cleanable/blood/footprints{dir = 8},/obj/machinery/atmospherics/components/unary/vent_scrubber/layer4{dir = 4},/obj/machinery/atmospherics/pipe/simple/supply/hidden/layer2{dir = 4},/obj/item/ammo_casing/spent{dir = 10; pixel_x = -11; pixel_y = -5},/turf/open/floor/plating/airless,/area/ruin/unpowered)
"GV" = (/turf/open/floor/plating/airless{icon_state = "platingdmg3"},/area/ruin/unpowered)
"Hn" = (/obj/machinery/light/broken{dir = 1},/turf/open/floor/engine/airless,/area/ruin/unpowered)
"Hy" = (/obj/structure/cable{icon_state = "0-4"},/obj/machinery/atmospherics/pipe/simple/supply/hidden/layer2{dir = 4},/turf/open/floor/plating/airless{icon_state = "platingdmg3"},/area/ruin/unpowered)
"HS" = (/obj/effect/decal/cleanable/blood/drip,/turf/open/floor/plating/airless,/area/ruin/unpowered)
"IX" = (/obj/structure/lattice,/turf/open/space/basic,/area/space)
"Ji" = (/obj/structure/grille/broken,/obj/effect/decal/cleanable/glass,/obj/item/stack/rods,/turf/open/floor/plating/airless,/area/ruin/unpowered)
"Jj" = (/turf/open/floor/engine/airless,/area/ruin/unpowered)
"KY" = (/turf/open/space/basic,/area/space)
"KZ" = (/obj/structure/grille/broken,/turf/open/floor/plating/airless,/area/ruin/unpowered)
"LP" = (/mob/living/simple_animal/hostile/carp,/obj/effect/decal/cleanable/blood/footprints{dir = 8},/obj/machinery/atmospherics/pipe/manifold/scrubbers/hidden/layer4{dir = 1},/obj/machinery/atmospherics/pipe/simple/supply/hidden/layer2{dir = 4},/turf/open/floor/plating/airless,/area/ruin/unpowered)
"LY" = (/obj/structure/chair/stool,/obj/machinery/atmospherics/components/unary/vent_scrubber/layer4{dir = 8},/obj/effect/decal/remains/human,/turf/open/floor/plating/airless,/area/ruin/unpowered)
"Mf" = (/obj/effect/mob_spawn/human/corpse/damaged,/obj/effect/decal/cleanable/blood,/obj/structure/cable{icon_state = "4-8"},/obj/structure/cable{icon_state = "2-8"},/obj/machinery/atmospherics/pipe/simple/scrubbers/hidden/layer4,/turf/open/floor/plating/airless,/area/ruin/unpowered)
"Na" = (/obj/machinery/atmospherics/components/binary/pump{dir = 8},/obj/machinery/light{dir = 1},/turf/open/floor/plasteel/airless/white,/area/ruin/unpowered)
"NM" = (/obj/machinery/atmospherics/pipe/simple/supply/hidden/layer2{dir = 4},/turf/closed/wall/r_wall,/area/ruin/unpowered)
"OH" = (/turf/open/floor/plating/airless,/area/ruin/unpowered)
"Pg" = (/obj/effect/mob_spawn/human/corpse/damaged,/turf/open/space/basic,/area/space)
"Po" = (/obj/effect/decal/cleanable/blood/splatter,/obj/machinery/atmospherics/pipe/manifold/scrubbers/hidden/layer4,/turf/open/floor/plating/airless,/area/ruin/unpowered)
"PD" = (/obj/effect/decal/cleanable/blood/splatter,/obj/machinery/atmospherics/pipe/simple/scrubbers/hidden/layer4,/turf/open/floor/plating/airless,/area/ruin/unpowered)
"PN" = (/obj/machinery/atmospherics/pipe/simple/scrubbers/hidden/layer4{dir = 10},/turf/open/floor/plating/airless,/area/ruin/unpowered)
"PW" = (/obj/machinery/atmospherics/components/unary/portables_connector/visible{dir = 8},/obj/machinery/portable_atmospherics/canister/oxygen,/turf/open/floor/plasteel/airless/white,/area/ruin/unpowered)
"Qi" = (/obj/effect/decal/cleanable/blood/splatter,/obj/effect/decal/cleanable/blood/gibs,/obj/machinery/atmospherics/pipe/simple/supply/hidden/layer2{dir = 4},/turf/open/floor/plating/airless,/area/ruin/unpowered)
"QC" = (/turf/open/floor/plasteel/airless/white,/area/ruin/unpowered)
"QH" = (/obj/effect/decal/cleanable/blood,/obj/machinery/atmospherics/pipe/simple/scrubbers/hidden/layer4,/turf/open/floor/plating/airless,/area/ruin/unpowered)
"QV" = (/obj/effect/decal/cleanable/blood/gibs/body,/obj/structure/cable{icon_state = "1-8"},/turf/open/floor/plating/airless,/area/ruin/unpowered)
"Rj" = (/obj/structure/cable{icon_state = "4-8"},/obj/machinery/atmospherics/pipe/simple/supply/hidden/layer2,/turf/open/floor/plating/airless,/area/ruin/unpowered)
"Ro" = (/obj/structure/lattice,/obj/item/stack/cable_coil/cut/red,/turf/open/space/basic,/area/space)
"RZ" = (/obj/effect/gibspawner/human,/obj/item/clothing/suit/toggle/labcoat,/turf/open/floor/plating/airless,/area/ruin/unpowered)
"Sk" = (/obj/machinery/light/broken,/obj/machinery/atmospherics/pipe/simple/scrubbers/hidden/layer4{dir = 4},/turf/open/floor/plating/airless,/area/ruin/unpowered)
"Tr" = (/obj/item/shard,/turf/open/space/basic,/area/space)
"TF" = (/obj/effect/decal/cleanable/blood/splatter,/obj/machinery/atmospherics/pipe/simple/supply/hidden/layer2{dir = 4},/turf/open/floor/plating/airless,/area/ruin/unpowered)
"TG" = (/mob/living/simple_animal/hostile/carp,/obj/structure/cable{icon_state = "4-8"},/obj/machinery/atmospherics/pipe/simple/scrubbers/hidden/layer4{dir = 4},/obj/machinery/atmospherics/pipe/simple/supply/hidden/layer2{dir = 4},/turf/open/floor/plating/airless,/area/ruin/unpowered)
"TL" = (/obj/machinery/atmospherics/pipe/simple/supply/hidden/layer2,/turf/open/floor/plating/airless,/area/ruin/unpowered)
"TU" = (/obj/item/shard,/obj/machinery/atmospherics/pipe/simple/scrubbers/hidden/layer4,/obj/machinery/atmospherics/pipe/simple/supply/hidden/layer2{dir = 4},/turf/open/floor/plating/airless,/area/ruin/unpowered)
"UL" = (/obj/machinery/atmospherics/pipe/manifold{dir = 1},/obj/structure/cable{icon_state = "1-8"},/turf/open/floor/plating/airless,/area/ruin/unpowered)
"Wm" = (/obj/structure/cable{icon_state = "4-8"},/obj/machinery/atmospherics/pipe/manifold/scrubbers/hidden/layer4,/obj/machinery/atmospherics/pipe/simple/supply/hidden/layer2{dir = 4},/turf/open/floor/plating/airless,/area/ruin/unpowered)
"WR" = (/obj/structure/grille,/obj/structure/window/plasma/reinforced/fulltile,/obj/structure/cable{icon_state = "0-2"},/obj/machinery/door/poddoor/preopen{id = "cryocontainmentblastdoors"},/turf/open/floor/plating/airless,/area/ruin/unpowered)
"Xn" = (/obj/machinery/light/broken{dir = 8; icon_state = "tube-broken"},/obj/item/ammo_casing/spent{dir = 8; pixel_x = -1; pixel_y = 8},/obj/item/ammo_casing/spent{dir = 9; pixel_x = 5; pixel_y = -3},/obj/item/ammo_casing/spent,/obj/item/ammo_casing/spent{pixel_x = 10; pixel_y = 5},/obj/item/ammo_casing/spent{dir = 1; pixel_x = -10},/turf/open/floor/plating/airless,/area/ruin/unpowered)
"Xs" = (/obj/structure/table/reinforced,/obj/machinery/button/door{id = "cryocontainmentblastdoors"; name = "Blast Door Control"},/obj/structure/cable{icon_state = "1-4"},/turf/open/floor/plating/airless,/area/ruin/unpowered)
"Ye" = (/obj/machinery/light/broken,/obj/structure/cable{icon_state = "4-8"},/obj/machinery/atmospherics/pipe/simple/scrubbers/hidden/layer4{dir = 4},/obj/machinery/atmospherics/pipe/simple/supply/hidden/layer2{dir = 4},/turf/open/floor/plating/airless,/area/ruin/unpowered)
"Zx" = (/obj/machinery/atmospherics/components/unary/cryo_cell{state_open = 1},/turf/open/floor/engine/airless,/area/ruin/unpowered)
"Zz" = (/obj/effect/mob_spawn/human/corpse/damaged,/obj/effect/decal/cleanable/blood,/obj/structure/cable{icon_state = "1-2"},/turf/open/floor/plating/airless,/area/ruin/unpowered)

(1,1,1) = {"
KYKYKYKYKYKYKYKYKYKYKYKYKYKZKZtststststsKZtstststsKZKZKY
KYKYKYKYKYKYKYKYKYKYKYKYKYKZKYKYIXKYKYIXKYKYIXKYKYIXKYKY
KYKYKYKYKYKYKYKYKYxBKYKYKYtsKYKYcycycycycycyCqCqcyIXKYKZ
KYKYKYKYKYKYKYKYKYKYKYKYKYtsIXIXCqcyCqCqCqCqCqCqCqIXKYts
KYKYKYKYKYKYKYKYKYKYKYKYKYtsKYKYCqcyJjHnZxHnJjCqCqIXKYts
KYKYKYKYKYKYKYKYKYKYKYKYKYtsKYKYcycyJjJjqaJjJjCqcyIXKYts
KYKYKYKYKYKYKYKYKYKYKYKYKYtsIXcycycyWRWREHWRWRcycycyKYts
KYKYKYKYKYKYKYKYKYtsKYKYKYKYKYcytnhaXsfLeZabULNaPWcyIXts
KYKYKYKYxBKYKYKYKYtsIXCqCqcycycyQCHSOHeNZzwrgCnYhwCqKYts
KYKYKYKYKYKYKYKYKYKZKYCqklyeGjdtzILPjNgdfEPoPNsJnhCqKYKZ
KYKYKYKYKYKYKYKYKYKZKYCqFbbmbWcyXnQHRZTLfYkWPDQCFkCqKYKY
IXKYKYKYKYKYTrKYKYTrKYcyunununCqqkMfDLRjQVbKkHjdnlCqqCqC
KYKYIXRoKYIXCqJiAxFqqCcywrOHgGCqOHFWOHeTTFeUTUraQiNMveqC
KYKYKYjqBVbpGVCsGVHyaltmWmYenttmTGihTFkmgmCDoDSkCIqfLYqC
KYKYKYIXRoxBCqAxFqqCqCcycyCqCqCqCqcycycyGVBVCqCqCqcyqCqC
KYIXKYBlEjKYIXyMKYKYKYKYKYIXKYKYIXKYKYIXBlKYIXKYKYIXKYKY
KYKYKYKYKYKYKZKZucKYKYtstststsKZKZtstsKZKZKZKZKZtstsKZKZ
KYKYKYKYKYKYKYKYKYKYKYKYKYKYKYKYKYKYKYKYxBPgKYKYKYKYKYKY
"}
