//MAP CONVERTED BY dmm2tgm.py THIS HEADER COMMENT PREVENTS RECONVERSION, DO NOT REMOVE
"aa" = (
/turf/open/space/basic,
/area/space)
"ab" = (
/turf/closed/wall/r_wall,
/area/ruin/space/has_grav/storage/materials3)
"ac" = (
/obj/structure/closet/crate,
/obj/effect/spawner/lootdrop/maintenance/four,
/turf/open/floor/plasteel,
/area/ruin/space/has_grav/storage/materials3)
"ad" = (
/turf/closed/wall/r_wall,
/area/ruin/space/has_grav/storage/materials2)
"ae" = (
/turf/open/floor/plasteel,
/area/ruin/space/has_grav/storage/materials3)
"af" = (
/obj/effect/decal/cleanable/blood/footprints{
	dir = 4;
	icon_state = "blood1"
	},
/turf/open/floor/plasteel,
/area/ruin/space/has_grav/storage/materials2)
"ag" = (
/obj/item/storage/pill_bottle,
/obj/effect/decal/cleanable/blood/footprints{
	dir = 4;
	icon_state = "blood1"
	},
/turf/open/floor/plasteel,
/area/ruin/space/has_grav/storage/materials2)
"ah" = (
/turf/closed/mineral,
/area/ruin/space/has_grav)
"ai" = (
/turf/closed/wall/r_wall,
/area/ruin/space/has_grav/storage/materials1)
"ak" = (
/obj/effect/decal/cleanable/blood/footprints{
	dir = 1;
	icon_state = "blood1"
	},
/turf/open/floor/plasteel,
/area/ruin/space/has_grav/storage/materials2)
"al" = (
/obj/effect/decal/cleanable/blood/footprints{
	dir = 4;
	icon_state = "blood1"
	},
/obj/effect/decal/cleanable/dirt,
/turf/open/floor/plasteel,
/area/ruin/space/has_grav/storage/materials2)
"am" = (
/turf/open/floor/plasteel,
/area/ruin/space/has_grav/storage/materials2)
"an" = (
/obj/structure/closet/crate/secure/weapon,
/obj/item/ammo_box/magazine/smgm9mm,
/obj/item/ammo_box/magazine/smgm9mm/ap,
/obj/item/ammo_box/magazine/smgm9mm,
/turf/open/floor/plasteel,
/area/ruin/space/has_grav/storage/materials2)
"ao" = (
/obj/effect/decal/cleanable/blood/footprints{
	dir = 4;
	icon_state = "blood1"
	},
/obj/effect/decal/cleanable/dirt/dust,
/turf/open/floor/plasteel,
/area/ruin/space/has_grav/storage/materials2)
"ap" = (
/obj/effect/decal/cleanable/cobweb,
/turf/open/floor/plasteel,
/area/ruin/space/has_grav/storage/materials1)
"aq" = (
/turf/open/floor/plasteel,
/area/ruin/space/has_grav/storage/materials1)
"au" = (
/obj/machinery/door/airlock/highsecurity,
/obj/effect/mapping_helpers/airlock/locked,
/turf/open/floor/plasteel,
/area/ruin/space/has_grav/storage/materials3)
"av" = (
/obj/structure/falsewall/reinforced,
/obj/effect/decal/cleanable/blood/footprints{
	dir = 1;
	icon_state = "blood1"
	},
/turf/open/floor/plasteel,
/area/ruin/space/has_grav/storage/materials2)
"aw" = (
/obj/structure/closet/syndicate/resources{
	name = "Resourse storage"
	},
/obj/effect/decal/cleanable/cobweb,
/turf/open/floor/plasteel,
/area/ruin/space/has_grav/storage/materials2)
"ax" = (
/obj/structure/closet/syndicate/resources{
	name = "Resourse storage"
	},
/turf/open/floor/plasteel,
/area/ruin/space/has_grav/storage/materials2)
"ay" = (
/obj/machinery/doorButtons/access_button,
/turf/closed/wall/r_wall,
/area/ruin/space/has_grav/storage/materials2)
"aA" = (
/obj/effect/decal/cleanable/blood/tracks{
	dir = 4;
	icon_state = "tracks"
	},
/turf/open/floor/plasteel,
/area/ruin/space/has_grav/storage/materials1)
"aB" = (
/obj/machinery/door/airlock/highsecurity,
/obj/effect/decal/cleanable/blood/tracks{
	dir = 4;
	icon_state = "tracks"
	},
/obj/effect/mapping_helpers/airlock/locked,
/turf/open/floor/plasteel,
/area/ruin/space/has_grav/storage/materials2)
"aC" = (
/obj/effect/decal/cleanable/blood,
/turf/open/floor/plasteel,
/area/ruin/space/has_grav/storage/materials2)
"aD" = (
/obj/machinery/door/airlock/highsecurity,
/obj/effect/mapping_helpers/airlock/locked,
/turf/open/floor/plasteel,
/area/ruin/space/has_grav/storage/materials2)
"aE" = (
/obj/item/bear_armor,
/turf/open/floor/plasteel,
/area/ruin/space/has_grav/storage/materials2)
"aH" = (
/obj/structure/closet/syndicate/resources{
	name = "Resourse storage"
	},
/obj/effect/decal/cleanable/blood,
/turf/open/floor/plasteel,
/area/ruin/space/has_grav/storage/materials2)
"aI" = (
/obj/effect/spawner/lootdrop/glowstick,
/turf/open/floor/plasteel,
/area/ruin/space/has_grav/storage/materials1)
"aJ" = (
/obj/effect/decal/cleanable/cobweb,
/turf/open/floor/plasteel,
/area/ruin/space/has_grav/storage/materials2)
"aK" = (
/obj/structure/falsewall/reinforced,
/turf/open/floor/plasteel,
/area/ruin/space/has_grav/storage/materials2)
"aM" = (
/turf/closed/wall/r_wall,
/area/ruin/space/has_grav/storage/power1)
"aR" = (
/turf/closed/wall/r_wall,
/area/ruin/space/has_grav/storage/power2)
"aS" = (
/turf/closed/wall/r_wall,
/area/ruin/space/has_grav/storage/power3)
"aT" = (
/obj/structure/closet/crate/secure/loot,
/obj/effect/decal/cleanable/cobweb,
/turf/open/floor/plasteel,
/area/ruin/space/has_grav/storage/power3)
"aU" = (
/turf/open/floor/plasteel,
/area/ruin/space/has_grav/storage/power3)
"aV" = (
/obj/effect/decal/cleanable/cobweb,
/turf/open/floor/plasteel,
/area/ruin/space/has_grav/storage/power1)
"aW" = (
/obj/item/export_scanner,
/obj/effect/decal/cleanable/dirt/dust,
/obj/structure/cable{
	icon_state = "4-8"
	},
/turf/open/floor/plasteel,
/area/ruin/space/has_grav/storage/central)
"aX" = (
/turf/open/floor/plasteel,
/area/ruin/space/has_grav/storage/power1)
"aY" = (
/turf/closed/wall/r_wall,
/area/ruin/space/has_grav/storage/central)
"aZ" = (
/obj/item/trash/pistachios,
/obj/item/storage/pill_bottle/floorpill/full,
/turf/open/floor/plasteel,
/area/ruin/space/has_grav/storage/central)
"ba" = (
/obj/structure/closet/toolcloset,
/obj/effect/decal/cleanable/cobweb,
/turf/open/floor/plasteel,
/area/ruin/space/has_grav/storage/power2)
"bb" = (
/obj/item/trash/sosjerky,
/obj/item/trash/syndi_cakes,
/obj/effect/mob_spawn/human/corpse/cargo_tech,
/turf/open/floor/plasteel,
/area/ruin/space/has_grav/storage/central)
"bc" = (
/obj/structure/closet/toolcloset,
/turf/open/floor/plasteel,
/area/ruin/space/has_grav/storage/power2)
"bd" = (
/obj/effect/decal/cleanable/blood/splatter,
/obj/effect/mob_spawn/human/corpse/cargo_tech,
/obj/item/weldingtool/mini,
/obj/item/storage/pill_bottle/lsd,
/turf/open/floor/plasteel,
/area/ruin/space/has_grav/storage/central)
"be" = (
/obj/effect/decal/cleanable/cobweb/cobweb2,
/turf/open/floor/plasteel,
/area/ruin/space/has_grav/storage/materials1)
"bf" = (
/obj/item/storage/pill_bottle,
/turf/open/floor/plasteel,
/area/ruin/space/has_grav/storage/materials2)
"bh" = (
/obj/effect/decal/cleanable/dirt/dust,
/turf/open/floor/plasteel,
/area/ruin/space/has_grav/storage/materials1)
"bi" = (
/turf/open/floor/plasteel,
/area/ruin/space/has_grav/storage/power2)
"bj" = (
/obj/machinery/vending/engivend,
/turf/open/floor/plasteel,
/area/ruin/space/has_grav/storage/power2)
"bk" = (
/turf/closed/wall/r_wall,
/area/ruin/space/has_grav/storage/central2)
"bl" = (
/turf/closed/wall,
/area/ruin/space/has_grav/storage/central)
"bm" = (
/obj/structure/falsewall/reinforced,
/obj/effect/decal/cleanable/blood/tracks,
/turf/open/floor/plasteel,
/area/ruin/space/has_grav/storage/central)
"bp" = (
/turf/open/floor/plasteel,
/area/ruin/space/has_grav/storage/central)
"bq" = (
/obj/structure/closet/firecloset/full,
/turf/open/floor/plasteel,
/area/ruin/space/has_grav/storage/central)
"br" = (
/obj/structure/closet/crate,
/obj/effect/spawner/lootdrop/maintenance/two,
/obj/effect/decal/cleanable/cobweb,
/turf/open/floor/plasteel,
/area/ruin/space/has_grav/storage/central)
"bs" = (
/obj/structure/closet/crate,
/obj/effect/spawner/lootdrop/maintenance/two,
/turf/open/floor/plasteel,
/area/ruin/space/has_grav/storage/central)
"bt" = (
/obj/effect/decal/cleanable/blood/tracks{
	dir = 10;
	icon_state = "tracks"
	},
/turf/open/floor/plasteel,
/area/ruin/space/has_grav/storage/central)
"bx" = (
/obj/structure/cable{
	icon_state = "1-4"
	},
/turf/closed/wall/r_wall,
/area/ruin/space/has_grav/storage/power2)
"by" = (
/obj/effect/decal/cleanable/cobweb/cobweb2,
/turf/open/floor/plasteel,
/area/ruin/space/has_grav/storage/central)
"bz" = (
/turf/open/space/basic,
/area/ruin/space/has_grav/storage/central2)
"bB" = (
/obj/vehicle/ridden/bicycle,
/turf/open/floor/plasteel,
/area/ruin/space/has_grav/storage/central2)
"bC" = (
/turf/open/floor/plasteel,
/area/ruin/space/has_grav/storage/central2)
"bD" = (
/obj/structure/table/wood/fancy/red,
/obj/structure/table/wood/fancy/cyan,
/obj/item/storage/lockbox/dueling{
	req_access = null
	},
/turf/open/floor/plasteel,
/area/ruin/space/has_grav/storage/central2)
"bE" = (
/obj/structure/cable{
	icon_state = "4-8"
	},
/obj/effect/decal/cleanable/cobweb,
/turf/open/floor/plasteel,
/area/ruin/space/has_grav/storage/power2)
"bG" = (
/obj/structure/closet/crate/secure/loot,
/turf/open/floor/plasteel,
/area/ruin/space/has_grav/storage/power3)
"bH" = (
/obj/machinery/door/airlock/highsecurity,
/obj/effect/mapping_helpers/airlock/locked,
/turf/open/floor/plasteel,
/area/ruin/space/has_grav/storage/central2)
"bI" = (
/obj/machinery/door/airlock/vault,
/obj/effect/mapping_helpers/airlock/locked,
/turf/open/floor/plasteel,
/area/ruin/space/has_grav/storage/central2)
"bQ" = (
/obj/effect/decal/cleanable/blood/footprints{
	dir = 8;
	icon_state = "blood1"
	},
/turf/open/floor/plasteel,
/area/ruin/space/has_grav/storage/power2)
"bS" = (
/obj/structure/table/wood/fancy/royalblue,
/obj/item/reagent_containers/hypospray,
/turf/open/floor/plasteel,
/area/ruin/space/has_grav/storage/central2)
"bT" = (
/obj/effect/decal/cleanable/blood/tracks{
	dir = 4;
	icon_state = "tracks"
	},
/obj/effect/decal/cleanable/dirt/dust,
/turf/open/floor/plasteel,
/area/ruin/space/has_grav/storage/materials1)
"bX" = (
/obj/effect/decal/cleanable/dirt/dust,
/turf/open/floor/plasteel,
/area/ruin/space/has_grav/storage/materials2)
"bZ" = (
/obj/effect/decal/cleanable/dirt/dust,
/turf/closed/wall/r_wall,
/area/ruin/space/has_grav/storage/materials2)
"ca" = (
/obj/effect/mob_spawn/human/corpse/cargo_tech,
/turf/open/floor/plasteel,
/area/ruin/space/has_grav/storage/central)
"cc" = (
/obj/machinery/door/airlock/highsecurity,
/obj/effect/decal/cleanable/blood/footprints{
	dir = 8;
	icon_state = "blood1"
	},
/obj/effect/mapping_helpers/airlock/locked,
/turf/open/floor/plasteel,
/area/ruin/space/has_grav/storage/power2)
"cd" = (
/obj/structure/table/wood/fancy/red,
/obj/item/gun/ballistic/automatic/proto/unrestricted,
/turf/open/floor/plasteel,
/area/ruin/space/has_grav/storage/central2)
"ce" = (
/obj/item/crowbar/red,
/turf/open/floor/plasteel,
/area/ruin/space/has_grav/storage/central)
"cg" = (
/obj/structure/closet/crate/internals,
/turf/open/floor/plasteel,
/area/ruin/space/has_grav/storage/central)
"ch" = (
/obj/effect/decal/cleanable/oil,
/turf/open/floor/plasteel,
/area/ruin/space/has_grav/storage/materials1)
"ci" = (
/obj/structure/closet/crate/secure/loot,
/turf/open/floor/plasteel,
/area/ruin/space/has_grav/storage/central)
"cj" = (
/obj/structure/table/wood/fancy/orange,
/obj/item/construction/rcd/combat,
/turf/open/floor/plasteel,
/area/ruin/space/has_grav/storage/central2)
"ck" = (
/obj/structure/table/wood/fancy/green,
/obj/item/construction/rld,
/turf/open/floor/plasteel,
/area/ruin/space/has_grav/storage/central2)
"cl" = (
/obj/structure/table/wood/fancy/blue,
/obj/structure/table/wood/fancy/purple,
/obj/item/assembly/signaler/anomaly,
/turf/open/floor/plasteel,
/area/ruin/space/has_grav/storage/central2)
"cm" = (
/obj/item/crowbar/red,
/obj/effect/mob_spawn/human/corpse/cargo_tech,
/turf/open/floor/plasteel,
/area/ruin/space/has_grav/storage/power2)
"cp" = (
/obj/structure/closet/crate/medical,
/obj/item/storage/pill_bottle/lsd,
/obj/item/storage/pill_bottle/happy,
/turf/open/floor/plasteel,
/area/ruin/space/has_grav/storage/power2)
"cq" = (
/obj/effect/decal/cleanable/dirt,
/turf/open/floor/plasteel,
/area/ruin/space/has_grav/storage/materials2)
"cr" = (
/obj/structure/falsewall/reinforced,
/obj/effect/decal/cleanable/dirt/dust,
/turf/open/floor/plasteel,
/area/ruin/space/has_grav/storage/materials2)
"cs" = (
/obj/item/storage/pill_bottle,
/turf/open/floor/plasteel,
/area/ruin/space/has_grav/storage/power2)
"ct" = (
/obj/structure/closet/cardboard/metal,
/obj/item/storage/toolbox/mechanical,
/obj/item/storage/toolbox/mechanical,
/obj/item/storage/toolbox/emergency,
/obj/item/storage/toolbox/electrical,
/obj/item/storage/toolbox/electrical,
/turf/open/floor/plasteel,
/area/ruin/space/has_grav/storage/power1)
"cu" = (
/obj/structure/closet/crate/solarpanel_small,
/turf/open/floor/plasteel,
/area/ruin/space/has_grav/storage/power2)
"cv" = (
/obj/structure/falsewall/reinforced,
/turf/open/floor/plasteel,
/area/ruin/space/has_grav/storage/power2)
"cw" = (
/obj/effect/decal/cleanable/dirt,
/obj/effect/decal/cleanable/dirt,
/turf/open/floor/plasteel,
/area/ruin/space/has_grav/storage/materials2)
"cx" = (
/obj/effect/decal/cleanable/dirt/dust,
/obj/effect/decal/cleanable/dirt,
/turf/open/floor/plasteel,
/area/ruin/space/has_grav/storage/materials2)
"cy" = (
/obj/effect/decal/cleanable/blood/tracks{
	dir = 8;
	icon_state = "tracks"
	},
/obj/effect/decal/cleanable/vomit,
/turf/open/floor/plasteel,
/area/ruin/space/has_grav/storage/central)
"cA" = (
/obj/effect/decal/cleanable/dirt/dust,
/turf/open/floor/plasteel,
/area/ruin/space/has_grav/storage/central)
"cB" = (
/obj/structure/closet/crate,
/obj/effect/spawner/lootdrop/maintenance/two,
/obj/effect/decal/cleanable/generic,
/turf/open/floor/plasteel,
/area/ruin/space/has_grav/storage/central)
"cD" = (
/obj/effect/spawner/lootdrop/glowstick,
/obj/effect/decal/cleanable/glass,
/turf/open/floor/plasteel,
/area/ruin/space/has_grav/storage/central)
"cE" = (
/obj/effect/decal/cleanable/dirt/dust,
/obj/effect/decal/cleanable/dirt/dust,
/turf/open/floor/plasteel,
/area/ruin/space/has_grav/storage/central)
"cH" = (
/obj/item/inducer,
/obj/effect/decal/cleanable/dirt,
/turf/open/floor/plasteel,
/area/ruin/space/has_grav/storage/central)
"cI" = (
/obj/effect/decal/cleanable/dirt,
/obj/effect/decal/cleanable/vomit,
/turf/open/floor/plasteel,
/area/ruin/space/has_grav/storage/central)
"cJ" = (
/obj/effect/decal/cleanable/dirt,
/turf/open/floor/plasteel,
/area/ruin/space/has_grav/storage/central)
"cM" = (
/obj/effect/decal/cleanable/oil,
/turf/open/floor/plasteel,
/area/ruin/space/has_grav/storage/central)
"cN" = (
/obj/effect/decal/cleanable/generic,
/turf/open/floor/plasteel,
/area/ruin/space/has_grav/storage/central)
"cO" = (
/obj/structure/closet/crate/engineering/electrical,
/obj/effect/decal/cleanable/generic,
/turf/open/floor/plasteel,
/area/ruin/space/has_grav/storage/central)
"cP" = (
/obj/effect/decal/cleanable/vomit,
/turf/open/floor/plasteel,
/area/ruin/space/has_grav/storage/power2)
"cQ" = (
/obj/effect/decal/cleanable/dirt,
/turf/open/floor/plasteel,
/area/ruin/space/has_grav/storage/power2)
"cR" = (
/obj/effect/decal/cleanable/oil,
/turf/open/floor/plasteel,
/area/ruin/space/has_grav/storage/power3)
"cS" = (
/obj/machinery/power/port_gen/pacman/super,
/obj/structure/cable,
/obj/effect/decal/cleanable/dirt,
/turf/open/floor/plasteel,
/area/ruin/space/has_grav/storage/power2)
"cT" = (
/obj/effect/decal/cleanable/vomit,
/turf/open/floor/plasteel,
/area/ruin/space/has_grav/storage/power3)
"cU" = (
/obj/structure/closet/crate,
/obj/item/bedsheet/ian,
/obj/item/bedsheet/dorms,
/obj/item/bedsheet/nanotrasen,
/obj/item/bedsheet/centcom,
/obj/item/bedsheet/syndie,
/turf/open/floor/plasteel,
/area/ruin/space/has_grav/storage/power1)
"cV" = (
/obj/effect/decal/cleanable/oil,
/turf/open/floor/plasteel,
/area/ruin/space/has_grav/storage/power1)
"cW" = (
/obj/effect/decal/cleanable/oil,
/turf/open/floor/plasteel,
/area/ruin/space/has_grav/storage/power2)
"fd" = (
/obj/structure/cable{
	icon_state = "4-8"
	},
/turf/open/floor/plasteel,
/area/ruin/space/has_grav/storage/central)
"gD" = (
/obj/machinery/power/apc/auto_name/north{
	pixel_y = 24;
	start_charge = 0
	},
/obj/effect/decal/cleanable/ash,
/obj/structure/cable{
	icon_state = "0-8"
	},
/turf/open/floor/plasteel,
/area/ruin/space/has_grav/storage/materials1)
"gG" = (
/obj/machinery/power/apc/auto_name/west{
	pixel_x = -24;
	start_charge = 0
	},
/obj/structure/cable{
	icon_state = "0-2"
	},
/turf/open/floor/plasteel,
/area/ruin/space/has_grav/storage/power3)
"gS" = (
/obj/effect/decal/cleanable/blood/footprints{
	dir = 1;
	icon_state = "blood1"
	},
/obj/structure/cable{
	icon_state = "1-8"
	},
/obj/structure/cable{
	icon_state = "1-2"
	},
/turf/open/floor/plasteel,
/area/ruin/space/has_grav/storage/central)
"hH" = (
/obj/effect/decal/cleanable/blood/footprints{
	dir = 1;
	icon_state = "blood1"
	},
/turf/open/floor/plasteel,
/area/ruin/space/has_grav/storage/power1)
"ku" = (
/obj/machinery/door/airlock/highsecurity,
/obj/effect/mapping_helpers/airlock/locked,
/obj/structure/cable{
	icon_state = "0-4"
	},
/turf/open/floor/plasteel,
/area/ruin/space/has_grav/storage/power3)
"kv" = (
/obj/structure/cable{
	icon_state = "2-8"
	},
/obj/structure/cable{
	icon_state = "2-4"
	},
/obj/structure/cable{
	icon_state = "4-8"
	},
/turf/closed/wall/r_wall,
/area/ruin/space/has_grav/storage/power2)
"kA" = (
/obj/structure/cable{
	icon_state = "4-8"
	},
/turf/open/floor/plasteel,
/area/ruin/space/has_grav/storage/materials1)
"kD" = (
/obj/machinery/door/airlock/highsecurity,
/obj/effect/decal/cleanable/blood/tracks,
/obj/effect/decal/cleanable/blood/tracks,
/obj/effect/mapping_helpers/airlock/locked,
/obj/structure/cable{
	icon_state = "1-2"
	},
/turf/open/floor/plasteel,
/area/ruin/space/has_grav/storage/materials1)
"lG" = (
/obj/machinery/power/apc/auto_name/east{
	pixel_x = 24;
	start_charge = 0
	},
/obj/effect/decal/cleanable/vomit,
/obj/structure/cable{
	icon_state = "0-8"
	},
/turf/open/floor/plasteel,
/area/ruin/space/has_grav/storage/materials2)
"mg" = (
/obj/structure/cable{
	icon_state = "1-2"
	},
/turf/open/floor/plasteel,
/area/ruin/space/has_grav/storage/central)
"mF" = (
/obj/machinery/power/apc/auto_name/east{
	pixel_x = 24;
	start_charge = 0
	},
/obj/structure/cable{
	icon_state = "0-2"
	},
/turf/open/floor/plasteel,
/area/ruin/space/has_grav/storage/central)
"mI" = (
/obj/structure/cable{
	icon_state = "1-4"
	},
/obj/structure/cable{
	icon_state = "1-8"
	},
/obj/structure/cable{
	icon_state = "4-8"
	},
/turf/open/floor/plasteel,
/area/ruin/space/has_grav/storage/power1)
"oT" = (
/obj/machinery/door/airlock/hatch,
/obj/structure/fans/tiny,
/turf/open/floor/plasteel,
/area/ruin/space/has_grav/storage/central)
"rc" = (
/obj/effect/decal/cleanable/blood/tracks,
/obj/structure/cable{
	icon_state = "1-2"
	},
/turf/open/floor/plasteel,
/area/ruin/space/has_grav/storage/materials1)
"up" = (
/obj/structure/cable{
	icon_state = "4-8"
	},
/turf/closed/wall/r_wall,
/area/ruin/space/has_grav/storage/power2)
"uu" = (
/obj/effect/decal/cleanable/blood/footprints{
	dir = 8;
	icon_state = "blood1"
	},
/obj/structure/cable{
	icon_state = "4-8"
	},
/turf/open/floor/plasteel,
/area/ruin/space/has_grav/storage/power1)
"uX" = (
/obj/machinery/door/airlock/highsecurity,
/obj/effect/decal/cleanable/blood/tracks,
/obj/effect/mapping_helpers/airlock/locked,
/obj/structure/cable{
	icon_state = "1-2"
	},
/turf/open/floor/plasteel,
/area/ruin/space/has_grav/storage/materials1)
"vE" = (
/obj/effect/decal/cleanable/blood/tracks{
	dir = 6;
	icon_state = "tracks"
	},
/obj/structure/cable{
	icon_state = "2-4"
	},
/obj/structure/cable{
	icon_state = "1-2"
	},
/obj/structure/cable{
	icon_state = "1-4"
	},
/turf/open/floor/plasteel,
/area/ruin/space/has_grav/storage/central)
"vJ" = (
/obj/machinery/power/apc/auto_name/west{
	pixel_x = -24;
	start_charge = 0
	},
/obj/structure/cable{
	icon_state = "0-4"
	},
/turf/open/floor/plasteel,
/area/ruin/space/has_grav/storage/materials3)
"ws" = (
/obj/effect/decal/cleanable/dirt,
/obj/structure/cable{
	icon_state = "1-4"
	},
/turf/open/floor/plasteel,
/area/ruin/space/has_grav/storage/central)
"ww" = (
/obj/effect/decal/cleanable/blood/footprints{
	dir = 1;
	icon_state = "blood1"
	},
/obj/structure/cable{
	icon_state = "4-8"
	},
/turf/open/floor/plasteel,
/area/ruin/space/has_grav/storage/power1)
"xi" = (
/obj/machinery/power/smes,
/obj/structure/cable{
	icon_state = "0-8"
	},
/turf/open/floor/plasteel,
/area/ruin/space/has_grav/storage/power2)
"Af" = (
/obj/structure/cable{
	icon_state = "2-8"
	},
/turf/closed/wall/r_wall,
/area/ruin/space/has_grav/storage/central2)
"Ao" = (
/obj/effect/decal/cleanable/ash,
/obj/structure/cable{
	icon_state = "4-8"
	},
/turf/open/floor/plasteel,
/area/ruin/space/has_grav/storage/central)
"Bq" = (
/obj/structure/cable{
	icon_state = "1-2"
	},
/turf/closed/wall/r_wall,
/area/ruin/space/has_grav/storage/central2)
"CD" = (
/obj/effect/decal/cleanable/glass,
/obj/structure/cable{
	icon_state = "1-2"
	},
/turf/open/floor/plasteel,
/area/ruin/space/has_grav/storage/central)
"Im" = (
/obj/machinery/door/airlock/highsecurity,
/obj/effect/mapping_helpers/airlock/locked,
/obj/structure/cable{
	icon_state = "4-8"
	},
/turf/open/floor/plasteel,
/area/ruin/space/has_grav/storage/central)
"In" = (
/obj/machinery/power/apc/auto_name/south{
	pixel_y = -24;
	start_charge = 0
	},
/obj/structure/cable{
	icon_state = "0-4"
	},
/turf/open/floor/plasteel,
/area/ruin/space/has_grav/storage/central2)
"Ir" = (
/obj/structure/cable{
	icon_state = "0-2"
	},
/obj/machinery/power/terminal{
	dir = 1
	},
/turf/open/floor/plasteel,
/area/ruin/space/has_grav/storage/power2)
"KY" = (
/obj/structure/cable{
	icon_state = "1-2"
	},
/turf/open/floor/plasteel,
/area/ruin/space/has_grav/storage/power1)
"Mg" = (
/obj/structure/cable{
	icon_state = "4-8"
	},
/obj/structure/cable{
	icon_state = "2-4"
	},
/obj/structure/cable{
	icon_state = "2-8"
	},
/turf/open/floor/plasteel,
/area/ruin/space/has_grav/storage/materials1)
"Mh" = (
/obj/machinery/power/apc/auto_name/south{
	pixel_y = -24;
	start_charge = 0
	},
/obj/structure/cable{
	icon_state = "0-4"
	},
/turf/open/floor/plasteel,
/area/ruin/space/has_grav/storage/power1)
"Mm" = (
/obj/effect/decal/cleanable/blood/footprints{
	dir = 8;
	icon_state = "blood1"
	},
/obj/structure/cable{
	icon_state = "1-8"
	},
/turf/open/floor/plasteel,
/area/ruin/space/has_grav/storage/power1)
"OO" = (
/obj/machinery/door/airlock/highsecurity,
/obj/effect/decal/cleanable/blood/footprints{
	dir = 1;
	icon_state = "blood1"
	},
/obj/effect/mapping_helpers/airlock/locked,
/obj/structure/cable{
	icon_state = "1-4"
	},
/obj/structure/cable{
	icon_state = "0-4"
	},
/turf/open/floor/plasteel,
/area/ruin/space/has_grav/storage/power1)
"PF" = (
/obj/effect/decal/cleanable/blood/tracks{
	dir = 9;
	icon_state = "tracks"
	},
/obj/effect/decal/cleanable/dirt/dust,
/obj/effect/decal/cleanable/dirt/dust,
/obj/structure/cable{
	icon_state = "1-2"
	},
/turf/open/floor/plasteel,
/area/ruin/space/has_grav/storage/materials1)
"PU" = (
/obj/effect/decal/cleanable/dirt/dust,
/obj/structure/cable{
	icon_state = "1-2"
	},
/turf/open/floor/plasteel,
/area/ruin/space/has_grav/storage/central)
"RB" = (
/obj/structure/cable{
	icon_state = "1-8"
	},
/obj/structure/cable{
	icon_state = "1-2"
	},
/obj/structure/cable{
	icon_state = "2-8"
	},
/turf/open/floor/plasteel,
/area/ruin/space/has_grav/storage/central)
"SY" = (
/obj/machinery/power/apc/auto_name/east{
	pixel_x = 24;
	start_charge = 0
	},
/obj/structure/cable,
/obj/structure/cable{
	icon_state = "0-2"
	},
/turf/open/floor/plasteel,
/area/ruin/space/has_grav/storage/power2)
"Vs" = (
/obj/structure/cable{
	icon_state = "4-8"
	},
/obj/structure/cable{
	icon_state = "2-4"
	},
/obj/structure/cable{
	icon_state = "2-8"
	},
/turf/closed/wall/r_wall,
/area/ruin/space/has_grav/storage/central)
"VV" = (
/turf/open/floor/plating/asteroid/airless,
/area/ruin/space/has_grav)
"VX" = (
/obj/structure/cable{
	icon_state = "4-8"
	},
/turf/closed/wall/r_wall,
/area/ruin/space/has_grav/storage/central)
"Zz" = (
/obj/structure/cable{
	icon_state = "1-8"
	},
/turf/closed/wall/r_wall,
/area/ruin/space/has_grav/storage/power2)

(1,1,1) = {"
aa
aa
aa
aa
aa
aa
aa
aa
aa
aa
aa
aa
aa
ah
ah
ah
VV
ah
ah
ah
ah
aa
aa
aa
aa
aa
aa
aa
aa
aa
"}
(2,1,1) = {"
aa
aa
aa
aa
aa
aa
aa
aa
aa
aa
aa
aa
ah
ah
ah
ah
VV
ah
ah
ah
ah
ah
ah
aa
aa
aa
aa
aa
aa
aa
"}
(3,1,1) = {"
aa
aa
aa
aa
aa
aa
aa
aa
aa
aa
aa
ah
bl
bl
bl
bl
oT
bl
bl
bl
bl
ah
ah
aa
aa
aa
aa
aa
aa
aa
"}
(4,1,1) = {"
aa
aa
aa
aa
aa
ah
ah
aa
aa
ah
ah
ah
bl
bp
bp
bp
bp
bp
bp
bp
bl
ah
ah
ah
aa
aa
aa
aa
aa
aa
"}
(5,1,1) = {"
aa
aa
ah
ah
ah
ah
ah
ah
ah
ah
ah
ah
bl
bp
bp
bp
cH
cJ
bp
cg
bl
ah
ah
ah
ah
ah
ah
aa
aa
aa
"}
(6,1,1) = {"
aa
aa
ah
ah
ah
ah
ah
ah
ah
ah
ah
ah
bl
bq
bp
cD
cI
cJ
cg
bp
bl
ah
ah
ah
ah
ah
ah
ah
aa
aa
"}
(7,1,1) = {"
aa
aa
aa
ah
ab
ab
ab
ab
ab
ab
ab
ah
bl
bq
bp
mF
ws
cJ
cA
bp
bl
aS
aS
aS
aS
aS
aS
ah
ah
aa
"}
(8,1,1) = {"
aa
aa
aa
ah
ab
ac
ac
ac
ac
ac
ab
aY
aY
aY
aY
aY
Im
aY
aY
aY
aY
aT
bG
bG
aU
aU
aS
ah
ah
aa
"}
(9,1,1) = {"
aa
aa
ah
ah
ab
ae
ae
ae
ae
ae
ab
aZ
aY
br
bp
bp
fd
bp
bp
bp
aY
aU
aU
cR
cT
aU
aS
ah
ah
aa
"}
(10,1,1) = {"
aa
ah
ah
ah
ab
ac
ac
ae
ac
ac
ab
bb
aY
bs
bp
bp
fd
cN
cO
bp
aY
aU
aU
aU
aU
aU
aS
ah
ah
aa
"}
(11,1,1) = {"
aa
aa
ah
ah
ab
ab
ab
au
ab
ab
ab
bd
bm
bt
cB
cE
aW
bp
bp
bp
aY
aS
aS
ku
aS
aS
aS
ah
aa
aa
"}
(12,1,1) = {"
aa
aa
ah
ah
ai
ap
vJ
bh
aq
aq
ai
ai
ai
cy
bp
bp
Ao
bp
cD
Mh
aM
aV
gG
mI
cU
aX
aM
ah
ah
aa
"}
(13,1,1) = {"
aa
aa
ah
ah
ai
aq
Mg
PF
rc
rc
uX
rc
kD
vE
CD
PU
RB
PU
mg
gS
OO
hH
hH
ww
cV
aX
aM
ah
ah
ah
"}
(14,1,1) = {"
aa
aa
ah
ah
ai
aq
kA
bT
ch
aI
ai
aq
ai
gD
bp
bp
ca
cN
cM
bp
VX
aX
aX
uu
aX
aX
aM
ah
ah
ah
"}
(15,1,1) = {"
aa
aa
ah
ah
ai
aq
lG
aA
aq
aq
ai
be
aY
cA
bp
cB
bp
ce
bp
ci
Vs
KY
SY
Mm
aX
ct
aM
ah
ah
aa
"}
(16,1,1) = {"
aa
ah
ah
ad
ad
ad
ad
aB
ad
bZ
ad
ad
aY
by
bs
bp
cM
bp
ci
bp
VX
aR
aR
cc
aR
aR
aR
ah
ah
aa
"}
(17,1,1) = {"
aa
ah
ah
ad
af
ak
av
aC
ad
aJ
am
bf
aY
aY
aY
aY
bp
aY
aY
aY
VX
ba
bi
bQ
bi
bi
aR
ah
aa
aa
"}
(18,1,1) = {"
aa
ah
ah
ad
al
am
ad
am
ad
am
am
bf
bk
bz
bz
bk
bH
bk
bz
bz
up
bc
bi
bQ
cQ
bi
aR
ah
ah
aa
"}
(19,1,1) = {"
aa
ah
ah
ad
af
ad
ad
aD
ad
cr
bZ
cq
bk
bk
bk
bk
bC
bk
bk
bk
up
bi
cP
bQ
bi
cu
aR
ah
aa
aa
"}
(20,1,1) = {"
aa
ah
ah
ad
af
ad
aw
bX
aH
aK
ad
cw
bk
bk
bk
bk
bI
bk
bk
bk
up
bi
cQ
cm
cs
cu
aR
ah
ah
aa
"}
(21,1,1) = {"
aa
ah
ah
ad
ao
ad
ax
am
ax
ad
ad
cx
bk
bk
bB
bC
bC
bC
cj
bk
up
bj
bi
cp
cW
cu
aR
ah
ah
aa
"}
(22,1,1) = {"
ah
ah
ah
ad
af
ad
ax
am
ax
ad
ad
am
bk
bk
bC
bC
bC
bC
bC
bk
kv
bx
aR
aR
aR
cv
aR
ah
ah
aa
"}
(23,1,1) = {"
aa
ah
ah
ad
af
ad
ad
bZ
ad
ad
ad
am
bk
bk
bD
bC
bC
bC
ck
bk
up
bE
bi
cQ
cQ
cQ
aR
ah
ah
aa
"}
(24,1,1) = {"
aa
ah
ah
ad
ag
ad
am
aE
am
am
aK
am
bk
bk
bC
bC
bC
bC
bC
bk
up
xi
Ir
cS
cQ
cQ
aR
ah
ah
aa
"}
(25,1,1) = {"
aa
ah
ah
ad
an
ad
am
am
cq
cq
ad
In
bk
bk
bS
bC
cd
bC
cl
bk
up
aR
aR
aR
aR
aR
aR
ah
ah
aa
"}
(26,1,1) = {"
aa
ah
ah
ad
ad
ad
ay
ad
ad
ad
ad
Af
Bq
Bq
Bq
Bq
Bq
Bq
Bq
Bq
Zz
ah
ah
ah
ah
ah
ah
ah
ah
aa
"}
(27,1,1) = {"
aa
ah
ah
ah
ah
ah
ah
ah
ah
ah
ah
ah
bk
bk
bk
bk
bk
bk
bk
bk
aR
ah
ah
aa
ah
ah
ah
aa
aa
aa
"}
(28,1,1) = {"
aa
aa
ah
ah
ah
ah
ah
ah
ah
ah
ah
ah
ah
ah
ah
ah
ah
ah
ah
ah
ah
ah
ah
aa
aa
aa
aa
aa
aa
aa
"}
(29,1,1) = {"
aa
aa
aa
aa
aa
aa
aa
aa
aa
aa
aa
ah
ah
ah
ah
ah
ah
ah
ah
ah
aa
aa
aa
aa
aa
aa
aa
aa
aa
aa
"}
(30,1,1) = {"
aa
aa
aa
aa
aa
aa
aa
aa
aa
aa
aa
aa
aa
aa
ah
ah
ah
ah
aa
aa
aa
aa
aa
aa
aa
aa
aa
aa
aa
aa
"}
