//MAP CONVERTED BY dmm2tgm.py THIS HEADER COMMENT PREVENTS RECONVERSION, DO NOT REMOVE
"a" = (
/turf/open/space/basic,
/area/space)
"b" = (
/turf/closed/mineral,
/area/ruin/space/has_grav)
"c" = (
/obj/machinery/door/airlock/hatch,
/turf/open/floor/plating/airless,
/area/ruin/space/has_grav/powered)
"d" = (
/obj/item/radio/off,
/turf/open/floor/plating/airless,
/area/ruin/space/has_grav/powered)
"e" = (
/mob/living/simple_animal/hostile/asteroid/hivelord,
/turf/open/floor/plating/asteroid/airless,
/area/ruin/space/has_grav)
"f" = (
/obj/item/stack/medical/bruise_pack,
/turf/open/floor/plating/asteroid/airless,
/area/ruin/space/has_grav)
"g" = (
/obj/item/stack/ore/gold{
	amount = 2;
	pixel_x = 13
	},
/turf/open/floor/plating/asteroid/airless,
/area/ruin/space/has_grav)
"h" = (
/obj/item/stack/ore/iron{
	amount = 15;
	pixel_x = 15;
	pixel_y = 5
	},
/obj/item/stack/ore/titanium{
	amount = 10;
	pixel_x = 5;
	pixel_y = -2
	},
/turf/open/floor/plating/asteroid/airless,
/area/ruin/space/has_grav)
"i" = (
/obj/machinery/portable_atmospherics/canister/air,
/turf/open/floor/plating/airless,
/area/ruin/space/has_grav/powered)
"j" = (
/obj/item/stack/ore/iron{
	amount = 20;
	pixel_x = -15;
	pixel_y = 10
	},
/obj/item/stack/ore/silver{
	amount = 5;
	pixel_x = 7;
	pixel_y = -3
	},
/obj/item/stack/ore/diamond{
	pixel_x = 5;
	pixel_y = 10
	},
/obj/item/stack/ore/silver{
	amount = 10;
	pixel_x = 5;
	pixel_y = -10
	},
/turf/open/floor/plating/asteroid/airless,
/area/ruin/space/has_grav)
"l" = (
/obj/item/stack/ore/titanium,
/turf/open/floor/plating/asteroid/airless,
/area/ruin/space/has_grav)
"n" = (
/obj/machinery/portable_atmospherics/pump,
/turf/open/floor/plating/airless,
/area/ruin/space/has_grav/powered)
"o" = (
/turf/closed/wall/rust,
/area/ruin/space/has_grav/powered)
"p" = (
/obj/item/stack/ore/plasma{
	amount = 5;
	pixel_x = -15;
	pixel_y = -10
	},
/obj/item/stack/ore/uranium{
	pixel_x = -10
	},
/obj/item/stack/ore/silver{
	amount = 5;
	pixel_x = 6;
	pixel_y = 5
	},
/turf/open/floor/plating/asteroid/airless,
/area/ruin/space/has_grav)
"q" = (
/obj/machinery/portable_atmospherics/scrubber,
/turf/open/floor/plating/airless,
/area/ruin/space/has_grav/powered)
"t" = (
/obj/item/stack/medical/ointment,
/turf/open/floor/plating/asteroid/airless,
/area/ruin/space/has_grav)
"u" = (
/turf/open/floor/plating/asteroid/airless,
/area/ruin/space/has_grav)
"v" = (
/obj/machinery/portable_atmospherics/canister/oxygen,
/turf/open/floor/plating/airless,
/area/ruin/space/has_grav/powered)
"w" = (
/turf/open/floor/plating/airless,
/area/ruin/space/has_grav/powered)
"y" = (
/obj/item/mining_scanner,
/turf/open/floor/plating/asteroid/airless,
/area/ruin/space/has_grav)
"z" = (
/obj/machinery/power/port_gen/pacman,
/turf/open/floor/plating/airless,
/area/ruin/space/has_grav/powered)
"C" = (
/obj/item/stack/ore/gold{
	amount = 2;
	pixel_x = 13;
	pixel_y = 10
	},
/turf/open/floor/plating/asteroid/airless,
/area/ruin/space/has_grav)
"D" = (
/obj/item/pickaxe/drill,
/turf/open/floor/plating/asteroid/airless,
/area/ruin/space/has_grav)
"I" = (
/obj/effect/decal/cleanable/oil/streak,
/turf/open/floor/plating/airless,
/area/ruin/space/has_grav/powered)
"K" = (
/obj/item/stack/spacecash/c500,
/turf/open/floor/plating/asteroid/airless,
/area/ruin/space/has_grav)
"O" = (
/obj/item/tank/internals/oxygen,
/obj/item/tank/internals/oxygen,
/obj/item/tank/jetpack/improvised,
/turf/open/floor/plating/airless,
/area/ruin/space/has_grav/powered)
"P" = (
/obj/item/stack/sheet/glass/fifty,
/turf/open/floor/plating/airless,
/area/ruin/space/has_grav/powered)
"Q" = (
/turf/closed/mineral/random,
/area/ruin/space/has_grav)
"S" = (
/obj/item/stack/ore/iron{
	amount = 15;
	pixel_x = -10;
	pixel_y = -4
	},
/obj/item/stack/ore/silver{
	amount = 2;
	pixel_x = -16;
	pixel_y = -4
	},
/obj/item/stack/ore/silver{
	amount = 5;
	pixel_x = -9;
	pixel_y = 5
	},
/turf/open/floor/plating/asteroid/airless,
/area/ruin/space/has_grav)
"U" = (
/obj/item/stack/ore/plasma{
	amount = 10;
	pixel_x = -10;
	pixel_y = -10
	},
/turf/open/floor/plating/asteroid/airless,
/area/ruin/space/has_grav)
"W" = (
/obj/structure/door_assembly/door_assembly_hatch,
/obj/effect/decal/cleanable/oil,
/turf/open/floor/plating/airless,
/area/ruin/space/has_grav/powered)
"Y" = (
/obj/item/stack/ore/iron{
	amount = 5;
	pixel_x = -10;
	pixel_y = 3
	},
/obj/item/stack/ore/bluespace_crystal{
	pixel_x = -5;
	pixel_y = 10
	},
/turf/open/floor/plating/asteroid/airless,
/area/ruin/space/has_grav)

(1,1,1) = {"
a
a
a
a
a
a
a
a
a
a
a
a
a
a
a
a
a
a
a
a
"}
(2,1,1) = {"
a
Q
Q
Q
Q
Q
a
Q
Q
Q
Q
Q
a
a
a
a
Q
Q
a
a
"}
(3,1,1) = {"
a
Q
Q
Q
Q
Q
a
Q
Q
Q
Q
Q
Q
Q
a
b
Q
Q
a
a
"}
(4,1,1) = {"
a
Q
Q
Q
Q
Q
b
Q
Q
Q
Q
Q
Q
Q
Q
Q
Q
Q
a
a
"}
(5,1,1) = {"
a
Q
Q
Q
Q
Q
b
Q
Q
Q
Q
Q
Q
Q
Q
Q
Q
Q
a
a
"}
(6,1,1) = {"
a
Q
Q
Q
Q
Q
b
Q
Q
Q
Q
Q
Q
Q
Q
Q
Q
Q
Q
Q
"}
(7,1,1) = {"
a
Q
Q
u
u
y
u
Q
Q
Q
Q
Q
Q
Q
Q
Q
Q
Q
Q
Q
"}
(8,1,1) = {"
a
Q
Q
u
u
D
e
u
u
u
u
f
u
u
u
u
Q
Q
Q
Q
"}
(9,1,1) = {"
a
Q
Q
Q
Q
Q
h
l
C
u
f
t
u
y
D
u
Q
Q
Q
Q
"}
(10,1,1) = {"
a
Q
Q
Q
Q
Q
p
j
g
u
u
u
K
e
u
u
Q
Q
Q
Q
"}
(11,1,1) = {"
a
a
a
Q
Q
Q
U
S
Y
u
u
u
u
Q
Q
Q
Q
Q
Q
Q
"}
(12,1,1) = {"
a
a
a
Q
Q
Q
Q
Q
o
o
o
W
o
o
o
Q
Q
Q
Q
Q
"}
(13,1,1) = {"
a
a
a
Q
Q
Q
Q
Q
o
w
P
I
i
i
o
Q
Q
Q
b
a
"}
(14,1,1) = {"
a
a
a
Q
Q
Q
Q
Q
o
w
w
w
q
n
o
Q
Q
Q
b
a
"}
(15,1,1) = {"
a
a
a
Q
Q
Q
Q
Q
o
w
w
w
d
w
o
Q
Q
Q
b
a
"}
(16,1,1) = {"
a
a
Q
Q
Q
Q
Q
Q
o
w
w
w
w
O
o
Q
Q
Q
b
a
"}
(17,1,1) = {"
a
a
Q
Q
Q
Q
Q
Q
o
z
w
w
w
v
o
Q
a
a
a
a
"}
(18,1,1) = {"
a
a
Q
Q
Q
Q
Q
Q
o
o
o
c
o
o
o
Q
a
a
a
a
"}
(19,1,1) = {"
a
a
Q
Q
Q
a
a
a
a
a
a
a
a
a
a
a
a
a
a
a
"}
(20,1,1) = {"
a
a
a
a
a
a
a
a
a
a
a
a
a
a
a
a
a
a
a
a
"}
