//MAP CONVERTED BY dmm2tgm.py THIS HEADER COMMENT PREVENTS RECONVERSION, DO NOT REMOVE
"au" = (
/turf/open/space/basic,
/area/space)
"aC" = (
/obj/structure/sign/plaques/kiddie{
	desc = "TODAY: KEPLER 453B";
	name = "Exhibit";
	pixel_y = 14
	},
/turf/open/floor/carpet/nanoweave/purple,
/area/space)
"bq" = (
/obj/structure/window/reinforced/spawner{
	dir = 4
	},
/obj/item/paper{
	pixel_x = 10;
	pixel_y = -7
	},
/obj/structure/table/wood/fancy/blue,
/turf/open/floor/carpet/royalblue,
/area/space)
"bu" = (
/turf/open/floor/carpet/nanoweave/purple{
	initial_gas_mix = "TEMP=2.7"
	},
/area/space)
"bz" = (
/obj/structure/railing{
	dir = 1
	},
/obj/effect/turf_decal/industrial/warning{
	dir = 1
	},
/turf/open/floor/plating/airless,
/area/space)
"do" = (
/obj/structure/window/reinforced/spawner,
/obj/item/gun/ballistic/automatic/pistol/solgov,
/obj/item/paper{
	pixel_x = 10;
	pixel_y = -7
	},
/turf/open/floor/carpet/royalblue,
/area/space)
"dE" = (
/obj/structure/window/reinforced/spawner{
	dir = 8
	},
/obj/structure/window/reinforced/spawner,
/obj/item/desk_flag/solgov,
/turf/open/floor/carpet/royalblue,
/area/space)
"es" = (
/turf/open/floor/plating/airless{
	icon_state = "platingdmg1"
	},
/area/space)
"et" = (
/obj/structure/sign/poster/official/solgov_enlist{
	pixel_y = -32
	},
/turf/open/floor/carpet/nanoweave/purple,
/area/space)
"eu" = (
/obj/structure/window/reinforced/spawner{
	dir = 1
	},
/obj/item/gun/ballistic/automatic/ak47{
	pixel_x = -6
	},
/obj/item/paper{
	pixel_x = 10;
	pixel_y = -7
	},
/turf/open/floor/grass/fakebasalt,
/area/space)
"eO" = (
/obj/structure/door_assembly/door_assembly_sgv,
/turf/open/floor/plating/airless,
/area/space)
"gv" = (
/obj/machinery/door/airlock/solgov/glass,
/obj/effect/mapping_helpers/airlock/locked,
/turf/open/floor/carpet/nanoweave/purple,
/area/space)
"gP" = (
/obj/structure/railing{
	dir = 4
	},
/turf/open/floor/carpet/nanoweave/red{
	initial_gas_mix = "TEMP=2.7"
	},
/area/space)
"gQ" = (
/obj/structure/table/wood/fancy/orange,
/obj/item/gun/ballistic/rifle/boltaction/polymer,
/obj/item/paper{
	pixel_x = 10;
	pixel_y = -7
	},
/obj/structure/sign/poster/official/nanotrasen_logo{
	pixel_x = -32
	},
/turf/open/floor/grass/fakebasalt{
	icon = 'whitesands/icons/turf/floors/whitesands/ws_floors.dmi';
	icon_plating = "sand";
	icon_state = "sand"
	},
/area/space)
"gT" = (
/obj/structure/railing{
	dir = 4
	},
/turf/open/floor/plating/airless,
/area/space)
"ic" = (
/turf/open/floor/carpet/nanoweave/beige,
/area/space)
"il" = (
/obj/structure/statue/petrified,
/obj/structure/sign/plaques/kiddie{
	desc = "2100 - 2400";
	name = "Exhibit";
	pixel_y = 32
	},
/obj/structure/table/wood/fancy/blue,
/obj/item/clothing/under/solgov/formal/terragov{
	pixel_y = -2
	},
/obj/item/clothing/shoes/jackboots{
	pixel_x = -3;
	pixel_y = -9
	},
/obj/item/clothing/suit/toggle/solgov/terragov,
/obj/item/clothing/head/solgov/terragov{
	pixel_y = 14
	},
/turf/open/floor/carpet/royalblue,
/area/space)
"iH" = (
/obj/effect/spawner/structure/window/reinforced,
/turf/open/floor/plating,
/area/space)
"ju" = (
/obj/structure/table/wood/reinforced,
/turf/open/floor/carpet/nanoweave/beige,
/area/space)
"kj" = (
/turf/open/floor/carpet/nanoweave/red{
	initial_gas_mix = "TEMP=2.7"
	},
/area/space)
"kp" = (
/obj/effect/turf_decal/arrows,
/turf/open/floor/carpet/nanoweave/purple,
/area/space)
"kK" = (
/obj/structure/window/reinforced/spawner{
	dir = 8
	},
/obj/item/ammo_box/magazine/pistol556mm,
/obj/item/paper{
	pixel_x = 10;
	pixel_y = -7
	},
/obj/structure/table/wood/fancy/blue,
/turf/open/floor/carpet/royalblue,
/area/space)
"kU" = (
/obj/structure/window/reinforced/spawner{
	dir = 4
	},
/turf/open/floor/grass/fakebasalt{
	icon = 'whitesands/icons/turf/floors/whitesands/ws_floors.dmi';
	icon_plating = "sand";
	icon_state = "sand"
	},
/area/space)
"la" = (
/obj/structure/table/wood/fancy/orange,
/obj/item/spear/grey_tide,
/obj/item/paper{
	pixel_x = 10;
	pixel_y = -7
	},
/obj/structure/sign/poster/official/pda_ad{
	pixel_x = -32
	},
/turf/open/floor/grass/fakebasalt{
	icon = 'whitesands/icons/turf/floors/whitesands/ws_floors.dmi';
	icon_plating = "sand";
	icon_state = "sand"
	},
/area/space)
"mn" = (
/obj/structure/fluff/broken_flooring{
	dir = 4;
	icon_state = "singular"
	},
/turf/open/space/basic,
/area/space)
"ns" = (
/turf/open/floor/plating/airless{
	icon_state = "platingdmg2"
	},
/area/space)
"nU" = (
/obj/structure/railing{
	dir = 5
	},
/turf/open/floor/carpet/nanoweave/red{
	initial_gas_mix = "TEMP=2.7"
	},
/area/space)
"ou" = (
/obj/structure/fluff/broken_flooring{
	dir = 8;
	icon_state = "singular"
	},
/turf/open/floor/plating/airless,
/area/space)
"ov" = (
/obj/structure/table/glass,
/obj/item/storage/firstaid/ancient,
/obj/item/paper{
	pixel_x = 10;
	pixel_y = -7
	},
/obj/structure/sign/poster/retro/nanotrasen_logo_70s{
	pixel_x = 32
	},
/turf/open/floor/plastic,
/area/space)
"oH" = (
/obj/structure/window/reinforced/spawner{
	dir = 8
	},
/obj/structure/window/reinforced/spawner{
	dir = 1
	},
/turf/open/floor/fakepit,
/area/space)
"pH" = (
/obj/structure/girder/displaced,
/turf/open/floor/plating/airless,
/area/space)
"qG" = (
/obj/structure/fluff/broken_flooring{
	icon_state = "singular"
	},
/turf/open/floor/plating/airless{
	icon_state = "platingdmg1"
	},
/area/space)
"qH" = (
/obj/structure/window/reinforced/spawner{
	dir = 1
	},
/obj/structure/window/reinforced/spawner{
	dir = 4
	},
/obj/structure/statue{
	desc = "A lifelike statue of a horrifying monster.";
	dir = 4;
	icon = 'icons/mob/lavaland/lavaland_monsters.dmi';
	icon_state = "goliath";
	name = "goliath"
	},
/obj/item/paper{
	pixel_x = 10;
	pixel_y = -7
	},
/turf/open/floor/grass/fakebasalt{
	icon = 'whitesands/icons/turf/floors/whitesands/ws_floors.dmi';
	icon_plating = "sand";
	icon_state = "sand"
	},
/area/space)
"qI" = (
/obj/structure/statue/petrified,
/obj/item/clothing/under/solgov,
/obj/item/clothing/head/helmet/solgov{
	pixel_y = 11
	},
/obj/item/clothing/suit/armor/vest/solgov{
	pixel_x = -3;
	pixel_y = -5
	},
/obj/structure/sign/plaques/kiddie{
	desc = "2400 - Today";
	name = "Exhibit";
	pixel_y = 32
	},
/obj/item/clothing/gloves/combat,
/obj/structure/table/wood/fancy/blue,
/obj/item/clothing/shoes/jackboots{
	pixel_x = -3;
	pixel_y = -9
	},
/turf/open/floor/carpet/royalblue,
/area/space)
"qJ" = (
/obj/structure/table/wood/fancy/red,
/obj/structure/statue/petrified,
/obj/item/clothing/under/costume/soviet{
	pixel_y = -2
	},
/obj/item/clothing/suit/armor/vest/russian,
/obj/item/clothing/head/ushanka{
	pixel_x = 1;
	pixel_y = 12
	},
/obj/structure/sign/poster/retro/nanotrasen_logo_80s{
	pixel_y = -32
	},
/obj/item/clothing/shoes/jackboots{
	pixel_x = -3;
	pixel_y = -9
	},
/turf/open/floor/grass/fakebasalt,
/area/space)
"rh" = (
/obj/structure/window/reinforced/spawner{
	dir = 1
	},
/obj/structure/window/reinforced/spawner{
	dir = 4
	},
/turf/open/floor/fakepit,
/area/space)
"rv" = (
/obj/structure/railing{
	dir = 1
	},
/turf/open/floor/plating/airless,
/area/space)
"sz" = (
/obj/effect/turf_decal/arrows{
	dir = 8;
	pixel_y = 15
	},
/turf/open/floor/carpet/nanoweave/purple,
/area/space)
"sA" = (
/obj/structure/table/wood/fancy/red,
/obj/item/seeds/lavaland/cactus,
/obj/item/paper{
	pixel_x = 10;
	pixel_y = -7
	},
/turf/open/floor/grass/fakebasalt,
/area/space)
"sC" = (
/obj/structure/window/reinforced/spawner{
	dir = 1
	},
/obj/structure/window/reinforced/spawner{
	dir = 8
	},
/obj/item/scalpel{
	icon = 'icons/obj/surgery.dmi'
	},
/turf/open/floor/plastic,
/area/space)
"sI" = (
/obj/item/paper{
	pixel_x = 10;
	pixel_y = -7
	},
/obj/structure/table/wood/fancy/blue,
/turf/open/floor/carpet/royalblue,
/area/space)
"sW" = (
/obj/structure/railing{
	dir = 4
	},
/obj/effect/turf_decal/industrial/warning{
	dir = 4
	},
/turf/open/floor/plating/airless,
/area/space)
"tx" = (
/turf/open/floor/carpet/nanoweave/purple,
/area/space)
"ty" = (
/obj/structure/table/glass,
/obj/item/storage/firstaid/brute{
	icon = 'icons/obj/storage.dmi'
	},
/obj/item/paper{
	pixel_x = 10;
	pixel_y = -7
	},
/turf/open/floor/plastic,
/area/space)
"tO" = (
/obj/structure/table/wood/fancy/red,
/obj/item/ammo_box/magazine/ak47,
/obj/item/paper{
	pixel_x = 10;
	pixel_y = -7
	},
/turf/open/floor/grass/fakebasalt,
/area/space)
"ue" = (
/obj/structure/lattice,
/obj/structure/fluff/broken_flooring{
	icon_state = "singular"
	},
/turf/open/space/basic,
/area/space)
"uU" = (
/turf/open/floor/plasteel/airless,
/area/space)
"vm" = (
/obj/structure/rack,
/obj/item/clothing/head/solgov{
	armor = null;
	armor_list = null;
	name = "Collectable SolGov officer's cap"
	},
/obj/item/clothing/head/solgov{
	armor = null;
	armor_list = null;
	name = "Collectable SolGov officer's cap";
	pixel_x = 3;
	pixel_y = 3
	},
/turf/open/floor/carpet/nanoweave/beige,
/area/space)
"vS" = (
/obj/structure/table/wood/fancy/orange,
/obj/structure/statue/petrified,
/obj/item/clothing/under/color/random{
	pixel_y = -2
	},
/obj/item/clothing/shoes/workboots/mining{
	pixel_x = -2;
	pixel_y = -10
	},
/obj/item/clothing/suit/hooded/explorer,
/obj/item/clothing/mask/gas/explorer{
	pixel_y = 7
	},
/turf/open/floor/grass/fakebasalt{
	icon = 'whitesands/icons/turf/floors/whitesands/ws_floors.dmi';
	icon_plating = "sand";
	icon_state = "sand"
	},
/area/space)
"wd" = (
/obj/structure/table/wood/reinforced,
/obj/item/desk_flag/solgov,
/turf/open/floor/carpet/nanoweave/beige,
/area/space)
"wq" = (
/obj/structure/table/glass,
/obj/item/storage/firstaid/toxin{
	icon = 'icons/obj/storage.dmi'
	},
/obj/item/paper{
	pixel_x = 10;
	pixel_y = -7
	},
/obj/structure/sign/poster/retro/pdaancient{
	pixel_x = 32
	},
/turf/open/floor/plastic,
/area/space)
"wP" = (
/obj/structure/fluff/broken_flooring{
	dir = 8;
	icon_state = "singular"
	},
/turf/open/space/basic,
/area/space)
"wQ" = (
/obj/structure/girder,
/turf/open/floor/plating/airless{
	icon_state = "platingdmg2"
	},
/area/space)
"xq" = (
/obj/structure/table,
/turf/open/floor/plasteel/airless,
/area/space)
"xG" = (
/obj/structure/fluff/broken_flooring{
	icon_state = "singular"
	},
/turf/open/space/basic,
/area/space)
"zk" = (
/turf/open/floor/plating/airless{
	icon_state = "platingdmg3"
	},
/area/space)
"zu" = (
/obj/structure/lattice,
/obj/structure/fluff/broken_flooring,
/turf/open/space/basic,
/area/space)
"Ap" = (
/obj/structure/table/wood/fancy/red,
/obj/structure/statue/petrified,
/obj/item/clothing/head/helmet/rus_ushanka{
	pixel_y = 11
	},
/obj/item/clothing/under/syndicate/camo{
	pixel_y = -2
	},
/obj/item/clothing/shoes/russian{
	pixel_x = -1;
	pixel_y = -11
	},
/obj/item/clothing/suit/armor/vest/alt,
/obj/structure/sign/poster/contraband/communist_state{
	pixel_y = -32
	},
/turf/open/floor/grass/fakebasalt,
/area/space)
"AU" = (
/obj/structure/railing{
	dir = 1
	},
/turf/open/floor/carpet/nanoweave/red{
	initial_gas_mix = "TEMP=2.7"
	},
/area/space)
"BK" = (
/obj/structure/window/reinforced/spawner{
	dir = 1
	},
/obj/item/gun/ballistic/rifle/boltaction,
/obj/item/paper{
	pixel_x = 10;
	pixel_y = -7
	},
/turf/open/floor/grass/fakebasalt,
/area/space)
"BZ" = (
/obj/structure/girder,
/turf/open/floor/plating/airless{
	icon_state = "platingdmg1"
	},
/area/space)
"Ce" = (
/obj/structure/window/reinforced/spawner,
/obj/structure/window/reinforced/spawner{
	dir = 4
	},
/obj/item/desk_flag/solgov,
/turf/open/floor/carpet/royalblue,
/area/space)
"DA" = (
/obj/structure/fluff/broken_flooring,
/turf/open/floor/plating/airless{
	icon_state = "platingdmg3"
	},
/area/space)
"DE" = (
/obj/structure/fluff/broken_flooring{
	dir = 4;
	icon_state = "singular"
	},
/turf/open/floor/plating/airless{
	icon_state = "platingdmg1"
	},
/area/space)
"Ee" = (
/obj/structure/window/reinforced/spawner{
	dir = 4
	},
/obj/structure/table/wood/fancy/red,
/obj/item/ammo_box/a762,
/obj/item/paper{
	pixel_x = 10;
	pixel_y = -7
	},
/turf/open/floor/grass/fakebasalt,
/area/space)
"Er" = (
/obj/structure/window/reinforced/spawner{
	dir = 8
	},
/obj/structure/table/wood/fancy/red,
/obj/item/flashlight/lantern,
/obj/item/paper{
	pixel_x = 10;
	pixel_y = -7
	},
/turf/open/floor/grass/fakebasalt,
/area/space)
"Ev" = (
/obj/structure/table/glass,
/obj/item/storage/firstaid/fire{
	icon = 'icons/obj/storage.dmi'
	},
/obj/item/paper{
	pixel_x = 10;
	pixel_y = -7
	},
/turf/open/floor/plastic,
/area/space)
"GF" = (
/obj/structure/fluff/broken_flooring,
/turf/open/space/basic,
/area/space)
"Hl" = (
/obj/structure/fluff/broken_flooring{
	dir = 1;
	icon_state = "singular"
	},
/obj/structure/lattice,
/turf/open/space/basic,
/area/space)
"Ia" = (
/obj/structure/window/reinforced/spawner,
/obj/item/gun/energy/laser/terra,
/obj/item/paper{
	pixel_x = 10;
	pixel_y = -7
	},
/turf/open/floor/carpet/royalblue,
/area/space)
"Ik" = (
/obj/structure/railing{
	dir = 4
	},
/obj/effect/turf_decal/industrial/warning{
	dir = 6
	},
/turf/open/floor/plating/airless{
	icon_state = "platingdmg1"
	},
/area/space)
"Ip" = (
/obj/machinery/door/window{
	dir = 4
	},
/turf/open/floor/carpet/nanoweave/beige,
/area/space)
"IH" = (
/obj/structure/fluff/broken_flooring{
	icon_state = "singular"
	},
/obj/structure/lattice,
/turf/open/space/basic,
/area/space)
"Ji" = (
/obj/effect/turf_decal/industrial/warning,
/turf/open/floor/plating/airless{
	icon_state = "platingdmg2"
	},
/area/space)
"Jv" = (
/turf/closed/wall,
/area/space)
"JR" = (
/obj/structure/fluff/broken_flooring{
	dir = 1;
	icon_state = "singular"
	},
/turf/open/space/basic,
/area/space)
"Ld" = (
/obj/structure/statue/petrified,
/obj/structure/sign/plaques/kiddie{
	desc = "1945 - 2100";
	name = "Exhibit";
	pixel_y = 32
	},
/obj/item/clothing/under/syndicate/camo,
/obj/item/clothing/suit/armor/bulletproof,
/obj/structure/table/wood/fancy/blue,
/obj/item/clothing/shoes/jackboots{
	pixel_x = -3;
	pixel_y = -9
	},
/turf/open/floor/carpet/royalblue,
/area/space)
"Nn" = (
/obj/structure/table/wood/fancy/red,
/obj/structure/statue/petrified,
/obj/item/clothing/under/costume/gladiator/ash_walker,
/obj/item/clothing/head/helmet/gladiator{
	pixel_y = 14
	},
/obj/structure/sign/poster/contraband/syndicate{
	pixel_y = -32
	},
/turf/open/floor/grass/fakebasalt,
/area/space)
"NM" = (
/obj/structure/window/reinforced/spawner{
	dir = 8
	},
/obj/item/circular_saw{
	icon = 'icons/obj/surgery.dmi'
	},
/turf/open/floor/plastic,
/area/space)
"NW" = (
/obj/structure/window/reinforced/spawner{
	dir = 8
	},
/obj/item/cautery{
	icon = 'icons/obj/surgery.dmi'
	},
/turf/open/floor/plastic,
/area/space)
"OB" = (
/obj/structure/lattice,
/obj/structure/fluff/broken_flooring{
	dir = 1;
	icon_state = "singular"
	},
/turf/open/space/basic,
/area/space)
"Pd" = (
/obj/structure/window/reinforced/spawner,
/obj/item/paper{
	pixel_x = 10;
	pixel_y = -7
	},
/turf/open/floor/carpet/royalblue,
/area/space)
"Pu" = (
/obj/structure/lattice,
/turf/open/space/basic,
/area/space)
"QH" = (
/obj/machinery/door/airlock/solgov,
/obj/effect/mapping_helpers/airlock/locked,
/turf/open/floor/carpet/nanoweave/purple,
/area/space)
"QK" = (
/obj/structure/girder/displaced,
/turf/open/floor/plating/airless{
	icon_state = "platingdmg2"
	},
/area/space)
"RC" = (
/obj/structure/window/reinforced/spawner{
	dir = 8
	},
/obj/item/hemostat{
	icon = 'icons/obj/surgery.dmi'
	},
/turf/open/floor/plastic,
/area/space)
"RQ" = (
/obj/structure/lattice,
/obj/structure/fluff/broken_flooring{
	dir = 4;
	icon_state = "singular"
	},
/turf/open/space/basic,
/area/space)
"So" = (
/obj/structure/window/reinforced/spawner{
	dir = 1
	},
/turf/open/floor/fakepit,
/area/space)
"TK" = (
/obj/structure/table/wood/reinforced,
/obj/item/paper_bin/carbon,
/obj/item/pen/solgov,
/turf/open/floor/carpet/nanoweave/beige,
/area/space)
"TR" = (
/obj/structure/window/reinforced/spawner{
	dir = 8
	},
/obj/item/retractor{
	icon = 'icons/obj/surgery.dmi'
	},
/turf/open/floor/plastic,
/area/space)
"Us" = (
/obj/structure/girder,
/turf/open/floor/plating/airless,
/area/space)
"UM" = (
/obj/structure/window/reinforced/spawner,
/obj/item/desk_flag/solgov,
/turf/open/floor/carpet/royalblue,
/area/space)
"Wk" = (
/turf/open/floor/plating/airless,
/area/space)
"Wp" = (
/obj/structure/window/reinforced/spawner,
/obj/structure/window/reinforced/spawner{
	dir = 8
	},
/obj/structure/table/optable,
/turf/open/floor/plastic,
/area/space)
"WO" = (
/obj/structure/fluff/broken_flooring{
	dir = 8;
	icon_state = "singular"
	},
/obj/structure/lattice,
/turf/open/space/basic,
/area/space)
"WU" = (
/obj/structure/table/wood/fancy/orange,
/obj/structure/statue/petrified,
/obj/item/clothing/under/color/grey{
	pixel_y = -2
	},
/obj/item/clothing/shoes/sneakers/black{
	pixel_x = -3;
	pixel_y = -13
	},
/obj/item/clothing/head/hardhat/red{
	pixel_y = 10
	},
/obj/item/clothing/mask/gas{
	pixel_y = 9
	},
/turf/open/floor/grass/fakebasalt{
	icon = 'whitesands/icons/turf/floors/whitesands/ws_floors.dmi';
	icon_plating = "sand";
	icon_state = "sand"
	},
/area/space)
"Xx" = (
/obj/effect/turf_decal/industrial/warning,
/turf/open/floor/plating/airless,
/area/space)
"XC" = (
/obj/structure/railing{
	dir = 1
	},
/obj/effect/turf_decal/industrial/warning{
	dir = 1
	},
/turf/open/floor/plating/airless{
	icon_state = "platingdmg3"
	},
/area/space)
"YF" = (
/obj/structure/fluff/broken_flooring{
	dir = 4
	},
/obj/structure/lattice,
/turf/open/space/basic,
/area/space)
"YW" = (
/obj/structure/window/reinforced/spawner{
	dir = 1
	},
/obj/item/fireaxe/boneaxe,
/obj/item/paper{
	pixel_x = 10;
	pixel_y = -7
	},
/turf/open/floor/grass/fakebasalt,
/area/space)
"ZH" = (
/obj/structure/window/reinforced/spawner,
/obj/structure/window/reinforced/spawner{
	dir = 4
	},
/obj/structure/statue{
	desc = "A lifelike statue of a horrifying monster.";
	dir = 4;
	icon = 'icons/mob/lavaland/lavaland_monsters.dmi';
	icon_state = "legion";
	name = "legion"
	},
/obj/item/paper{
	pixel_x = 10;
	pixel_y = -7
	},
/turf/open/floor/grass/fakebasalt{
	icon = 'whitesands/icons/turf/floors/whitesands/ws_floors.dmi';
	icon_plating = "sand";
	icon_state = "sand"
	},
/area/space)

(1,1,1) = {"
au
au
au
au
au
au
au
au
au
au
au
au
au
au
au
au
au
au
au
au
au
au
au
au
au
au
au
au
au
au
au
au
au
au
au
au
au
au
au
au
au
au
au
au
au
au
au
au
au
au
"}
(2,1,1) = {"
au
au
au
au
au
au
au
au
au
au
au
au
au
au
au
au
au
au
au
au
au
au
au
au
au
au
au
au
au
au
au
au
au
au
au
au
au
au
au
au
au
au
au
au
au
au
au
au
au
au
"}
(3,1,1) = {"
au
au
au
au
au
au
au
au
au
au
au
au
au
au
au
au
au
au
au
au
au
au
au
au
au
au
au
au
au
au
au
au
au
au
au
au
au
au
au
au
au
au
au
au
au
au
au
au
au
au
"}
(4,1,1) = {"
au
au
au
au
au
au
au
au
au
au
au
au
au
au
au
au
au
au
au
au
au
au
au
au
au
au
au
au
au
au
au
au
au
au
au
au
au
au
au
au
au
au
au
au
au
au
au
au
au
au
"}
(5,1,1) = {"
au
au
au
au
au
au
au
au
au
au
au
au
au
au
au
au
au
au
au
au
au
au
au
au
au
au
au
au
au
au
au
au
au
au
au
au
au
au
au
au
au
au
au
au
au
au
au
au
au
au
"}
(6,1,1) = {"
au
au
au
au
au
au
au
au
au
au
au
au
au
au
au
au
au
au
au
au
au
au
au
au
au
au
au
au
au
au
au
au
au
au
au
au
au
au
au
au
au
au
au
au
au
au
au
au
au
au
"}
(7,1,1) = {"
au
au
au
au
au
au
au
au
au
au
au
au
au
au
au
au
au
au
au
au
au
au
au
au
au
au
au
au
au
au
au
au
au
au
au
au
au
au
au
au
au
au
au
au
au
au
au
au
au
au
"}
(8,1,1) = {"
au
au
au
au
au
au
au
au
au
au
au
au
au
au
au
au
au
au
au
au
au
au
au
au
au
au
au
au
au
au
au
au
au
au
au
au
au
au
au
au
au
au
au
au
au
au
au
au
au
au
"}
(9,1,1) = {"
au
au
au
au
au
au
au
au
au
au
au
au
au
au
au
au
au
au
au
au
au
au
au
au
au
au
au
au
au
au
au
au
au
au
au
au
au
au
au
au
au
au
au
au
au
au
au
au
au
au
"}
(10,1,1) = {"
au
au
au
au
au
au
au
au
au
au
au
au
au
au
au
au
au
au
au
au
au
au
au
au
au
au
au
au
au
au
au
au
au
au
au
au
au
au
au
au
au
au
au
au
au
au
au
au
au
au
"}
(11,1,1) = {"
au
au
au
au
au
au
au
au
au
au
au
au
au
au
au
au
au
au
au
au
au
au
au
au
au
au
au
au
au
au
au
au
au
au
au
au
au
au
au
au
au
au
au
au
au
au
au
au
au
au
"}
(12,1,1) = {"
au
au
au
au
au
au
au
au
au
au
au
au
au
au
au
au
au
au
au
au
au
au
au
au
au
au
au
au
au
au
au
au
au
au
au
au
au
au
au
au
au
au
au
au
au
au
au
au
au
au
"}
(13,1,1) = {"
au
au
au
au
au
au
au
au
au
au
au
au
au
au
au
au
au
au
au
au
au
au
au
au
au
au
au
au
au
au
au
au
au
au
au
au
au
au
au
au
au
au
au
au
au
au
au
au
au
au
"}
(14,1,1) = {"
au
au
au
au
au
au
au
au
au
au
au
au
au
au
au
au
au
au
au
au
au
au
au
au
au
au
au
au
au
au
au
au
au
au
au
au
au
au
au
au
au
au
au
au
au
au
au
au
au
au
"}
(15,1,1) = {"
au
au
au
au
au
au
au
Wk
xG
au
ns
au
au
au
au
mn
au
au
mn
zu
ns
Jv
Jv
Jv
Jv
Jv
Jv
au
au
au
au
au
au
au
au
au
au
au
au
au
au
au
au
au
au
au
au
au
au
au
"}
(16,1,1) = {"
au
au
au
au
au
au
au
au
Pu
au
DE
Pu
au
au
au
au
au
au
Hl
uU
Jv
wQ
gQ
vS
WU
la
Jv
Jv
au
au
au
au
au
au
au
au
au
au
au
au
au
au
au
au
au
au
au
au
au
au
"}
(17,1,1) = {"
au
au
au
IH
Pu
ns
Pu
Wk
ue
es
Pu
Wk
au
xG
JR
au
QK
Us
Jv
Jv
Jv
qH
kU
kU
kU
kU
ZH
Jv
au
au
au
au
au
au
au
au
au
au
au
au
au
au
au
au
au
au
au
au
au
au
"}
(18,1,1) = {"
au
au
Pu
Wk
Wk
ou
Ji
rv
es
Pu
WO
Wk
au
au
au
ns
uU
Jv
bu
bu
Jv
tx
tx
tx
aC
tx
tx
Jv
au
au
au
au
au
au
au
au
au
au
au
au
au
au
au
au
au
au
au
au
au
au
"}
(19,1,1) = {"
au
au
XC
Wk
es
Wk
Xx
AU
Pu
es
Wk
Pu
au
au
zu
bu
Pu
xq
bu
bu
QH
tx
tx
tx
tx
tx
et
Jv
au
au
au
au
au
au
au
au
au
au
au
au
au
au
au
au
au
au
au
au
au
au
"}
(20,1,1) = {"
au
au
bz
es
Wk
Wk
Ji
kj
kj
Pu
kj
Pu
au
Pu
pH
OB
es
xq
bu
bu
Jv
tx
tx
tx
sz
tx
tx
Jv
au
au
au
au
au
au
au
au
au
au
au
au
au
au
au
au
au
au
au
au
au
au
"}
(21,1,1) = {"
au
au
bz
Pu
zk
Wk
Xx
es
kj
kj
kj
kj
eO
bu
es
bu
uU
xq
bu
bu
Jv
kK
dE
tx
tx
oH
Er
Jv
au
au
au
au
au
au
au
au
au
au
au
au
au
au
au
au
au
au
au
au
au
au
"}
(22,1,1) = {"
au
au
bz
ns
Wk
es
Xx
AU
kj
kj
kj
kj
Jv
uU
bu
bu
uU
xq
bu
bu
Jv
qI
do
tx
sz
YW
Nn
Jv
au
au
au
au
au
au
au
au
au
au
au
au
au
au
au
au
au
au
au
au
au
au
"}
(23,1,1) = {"
au
au
Pu
sW
sW
sW
Ik
AU
kj
kj
kj
kj
Jv
uU
bu
bu
uU
pH
bu
bu
Jv
sI
UM
tx
tx
So
sA
Jv
au
au
au
au
au
au
au
au
au
au
au
au
au
au
au
au
au
au
au
au
au
au
"}
(24,1,1) = {"
au
au
au
au
au
au
au
nU
gT
gP
es
gP
Jv
Jv
gv
gv
Jv
Jv
Jv
Jv
Jv
il
Ia
tx
sz
eu
Ap
Jv
au
au
au
au
au
au
au
au
au
au
au
au
au
au
au
au
au
au
au
au
au
au
"}
(25,1,1) = {"
au
au
au
au
au
au
au
au
au
au
au
au
au
Jv
tx
tx
ic
TK
ic
vm
Jv
sI
UM
tx
tx
So
tO
Jv
au
au
au
au
au
au
au
au
au
au
au
au
au
au
au
au
au
au
au
au
au
au
"}
(26,1,1) = {"
au
au
au
au
au
au
au
au
au
au
au
au
au
iH
tx
tx
ic
ju
ic
ic
Jv
Ld
Pd
tx
sz
BK
qJ
Jv
au
au
au
au
au
au
au
au
au
au
au
au
au
au
au
au
au
au
au
au
au
au
"}
(27,1,1) = {"
au
au
au
au
au
au
au
au
au
au
au
au
au
iH
tx
tx
ic
ju
wd
Ip
Jv
bq
Ce
tx
tx
rh
Ee
Jv
au
au
au
au
au
au
au
au
au
au
au
au
au
au
au
au
au
au
au
au
au
au
"}
(28,1,1) = {"
au
au
au
au
au
au
au
au
au
au
au
au
au
iH
tx
tx
ic
ic
ic
ic
Jv
tx
tx
tx
sz
tx
tx
Jv
au
au
au
au
au
au
au
au
au
au
au
au
au
au
au
au
au
au
au
au
au
au
"}
(29,1,1) = {"
au
au
au
au
au
au
au
au
au
au
au
au
au
iH
tx
tx
tx
tx
tx
tx
QH
kp
kp
kp
tx
tx
et
Jv
au
au
au
au
au
au
au
au
au
au
au
au
au
au
au
au
au
au
au
au
au
au
"}
(30,1,1) = {"
au
au
au
au
au
au
au
au
au
au
au
au
au
iH
tx
tx
ic
ic
ic
ic
Jv
tx
tx
tx
tx
tx
tx
Jv
au
au
au
au
au
au
au
au
au
au
au
au
au
au
au
au
au
au
au
au
au
au
"}
(31,1,1) = {"
au
au
au
au
au
au
au
au
au
au
au
au
au
Jv
tx
tx
Jv
Jv
Jv
Jv
Jv
sC
RC
NW
TR
NM
Wp
Jv
au
au
au
au
au
au
au
au
au
au
au
au
au
au
au
au
au
au
au
au
au
au
"}
(32,1,1) = {"
au
au
au
au
au
au
au
au
au
au
au
au
Pu
Jv
gv
gv
Jv
GF
es
uU
QK
Jv
ov
ty
Ev
wq
Jv
Jv
au
au
au
au
au
au
au
au
au
au
au
au
au
au
au
au
au
au
au
au
au
au
"}
(33,1,1) = {"
au
au
au
au
au
au
au
au
au
au
au
au
au
RQ
zk
tx
ns
Pu
Wk
au
au
BZ
Jv
Jv
Jv
Jv
Jv
au
au
au
au
au
au
au
au
au
au
au
au
au
au
au
au
au
au
au
au
au
au
au
"}
(34,1,1) = {"
au
au
au
au
au
au
au
au
au
au
au
au
au
Wk
zu
zk
Pu
qG
au
au
Pu
Wk
ue
zu
uU
uU
Wk
au
au
au
au
au
au
au
au
au
au
au
au
au
au
au
au
au
au
au
au
au
au
au
"}
(35,1,1) = {"
au
au
au
au
au
au
au
au
au
au
au
au
au
au
uU
tx
YF
au
au
JR
au
au
Wk
uU
DA
ns
au
au
au
au
au
au
au
au
au
au
au
au
au
au
au
au
au
au
au
au
au
au
au
au
"}
(36,1,1) = {"
au
au
au
au
au
au
au
au
au
au
au
au
au
au
tx
au
au
au
wP
au
au
ns
RQ
au
Wk
Pu
au
au
au
au
au
au
au
au
au
au
au
au
au
au
au
au
au
au
au
au
au
au
au
au
"}
(37,1,1) = {"
au
au
au
au
au
au
au
au
au
au
au
au
au
au
au
au
au
au
au
au
au
au
au
au
au
au
au
au
au
au
au
au
au
au
au
au
au
au
au
au
au
au
au
au
au
au
au
au
au
au
"}
(38,1,1) = {"
au
au
au
au
au
au
au
au
au
au
au
au
au
au
au
au
au
au
au
au
au
au
au
au
au
au
au
au
au
au
au
au
au
au
au
au
au
au
au
au
au
au
au
au
au
au
au
au
au
au
"}
(39,1,1) = {"
au
au
au
au
au
au
au
au
au
au
au
au
au
au
au
au
au
au
au
au
au
au
au
au
au
au
au
au
au
au
au
au
au
au
au
au
au
au
au
au
au
au
au
au
au
au
au
au
au
au
"}
(40,1,1) = {"
au
au
au
au
au
au
au
au
au
au
au
au
au
au
au
au
au
au
au
au
au
au
au
au
au
au
au
au
au
au
au
au
au
au
au
au
au
au
au
au
au
au
au
au
au
au
au
au
au
au
"}
(41,1,1) = {"
au
au
au
au
au
au
au
au
au
au
au
au
au
au
au
au
au
au
au
au
au
au
au
au
au
au
au
au
au
au
au
au
au
au
au
au
au
au
au
au
au
au
au
au
au
au
au
au
au
au
"}
(42,1,1) = {"
au
au
au
au
au
au
au
au
au
au
au
au
au
au
au
au
au
au
au
au
au
au
au
au
au
au
au
au
au
au
au
au
au
au
au
au
au
au
au
au
au
au
au
au
au
au
au
au
au
au
"}
(43,1,1) = {"
au
au
au
au
au
au
au
au
au
au
au
au
au
au
au
au
au
au
au
au
au
au
au
au
au
au
au
au
au
au
au
au
au
au
au
au
au
au
au
au
au
au
au
au
au
au
au
au
au
au
"}
(44,1,1) = {"
au
au
au
au
au
au
au
au
au
au
au
au
au
au
au
au
au
au
au
au
au
au
au
au
au
au
au
au
au
au
au
au
au
au
au
au
au
au
au
au
au
au
au
au
au
au
au
au
au
au
"}
(45,1,1) = {"
au
au
au
au
au
au
au
au
au
au
au
au
au
au
au
au
au
au
au
au
au
au
au
au
au
au
au
au
au
au
au
au
au
au
au
au
au
au
au
au
au
au
au
au
au
au
au
au
au
au
"}
(46,1,1) = {"
au
au
au
au
au
au
au
au
au
au
au
au
au
au
au
au
au
au
au
au
au
au
au
au
au
au
au
au
au
au
au
au
au
au
au
au
au
au
au
au
au
au
au
au
au
au
au
au
au
au
"}
(47,1,1) = {"
au
au
au
au
au
au
au
au
au
au
au
au
au
au
au
au
au
au
au
au
au
au
au
au
au
au
au
au
au
au
au
au
au
au
au
au
au
au
au
au
au
au
au
au
au
au
au
au
au
au
"}
(48,1,1) = {"
au
au
au
au
au
au
au
au
au
au
au
au
au
au
au
au
au
au
au
au
au
au
au
au
au
au
au
au
au
au
au
au
au
au
au
au
au
au
au
au
au
au
au
au
au
au
au
au
au
au
"}
(49,1,1) = {"
au
au
au
au
au
au
au
au
au
au
au
au
au
au
au
au
au
au
au
au
au
au
au
au
au
au
au
au
au
au
au
au
au
au
au
au
au
au
au
au
au
au
au
au
au
au
au
au
au
au
"}
(50,1,1) = {"
au
au
au
au
au
au
au
au
au
au
au
au
au
au
au
au
au
au
au
au
au
au
au
au
au
au
au
au
au
au
au
au
au
au
au
au
au
au
au
au
au
au
au
au
au
au
au
au
au
au
"}
