//MAP CONVERTED BY dmm2tgm.py THIS HEADER COMMENT PREVENTS RECONVERSION, DO NOT REMOVE
"a" = (
/turf/template_noop,
/area/template_noop)
"b" = (
/obj/structure/flora/ausbushes/sunnybush,
/turf/open/floor/plating/asteroid/sand/jungle,
/area/template_noop)
"c" = (
/obj/structure/flora/ausbushes/reedbush,
/turf/open/water/jungle,
/area/template_noop)
"d" = (
/obj/effect/turf_decal/siding/wood{
	dir = 8
	},
/obj/effect/turf_decal/siding/wood/corner{
	dir = 8
	},
/obj/effect/turf_decal/siding/wood/corner,
/turf/open/water/jungle,
/area/template_noop)
"f" = (
/obj/structure/flora/junglebush/large,
/turf/open/floor/plating/asteroid/dirt/jungle/dark,
/area/template_noop)
"j" = (
/obj/structure/closet/crate/wooden,
/obj/item/fishing_hook,
/obj/item/bait_can/worm,
/turf/open/floor/plating/asteroid/dirt/jungle/dark,
/area/template_noop)
"m" = (
/turf/open/water/jungle,
/area/template_noop)
"n" = (
/obj/structure/flora/ausbushes/stalkybush{
	pixel_x = 10;
	pixel_y = 15
	},
/turf/open/water/jungle,
/area/template_noop)
"q" = (
/obj/structure/flora/ausbushes/sparsegrass,
/turf/open/floor/plating/asteroid/sand/jungle,
/area/template_noop)
"s" = (
/obj/structure/closet/crate/freezer,
/obj/structure/fluff/beach_umbrella/cap,
/obj/item/storage/cans/sixbeer,
/obj/item/fish/trout,
/obj/item/storage/cans/sixbeer,
/turf/open/floor/plating/asteroid/sand/jungle,
/area/template_noop)
"u" = (
/turf/open/floor/plating/asteroid/dirt/jungle/dark,
/area/template_noop)
"v" = (
/obj/structure/flora/grass/jungle,
/turf/open/floor/plating/asteroid/dirt/jungle/dark,
/area/template_noop)
"w" = (
/obj/structure/flora/junglebush/c,
/turf/open/floor/plating/asteroid/dirt/jungle/dark,
/area/template_noop)
"x" = (
/obj/structure/flora/ausbushes/fullgrass,
/turf/open/floor/plating/asteroid/sand/jungle,
/area/template_noop)
"y" = (
/obj/structure/flora/ausbushes/stalkybush{
	name = "reeds"
	},
/obj/structure/flora/ausbushes/stalkybush{
	pixel_x = 10;
	pixel_y = 15
	},
/turf/open/water/jungle,
/area/template_noop)
"B" = (
/obj/structure/flora/ausbushes/stalkybush{
	name = "reeds"
	},
/obj/structure/flora/ausbushes/stalkybush{
	pixel_x = -5;
	pixel_y = 17
	},
/turf/open/water/jungle,
/area/template_noop)
"C" = (
/obj/structure/flora/ausbushes/stalkybush{
	name = "reeds"
	},
/obj/structure/flora/ausbushes/stalkybush{
	pixel_x = 3;
	pixel_y = 10
	},
/turf/open/water/jungle,
/area/template_noop)
"D" = (
/obj/effect/turf_decal/siding/wood{
	dir = 4
	},
/obj/effect/turf_decal/siding/wood{
	dir = 8
	},
/obj/item/fishing_line,
/turf/open/floor/wood/jungleplanet,
/area/template_noop)
"E" = (
/obj/structure/flora/grass/jungle/b,
/turf/open/floor/plating/asteroid/dirt/jungle/dark,
/area/template_noop)
"H" = (
/obj/structure/flora/ausbushes/stalkybush{
	name = "reeds"
	},
/obj/effect/turf_decal/siding/wood{
	dir = 8
	},
/obj/effect/turf_decal/siding/wood{
	dir = 4
	},
/obj/effect/turf_decal/siding/wood/corner,
/obj/effect/turf_decal/siding/wood/corner{
	dir = 8
	},
/obj/effect/turf_decal/siding/wood/corner{
	dir = 1
	},
/obj/effect/turf_decal/siding/wood/corner{
	dir = 4
	},
/turf/open/water/jungle,
/area/template_noop)
"K" = (
/mob/living/simple_animal/crab{
	name = "crayfish"
	},
/turf/open/water/jungle,
/area/template_noop)
"L" = (
/obj/structure/flora/junglebush,
/turf/open/floor/plating/asteroid/dirt/jungle/dark,
/area/template_noop)
"M" = (
/obj/item/fishing_rod,
/turf/open/floor/plating/asteroid/dirt/jungle/dark,
/area/template_noop)
"S" = (
/obj/structure/chair/wood{
	dir = 1
	},
/obj/item/book/fish_catalog,
/turf/open/floor/plating/asteroid/dirt/jungle/dark,
/area/template_noop)
"T" = (
/turf/open/floor/plating/asteroid/sand/jungle,
/area/template_noop)
"U" = (
/obj/structure/flora/ausbushes/stalkybush{
	name = "reeds"
	},
/turf/open/water/jungle,
/area/template_noop)
"Y" = (
/obj/effect/overlay/palmtree_r,
/turf/open/floor/plating/asteroid/sand/jungle,
/area/template_noop)
"Z" = (
/obj/structure/flora/ausbushes/stalkybush{
	pixel_x = 3;
	pixel_y = 10
	},
/turf/open/water/jungle,
/area/template_noop)

(1,1,1) = {"
a
L
b
T
q
u
a
a
"}
(2,1,1) = {"
f
q
m
m
Z
x
E
a
"}
(3,1,1) = {"
T
m
n
m
B
T
v
E
"}
(4,1,1) = {"
D
H
d
c
m
U
q
T
"}
(5,1,1) = {"
q
m
y
K
m
m
M
S
"}
(6,1,1) = {"
u
x
Z
m
C
Z
j
s
"}
(7,1,1) = {"
a
E
Y
m
Z
q
T
w
"}
(8,1,1) = {"
a
v
E
T
q
T
E
a
"}
