//MAP CONVERTED BY dmm2tgm.py THIS HEADER COMMENT PREVENTS RECONVERSION, DO NOT REMOVE
"a" = (
/turf/open/floor/plating/asteroid/dirt/grass/jungle/yellow,
/area/template_noop)
"g" = (
/obj/effect/decal/cleanable/dirt/dust,
/obj/effect/decal/cleanable/vomit/old,
/obj/effect/mob_spawn/animal_corpse/junglefowl,
/turf/open/floor/plating/asteroid/dirt/grass/jungle/yellow,
/area/template_noop)
"k" = (
/obj/effect/decal/cleanable/dirt/dust,
/turf/open/floor/plating/asteroid/dirt/wasteland,
/area/template_noop)
"p" = (
/turf/template_noop,
/area/template_noop)
"r" = (
/obj/effect/decal/cleanable/dirt/dust,
/obj/effect/decal/cleanable/glass/strange,
/turf/open/floor/plating/asteroid/dirt/wasteland,
/area/template_noop)
"s" = (
/obj/effect/anomaly/tvstatic/blackbox,
/obj/effect/decal/cleanable/dirt/dust,
/obj/structure/flora/rock/pile,
/obj/effect/decal/cleanable/glass/strange,
/obj/effect/decal/cleanable/robot_debris/down,
/turf/open/floor/plating/asteroid/dirt/wasteland,
/area/template_noop)
"x" = (
/obj/effect/decal/cleanable/dirt/dust,
/obj/effect/decal/cleanable/vomit/old,
/turf/open/floor/plating/asteroid/dirt/grass/jungle/yellow,
/area/template_noop)
"D" = (
/obj/effect/decal/cleanable/vomit/old,
/obj/effect/mob_spawn/animal_corpse/junglefowl,
/turf/open/floor/plating/asteroid/dirt/grass/jungle/yellow,
/area/template_noop)
"K" = (
/obj/effect/decal/cleanable/dirt/dust,
/obj/effect/mob_spawn/animal_corpse/junglefowl,
/turf/open/floor/plating/asteroid/dirt/grass/jungle/yellow,
/area/template_noop)
"M" = (
/obj/structure/flora/tree/dead/tall,
/obj/effect/decal/cleanable/glass/strange,
/obj/effect/decal/cleanable/vomit/old,
/obj/effect/mob_spawn/animal_corpse/junglefowl,
/turf/open/floor/plating/asteroid/dirt/grass/jungle/yellow,
/area/template_noop)
"P" = (
/obj/effect/decal/cleanable/dirt/dust,
/obj/effect/decal/cleanable/glass/strange,
/obj/effect/mob_spawn/animal_corpse/junglefowl,
/turf/open/floor/plating/asteroid/dirt/wasteland,
/area/template_noop)
"R" = (
/obj/effect/decal/cleanable/dirt/dust,
/obj/effect/decal/cleanable/glass/strange,
/obj/effect/mob_spawn/animal_corpse/junglefowl,
/turf/open/floor/plating/asteroid/dirt/grass/jungle/yellow,
/area/template_noop)
"V" = (
/obj/effect/decal/cleanable/dirt/dust,
/turf/open/floor/plating/asteroid/dirt/grass/jungle/yellow,
/area/template_noop)
"Y" = (
/obj/effect/decal/cleanable/dirt/dust,
/obj/structure/flora/rock/pile/largejungle,
/obj/effect/decal/cleanable/glass/strange,
/turf/open/floor/plating/asteroid/dirt/wasteland,
/area/template_noop)
"Z" = (
/obj/structure/flora/tree/dead/tall,
/turf/open/floor/plating/asteroid/dirt/grass/jungle/yellow,
/area/template_noop)

(1,1,1) = {"
Z
g
V
a
a
p
p
"}
(2,1,1) = {"
a
Y
P
k
a
D
p
"}
(3,1,1) = {"
p
K
k
k
r
p
p
"}
(4,1,1) = {"
p
x
k
s
k
a
p
"}
(5,1,1) = {"
p
p
k
k
R
V
a
"}
(6,1,1) = {"
p
p
p
p
a
M
p
"}
(7,1,1) = {"
p
p
p
p
p
a
p
"}
