//MAP CONVERTED BY dmm2tgm.py THIS HEADER COMMENT PREVENTS RECONVERSION, DO NOT REMOVE
"a" = (
/obj/structure/flora/grass/jungle/b,
/obj/structure/spacevine/dense,
/turf/open/floor/plating/asteroid/dirt/jungle/dark,
/area/template_noop)
"c" = (
/obj/effect/turf_decal/siding/thinplating{
	dir = 6
	},
/obj/effect/decal/cleanable/glass,
/turf/open/floor/plating/airless,
/area/template_noop)
"d" = (
/obj/structure/spacevine/weak,
/turf/closed/wall,
/area/template_noop)
"e" = (
/obj/structure/flora/grass/jungle/b,
/obj/structure/spacevine/weak,
/obj/item/stack/ore/salvage/scrapmetal,
/turf/open/floor/plating/asteroid/dirt/jungle/dark,
/area/template_noop)
"f" = (
/obj/structure/poddoor_assembly/shutters,
/obj/effect/decal/cleanable/glass,
/turf/open/floor/plasteel/tech/techmaint/airless,
/area/template_noop)
"h" = (
/obj/structure/flora/grass/jungle/b,
/obj/structure/spacevine/weak,
/turf/open/floor/plating/asteroid/dirt/jungle/dark,
/area/template_noop)
"j" = (
/obj/effect/decal/cleanable/glass,
/obj/item/stack/ore/salvage/scrapmetal,
/turf/open/floor/plasteel/tech/techmaint/airless,
/area/template_noop)
"l" = (
/obj/machinery/power/terminal{
	dir = 4
	},
/obj/structure/cable{
	icon_state = "0-8"
	},
/obj/structure/poddoor_assembly/shutters,
/turf/open/floor/plating/airless,
/area/template_noop)
"n" = (
/obj/structure/spacevine/weak,
/turf/open/floor/plating/asteroid/dirt/jungle/dark,
/area/template_noop)
"o" = (
/turf/template_noop,
/area/template_noop)
"p" = (
/obj/machinery/power/smes/shuttle/precharged{
	dir = 8
	},
/obj/structure/cable{
	icon_state = "0-4"
	},
/obj/structure/window/reinforced{
	dir = 4
	},
/obj/structure/spacevine/dense,
/turf/open/floor/plating/airless,
/area/template_noop)
"q" = (
/obj/structure/chair/comfy/shuttle,
/turf/open/floor/plasteel/tech/techmaint/airless,
/area/template_noop)
"r" = (
/turf/closed/wall,
/area/template_noop)
"s" = (
/obj/effect/gibspawner/human,
/obj/effect/decal/cleanable/glass,
/turf/open/floor/plasteel/tech/grid/airless,
/area/template_noop)
"w" = (
/obj/structure/chair/comfy/shuttle,
/obj/item/stack/ore/salvage/scrapmetal,
/turf/open/floor/plasteel/tech/techmaint/airless,
/area/template_noop)
"z" = (
/obj/effect/turf_decal/siding/thinplating{
	dir = 5
	},
/obj/effect/decal/cleanable/glass,
/turf/open/floor/plating/airless,
/area/template_noop)
"B" = (
/obj/machinery/power/shuttle/engine/electric{
	dir = 8
	},
/obj/structure/cable{
	icon_state = "0-8"
	},
/obj/structure/spacevine/dense,
/turf/open/floor/plating/airless,
/area/template_noop)
"C" = (
/obj/structure/flora/grass/jungle/b,
/obj/structure/spacevine/dense,
/obj/effect/decal/cleanable/glass,
/turf/open/floor/plating/asteroid/dirt/jungle/dark,
/area/template_noop)
"E" = (
/obj/structure/cable{
	icon_state = "2-4"
	},
/turf/open/floor/plating/airless,
/area/template_noop)
"G" = (
/obj/structure/spacevine/weak,
/obj/item/stack/ore/salvage/scrapmetal,
/turf/open/floor/plating/asteroid/dirt/jungle/dark,
/area/template_noop)
"H" = (
/obj/effect/abstract/turf_fire/small/magical,
/obj/effect/decal/cleanable/glass,
/turf/open/floor/plating/asteroid/dirt/jungle/dark,
/area/template_noop)
"I" = (
/obj/structure/spacevine/dense,
/turf/closed/wall,
/area/template_noop)
"K" = (
/obj/structure/spacevine/weak,
/obj/effect/decal/cleanable/glass,
/turf/open/floor/plating/asteroid/dirt/jungle/dark,
/area/template_noop)
"L" = (
/obj/structure/flora/grass/jungle,
/obj/structure/spacevine/dense,
/obj/effect/decal/cleanable/glass,
/obj/item/stack/ore/salvage/scrapmetal,
/turf/open/floor/plating/asteroid/dirt/jungle/dark,
/area/template_noop)
"M" = (
/turf/closed/mineral/random/jungle,
/area/template_noop)
"N" = (
/obj/effect/abstract/turf_fire/small/magical,
/turf/open/floor/plating/asteroid/dirt/jungle/dark,
/area/template_noop)
"O" = (
/obj/structure/spacevine/dense,
/turf/open/floor/plating/asteroid/dirt/jungle/dark,
/area/template_noop)
"P" = (
/obj/structure/flora/grass/jungle,
/turf/open/floor/plating/asteroid/dirt/jungle/dark,
/area/template_noop)
"Q" = (
/obj/machinery/door/poddoor/shutters/preopen{
	dir = 4;
	id = "frontiepod1"
	},
/obj/effect/decal/cleanable/glass,
/turf/open/floor/plasteel/tech/grid/airless,
/area/template_noop)
"R" = (
/obj/machinery/power/terminal{
	dir = 4
	},
/obj/structure/cable{
	icon_state = "0-8"
	},
/obj/effect/gibspawner/human,
/turf/open/floor/plating/airless,
/area/template_noop)
"T" = (
/obj/effect/gibspawner/human,
/obj/effect/decal/cleanable/glass,
/turf/open/floor/plating/airless,
/area/template_noop)
"U" = (
/obj/structure/flora/grass/jungle/b,
/obj/structure/spacevine/weak,
/obj/effect/decal/cleanable/glass,
/turf/open/floor/plating/asteroid/dirt/jungle/dark,
/area/template_noop)
"V" = (
/obj/structure/chair/comfy/shuttle,
/obj/machinery/light/broken/directional/north,
/turf/open/floor/plasteel/tech/techmaint/airless,
/area/template_noop)
"Y" = (
/obj/structure/spacevine/weak,
/turf/closed/mineral/random/jungle,
/area/template_noop)
"Z" = (
/obj/structure/cable{
	icon_state = "2-4"
	},
/obj/structure/cable{
	icon_state = "1-2"
	},
/turf/open/floor/plating/airless,
/area/template_noop)

(1,1,1) = {"
o
M
M
M
M
M
M
M
o
"}
(2,1,1) = {"
M
M
T
M
M
M
M
M
M
"}
(3,1,1) = {"
M
M
Q
Q
s
M
M
M
M
"}
(4,1,1) = {"
o
r
q
z
c
M
Y
Y
M
"}
(5,1,1) = {"
o
r
V
f
j
M
Y
Y
Y
"}
(6,1,1) = {"
o
r
w
E
Z
Y
Y
Y
o
"}
(7,1,1) = {"
o
r
r
R
l
Y
Y
N
o
"}
(8,1,1) = {"
a
N
I
p
p
I
e
N
o
"}
(9,1,1) = {"
L
C
I
B
B
I
U
h
o
"}
(10,1,1) = {"
K
N
I
h
N
d
H
n
o
"}
(11,1,1) = {"
o
O
a
e
N
n
n
o
o
"}
(12,1,1) = {"
o
o
P
H
N
G
o
o
o
"}
