//MAP CONVERTED BY dmm2tgm.py THIS HEADER COMMENT PREVENTS RECONVERSION, DO NOT REMOVE
"a" = (
/obj/structure/flora/grass/jungle/b,
/turf/open/floor/plating/asteroid/dirt/grass/jungle/dark,
/area/template_noop)
"b" = (
/obj/structure/flora/tree/jungle/small,
/turf/open/floor/plating/asteroid/dirt/grass/jungle/dark,
/area/template_noop)
"c" = (
/obj/structure/flora/grass/jungle/b,
/turf/open/floor/plating/asteroid/dirt/jungle/dark,
/area/template_noop)
"h" = (
/obj/structure/flora/tree/jungle/small,
/obj/structure/flora/grass/jungle,
/turf/open/floor/plating/asteroid/dirt/grass/jungle/dark,
/area/template_noop)
"l" = (
/obj/structure/flora/grass/jungle,
/obj/structure/flora/ausbushes/ppflowers,
/turf/open/floor/plating/asteroid/dirt/grass/jungle/dark,
/area/template_noop)
"m" = (
/mob/living/simple_animal/hostile/retaliate/chicken,
/turf/open/floor/plating/asteroid/dirt/jungle/dark,
/area/template_noop)
"q" = (
/mob/living/simple_animal/hostile/retaliate/chicken,
/turf/open/floor/plating/asteroid/dirt/grass/jungle/dark,
/area/template_noop)
"s" = (
/obj/structure/flora/junglebush,
/turf/open/floor/plating/asteroid/dirt/grass/jungle/dark,
/area/template_noop)
"u" = (
/turf/template_noop,
/area/template_noop)
"B" = (
/obj/structure/flora/rock/pile/largejungle,
/obj/structure/flora/rock{
	pixel_y = 4
	},
/obj/item/food/grown/poppy/lily{
	pixel_y = 13;
	pixel_x = 7
	},
/turf/open/floor/plating/asteroid/dirt/jungle/dark,
/area/template_noop)
"D" = (
/obj/structure/flora/grass/jungle,
/obj/structure/flora/ausbushes/brflowers,
/turf/open/floor/plating/asteroid/dirt/grass/jungle/dark,
/area/template_noop)
"E" = (
/obj/structure/flora/junglebush/b,
/turf/open/floor/plating/asteroid/dirt/grass/jungle/dark,
/area/template_noop)
"J" = (
/turf/open/floor/plating/asteroid/dirt/grass/jungle/dark,
/area/template_noop)
"P" = (
/obj/structure/flora/grass/jungle,
/mob/living/simple_animal/hostile/retaliate/chicken,
/turf/open/floor/plating/asteroid/dirt/jungle/dark,
/area/template_noop)
"Q" = (
/obj/structure/flora/grass/jungle,
/turf/open/floor/plating/asteroid/dirt/grass/jungle/dark,
/area/template_noop)
"U" = (
/obj/structure/flora/grass/jungle/b,
/obj/structure/flora/ausbushes/brflowers,
/turf/open/floor/plating/asteroid/dirt/grass/jungle/dark,
/area/template_noop)
"X" = (
/turf/open/floor/plating/asteroid/dirt/jungle/dark,
/area/template_noop)
"Z" = (
/obj/structure/flora/ausbushes/ppflowers,
/turf/open/floor/plating/asteroid/dirt/jungle/dark,
/area/template_noop)

(1,1,1) = {"
u
u
u
J
b
U
u
u
u
"}
(2,1,1) = {"
u
J
s
Q
a
J
Q
s
u
"}
(3,1,1) = {"
u
h
a
Z
m
c
X
b
Q
"}
(4,1,1) = {"
a
a
X
X
B
X
c
l
E
"}
(5,1,1) = {"
J
E
D
P
c
Z
q
s
J
"}
(6,1,1) = {"
u
u
b
s
X
a
a
J
u
"}
(7,1,1) = {"
u
u
a
a
J
b
u
u
u
"}
