//MAP CONVERTED BY dmm2tgm.py THIS HEADER COMMENT PREVENTS RECONVERSION, DO NOT REMOVE
"a" = (
/obj/effect/turf_decal/industrial/warning{
	dir = 5
	},
/obj/effect/decal/cleanable/dirt/dust,
/turf/open/floor/concrete/slab_1/jungleplanet,
/area/template_noop)
"b" = (
/obj/effect/turf_decal/industrial/warning{
	dir = 9
	},
/obj/effect/decal/cleanable/dirt/dust,
/turf/open/floor/concrete/slab_1/jungleplanet,
/area/template_noop)
"f" = (
/obj/structure/hazard/radioactive/stack,
/turf/open/space/basic,
/area/template_noop)
"g" = (
/obj/effect/turf_decal/industrial/warning{
	dir = 6
	},
/obj/effect/decal/cleanable/dirt/dust,
/turf/open/floor/concrete/slab_1/jungleplanet,
/area/template_noop)
"j" = (
/obj/structure/spacevine/dead,
/turf/open/floor/plating/asteroid/dirt/wasteland,
/area/template_noop)
"k" = (
/obj/effect/mob_spawn/animal_corpse/monkey,
/obj/effect/decal/cleanable/dirt/dust,
/turf/open/floor/plating/asteroid/dirt/wasteland,
/area/template_noop)
"l" = (
/turf/closed/mineral/random/jungle/polluted,
/area/template_noop)
"m" = (
/obj/structure/flora/grass/rockplanet/dead,
/obj/effect/decal/cleanable/dirt/dust,
/obj/structure/spacevine/dead,
/turf/open/floor/plating/asteroid/dirt/wasteland,
/area/template_noop)
"n" = (
/obj/structure/flora/grass/rockplanet/dead,
/turf/open/floor/plating/asteroid/dirt/wasteland,
/area/template_noop)
"o" = (
/obj/effect/decal/cleanable/dirt/dust,
/obj/structure/spacevine/dead,
/turf/open/floor/plating/asteroid/dirt/wasteland,
/area/template_noop)
"q" = (
/obj/effect/turf_decal/industrial/warning{
	dir = 1
	},
/obj/effect/decal/cleanable/dirt/dust,
/turf/open/floor/concrete/slab_1/jungleplanet,
/area/template_noop)
"t" = (
/obj/effect/anomaly/heartbeat/planetary{
	pixel_y = 2
	},
/obj/effect/decal/cleanable/dirt/dust,
/obj/effect/decal/cleanable/greenglow/filled,
/turf/open/floor/concrete/slab_1/jungleplanet,
/area/template_noop)
"w" = (
/turf/template_noop,
/area/template_noop)
"y" = (
/obj/effect/turf_decal/industrial/warning/cee{
	dir = 8
	},
/obj/effect/decal/cleanable/dirt/dust,
/turf/open/floor/concrete/slab_1/jungleplanet,
/area/template_noop)
"z" = (
/obj/effect/decal/cleanable/dirt/dust,
/obj/structure/spacevine/dead,
/turf/open/water/jungle,
/area/template_noop)
"B" = (
/obj/structure/spacevine/dead,
/turf/open/water/jungle,
/area/template_noop)
"D" = (
/obj/effect/turf_decal/industrial/warning/corner,
/obj/effect/turf_decal/industrial/warning/corner{
	dir = 4
	},
/obj/effect/decal/cleanable/dirt/dust,
/turf/open/floor/concrete/slab_1/jungleplanet,
/area/template_noop)
"H" = (
/obj/effect/decal/cleanable/greenglow/filled,
/turf/open/water/jungle,
/area/template_noop)
"I" = (
/obj/structure/hazard/radioactive/waste,
/obj/structure/spacevine/dead,
/turf/open/water/jungle,
/area/template_noop)
"J" = (
/obj/effect/decal/cleanable/dirt/dust,
/turf/open/water/jungle,
/area/template_noop)
"K" = (
/obj/structure/flora/grass/rockplanet/dead,
/obj/effect/decal/cleanable/dirt/dust,
/turf/open/floor/plating/asteroid/dirt/wasteland,
/area/template_noop)
"M" = (
/obj/effect/turf_decal/industrial/warning,
/obj/effect/decal/cleanable/dirt/dust,
/turf/open/floor/concrete/slab_1/jungleplanet,
/area/template_noop)
"O" = (
/obj/structure/spacevine/dead,
/turf/closed/mineral/random/jungle/polluted,
/area/template_noop)
"R" = (
/obj/effect/turf_decal/industrial/warning/corner{
	dir = 1
	},
/obj/effect/turf_decal/industrial/warning/corner{
	dir = 8
	},
/obj/effect/decal/cleanable/dirt/dust,
/turf/open/floor/concrete/slab_1/jungleplanet,
/area/template_noop)
"S" = (
/obj/effect/turf_decal/industrial/warning{
	dir = 10
	},
/obj/effect/decal/cleanable/dirt/dust,
/obj/effect/decal/cleanable/dirt/dust,
/turf/open/floor/concrete/slab_1/jungleplanet,
/area/template_noop)
"T" = (
/obj/effect/decal/cleanable/greenglow/filled,
/turf/open/floor/plating/asteroid/dirt/wasteland,
/area/template_noop)
"U" = (
/obj/effect/turf_decal/industrial/warning/cee{
	dir = 4
	},
/obj/effect/decal/cleanable/dirt/dust,
/obj/structure/spacevine/dead,
/turf/open/floor/concrete/slab_1/jungleplanet,
/area/template_noop)
"W" = (
/turf/open/floor/plating/asteroid/dirt/wasteland,
/area/template_noop)
"Y" = (
/obj/effect/decal/cleanable/dirt/dust,
/turf/open/floor/plating/asteroid/dirt/wasteland,
/area/template_noop)

(1,1,1) = {"
w
w
l
l
l
l
l
w
w
w
"}
(2,1,1) = {"
w
l
l
O
l
H
l
l
w
w
"}
(3,1,1) = {"
w
l
O
I
z
z
J
n
w
w
"}
(4,1,1) = {"
l
l
O
B
z
y
Y
T
W
w
"}
(5,1,1) = {"
l
l
f
B
b
R
S
k
W
w
"}
(6,1,1) = {"
l
l
l
B
q
t
M
Y
Y
n
"}
(7,1,1) = {"
w
l
l
H
a
D
g
Y
W
w
"}
(8,1,1) = {"
w
w
O
o
o
U
K
Y
w
w
"}
(9,1,1) = {"
w
w
j
m
Y
Y
Y
w
w
w
"}
