//MAP CONVERTED BY dmm2tgm.py THIS HEADER COMMENT PREVENTS RECONVERSION, DO NOT REMOVE
"a" = (
/turf/closed/wall/rust,
/area/template_noop)
"f" = (
/obj/structure/girder,
/turf/open/floor/plating/rust,
/area/template_noop)
"h" = (
/obj/structure/flora/junglebush,
/turf/open/floor/plating/asteroid/dirt/jungle/dark,
/area/template_noop)
"l" = (
/obj/structure/flora/grass/jungle/b,
/turf/open/floor/plating/asteroid/dirt/jungle/dark,
/area/template_noop)
"n" = (
/turf/open/floor/plating/rust,
/area/template_noop)
"o" = (
/turf/template_noop,
/area/template_noop)
"q" = (
/obj/structure/flora/junglebush/c,
/turf/open/floor/plating/asteroid/dirt/jungle/dark,
/area/template_noop)
"y" = (
/obj/structure/flora/rock/jungle,
/turf/open/floor/plating/asteroid/dirt/jungle/dark,
/area/template_noop)
"B" = (
/obj/structure/flora/grass/jungle,
/turf/open/floor/plating/asteroid/dirt/jungle/dark,
/area/template_noop)
"C" = (
/obj/effect/decal/cleanable/glass,
/obj/item/shard,
/turf/open/floor/plating/rust,
/area/template_noop)
"L" = (
/obj/effect/decal/cleanable/glass,
/obj/structure/flora/grass/jungle/b,
/turf/open/floor/plating/asteroid/dirt/jungle/dark,
/area/template_noop)
"M" = (
/turf/closed/wall,
/area/template_noop)
"T" = (
/obj/effect/decal/cleanable/glass,
/turf/open/floor/plating/asteroid/dirt/jungle/dark,
/area/template_noop)
"U" = (
/obj/structure/flora/tree/jungle/small,
/turf/open/floor/plating/asteroid/dirt/jungle/dark,
/area/template_noop)
"V" = (
/turf/open/floor/plating/asteroid/dirt/jungle/dark,
/area/template_noop)
"X" = (
/obj/item/stack/ore/salvage/scrapmetal/five,
/obj/machinery/light/broken/directional/north,
/obj/effect/spawner/random/salvage/machine,
/turf/open/floor/plating/rust,
/area/template_noop)

(1,1,1) = {"
o
V
U
o
V
o
"}
(2,1,1) = {"
o
a
f
L
a
o
"}
(3,1,1) = {"
B
a
X
B
C
T
"}
(4,1,1) = {"
l
f
y
n
a
q
"}
(5,1,1) = {"
V
a
V
a
M
V
"}
(6,1,1) = {"
o
B
o
o
h
o
"}
