//MAP CONVERTED BY dmm2tgm.py THIS HEADER COMMENT PREVENTS RECONVERSION, DO NOT REMOVE
"a" = (
/obj/structure/flora/grass/rockplanet/dead,
/turf/open/floor/plating/asteroid/dirt/wasteland,
/area/template_noop)
"f" = (
/obj/effect/anomaly/heartbeat/planetary,
/turf/open/floor/plating/asteroid/dirt/wasteland,
/area/template_noop)
"g" = (
/obj/structure/flora/tree/dead/tall,
/turf/open/floor/plating/asteroid/dirt/wasteland,
/area/template_noop)
"l" = (
/obj/effect/radiation,
/obj/structure/flora/grass/rockplanet/dead,
/obj/structure/spacevine/dead,
/turf/open/floor/plating/asteroid/dirt/wasteland,
/area/template_noop)
"m" = (
/turf/open/floor/plating/asteroid/dirt/wasteland,
/area/template_noop)
"z" = (
/obj/structure/flora/tree/dead/tall,
/obj/structure/flora/grass/rockplanet/dead,
/turf/open/floor/plating/asteroid/dirt/wasteland,
/area/template_noop)
"I" = (
/turf/template_noop,
/area/template_noop)
"J" = (
/obj/effect/radiation,
/obj/structure/flora/grass/rockplanet/dead,
/turf/open/floor/plating/asteroid/dirt/wasteland,
/area/template_noop)
"P" = (
/obj/structure/flora/grass/rockplanet/dead,
/obj/structure/spacevine/dead,
/turf/open/floor/plating/asteroid/dirt/wasteland,
/area/template_noop)
"V" = (
/obj/structure/spacevine/dead,
/turf/open/floor/plating/asteroid/dirt/wasteland,
/area/template_noop)

(1,1,1) = {"
I
a
I
I
I
"}
(2,1,1) = {"
a
J
a
I
I
"}
(3,1,1) = {"
I
g
m
V
I
"}
(4,1,1) = {"
I
m
f
V
V
"}
(5,1,1) = {"
I
m
m
V
g
"}
(6,1,1) = {"
P
z
m
l
P
"}
(7,1,1) = {"
V
a
I
V
I
"}
