//MAP CONVERTED BY dmm2tgm.py THIS HEADER COMMENT PREVENTS RECONVERSION, DO NOT REMOVE
"a" = (
/turf/closed/mineral/random/jungle,
/area/template_noop)
"b" = (
/obj/structure/flora/grass/jungle/b,
/obj/structure/spacevine/dense,
/turf/open/floor/plating/asteroid/dirt/jungle,
/area/template_noop)
"e" = (
/obj/effect/decal/remains/human,
/obj/effect/decal/cleanable/blood/splatter{
	color = "#4D0000"
	},
/obj/structure/spacevine,
/turf/open/floor/plating/asteroid/dirt/jungle,
/area/template_noop)
"g" = (
/obj/structure/spacevine/dense,
/turf/open/floor/plating/asteroid/dirt/jungle,
/area/template_noop)
"i" = (
/turf/template_noop,
/area/template_noop)
"j" = (
/obj/effect/decal/remains/human,
/obj/structure/spacevine,
/turf/open/floor/plating/asteroid/dirt/jungle,
/area/template_noop)
"l" = (
/obj/structure/flora/rock/pile,
/obj/structure/spacevine,
/turf/open/floor/plating/asteroid/dirt/jungle,
/area/template_noop)
"m" = (
/obj/structure/flora/grass/jungle/b,
/obj/structure/spacevine,
/turf/open/floor/plating/asteroid/dirt/jungle,
/area/template_noop)
"v" = (
/obj/effect/decal/remains/human,
/obj/structure/spacevine/dense,
/obj/structure/spacevine,
/turf/open/floor/plating/asteroid/dirt/jungle,
/area/template_noop)
"w" = (
/obj/structure/spacevine,
/turf/open/floor/plating/asteroid/dirt/jungle,
/area/template_noop)
"K" = (
/mob/living/simple_animal/hostile/asteroid/wolf/alpha,
/obj/effect/decal/remains/human,
/turf/open/floor/plating/asteroid/dirt/jungle,
/area/template_noop)
"M" = (
/obj/structure/flora/grass/jungle/b,
/turf/open/floor/plating/asteroid/dirt/jungle,
/area/template_noop)
"P" = (
/obj/effect/mob_spawn/human/corpse/damaged/legioninfested,
/obj/effect/decal/cleanable/blood/old,
/turf/open/floor/plating/asteroid/dirt/jungle,
/area/template_noop)
"R" = (
/obj/structure/flora/rock/pile,
/turf/open/floor/plating/asteroid/dirt/jungle,
/area/template_noop)
"Y" = (
/turf/open/floor/plating/asteroid/dirt/jungle,
/area/template_noop)

(1,1,1) = {"
i
i
a
R
m
a
a
i
"}
(2,1,1) = {"
i
a
a
w
v
l
a
a
"}
(3,1,1) = {"
a
a
P
Y
w
M
w
g
"}
(4,1,1) = {"
a
a
w
R
K
Y
R
a
"}
(5,1,1) = {"
w
b
j
a
M
l
a
a
"}
(6,1,1) = {"
a
a
M
w
Y
P
a
i
"}
(7,1,1) = {"
a
a
l
b
e
g
Y
i
"}
(8,1,1) = {"
i
a
a
w
a
a
i
i
"}
