//MAP CONVERTED BY dmm2tgm.py THIS HEADER COMMENT PREVENTS RECONVERSION, DO NOT REMOVE
"a" = (
/turf/template_noop,
/area/template_noop)
"e" = (
/obj/structure/flora/rock,
/turf/open/floor/plating/asteroid/dirt/grass/jungle,
/area/template_noop)
"m" = (
/obj/structure/flora/ash/leaf_shroom,
/turf/open/floor/plating/asteroid/dirt/jungle,
/area/template_noop)
"p" = (
/obj/structure/flora/ash/leaf_shroom,
/turf/open/floor/plating/asteroid/dirt/grass/jungle,
/area/template_noop)
"s" = (
/turf/open/water/jungle/lit,
/area/template_noop)
"K" = (
/obj/structure/flora/rock/jungle,
/turf/open/floor/plating/asteroid/dirt/grass/jungle,
/area/template_noop)
"M" = (
/obj/structure/flora/ash/tall_shroom,
/turf/open/floor/plating/asteroid/dirt/jungle,
/area/template_noop)
"N" = (
/obj/structure/flora/ash/stem_shroom,
/turf/open/floor/plating/asteroid/dirt/jungle,
/area/template_noop)
"O" = (
/obj/structure/flora/junglebush,
/turf/open/floor/plating/asteroid/dirt/grass/jungle,
/area/template_noop)
"R" = (
/obj/structure/flora/ash/cap_shroom,
/turf/open/floor/plating/asteroid/dirt/jungle,
/area/template_noop)
"U" = (
/turf/open/floor/plating/asteroid/dirt/jungle,
/area/template_noop)
"W" = (
/turf/closed/mineral/random/jungle,
/area/template_noop)

(1,1,1) = {"
a
W
W
U
W
W
W
a
"}
(2,1,1) = {"
W
W
U
M
R
W
m
W
"}
(3,1,1) = {"
a
M
m
e
M
R
M
W
"}
(4,1,1) = {"
W
U
O
s
p
K
N
U
"}
(5,1,1) = {"
a
W
N
K
e
R
U
W
"}
(6,1,1) = {"
W
M
U
m
N
M
W
W
"}
(7,1,1) = {"
W
W
R
W
W
U
W
a
"}
(8,1,1) = {"
a
W
W
a
W
W
a
a
"}
