//MAP CONVERTED BY dmm2tgm.py THIS HEADER COMMENT PREVENTS RECONVERSION, DO NOT REMOVE
"a" = (
/turf/template_noop,
/area/template_noop)
"b" = (
/obj/effect/mob_spawn/human/corpse/srm/hunter,
/obj/structure/flora/grass/jungle,
/obj/machinery/light/broken/directional/south,
/obj/effect/decal/cleanable/blood,
/obj/structure/spacevine/weak,
/turf/open/floor/plating/rust/jungleplanet,
/area/template_noop)
"d" = (
/obj/structure/flora/grass/jungle/b,
/turf/open/floor/plating/asteroid/dirt/jungle,
/area/template_noop)
"e" = (
/obj/effect/mob_spawn/animal_corpse/monkey,
/obj/structure/spacevine/dense,
/turf/open/floor/plating/asteroid/dirt/jungle,
/area/template_noop)
"g" = (
/obj/structure/door_assembly/door_assembly_ext,
/turf/open/floor/plating/rust/jungleplanet,
/area/template_noop)
"i" = (
/turf/closed/wall/mineral/titanium/survival,
/area/template_noop)
"j" = (
/obj/structure/flora/grass/jungle,
/obj/structure/spacevine/dense,
/turf/open/floor/plating/asteroid/dirt/jungle,
/area/template_noop)
"k" = (
/obj/item/gps/computer,
/turf/open/floor/plating/rust/jungleplanet,
/area/template_noop)
"l" = (
/obj/structure/spacevine/dense,
/turf/open/floor/plating/asteroid/dirt/jungle,
/area/template_noop)
"o" = (
/turf/open/floor/plating/rust/jungleplanet,
/area/template_noop)
"p" = (
/obj/structure/flora/grass/jungle/b,
/obj/effect/decal/cleanable/blood,
/obj/structure/spacevine/dense,
/turf/open/floor/plating/asteroid/dirt/jungle,
/area/template_noop)
"q" = (
/obj/structure/flora/grass/jungle,
/obj/structure/spacevine/weak,
/turf/open/floor/plating/asteroid/dirt/jungle,
/area/template_noop)
"s" = (
/obj/structure/spacevine/dense,
/turf/closed/wall/mineral/titanium/survival,
/area/template_noop)
"t" = (
/obj/machinery/stasis/survival_pod,
/turf/open/floor/plating/rust/jungleplanet,
/area/template_noop)
"v" = (
/obj/structure/spacevine/weak,
/turf/closed/wall/mineral/titanium/survival,
/area/template_noop)
"w" = (
/obj/effect/anomaly/phantom/planetary,
/turf/open/floor/plating/rust/jungleplanet,
/area/template_noop)
"x" = (
/obj/structure/spacevine/weak,
/turf/open/floor/plating/asteroid/dirt/jungle,
/area/template_noop)
"y" = (
/obj/structure/door_assembly/door_assembly_ext,
/turf/open/floor/plating/asteroid/dirt/jungle,
/area/template_noop)
"A" = (
/obj/effect/decal/cleanable/blood,
/obj/structure/spacevine/dense,
/turf/open/floor/plating/asteroid/dirt/jungle,
/area/template_noop)
"C" = (
/obj/structure/flora/grass/jungle/b,
/obj/structure/spacevine/weak,
/turf/open/floor/plating/asteroid/dirt/jungle,
/area/template_noop)
"D" = (
/obj/structure/flora/grass/jungle,
/obj/effect/decal/cleanable/blood,
/turf/open/floor/plating/asteroid/dirt/jungle,
/area/template_noop)
"F" = (
/turf/open/floor/plating/asteroid/dirt/jungle,
/area/template_noop)
"H" = (
/obj/structure/spacevine/weak,
/turf/open/floor/plating/rust/jungleplanet,
/area/template_noop)
"J" = (
/obj/structure/flora/grass/jungle,
/turf/open/floor/plating/asteroid/dirt/jungle,
/area/template_noop)
"M" = (
/obj/structure/flora/grass/jungle/b,
/obj/structure/spacevine/dense,
/turf/open/floor/plating/asteroid/dirt/jungle,
/area/template_noop)
"O" = (
/obj/machinery/smartfridge/survival_pod/empty,
/obj/machinery/light/broken/directional/north,
/turf/open/floor/plating/rust/jungleplanet,
/area/template_noop)
"R" = (
/obj/structure/girder/displaced,
/obj/structure/spacevine/dense,
/turf/open/floor/plating/asteroid/dirt/jungle,
/area/template_noop)
"S" = (
/obj/effect/mob_spawn/human/corpse/srm/hunter,
/obj/structure/flora/grass/jungle,
/obj/effect/decal/cleanable/blood,
/obj/structure/spacevine/weak,
/turf/open/floor/plating/rust/jungleplanet,
/area/template_noop)
"T" = (
/obj/structure/flora/grass/jungle/b,
/obj/effect/decal/cleanable/blood,
/obj/structure/spacevine/weak,
/turf/open/floor/plating/asteroid/dirt/jungle,
/area/template_noop)
"V" = (
/obj/structure/girder/displaced,
/turf/open/floor/plating/asteroid/dirt/jungle,
/area/template_noop)
"W" = (
/obj/effect/mob_spawn/animal_corpse/monkey,
/turf/open/floor/plating/asteroid/dirt/jungle,
/area/template_noop)

(1,1,1) = {"
a
F
J
l
A
d
a
a
a
"}
(2,1,1) = {"
a
l
e
l
M
j
F
F
a
"}
(3,1,1) = {"
F
v
v
v
v
v
d
D
a
"}
(4,1,1) = {"
q
V
k
o
H
S
F
V
a
"}
(5,1,1) = {"
R
i
O
w
H
H
g
o
a
"}
(6,1,1) = {"
l
R
t
o
b
v
x
F
y
"}
(7,1,1) = {"
p
s
s
i
v
v
q
C
a
"}
(8,1,1) = {"
l
C
J
W
x
T
x
a
a
"}
