//MAP CONVERTED BY dmm2tgm.py THIS HEADER COMMENT PREVENTS RECONVERSION, DO NOT REMOVE
"a" = (
/obj/structure/flora/grass/rockplanet/dead,
/turf/open/floor/plating/asteroid/dirt/wasteland,
/area/template_noop)
"b" = (
/turf/template_noop,
/area/template_noop)
"j" = (
/obj/effect/anomaly/phantom/planetary,
/turf/open/floor/plating/asteroid/dirt/wasteland,
/area/template_noop)
"n" = (
/turf/open/floor/plating/asteroid/dirt/wasteland,
/area/template_noop)
"z" = (
/turf/open/floor/plating/asteroid/dirt/jungle,
/area/template_noop)
"F" = (
/obj/effect/anomaly/phantom/planetary{
	drops_core = 0
	},
/turf/open/floor/plating/asteroid/dirt/wasteland,
/area/template_noop)
"H" = (
/obj/structure/flora/rock/jungle,
/turf/open/floor/plating/asteroid/dirt/jungle,
/area/template_noop)
"J" = (
/obj/structure/flora/rock/pile,
/turf/open/floor/plating/asteroid/dirt/wasteland,
/area/template_noop)

(1,1,1) = {"
b
z
n
z
H
z
b
"}
(2,1,1) = {"
z
n
F
a
z
z
z
"}
(3,1,1) = {"
z
a
J
n
n
F
H
"}
(4,1,1) = {"
b
H
n
j
J
a
z
"}
(5,1,1) = {"
b
n
n
a
n
F
n
"}
(6,1,1) = {"
n
F
n
n
H
n
z
"}
(7,1,1) = {"
J
a
b
z
b
b
z
"}
