//MAP CONVERTED BY dmm2tgm.py THIS HEADER COMMENT PREVENTS RECONVERSION, DO NOT REMOVE
"a" = (
/turf/template_noop,
/area/template_noop)
"b" = (
/turf/closed/wall/rust,
/area/template_noop)
"f" = (
/obj/structure/flora/grass/jungle/b,
/turf/open/floor/plating/asteroid/dirt/jungle/dark,
/area/template_noop)
"h" = (
/turf/closed/wall,
/area/template_noop)
"k" = (
/obj/structure/flora/junglebush/large,
/turf/open/floor/plating/asteroid/dirt/jungle/dark,
/area/template_noop)
"o" = (
/obj/item/stack/ore/salvage/scrapmetal/five,
/turf/open/floor/plating/rust,
/area/template_noop)
"y" = (
/obj/structure/flora/ash/garden,
/turf/open/floor/plating/asteroid/dirt/jungle/dark,
/area/template_noop)
"A" = (
/turf/open/floor/plating/asteroid/dirt/jungle/dark,
/area/template_noop)
"C" = (
/obj/structure/flora/grass/jungle,
/turf/open/floor/plating/asteroid/dirt/jungle/dark,
/area/template_noop)
"M" = (
/obj/structure/girder,
/turf/open/floor/plating/rust,
/area/template_noop)
"O" = (
/obj/structure/flora/rock/jungle,
/turf/open/floor/plating/asteroid/dirt/jungle/dark,
/area/template_noop)

(1,1,1) = {"
a
a
C
a
a
a
"}
(2,1,1) = {"
a
f
y
k
A
a
"}
(3,1,1) = {"
C
y
b
h
M
C
"}
(4,1,1) = {"
a
k
M
o
A
a
"}
(5,1,1) = {"
a
C
y
f
a
a
"}
(6,1,1) = {"
a
a
O
a
a
a
"}
