//MAP CONVERTED BY dmm2tgm.py THIS HEADER COMMENT PREVENTS RECONVERSION, DO NOT REMOVE
"a" = (
/turf/open/floor/plating/asteroid/dirt/jungle/dark,
/area/template_noop)
"h" = (
/obj/structure/flora/ausbushes/sparsegrass/hell,
/turf/open/water/jungle/blood,
/area/template_noop)
"p" = (
/turf/closed/mineral/random/jungle,
/area/template_noop)
"r" = (
/obj/effect/mob_spawn/animal_corpse/monkey,
/turf/open/water/jungle/blood,
/area/template_noop)
"y" = (
/turf/template_noop,
/area/template_noop)
"L" = (
/turf/open/water/jungle/blood,
/area/template_noop)
"O" = (
/obj/structure/flora/ausbushes/sparsegrass/hell,
/turf/open/floor/plating/asteroid/dirt/jungle/dark,
/area/template_noop)
"P" = (
/obj/effect/anomaly/transfusion/planetary,
/turf/open/water/jungle/blood,
/area/template_noop)
"V" = (
/obj/structure/flora/ausbushes/sparsegrass/hell,
/obj/effect/mob_spawn/animal_corpse/monkey,
/turf/open/floor/plating/asteroid/dirt/jungle/dark,
/area/template_noop)

(1,1,1) = {"
y
y
p
p
p
p
a
"}
(2,1,1) = {"
y
p
p
r
L
O
a
"}
(3,1,1) = {"
p
p
h
L
V
a
a
"}
(4,1,1) = {"
p
p
P
L
p
p
V
"}
(5,1,1) = {"
p
p
p
p
p
p
a
"}
(6,1,1) = {"
y
p
p
p
p
y
y
"}
