//MAP CONVERTED BY dmm2tgm.py THIS HEADER COMMENT PREVENTS RECONVERSION, DO NOT REMOVE
"a" = (
/turf/open/space/basic,
/area/space)
"c" = (
/turf/closed/wall/mineral/plastitanium/nodiagonal,
/area/space)
"e" = (
/turf/open/floor/carpet/blue,
/area/space)
"h" = (
/turf/open/floor/plasteel/patterned/ridged,
/area/space)
"j" = (
/obj/machinery/cryopod{
	dir = 1
	},
/obj/effect/turf_decal/techfloor,
/turf/open/floor/pod/dark,
/area/space)
"n" = (
/turf/open/floor/carpet/nanoweave/blue,
/area/space)
"o" = (
/turf/open/floor/plasteel/tech,
/area/space)
"r" = (
/obj/effect/turf_decal/techfloor{
	dir = 1
	},
/turf/open/floor/plasteel/telecomms_floor,
/area/space)
"u" = (
/obj/machinery/cryopod,
/turf/open/floor/pod/dark,
/area/space)
"x" = (
/turf/open/floor/plating,
/area/space)
"y" = (
/obj/effect/turf_decal/atmos/air,
/turf/open/floor/engine/air,
/area/space)
"C" = (
/turf/open/floor/engine/air,
/area/space)
"H" = (
/turf/open/floor/plasteel/stairs{
	icon = 'icons/obj/stairs.dmi';
	dir = 4
	},
/area/space)
"I" = (
/turf/closed/wall/mineral/titanium/nodiagonal,
/area/space)
"J" = (
/turf/open/floor/plasteel/dark,
/area/space)
"O" = (
/obj/effect/turf_decal/techfloor,
/turf/open/floor/plasteel/telecomms_floor,
/area/space)
"Q" = (
/turf/open/floor/plasteel/patterned/grid,
/area/space)
"R" = (
/turf/open/floor/plasteel/patterned/cargo_one,
/area/space)
"S" = (
/obj/structure/grille,
/turf/open/floor/plating,
/area/space)
"V" = (
/turf/open/floor/carpet/nanoweave/red,
/area/space)
"W" = (
/turf/open/floor/carpet/green,
/area/space)
"Y" = (
/obj/structure/grille,
/turf/open/space/basic,
/area/space)

(1,1,1) = {"
a
a
a
a
a
a
a
a
a
a
a
a
a
a
a
a
a
a
a
a
"}
(2,1,1) = {"
a
a
a
a
a
a
a
a
a
S
a
S
a
a
a
a
a
a
a
a
"}
(3,1,1) = {"
a
a
a
a
a
a
a
a
a
S
a
S
a
a
a
a
a
a
a
a
"}
(4,1,1) = {"
a
a
o
a
a
a
S
a
a
S
c
S
a
a
S
a
a
a
a
a
"}
(5,1,1) = {"
a
a
a
a
a
a
S
a
a
a
c
a
a
a
S
a
a
a
a
a
"}
(6,1,1) = {"
a
a
a
a
a
a
S
c
x
x
c
x
x
c
S
a
a
a
a
a
"}
(7,1,1) = {"
a
a
a
a
a
a
a
c
a
a
a
a
a
c
a
a
a
a
a
a
"}
(8,1,1) = {"
a
a
a
a
a
I
c
c
a
a
a
a
a
c
c
I
a
a
a
a
"}
(9,1,1) = {"
a
a
a
a
a
I
y
x
a
a
a
a
a
a
a
I
a
a
a
a
"}
(10,1,1) = {"
a
a
a
a
a
I
C
x
a
a
a
a
a
a
a
I
a
a
a
a
"}
(11,1,1) = {"
a
a
a
a
I
I
I
I
I
a
a
a
a
a
a
I
a
a
a
a
"}
(12,1,1) = {"
a
a
a
a
I
V
V
V
I
I
J
I
I
I
I
I
I
a
a
a
"}
(13,1,1) = {"
a
a
a
a
I
V
V
V
V
I
a
a
I
u
H
j
I
a
a
a
"}
(14,1,1) = {"
a
a
a
a
I
V
V
V
V
I
a
a
I
r
J
O
I
a
a
a
"}
(15,1,1) = {"
a
a
a
a
I
V
V
V
I
I
a
a
I
I
J
I
I
a
a
a
"}
(16,1,1) = {"
a
a
a
I
I
I
J
I
I
a
a
a
a
a
a
I
a
a
a
a
"}
(17,1,1) = {"
a
a
a
I
W
W
W
W
J
a
a
a
a
a
a
I
a
a
a
a
"}
(18,1,1) = {"
a
a
a
I
W
W
W
W
I
I
I
J
I
I
I
I
a
a
Q
Q
"}
(19,1,1) = {"
a
a
a
I
W
W
W
W
W
I
a
a
a
a
a
I
a
a
R
R
"}
(20,1,1) = {"
a
a
a
I
W
W
W
W
W
I
a
a
a
a
a
a
a
a
h
h
"}
(21,1,1) = {"
a
a
a
I
W
W
W
W
W
I
a
a
a
a
a
a
a
a
a
a
"}
(22,1,1) = {"
a
a
a
I
W
W
W
W
W
I
a
a
a
a
a
a
a
a
a
a
"}
(23,1,1) = {"
a
a
a
I
I
I
I
J
I
I
I
a
a
a
a
a
a
a
a
a
"}
(24,1,1) = {"
a
a
a
I
I
a
a
a
a
a
I
a
a
a
a
I
a
a
a
a
"}
(25,1,1) = {"
a
a
a
a
I
a
a
a
a
a
I
I
J
I
I
I
a
a
a
a
"}
(26,1,1) = {"
a
a
a
a
I
a
a
a
a
a
I
a
a
a
a
I
I
a
a
a
"}
(27,1,1) = {"
a
a
a
a
I
c
a
a
a
c
I
a
a
a
a
a
I
a
a
a
"}
(28,1,1) = {"
a
a
a
a
I
c
c
a
c
c
I
a
a
a
a
a
I
a
a
a
"}
(29,1,1) = {"
a
a
a
a
a
c
a
a
a
c
I
a
a
a
a
a
I
a
a
a
"}
(30,1,1) = {"
a
a
a
a
a
c
c
a
c
c
I
a
a
a
a
a
I
a
a
a
"}
(31,1,1) = {"
a
a
a
a
a
c
a
a
a
c
I
a
a
a
I
I
I
I
a
a
"}
(32,1,1) = {"
a
a
a
a
a
c
a
a
a
c
I
a
a
I
I
n
n
I
a
a
"}
(33,1,1) = {"
a
a
a
a
a
c
a
c
a
c
I
a
a
I
n
n
n
I
a
a
"}
(34,1,1) = {"
a
a
a
a
a
Y
a
c
a
c
I
I
J
I
I
n
n
I
a
a
"}
(35,1,1) = {"
a
a
a
a
a
Y
a
c
a
Y
I
e
e
e
I
J
I
I
a
a
"}
(36,1,1) = {"
a
a
a
a
a
a
a
c
a
Y
I
e
e
e
e
e
I
a
a
a
"}
(37,1,1) = {"
a
a
a
a
a
a
a
c
a
a
I
e
e
e
e
e
x
a
a
a
"}
(38,1,1) = {"
a
a
a
a
a
a
a
c
a
a
I
I
e
e
e
e
x
a
a
a
"}
(39,1,1) = {"
a
a
a
a
a
a
a
c
a
a
a
I
I
e
e
x
x
a
a
a
"}
(40,1,1) = {"
a
a
a
a
a
a
a
a
a
a
a
a
I
x
x
x
a
a
a
a
"}
