//MAP CONVERTED BY dmm2tgm.py THIS HEADER COMMENT PREVENTS RECONVERSION, DO NOT REMOVE
"aa" = (
/obj/effect/turf_decal/techfloor{
	dir = 8
	},
/obj/machinery/telecomms/relay/preset/pgf,
/turf/open/floor/plasteel/telecomms_floor,
/area/space)
"aR" = (
/obj/effect/turf_decal/techfloor,
/turf/open/floor/plasteel/telecomms_floor,
/area/space)
"bw" = (
/obj/effect/turf_decal/atmos/air,
/turf/open/floor/engine/air,
/area/space)
"bS" = (
/obj/effect/turf_decal/trimline/opaque/green/warning,
/obj/effect/turf_decal/trimline/opaque/green/line{
	dir = 1
	},
/obj/effect/turf_decal/spline/fancy/opaque/black{
	dir = 1
	},
/turf/open/floor/plasteel/mono/dark,
/area/space)
"ch" = (
/turf/open/floor/plating,
/area/space)
"ci" = (
/obj/effect/turf_decal/trimline/opaque/white/filled/corner{
	dir = 1
	},
/obj/effect/turf_decal/trimline/opaque/green/filled/line{
	dir = 6
	},
/turf/open/floor/plasteel/mono/dark,
/area/space)
"cQ" = (
/obj/structure/railing{
	dir = 10
	},
/obj/structure/table/reinforced,
/turf/open/floor/plasteel/mono/dark,
/area/space)
"cU" = (
/turf/open/floor/engine/air,
/area/space)
"dv" = (
/obj/effect/turf_decal/borderfloor/cee{
	dir = 4
	},
/turf/open/floor/mineral/titanium,
/area/space)
"dV" = (
/obj/effect/turf_decal/trimline/opaque/green/filled/corner,
/turf/open/floor/plasteel/mono/dark,
/area/space)
"eL" = (
/obj/effect/turf_decal/industrial/stand_clear{
	dir = 1
	},
/obj/structure/railing/corner,
/turf/open/floor/plasteel/mono/dark,
/area/space)
"eT" = (
/obj/effect/turf_decal/trimline/opaque/green/warning{
	dir = 8
	},
/obj/effect/turf_decal/spline/fancy/opaque/black{
	dir = 8
	},
/turf/open/floor/plasteel/mono/dark,
/area/space)
"fn" = (
/obj/effect/turf_decal/trimline/opaque/green/line,
/obj/effect/turf_decal/spline/fancy/opaque/black,
/turf/open/floor/plasteel/mono/dark,
/area/space)
"fu" = (
/turf/open/floor/plasteel/sepia,
/area/space)
"fF" = (
/obj/effect/turf_decal/trimline/opaque/green/filled/corner{
	dir = 4
	},
/turf/open/floor/plasteel/mono/dark,
/area/space)
"fP" = (
/obj/effect/turf_decal/trimline/opaque/green/warning{
	dir = 8
	},
/obj/effect/turf_decal/trimline/opaque/green/warning{
	dir = 4
	},
/turf/open/floor/plasteel/mono/dark,
/area/space)
"gm" = (
/turf/open/floor/plasteel/mono/dark,
/area/space)
"gG" = (
/obj/effect/turf_decal/siding/wood{
	dir = 4
	},
/turf/open/floor/plasteel/sepia,
/area/space)
"gX" = (
/obj/effect/turf_decal/trimline/opaque/green/line{
	dir = 1
	},
/obj/effect/turf_decal/trimline/opaque/green/corner{
	dir = 8
	},
/obj/effect/turf_decal/spline/fancy/opaque/black{
	dir = 1
	},
/turf/open/floor/plasteel/mono/dark,
/area/space)
"hj" = (
/obj/effect/turf_decal/siding/wood{
	dir = 5
	},
/obj/structure/chair/sofa/grey/corpo/right/directional/east,
/turf/open/floor/plasteel/sepia,
/area/space)
"ho" = (
/obj/effect/turf_decal/trimline/opaque/green/corner{
	dir = 8
	},
/turf/open/floor/plasteel/mono/dark,
/area/space)
"hp" = (
/obj/effect/turf_decal/trimline/opaque/green/warning{
	dir = 1
	},
/obj/effect/turf_decal/trimline/opaque/green/warning,
/turf/open/floor/plasteel/mono/dark,
/area/space)
"hZ" = (
/obj/effect/turf_decal/trimline/opaque/green/warning{
	dir = 8
	},
/turf/open/floor/plasteel/mono/dark,
/area/space)
"iL" = (
/obj/effect/turf_decal/trimline/opaque/green/line{
	dir = 5
	},
/obj/effect/turf_decal/trimline/opaque/green/corner{
	dir = 8
	},
/obj/effect/turf_decal/spline/fancy/opaque/black{
	dir = 5
	},
/turf/open/floor/plasteel/mono/dark,
/area/space)
"jO" = (
/obj/effect/turf_decal/trimline/opaque/green/warning{
	dir = 4
	},
/obj/effect/turf_decal/trimline/opaque/green/warning{
	dir = 8
	},
/turf/open/floor/plasteel/mono/dark,
/area/space)
"ki" = (
/turf/open/floor/engine/hull/reinforced,
/area/space)
"ku" = (
/turf/open/floor/plasteel/showroomfloor,
/area/space)
"kI" = (
/obj/structure/table/chem,
/obj/effect/turf_decal/borderfloor{
	dir = 1
	},
/turf/open/floor/mineral/titanium/tiled,
/area/space)
"kQ" = (
/obj/structure/grille,
/turf/open/space/basic,
/area/space)
"lU" = (
/obj/effect/turf_decal/trimline/opaque/green/warning{
	dir = 4
	},
/turf/open/floor/plasteel/mono/dark,
/area/space)
"lZ" = (
/obj/effect/turf_decal/techfloor{
	dir = 4
	},
/turf/open/floor/plasteel/telecomms_floor,
/area/space)
"ml" = (
/obj/effect/turf_decal/siding/wood{
	dir = 8
	},
/obj/structure/chair/sofa/grey/corpo/corner/directional/north,
/turf/open/floor/plasteel/sepia,
/area/space)
"nQ" = (
/obj/structure/railing,
/obj/structure/table/reinforced,
/turf/open/floor/plasteel/mono/dark,
/area/space)
"nT" = (
/obj/structure/bed/pod{
	dir = 1
	},
/obj/structure/railing{
	dir = 9
	},
/obj/structure/curtain/bounty,
/turf/open/floor/plasteel/sepia,
/area/space)
"ok" = (
/obj/structure/railing{
	dir = 8
	},
/turf/open/floor/plasteel/stairs{
	icon = 'icons/obj/stairs.dmi';
	dir = 1
	},
/area/space)
"oK" = (
/obj/effect/turf_decal/industrial/outline/yellow,
/turf/open/floor/plasteel/patterned/ridged,
/area/space)
"pl" = (
/obj/structure/railing{
	dir = 8
	},
/obj/structure/chair/office,
/turf/open/floor/plasteel/dark,
/area/space)
"pX" = (
/obj/effect/turf_decal/trimline/opaque/green/warning{
	dir = 5
	},
/obj/effect/turf_decal/trimline/opaque/green/corner{
	dir = 8
	},
/turf/open/floor/plasteel/mono/dark,
/area/space)
"qA" = (
/obj/structure/closet/secure_closet/armory1{
	name = "armor locker";
	populate = 0
	},
/turf/open/floor/plasteel/rockvault,
/area/space)
"rB" = (
/obj/structure/grille,
/turf/open/floor/plating,
/area/space)
"sm" = (
/turf/open/floor/plasteel/tech,
/area/space)
"un" = (
/turf/open/floor/plasteel/stairs{
	icon = 'icons/obj/stairs.dmi';
	dir = 8
	},
/area/space)
"us" = (
/obj/effect/turf_decal/trimline/opaque/white/filled/line{
	dir = 4
	},
/obj/effect/turf_decal/trimline/opaque/green/filled/line{
	dir = 8
	},
/turf/open/floor/plasteel/mono/dark,
/area/space)
"uw" = (
/obj/effect/turf_decal/trimline/opaque/green/filled,
/obj/machinery/holopad,
/turf/open/floor/plasteel/mono/white,
/area/space)
"uM" = (
/turf/closed/wall/mineral/titanium/nodiagonal,
/area/space)
"vy" = (
/obj/effect/turf_decal/trimline/opaque/green/warning,
/obj/effect/turf_decal/trimline/opaque/green/corner{
	dir = 1
	},
/obj/effect/turf_decal/trimline/opaque/green/corner{
	dir = 4
	},
/turf/open/floor/plasteel/mono/dark,
/area/space)
"wf" = (
/obj/structure/closet/secure_closet/armory1{
	name = "gear locker";
	populate = 0
	},
/turf/open/floor/plasteel/rockvault,
/area/space)
"wB" = (
/obj/effect/turf_decal/trimline/opaque/green/filled/line{
	dir = 4
	},
/turf/open/floor/plasteel/mono/dark,
/area/space)
"wC" = (
/obj/effect/turf_decal/siding/wood{
	dir = 6
	},
/turf/open/floor/plasteel/sepia,
/area/space)
"xe" = (
/obj/effect/turf_decal/trimline/opaque/white/filled/corner{
	dir = 8
	},
/obj/effect/turf_decal/trimline/opaque/green/filled/line{
	dir = 5
	},
/turf/open/floor/plasteel/mono/dark,
/area/space)
"xf" = (
/obj/effect/turf_decal/siding/wood{
	dir = 4
	},
/obj/structure/chair/sofa/grey/corpo/corner/directional/west,
/turf/open/floor/plasteel/sepia,
/area/space)
"xK" = (
/turf/open/floor/plasteel/dark,
/turf/open/floor/plasteel/tech/grid,
/area/space)
"yp" = (
/obj/machinery/cryopod,
/turf/open/floor/pod/dark,
/area/space)
"yx" = (
/turf/open/floor/mineral/titanium/tiled,
/area/space)
"yz" = (
/obj/effect/turf_decal/siding/wood{
	dir = 9
	},
/obj/structure/chair/sofa/grey/corpo/left/directional/east,
/turf/open/floor/plasteel/sepia,
/area/space)
"yB" = (
/obj/effect/turf_decal/trimline/opaque/green/corner{
	dir = 1
	},
/turf/open/floor/plasteel/mono/dark,
/area/space)
"zI" = (
/obj/structure/filingcabinet/chestdrawer{
	dir = 8
	},
/obj/structure/railing{
	dir = 4
	},
/turf/open/floor/plasteel/mono/dark,
/area/space)
"Aj" = (
/obj/effect/turf_decal/trimline/opaque/white/filled/corner{
	dir = 4
	},
/obj/effect/turf_decal/trimline/opaque/green/filled/line{
	dir = 10
	},
/turf/open/floor/plasteel/mono/dark,
/area/space)
"Al" = (
/turf/open/floor/plasteel/stairs{
	icon = 'icons/obj/stairs.dmi';
	dir = 4
	},
/area/space)
"Ax" = (
/turf/open/floor/engine/hull/interior,
/area/space)
"AH" = (
/turf/open/floor/plasteel/patterned/ridged,
/area/space)
"Cm" = (
/obj/effect/turf_decal/trimline/opaque/green/warning,
/obj/effect/turf_decal/spline/fancy/opaque/black,
/turf/open/floor/plasteel/mono/dark,
/area/space)
"CY" = (
/obj/effect/turf_decal/trimline/opaque/green/line{
	dir = 1
	},
/obj/effect/turf_decal/spline/fancy/opaque/black{
	dir = 1
	},
/turf/open/floor/plasteel/mono/dark,
/area/space)
"Dz" = (
/obj/effect/turf_decal/trimline/opaque/green/filled/line,
/turf/open/floor/plasteel/mono/dark,
/area/space)
"DG" = (
/obj/effect/turf_decal/trimline/opaque/green/warning{
	dir = 1
	},
/obj/effect/turf_decal/spline/fancy/opaque/black{
	dir = 1
	},
/turf/open/floor/plasteel/mono/dark,
/area/space)
"DJ" = (
/obj/effect/turf_decal/trimline/opaque/green/line{
	dir = 8
	},
/obj/effect/turf_decal/spline/fancy/opaque/black{
	dir = 8
	},
/turf/open/floor/plasteel/mono/dark,
/area/space)
"DN" = (
/obj/effect/turf_decal/trimline/opaque/green/warning{
	dir = 8
	},
/obj/effect/turf_decal/trimline/opaque/green/line{
	dir = 4
	},
/turf/open/floor/plasteel/mono/dark,
/area/space)
"DO" = (
/obj/structure/rack,
/turf/open/floor/plasteel/rockvault,
/area/space)
"DW" = (
/obj/structure/railing{
	dir = 8
	},
/turf/open/floor/plasteel/mono/dark,
/area/space)
"Eb" = (
/obj/effect/turf_decal/trimline/opaque/green/warning{
	dir = 4
	},
/obj/effect/turf_decal/trimline/opaque/green/warning{
	dir = 8
	},
/obj/structure/railing,
/turf/open/floor/plasteel/mono/dark,
/area/space)
"Fm" = (
/obj/effect/turf_decal/borderfloor/cee{
	dir = 8
	},
/turf/open/floor/mineral/titanium,
/area/space)
"Gg" = (
/obj/structure/railing{
	dir = 4
	},
/turf/open/floor/plasteel/stairs{
	icon = 'icons/obj/stairs.dmi';
	dir = 1
	},
/area/space)
"GM" = (
/obj/effect/turf_decal/trimline/opaque/green/line{
	dir = 4
	},
/obj/effect/turf_decal/spline/fancy/opaque/black{
	dir = 4
	},
/turf/open/floor/plasteel/mono/dark,
/area/space)
"HH" = (
/obj/effect/turf_decal/industrial/stand_clear{
	dir = 1
	},
/obj/structure/railing/corner{
	dir = 8
	},
/turf/open/floor/plasteel/mono/dark,
/area/space)
"HM" = (
/obj/effect/turf_decal/trimline/opaque/green/filled/corner{
	dir = 1
	},
/turf/open/floor/plasteel/mono/dark,
/area/space)
"Ii" = (
/turf/open/floor/plasteel/patterned/grid,
/area/space)
"Is" = (
/turf/open/floor/plasteel/tech/grid,
/area/space)
"IJ" = (
/obj/effect/turf_decal/trimline/opaque/green/warning{
	dir = 9
	},
/obj/effect/turf_decal/trimline/opaque/green/corner,
/turf/open/floor/plasteel/mono/dark,
/area/space)
"Jb" = (
/obj/effect/turf_decal/techfloor{
	dir = 8
	},
/obj/machinery/blackbox_recorder,
/turf/open/floor/plasteel/telecomms_floor,
/area/space)
"Kz" = (
/obj/effect/turf_decal/trimline/opaque/white/filled/corner,
/obj/effect/turf_decal/trimline/opaque/green/filled/line{
	dir = 9
	},
/turf/open/floor/plasteel/mono/dark,
/area/space)
"KF" = (
/obj/structure/chair/office{
	dir = 8
	},
/turf/open/floor/mineral/titanium/tiled,
/area/space)
"Np" = (
/turf/closed/wall/mineral/plastitanium/nodiagonal,
/area/space)
"NF" = (
/obj/effect/turf_decal/trimline/opaque/green/line{
	dir = 9
	},
/obj/effect/turf_decal/trimline/opaque/green/corner,
/obj/effect/turf_decal/spline/fancy/opaque/black{
	dir = 9
	},
/turf/open/floor/plasteel/mono/dark,
/area/space)
"Of" = (
/obj/structure/railing{
	dir = 6
	},
/obj/structure/table/reinforced,
/turf/open/floor/plasteel/mono/dark,
/area/space)
"OB" = (
/obj/structure/table/chem,
/obj/effect/turf_decal/borderfloor{
	dir = 1
	},
/obj/structure/sink/chem{
	dir = 4;
	pixel_y = 6;
	pixel_x = -4
	},
/turf/open/floor/mineral/titanium/tiled,
/area/space)
"QI" = (
/obj/effect/turf_decal/trimline/opaque/green/line{
	dir = 1
	},
/obj/effect/turf_decal/trimline/opaque/green/line,
/obj/effect/turf_decal/spline/fancy/opaque/black{
	dir = 1
	},
/turf/open/floor/plasteel/mono/dark,
/area/space)
"Rm" = (
/obj/effect/turf_decal/siding/wood,
/turf/open/floor/plasteel/sepia,
/area/space)
"Rn" = (
/obj/effect/turf_decal/trimline/opaque/green/filled/corner{
	dir = 8
	},
/turf/open/floor/plasteel/mono/dark,
/area/space)
"RH" = (
/turf/open/floor/plasteel/patterned/cargo_one,
/area/space)
"SG" = (
/obj/machinery/holopad/secure,
/turf/open/floor/plasteel/dark,
/area/space)
"Tm" = (
/obj/machinery/suit_storage_unit/inherit/industrial,
/turf/open/floor/plasteel/rockvault,
/area/space)
"Ua" = (
/turf/open/space/basic,
/area/space)
"US" = (
/obj/effect/turf_decal/trimline/opaque/green/line{
	dir = 1
	},
/obj/effect/turf_decal/trimline/opaque/green/warning,
/obj/effect/turf_decal/spline/fancy/opaque/black{
	dir = 1
	},
/turf/open/floor/plasteel/mono/dark,
/area/space)
"Vs" = (
/obj/effect/turf_decal/siding/wood{
	dir = 1
	},
/obj/structure/table/wood,
/turf/open/floor/plasteel/sepia,
/area/space)
"Wh" = (
/obj/structure/chair/sofa/grey/corpo/directional/north,
/turf/open/floor/plasteel/sepia,
/area/space)
"Wk" = (
/obj/effect/turf_decal/trimline/opaque/green/warning{
	dir = 4
	},
/obj/effect/turf_decal/spline/fancy/opaque/black{
	dir = 4
	},
/obj/machinery/vending/coffee,
/turf/open/floor/plasteel/mono/dark,
/area/space)
"WF" = (
/obj/effect/turf_decal/trimline/opaque/green/line{
	dir = 5
	},
/obj/effect/turf_decal/spline/fancy/opaque/black{
	dir = 5
	},
/turf/open/floor/plasteel/mono/dark,
/area/space)
"WO" = (
/obj/effect/turf_decal/siding/wood,
/obj/structure/closet/cabinet,
/obj/structure/railing{
	dir = 8
	},
/turf/open/floor/plasteel/sepia,
/area/space)
"Xd" = (
/obj/effect/turf_decal/techfloor{
	dir = 1
	},
/turf/open/floor/plasteel/telecomms_floor,
/area/space)
"Xk" = (
/obj/effect/turf_decal/trimline/opaque/green/filled/line{
	dir = 1
	},
/turf/open/floor/plasteel/mono/dark,
/area/space)
"Xv" = (
/turf/open/floor/plasteel/dark,
/area/space)
"Xy" = (
/obj/machinery/cryopod{
	dir = 1
	},
/obj/effect/turf_decal/techfloor,
/turf/open/floor/pod/dark,
/area/space)
"Yl" = (
/obj/structure/table/reinforced,
/turf/open/floor/mineral/titanium/tiled,
/area/space)
"Yz" = (
/obj/effect/turf_decal/trimline/opaque/green/warning{
	dir = 8
	},
/obj/effect/turf_decal/trimline/opaque/green/warning{
	dir = 4
	},
/obj/structure/railing,
/turf/open/floor/plasteel/mono/dark,
/area/space)
"YK" = (
/obj/structure/railing{
	dir = 8
	},
/obj/structure/table/wood,
/turf/open/floor/plasteel/mono/dark,
/area/space)
"YR" = (
/obj/effect/turf_decal/trimline/opaque/green/filled/line{
	dir = 8
	},
/turf/open/floor/plasteel/mono/dark,
/area/space)
"YZ" = (
/obj/effect/turf_decal/trimline/opaque/green/warning,
/obj/effect/turf_decal/trimline/opaque/green/warning{
	dir = 1
	},
/turf/open/floor/plasteel/mono/dark,
/area/space)
"Zj" = (
/obj/structure/table/optable,
/turf/open/floor/mineral/titanium/tiled,
/area/space)
"Zo" = (
/obj/effect/turf_decal/trimline/opaque/green/warning{
	dir = 4
	},
/obj/effect/turf_decal/spline/fancy/opaque/black{
	dir = 4
	},
/turf/open/floor/plasteel/mono/dark,
/area/space)
"ZT" = (
/obj/effect/turf_decal/trimline/opaque/white/filled/line{
	dir = 8
	},
/obj/effect/turf_decal/trimline/opaque/green/filled/line{
	dir = 4
	},
/turf/open/floor/plasteel/mono/dark,
/area/space)

(1,1,1) = {"
Ua
Ua
Ua
Ua
Ua
Ua
Ua
Ua
Ua
rB
Ua
rB
Ua
Ua
Ua
Ua
Ua
Ua
Ua
Ua
"}
(2,1,1) = {"
Ua
Ua
Ua
Ua
Ua
Ua
Ua
Ua
Ua
rB
Ua
rB
Ua
Ua
Ua
Ua
Ua
Ua
Ua
Ua
"}
(3,1,1) = {"
Ua
Ua
Ua
Ua
Ua
Ua
rB
Ua
Ua
rB
Np
rB
Ua
Ua
rB
Ua
Ua
Ua
Ua
Ua
"}
(4,1,1) = {"
Ua
Ua
sm
Ua
Ua
Ua
rB
Ua
Ua
Ua
Np
Ua
Ua
Ua
rB
Ua
Ua
Ua
Ua
Ua
"}
(5,1,1) = {"
Ua
Ua
Ua
Ua
Ua
Ua
rB
Np
ch
ch
Np
ch
ch
Np
rB
Ua
Ua
Ua
Ua
Ua
"}
(6,1,1) = {"
Ua
Ua
Ua
Ua
Ua
Ua
Ua
Np
Ua
Ua
Ua
Ua
Ua
Np
Ua
Ua
Ua
Ua
Ua
Ua
"}
(7,1,1) = {"
Ua
Ua
Ua
Ua
Ua
uM
Np
Np
Ua
Ua
Ua
Ua
Ua
Np
Np
uM
Ua
Ua
Ua
Ua
"}
(8,1,1) = {"
Ua
Ua
Ua
Ua
Ua
uM
bw
ch
sm
sm
sm
sm
sm
Ua
Ua
uM
Ua
Ua
Ua
Ua
"}
(9,1,1) = {"
Ua
Ua
Ua
Ua
Ua
uM
cU
ch
sm
sm
sm
sm
sm
Ua
Ua
uM
Ua
Ua
Ua
Ua
"}
(10,1,1) = {"
Ua
Ua
Ua
Ua
uM
uM
uM
uM
uM
sm
sm
sm
sm
Ua
Ua
uM
Ua
Ua
Ua
Ua
"}
(11,1,1) = {"
Ua
Ua
Ua
Ua
uM
Tm
gm
DO
uM
uM
Is
uM
uM
uM
uM
uM
uM
Ua
Ua
Ua
"}
(12,1,1) = {"
Ua
Ua
Ua
Ua
uM
Kz
us
Aj
wf
uM
DG
Cm
uM
yp
Al
Xy
uM
Ua
Ua
Ua
"}
(13,1,1) = {"
Ua
Ua
Ua
Ua
uM
xe
ZT
ci
qA
uM
CY
fn
uM
Xd
Xv
aR
uM
Ua
Ua
Ua
"}
(14,1,1) = {"
Ua
Ua
Ua
Ua
uM
Tm
gm
DO
uM
uM
CY
fn
uM
uM
Xv
uM
uM
Ua
Ua
Ua
"}
(15,1,1) = {"
Ua
Ua
Ua
uM
uM
uM
Is
uM
uM
eT
yB
ho
DJ
DJ
hZ
uM
uM
Ua
Ua
Ua
"}
(16,1,1) = {"
Ua
Ua
Ua
uM
nT
WO
IJ
fP
Is
Zo
GM
lU
GM
GM
Wk
uM
uM
Ua
Ua
Ua
"}
(17,1,1) = {"
Ua
Ua
Ua
uM
fu
Rm
hp
gm
uM
uM
uM
Is
uM
uM
uM
uM
Ua
Ua
Ii
Ii
"}
(18,1,1) = {"
Ua
Ua
Ua
uM
nT
WO
YZ
yz
ml
uM
NF
Eb
oK
RH
oK
uM
Ua
Ua
RH
RH
"}
(19,1,1) = {"
Ua
Ua
Ua
uM
gG
wC
YZ
Vs
Wh
uM
bS
HH
ok
RH
RH
Is
ki
Ua
AH
AH
"}
(20,1,1) = {"
Ua
Ua
Ua
uM
YK
DW
YZ
Vs
Wh
uM
QI
pl
cQ
gm
RH
Is
ki
Ua
Ua
Ua
"}
(21,1,1) = {"
Ua
Ua
Ua
uM
jO
DN
vy
hj
xf
uM
bS
SG
nQ
gm
RH
Is
ki
Ua
Ua
Ua
"}
(22,1,1) = {"
Ua
Ua
Ua
uM
Is
uM
pX
jO
jO
uM
QI
zI
Of
gm
RH
Is
ki
Ua
Ua
Ua
"}
(23,1,1) = {"
Ua
Ua
Ua
uM
ku
uM
uM
xK
uM
uM
bS
eL
Gg
RH
RH
Is
ki
Ua
Ua
Ua
"}
(24,1,1) = {"
Ua
Ua
Ua
uM
uM
uM
OB
Fm
oK
uM
iL
Yz
oK
RH
oK
uM
Ua
Ua
Ua
Ua
"}
(25,1,1) = {"
Ua
Ua
Ua
Ua
uM
kI
yx
dv
Yl
uM
uM
Is
uM
uM
uM
uM
Ua
Ua
Ua
Ua
"}
(26,1,1) = {"
Ua
Ua
Ua
Ua
uM
kI
KF
Fm
yx
Zj
uM
US
Ua
uM
ku
uM
uM
Ua
Ua
Ua
"}
(27,1,1) = {"
Ua
Ua
Ua
Ua
uM
Np
kI
dv
yx
Np
uM
US
Ua
uM
ku
ku
uM
Ua
Ua
Ua
"}
(28,1,1) = {"
Ua
Ua
Ua
Ua
uM
Np
Np
Ua
Np
Np
uM
US
Ua
uM
Is
uM
uM
Ua
Ua
Ua
"}
(29,1,1) = {"
Ua
Ua
Ua
Ua
Ua
Np
Ax
Ax
Ax
Np
uM
US
Ua
Ua
Ua
Ua
uM
Ua
Ua
Ua
"}
(30,1,1) = {"
Ua
Ua
Ua
Ua
Ua
Np
Np
Ua
Np
Np
uM
US
Ua
Ua
Ua
Ua
uM
Ua
Ua
Ua
"}
(31,1,1) = {"
Ua
Ua
Ua
Ua
Ua
Np
ki
ki
ki
Np
uM
US
Ua
Ua
uM
uM
uM
uM
Ua
Ua
"}
(32,1,1) = {"
Ua
Ua
Ua
Ua
Ua
Np
ki
Np
ki
Np
uM
gX
hZ
hZ
uM
Ua
Ua
uM
Ua
Ua
"}
(33,1,1) = {"
Ua
Ua
Ua
Ua
Ua
Np
ki
Np
ki
Np
uM
WF
GM
lU
uM
fu
fu
uM
Ua
Ua
"}
(34,1,1) = {"
Ua
Ua
Ua
Ua
Ua
kQ
Ua
Np
ki
Np
uM
uM
uM
Is
uM
fu
fu
uM
Ua
Ua
"}
(35,1,1) = {"
Ua
Ua
Ua
Ua
Ua
kQ
Ua
Np
Ua
kQ
uM
Jb
aa
un
uM
Is
uM
uM
Ua
Ua
"}
(36,1,1) = {"
Ua
Ua
Ua
Ua
Ua
Ua
Ua
Np
Ua
kQ
uM
gm
dV
wB
fF
gm
uM
Ua
Ua
Ua
"}
(37,1,1) = {"
Ua
Ua
Ua
Ua
Ua
Ua
Ua
Np
Ua
Ua
ch
gm
Dz
uw
Xk
aR
ch
Ua
Ua
Ua
"}
(38,1,1) = {"
Ua
Ua
Ua
Ua
Ua
Ua
Ua
Np
Ua
Ua
ch
ch
Rn
YR
HM
aR
ch
Ua
Ua
Ua
"}
(39,1,1) = {"
Ua
Ua
Ua
Ua
Ua
Ua
Ua
Np
Ua
Ua
Ua
ch
uM
lZ
lZ
ch
ch
Ua
Ua
Ua
"}
(40,1,1) = {"
Ua
Ua
Ua
Ua
Ua
Ua
Ua
Ua
Ua
Ua
Ua
Ua
uM
ch
ch
ch
Ua
Ua
Ua
Ua
"}
