//MAP CONVERTED BY dmm2tgm.py THIS HEADER COMMENT PREVENTS RECONVERSION, DO NOT REMOVE
"c" = (
/obj/item/screwdriver/abductor{
	pixel_y = 10;
	pixel_x = -7
	},
/obj/item/wrench/abductor{
	pixel_x = 7;
	pixel_y = 5
	},
/obj/item/weldingtool/abductor{
	pixel_y = -8;
	pixel_x = -1
	},
/turf/open/indestructible/hierophant/two,
/area/ruin)
"f" = (
/obj/item/clothing/suit/armor/abductor/vest,
/obj/item/clothing/head/helmet/abductor{
	pixel_y = 9
	},
/turf/open/indestructible/hierophant/two,
/area/ruin)
"i" = (
/obj/item/clothing/under/abductor,
/turf/open/indestructible/hierophant/two,
/area/ruin)
"k" = (
/obj/structure/fluff/divine/powerpylon,
/obj/effect/light_emitter{
	set_cap = 3;
	set_luminosity = 5
	},
/turf/open/indestructible/hierophant/two,
/area/ruin)
"l" = (
/obj/machinery/door/keycard{
	puzzle_id = "wastepandora"
	},
/turf/open/indestructible/hierophant/two,
/area/ruin)
"m" = (
/obj/structure/flora/ash/garden/waste,
/turf/open/floor/plating/asteroid/wasteplanet,
/area/ruin)
"n" = (
/turf/open/floor/plating/rust/wasteplanet,
/area/ruin)
"q" = (
/obj/effect/light_emitter{
	set_cap = 3;
	set_luminosity = 5
	},
/turf/open/floor/plating/asteroid/wasteplanet,
/area/ruin)
"r" = (
/obj/structure/girder/reinforced,
/turf/open/floor/plating/rust/wasteplanet,
/area/ruin)
"s" = (
/turf/open/floor/plating/wasteplanet,
/area/ruin)
"t" = (
/obj/effect/spawner/lootdrop/maintenance/five,
/turf/open/floor/plating/rust/wasteplanet,
/area/ruin)
"u" = (
/turf/open/floor/plating/asteroid/wasteplanet,
/area/ruin)
"v" = (
/mob/living/simple_animal/hostile/asteroid/elite/pandora/dungeon{
	health = 600;
	maxHealth = 600;
	loot = list(/obj/item/keycard/wastepandora, /obj/item/clothing/accessory/pandora_hope)
	},
/turf/open/indestructible/hierophant/two,
/area/ruin)
"x" = (
/turf/open/indestructible/hierophant/two,
/area/ruin)
"y" = (
/obj/effect/spawner/lootdrop/armory_contraband,
/obj/effect/spawner/lootdrop/maintenance,
/obj/effect/spawner/lootdrop/maintenance,
/obj/effect/decal/cleanable/cobweb/cobweb2,
/turf/open/floor/plating/wasteplanet,
/area/ruin)
"z" = (
/obj/effect/decal/remains/xeno,
/turf/open/indestructible/hierophant/two,
/area/ruin)
"B" = (
/obj/machinery/door/keycard{
	puzzle_id = "wastepandora"
	},
/turf/open/floor/plating/wasteplanet,
/area/ruin)
"C" = (
/obj/structure/girder,
/turf/open/floor/plating/wasteplanet,
/area/ruin)
"D" = (
/obj/effect/spawner/lootdrop/maintenance/five,
/obj/effect/decal/cleanable/cobweb,
/turf/open/floor/plating/rust/wasteplanet,
/area/ruin)
"G" = (
/obj/structure/girder,
/turf/open/floor/plating/rust/wasteplanet,
/area/ruin)
"I" = (
/obj/structure/girder/reinforced,
/turf/open/floor/plating/wasteplanet,
/area/ruin)
"J" = (
/obj/effect/decal/remains/human,
/turf/open/floor/plating/asteroid/wasteplanet,
/area/ruin)
"M" = (
/turf/closed/indestructible/riveted/hierophant,
/area/ruin)
"O" = (
/turf/closed/indestructible/reinforced,
/area/ruin)
"P" = (
/obj/item/storage/belt/military/abductor,
/turf/open/indestructible/hierophant/two,
/area/ruin)
"Q" = (
/obj/effect/spawner/lootdrop/armory_contraband,
/obj/effect/spawner/lootdrop/maintenance,
/obj/effect/spawner/lootdrop/maintenance,
/turf/open/floor/plating/rust/wasteplanet,
/area/ruin)
"S" = (
/obj/effect/light_emitter{
	set_cap = 3;
	set_luminosity = 5
	},
/turf/open/indestructible/hierophant/two,
/area/ruin)
"W" = (
/obj/effect/spawner/lootdrop/maintenance,
/turf/open/floor/plating/rust/wasteplanet,
/area/ruin)
"X" = (
/obj/effect/spawner/lootdrop/tool_surgery_adv,
/obj/effect/spawner/lootdrop/maintenance,
/turf/open/floor/plating/rust/wasteplanet,
/area/ruin)
"Y" = (
/turf/template_noop,
/area/template_noop)

(1,1,1) = {"
Y
Y
Y
Y
Y
Y
Y
Y
Y
Y
Y
Y
Y
Y
Y
Y
Y
Y
Y
Y
Y
Y
Y
Y
Y
"}
(2,1,1) = {"
Y
Y
n
n
Y
s
s
C
n
Y
u
u
u
u
Y
Y
Y
Y
n
s
Y
Y
Y
Y
Y
"}
(3,1,1) = {"
Y
n
O
O
O
O
n
s
u
u
u
J
u
u
n
s
s
s
n
G
n
Y
Y
Y
Y
"}
(4,1,1) = {"
Y
n
O
i
P
O
s
u
u
u
m
u
u
n
n
C
s
n
n
s
n
Y
Y
Y
Y
"}
(5,1,1) = {"
Y
n
O
c
z
l
x
s
u
u
u
x
u
n
s
s
n
n
I
u
u
Y
Y
Y
Y
"}
(6,1,1) = {"
Y
s
O
f
O
O
x
n
u
u
x
x
u
r
n
s
u
u
u
u
m
Y
Y
Y
Y
"}
(7,1,1) = {"
Y
s
O
O
O
x
x
n
u
u
x
u
u
u
u
u
u
x
x
u
u
u
Y
Y
Y
"}
(8,1,1) = {"
Y
C
s
s
s
x
s
s
u
u
x
u
q
u
u
x
x
x
u
u
u
u
u
Y
Y
"}
(9,1,1) = {"
Y
Y
s
s
r
x
n
u
u
x
x
x
x
u
x
x
x
x
x
x
x
u
u
Y
Y
"}
(10,1,1) = {"
Y
Y
Y
s
s
x
x
x
x
x
x
x
x
x
x
x
x
x
x
u
x
x
u
u
Y
"}
(11,1,1) = {"
Y
Y
Y
u
u
u
x
x
x
M
M
x
x
x
M
M
x
x
u
u
u
u
u
u
Y
"}
(12,1,1) = {"
Y
Y
Y
m
J
u
u
x
x
M
k
x
x
x
k
M
x
x
u
u
u
J
u
u
Y
"}
(13,1,1) = {"
Y
Y
u
u
u
u
x
x
x
x
x
x
x
x
x
x
x
x
x
u
u
u
u
u
Y
"}
(14,1,1) = {"
Y
Y
u
x
u
u
q
x
x
x
x
x
v
x
x
x
x
x
S
x
x
u
u
u
Y
"}
(15,1,1) = {"
Y
s
u
x
x
x
u
x
x
x
x
x
x
x
x
x
x
x
x
u
x
m
u
u
Y
"}
(16,1,1) = {"
Y
n
u
u
u
x
x
x
x
M
k
x
x
x
k
M
x
x
u
u
u
u
u
Y
Y
"}
(17,1,1) = {"
Y
n
s
s
n
n
u
x
x
M
M
x
x
x
M
M
x
x
u
u
u
u
u
Y
Y
"}
(18,1,1) = {"
Y
n
C
n
s
n
r
u
x
x
x
x
x
x
x
x
x
x
x
n
u
u
I
Y
Y
"}
(19,1,1) = {"
Y
Y
n
s
u
n
x
x
x
x
x
x
x
x
u
u
x
n
x
x
n
u
n
Y
Y
"}
(20,1,1) = {"
Y
Y
n
s
u
x
x
x
u
u
x
x
S
u
u
u
x
n
n
O
O
O
n
Y
Y
"}
(21,1,1) = {"
Y
Y
n
s
u
x
u
u
u
u
u
u
x
u
u
u
n
O
B
O
D
O
s
C
Y
"}
(22,1,1) = {"
Y
n
n
s
u
u
u
s
I
u
u
x
u
u
u
s
s
O
W
Q
X
O
n
s
Y
"}
(23,1,1) = {"
Y
n
n
s
n
C
n
n
u
m
J
x
u
u
n
n
s
O
y
t
O
O
n
Y
Y
"}
(24,1,1) = {"
Y
Y
Y
n
s
n
Y
Y
Y
u
u
u
u
Y
Y
C
s
O
O
O
O
s
Y
Y
Y
"}
(25,1,1) = {"
Y
Y
Y
Y
Y
Y
Y
Y
Y
Y
Y
Y
Y
Y
Y
Y
Y
Y
Y
Y
Y
Y
Y
Y
Y
"}
