//MAP CONVERTED BY dmm2tgm.py THIS HEADER COMMENT PREVENTS RECONVERSION, DO NOT REMOVE
"aj" = (
/obj/structure/rack,
/obj/effect/spawner/lootdrop/aimodule_harmless,
/obj/effect/decal/cleanable/oil,
/turf/open/floor/plating/rust,
/area/ruin/unpowered)
"bY" = (
/obj/structure/closet/crate/engineering,
/obj/effect/decal/cleanable/cobweb,
/obj/machinery/power/terminal{
	dir = 8
	},
/obj/item/stack/sheet/mineral/plasma/five,
/turf/open/floor/pod/light,
/area/ruin/unpowered)
"ch" = (
/obj/effect/decal/cleanable/plasma,
/turf/open/floor/plating/rust,
/area/ruin/unpowered)
"cJ" = (
/obj/effect/decal/cleanable/dirt/dust,
/turf/open/floor/plating,
/area/ruin/unpowered)
"cL" = (
/obj/structure/cable{
	icon_state = "2-5"
	},
/turf/open/floor/plating,
/area/ruin/unpowered)
"em" = (
/obj/structure/chair/plastic,
/turf/open/floor/plating/rust,
/area/ruin/unpowered)
"en" = (
/obj/machinery/power/port_gen/pacman,
/obj/structure/cable,
/turf/open/floor/plating,
/area/ruin/unpowered)
"fC" = (
/obj/structure/rack,
/obj/item/stack/wrapping_paper,
/obj/effect/spawner/lootdrop/gambling,
/obj/effect/decal/cleanable/cobweb,
/turf/open/floor/plating/rust,
/area/ruin/unpowered)
"gy" = (
/obj/machinery/suit_storage_unit/mining/eva,
/obj/effect/decal/cleanable/cobweb,
/obj/effect/decal/cleanable/dirt/dust,
/turf/open/floor/plating/rust,
/area/ruin/unpowered)
"gA" = (
/obj/effect/decal/cleanable/glass,
/turf/open/floor/plating/asteroid/wasteplanet,
/area/overmap_encounter/planetoid/wasteplanet/explored)
"im" = (
/obj/structure/rack,
/obj/effect/spawner/lootdrop/donkpockets,
/obj/effect/spawner/lootdrop/donkpockets,
/obj/effect/spawner/lootdrop/mafia_outfit,
/turf/open/floor/plating,
/area/ruin/unpowered)
"ip" = (
/obj/structure/chair/plastic{
	dir = 8
	},
/turf/open/floor/plating/rust,
/area/ruin/unpowered)
"iy" = (
/obj/structure/cable,
/obj/structure/statue/sandstone/assistant,
/turf/open/floor/plating/asteroid/wasteplanet,
/area/overmap_encounter/planetoid/wasteplanet/explored)
"kf" = (
/obj/structure/ore_box,
/obj/effect/decal/cleanable/dirt/dust,
/obj/effect/turf_decal/industrial/warning/full,
/turf/open/floor/plating/asteroid/wasteplanet,
/area/overmap_encounter/planetoid/wasteplanet/explored)
"kF" = (
/obj/structure/closet/crate/bin,
/turf/open/floor/plating,
/area/ruin/unpowered)
"kU" = (
/obj/machinery/computer/helm,
/turf/open/floor/pod/light,
/area/ruin/unpowered)
"kW" = (
/obj/machinery/power/shuttle/engine/electric{
	dir = 4
	},
/turf/open/floor/plating/rust,
/area/ruin/unpowered)
"mj" = (
/obj/structure/fluff/oldturret,
/turf/open/floor/plating/asteroid/wasteplanet,
/area/overmap_encounter/planetoid/wasteplanet/explored)
"mK" = (
/obj/structure/marker_beacon,
/turf/open/floor/plating/rust,
/area/overmap_encounter/planetoid/wasteplanet/explored)
"np" = (
/obj/structure/cable,
/obj/machinery/power/floodlight,
/turf/open/floor/plating/asteroid/wasteplanet,
/area/overmap_encounter/planetoid/wasteplanet/explored)
"nw" = (
/obj/effect/decal/cleanable/plasma,
/turf/open/floor/plating,
/area/ruin/unpowered)
"nO" = (
/obj/structure/barricade/wooden/crude,
/obj/structure/window/fulltile,
/turf/open/floor/plating,
/area/ruin/unpowered)
"nV" = (
/turf/closed/wall,
/area/ruin/unpowered)
"pc" = (
/obj/structure/marker_beacon,
/turf/open/floor/plating,
/area/overmap_encounter/planetoid/wasteplanet/explored)
"pl" = (
/obj/machinery/vending/snack,
/turf/open/floor/plating,
/area/ruin/unpowered)
"rJ" = (
/obj/machinery/power/smes/shuttle/precharged{
	dir = 4
	},
/obj/structure/window/reinforced/spawner/west,
/turf/open/floor/pod/light,
/area/ruin/unpowered)
"sT" = (
/obj/structure/rack,
/obj/item/stack/wrapping_paper,
/turf/open/floor/plating/rust,
/area/ruin/unpowered)
"sW" = (
/obj/structure/rack,
/obj/effect/spawner/lootdrop/gambling,
/obj/effect/decal/cleanable/garbage,
/turf/open/floor/plating,
/area/ruin/unpowered)
"tl" = (
/obj/structure/barricade/wooden/crude,
/obj/structure/window/fulltile,
/obj/effect/decal/cleanable/glass,
/turf/open/floor/plating,
/area/ruin/unpowered)
"tm" = (
/obj/structure/table/reinforced,
/obj/item/flashlight/lamp/green,
/obj/effect/decal/cleanable/cobweb/cobweb2,
/turf/open/floor/plating/rust,
/area/ruin/unpowered)
"tp" = (
/turf/open/floor/pod/light,
/area/ruin/unpowered)
"ts" = (
/obj/effect/decal/cleanable/dirt/dust,
/obj/structure/chair/plastic{
	dir = 4
	},
/turf/open/floor/plating,
/area/ruin/unpowered)
"tU" = (
/obj/structure/closet/crate,
/obj/effect/decal/cleanable/dirt/dust,
/obj/effect/turf_decal/industrial/warning/full,
/obj/item/stack/sheet/mineral/plasma/five,
/turf/open/floor/plating/asteroid/wasteplanet,
/area/overmap_encounter/planetoid/wasteplanet/explored)
"uc" = (
/obj/machinery/door/airlock/shuttle,
/turf/open/floor/pod/light,
/area/ruin/unpowered)
"un" = (
/obj/effect/decal/cleanable/dirt/dust,
/turf/closed/wall/mineral/titanium,
/area/ruin/unpowered)
"uL" = (
/obj/structure/window/fulltile,
/obj/structure/barricade/wooden/crude,
/turf/open/floor/plating,
/area/ruin/unpowered)
"wA" = (
/obj/effect/decal/cleanable/dirt/dust,
/turf/open/floor/pod/light,
/area/ruin/unpowered)
"wB" = (
/obj/effect/decal/cleanable/garbage,
/obj/effect/decal/cleanable/dirt/dust,
/turf/open/floor/plating,
/area/ruin/unpowered)
"wM" = (
/obj/item/bot_assembly/medbot,
/turf/open/floor/plating/asteroid/wasteplanet,
/area/overmap_encounter/planetoid/wasteplanet/explored)
"yd" = (
/obj/structure/statue/sandstone/assistant,
/obj/structure/cable{
	icon_state = "4-9"
	},
/turf/open/floor/plating/asteroid/wasteplanet,
/area/overmap_encounter/planetoid/wasteplanet/explored)
"ym" = (
/turf/open/floor/plating/rust,
/area/ruin/unpowered)
"yI" = (
/obj/effect/decal/cleanable/dirt/dust,
/obj/structure/chair/plastic{
	dir = 8
	},
/turf/open/floor/plating/rust,
/area/ruin/unpowered)
"ze" = (
/obj/structure/cable{
	icon_state = "1-2"
	},
/turf/open/floor/plating,
/area/ruin/unpowered)
"zq" = (
/obj/machinery/modular_computer/console/preset/civilian,
/obj/effect/decal/cleanable/cobweb/cobweb2,
/obj/effect/decal/cleanable/dirt/dust,
/turf/open/floor/pod/light,
/area/ruin/unpowered)
"zY" = (
/obj/structure/closet/crate,
/obj/effect/decal/cleanable/dirt/dust,
/obj/item/gun/ballistic/revolver/detective,
/turf/open/floor/pod/light,
/area/ruin/unpowered)
"Ag" = (
/obj/effect/decal/cleanable/oil,
/turf/open/floor/plating/asteroid/wasteplanet,
/area/overmap_encounter/planetoid/wasteplanet/explored)
"Ba" = (
/obj/structure/door_assembly/door_assembly_highsecurity,
/obj/structure/cable{
	icon_state = "6-8"
	},
/turf/open/floor/plating/rust,
/area/ruin/unpowered)
"BE" = (
/obj/structure/door_assembly/door_assembly_hatch,
/obj/structure/cable{
	icon_state = "1-6"
	},
/turf/open/floor/plating,
/area/ruin/unpowered)
"Cf" = (
/obj/structure/rack,
/obj/item/stack/wrapping_paper,
/obj/effect/decal/cleanable/garbage,
/turf/open/floor/plating,
/area/ruin/unpowered)
"Cl" = (
/obj/mecha/working/ripley/cargo,
/obj/effect/turf_decal/industrial/warning/full,
/turf/open/floor/plating/asteroid/wasteplanet,
/area/overmap_encounter/planetoid/wasteplanet/explored)
"CC" = (
/obj/effect/decal/cleanable/dirt/dust,
/turf/open/floor/plating/rust,
/area/overmap_encounter/planetoid/wasteplanet/explored)
"De" = (
/turf/template_noop,
/area/template_noop)
"Eg" = (
/obj/effect/decal/cleanable/dirt/dust,
/obj/structure/chair/comfy/shuttle{
	dir = 1
	},
/turf/open/floor/pod/light,
/area/ruin/unpowered)
"Fc" = (
/obj/structure/door_assembly/door_assembly_hatch,
/turf/open/floor/plating,
/area/ruin/unpowered)
"Ga" = (
/obj/effect/decal/cleanable/blood/old,
/turf/open/floor/plating,
/area/ruin/unpowered)
"Gg" = (
/turf/open/floor/plating,
/area/ruin/unpowered)
"Ha" = (
/obj/structure/table/wood/poker,
/obj/item/storage/bag/money/vault,
/turf/open/floor/carpet/red,
/area/ruin/unpowered)
"Hm" = (
/obj/effect/decal/fakelattice,
/turf/open/floor/plating/asteroid/wasteplanet,
/area/overmap_encounter/planetoid/wasteplanet/explored)
"IN" = (
/obj/structure/grille,
/obj/effect/spawner/structure/window/shuttle,
/turf/open/floor/pod/light,
/area/ruin/unpowered)
"IU" = (
/obj/machinery/power/floodlight,
/obj/structure/cable{
	icon_state = "0-8"
	},
/turf/open/floor/plating/asteroid/wasteplanet,
/area/overmap_encounter/planetoid/wasteplanet/explored)
"IZ" = (
/obj/effect/decal/cleanable/robot_debris,
/turf/open/floor/plating/asteroid/wasteplanet,
/area/overmap_encounter/planetoid/wasteplanet/explored)
"Jh" = (
/obj/machinery/power/terminal{
	dir = 8
	},
/turf/open/floor/pod/light,
/area/ruin/unpowered)
"Lm" = (
/turf/closed/wall/mineral/titanium,
/area/ruin/unpowered)
"Ln" = (
/turf/open/floor/carpet/red,
/area/ruin/unpowered)
"LG" = (
/obj/effect/turf_decal/industrial/warning/full,
/turf/open/floor/plating/asteroid/wasteplanet,
/area/overmap_encounter/planetoid/wasteplanet/explored)
"LO" = (
/obj/structure/closet/crate,
/obj/effect/turf_decal/industrial/warning/full,
/obj/item/stack/sheet/mineral/plasma/five,
/turf/open/floor/plating/asteroid/wasteplanet,
/area/overmap_encounter/planetoid/wasteplanet/explored)
"Ma" = (
/obj/effect/decal/cleanable/dirt/dust,
/obj/effect/decal/cleanable/oil,
/turf/open/floor/plating,
/area/ruin/unpowered)
"MR" = (
/obj/effect/decal/cleanable/dirt/dust,
/turf/open/floor/plating,
/area/overmap_encounter/planetoid/wasteplanet/explored)
"Nl" = (
/obj/effect/decal/cleanable/greenglow,
/turf/open/floor/plating/asteroid/wasteplanet,
/area/overmap_encounter/planetoid/wasteplanet/explored)
"OC" = (
/obj/structure/chair/comfy/shuttle{
	dir = 1
	},
/turf/open/floor/pod/light,
/area/ruin/unpowered)
"OV" = (
/obj/effect/decal/cleanable/dirt/dust,
/turf/open/floor/plating/rust,
/area/ruin/unpowered)
"OY" = (
/obj/structure/chair/office{
	dir = 8
	},
/turf/open/floor/plating,
/area/ruin/unpowered)
"OZ" = (
/obj/structure/cable{
	icon_state = "4-10"
	},
/turf/open/floor/plating/rust,
/area/ruin/unpowered)
"PS" = (
/obj/structure/rack,
/obj/effect/decal/cleanable/garbage,
/obj/item/circuitboard/machine/thermomachine,
/turf/open/floor/plating,
/area/ruin/unpowered)
"Qp" = (
/obj/machinery/holopad,
/turf/open/floor/plating,
/area/ruin/unpowered)
"QD" = (
/obj/structure/rack,
/obj/effect/spawner/lootdrop/gambling,
/obj/effect/decal/cleanable/garbage,
/obj/effect/decal/cleanable/dirt/dust,
/obj/item/wrench,
/turf/open/floor/plating,
/area/ruin/unpowered)
"Rc" = (
/obj/structure/chair/plastic{
	dir = 4
	},
/turf/open/floor/plating/rust,
/area/ruin/unpowered)
"RB" = (
/obj/structure/chair{
	dir = 4
	},
/obj/effect/decal/cleanable/blood/old,
/obj/effect/decal/cleanable/dirt/dust,
/turf/open/floor/carpet/red,
/area/ruin/unpowered)
"RE" = (
/obj/effect/decal/cleanable/dirt/dust,
/obj/structure/cable{
	icon_state = "2-9"
	},
/turf/open/floor/plating,
/area/ruin/unpowered)
"Sn" = (
/turf/open/floor/plating,
/area/overmap_encounter/planetoid/wasteplanet/explored)
"SE" = (
/obj/effect/decal/cleanable/food/tomato_smudge,
/turf/open/floor/plating/rust,
/area/ruin/unpowered)
"Tk" = (
/turf/open/floor/plating/rust,
/area/overmap_encounter/planetoid/wasteplanet/explored)
"Tl" = (
/obj/effect/decal/cleanable/glass,
/turf/open/floor/plating,
/area/ruin/unpowered)
"TB" = (
/obj/structure/closet/crate/miningcar,
/obj/effect/turf_decal/industrial/warning/full,
/obj/item/stack/sheet/mineral/plasma,
/obj/item/stack/sheet/mineral/plasma,
/obj/item/stack/sheet/mineral/plasma,
/obj/item/stack/sheet/mineral/plasma,
/turf/open/floor/plating/asteroid/wasteplanet,
/area/overmap_encounter/planetoid/wasteplanet/explored)
"Ue" = (
/turf/closed/wall/rust,
/area/ruin/unpowered)
"VU" = (
/mob/living/simple_animal/pet/cat/kitten,
/turf/open/floor/plating,
/area/ruin/unpowered)
"Xc" = (
/obj/structure/filingcabinet/chestdrawer,
/obj/effect/decal/cleanable/cobweb/cobweb2,
/turf/open/floor/plating,
/area/ruin/unpowered)
"Ya" = (
/turf/open/floor/plating/asteroid/wasteplanet,
/area/overmap_encounter/planetoid/wasteplanet/explored)
"YH" = (
/obj/effect/decal/cleanable/dirt/dust,
/obj/structure/chair/plastic,
/turf/open/floor/plating,
/area/ruin/unpowered)
"Zq" = (
/obj/structure/table/wood/poker,
/obj/item/stack/sheet/mineral/plasma,
/obj/item/storage/pill_bottle/zoom,
/turf/open/floor/carpet/red,
/area/ruin/unpowered)

(1,1,1) = {"
De
De
De
De
De
Ue
Ue
Ue
nV
nV
nV
mj
Ya
Ya
Ya
Ya
Ya
De
De
De
"}
(2,1,1) = {"
De
De
De
De
De
Ue
fC
ch
im
Ga
nV
IZ
Ya
pc
MR
Tk
Tk
Tk
mK
De
"}
(3,1,1) = {"
De
De
De
De
De
Ue
sT
wB
QD
Gg
tl
wM
Ya
Lm
CC
kW
kW
MR
Lm
De
"}
(4,1,1) = {"
De
De
De
De
De
Ue
sW
Ga
Cf
OV
tl
Ya
Ya
un
Lm
rJ
rJ
Lm
Lm
De
"}
(5,1,1) = {"
Ue
uL
uL
uL
Ue
nV
PS
Tl
aj
SE
Ue
Ya
Ya
Lm
Lm
bY
Jh
Lm
Lm
De
"}
(6,1,1) = {"
nV
cJ
Rc
ts
ym
nV
Ma
Gg
cJ
ym
Ue
np
Ya
Tk
Lm
zY
wA
un
CC
De
"}
(7,1,1) = {"
uL
YH
Gg
Qp
Gg
Fc
Gg
VU
cJ
Gg
nV
iy
Ya
Tk
uc
tp
tp
uc
Tk
De
"}
(8,1,1) = {"
uL
em
Gg
OV
cJ
Ue
em
nw
cL
ze
BE
Hm
Hm
Tk
Lm
kU
Eg
Lm
Tk
De
"}
(9,1,1) = {"
nV
OV
yI
ip
cJ
Ue
tm
OZ
cJ
kF
nV
yd
Ya
Tk
Lm
zq
OC
Lm
Tk
De
"}
(10,1,1) = {"
nV
uL
uL
uL
Ue
Ue
Ue
Ba
nV
nV
nV
IU
Ya
CC
Lm
IN
IN
Lm
CC
De
"}
(11,1,1) = {"
De
De
De
De
De
Ue
gy
Gg
RE
en
nV
Ya
Ya
mK
Tk
Tk
CC
Sn
pc
De
"}
(12,1,1) = {"
De
De
De
De
De
Ue
cJ
Ln
RB
Gg
nO
Ya
Ya
Ya
Hm
Ya
Ya
Hm
De
De
"}
(13,1,1) = {"
De
De
De
De
De
nV
pl
Ha
Zq
cJ
nO
gA
Ya
Ya
tU
LO
LO
TB
Ya
De
"}
(14,1,1) = {"
De
De
De
De
De
nV
Xc
cJ
OY
ym
Ue
Ya
Nl
Ya
Cl
LO
kf
LG
Ag
De
"}
(15,1,1) = {"
De
De
De
De
De
nV
nV
nV
Ue
Ue
Ue
mj
Ya
Ya
Ya
Ya
De
De
De
De
"}
