//MAP CONVERTED BY dmm2tgm.py THIS HEADER COMMENT PREVENTS RECONVERSION, DO NOT REMOVE
"ax" = (
/obj/effect/decal/cleanable/blood/old,
/turf/open/floor/concrete/slab_1,
/area/overmap_encounter/planetoid/wasteplanet/explored)
"bQ" = (
/turf/open/floor/concrete/pavement,
/area/overmap_encounter/planetoid/wasteplanet/explored)
"cb" = (
/obj/effect/turf_decal/road,
/obj/effect/turf_decal/road/stripes,
/turf/open/floor/concrete/pavement,
/area/overmap_encounter/planetoid/wasteplanet/explored)
"ci" = (
/obj/structure/fence/door,
/turf/open/floor/plating/asteroid/wasteplanet,
/area/overmap_encounter/planetoid/wasteplanet/explored)
"cA" = (
/obj/effect/turf_decal/number/one,
/turf/open/floor/concrete,
/area/overmap_encounter/planetoid/wasteplanet/explored)
"cS" = (
/obj/effect/turf_decal/road{
	dir = 1
	},
/obj/item/grenade/frag,
/turf/open/floor/concrete/pavement,
/area/overmap_encounter/planetoid/wasteplanet/explored)
"cT" = (
/obj/structure/barricade/sandbags,
/obj/effect/turf_decal/road,
/obj/effect/turf_decal/road/stripes,
/turf/open/floor/concrete/pavement,
/area/overmap_encounter/planetoid/wasteplanet/explored)
"dl" = (
/obj/effect/turf_decal/road/line/edge/opaque/yellow,
/turf/open/floor/concrete/pavement,
/area/overmap_encounter/planetoid/wasteplanet/explored)
"dp" = (
/obj/structure/flippedtable,
/turf/open/floor/concrete,
/area/ruin/unpowered)
"dA" = (
/obj/effect/turf_decal/road{
	dir = 5
	},
/obj/effect/decal/cleanable/dirt,
/turf/open/floor/concrete/pavement,
/area/overmap_encounter/planetoid/wasteplanet/explored)
"dU" = (
/obj/effect/decal/cleanable/dirt/dust,
/turf/open/floor/concrete/slab_1,
/area/overmap_encounter/planetoid/wasteplanet/explored)
"eh" = (
/obj/structure/fence,
/turf/open/floor/plating/asteroid/wasteplanet,
/area/overmap_encounter/planetoid/wasteplanet/explored)
"eC" = (
/obj/effect/turf_decal/number/one{
	dir = 1
	},
/turf/open/floor/concrete,
/area/overmap_encounter/planetoid/wasteplanet/explored)
"eN" = (
/obj/structure/barricade/sandbags,
/obj/effect/turf_decal/road{
	dir = 8
	},
/turf/open/floor/concrete/pavement,
/area/overmap_encounter/planetoid/wasteplanet/explored)
"ff" = (
/turf/open/floor/concrete,
/area/ruin/unpowered)
"gj" = (
/obj/item/gun/ballistic/automatic/pistol/commander/no_mag,
/turf/open/floor/plating/asteroid/wasteplanet,
/area/overmap_encounter/planetoid/wasteplanet/explored)
"gn" = (
/obj/effect/turf_decal/road{
	dir = 1
	},
/obj/structure/barricade/sandbags,
/turf/open/floor/concrete/pavement,
/area/overmap_encounter/planetoid/wasteplanet/explored)
"gT" = (
/obj/effect/turf_decal/road{
	dir = 8
	},
/obj/effect/turf_decal/road/stripes{
	dir = 4
	},
/turf/open/floor/concrete/pavement,
/area/overmap_encounter/planetoid/wasteplanet/explored)
"hT" = (
/obj/structure/marker_beacon,
/turf/open/floor/concrete,
/area/overmap_encounter/planetoid/wasteplanet/explored)
"iB" = (
/obj/effect/decal/cleanable/dirt,
/turf/open/floor/concrete,
/area/overmap_encounter/planetoid/wasteplanet/explored)
"iH" = (
/obj/structure/barricade/sandbags,
/obj/effect/turf_decal/road{
	dir = 4
	},
/obj/effect/decal/cleanable/dirt,
/turf/open/floor/concrete/pavement,
/area/overmap_encounter/planetoid/wasteplanet/explored)
"iM" = (
/obj/structure/fence/corner{
	dir = 9
	},
/turf/open/floor/plating/asteroid/wasteplanet,
/area/overmap_encounter/planetoid/wasteplanet/explored)
"iN" = (
/obj/effect/turf_decal/road/line/edge/opaque/yellow{
	dir = 1
	},
/obj/effect/decal/cleanable/dirt,
/turf/open/floor/plating/asteroid/wasteplanet,
/area/overmap_encounter/planetoid/wasteplanet/explored)
"iV" = (
/obj/effect/turf_decal/road/line/opaque/yellow{
	dir = 8
	},
/obj/structure/barricade/sandbags,
/turf/open/floor/concrete/pavement,
/area/overmap_encounter/planetoid/wasteplanet/explored)
"jf" = (
/obj/structure/fence/corner,
/turf/open/floor/plating/asteroid/wasteplanet,
/area/overmap_encounter/planetoid/wasteplanet/explored)
"kj" = (
/obj/structure/marker_beacon,
/obj/effect/decal/cleanable/dirt,
/turf/open/floor/concrete,
/area/overmap_encounter/planetoid/wasteplanet/explored)
"ku" = (
/obj/effect/turf_decal/industrial/hatch,
/turf/open/floor/concrete,
/area/overmap_encounter/planetoid/wasteplanet/explored)
"kV" = (
/obj/vehicle/ridden/atv,
/obj/effect/turf_decal/siding/white{
	dir = 4
	},
/obj/machinery/light/dim/directional/west,
/obj/effect/decal/cleanable/dirt/dust,
/obj/effect/decal/cleanable/dirt/dust,
/turf/open/floor/concrete,
/area/ruin/unpowered)
"lC" = (
/obj/effect/turf_decal/road/line/edge/opaque/yellow,
/obj/effect/decal/cleanable/dirt,
/turf/open/floor/concrete/pavement,
/area/overmap_encounter/planetoid/wasteplanet/explored)
"mk" = (
/obj/effect/decal/cleanable/dirt/dust,
/turf/open/floor/concrete,
/area/ruin/unpowered)
"mr" = (
/obj/effect/turf_decal/road/line/edge/opaque/yellow{
	dir = 1
	},
/obj/effect/decal/cleanable/dirt,
/turf/open/floor/concrete/pavement,
/area/overmap_encounter/planetoid/wasteplanet/explored)
"my" = (
/obj/machinery/light/dim/directional/south,
/turf/open/floor/concrete,
/area/ruin/unpowered)
"mM" = (
/obj/machinery/door/airlock/engineering,
/obj/effect/mapping_helpers/airlock/locked,
/turf/open/floor/concrete,
/area/ruin/unpowered)
"nI" = (
/obj/effect/turf_decal/road/stripes{
	dir = 4
	},
/turf/open/floor/concrete/pavement,
/area/overmap_encounter/planetoid/wasteplanet/explored)
"oc" = (
/obj/item/reagent_containers/glass/bucket,
/turf/open/floor/plating/asteroid/wasteplanet,
/area/overmap_encounter/planetoid/wasteplanet/explored)
"qe" = (
/obj/structure/barricade/sandbags,
/turf/open/floor/concrete/slab_1,
/area/overmap_encounter/planetoid/wasteplanet/explored)
"qI" = (
/obj/structure/barricade/sandbags,
/obj/effect/turf_decal/road{
	dir = 1
	},
/obj/effect/turf_decal/road/stripes,
/turf/open/floor/concrete/pavement,
/area/overmap_encounter/planetoid/wasteplanet/explored)
"rb" = (
/obj/effect/turf_decal/industrial/warning{
	dir = 1
	},
/obj/effect/decal/cleanable/dirt/dust,
/turf/open/floor/concrete,
/area/ruin/unpowered)
"rw" = (
/obj/effect/turf_decal/road/line/opaque/yellow{
	dir = 8
	},
/turf/open/floor/concrete/pavement,
/area/overmap_encounter/planetoid/wasteplanet/explored)
"rV" = (
/obj/effect/turf_decal/road/line/edge/opaque/yellow{
	dir = 4
	},
/obj/effect/decal/cleanable/blood/old,
/turf/open/floor/concrete/pavement,
/area/overmap_encounter/planetoid/wasteplanet/explored)
"sE" = (
/obj/effect/turf_decal/road{
	dir = 1
	},
/turf/open/floor/concrete/pavement,
/area/overmap_encounter/planetoid/wasteplanet/explored)
"sW" = (
/obj/effect/turf_decal/road/line/opaque/yellow,
/turf/open/floor/concrete/pavement,
/area/overmap_encounter/planetoid/wasteplanet/explored)
"th" = (
/obj/effect/turf_decal/road/line/edge/opaque/yellow{
	dir = 8
	},
/turf/open/floor/concrete/pavement,
/area/overmap_encounter/planetoid/wasteplanet/explored)
"ts" = (
/obj/effect/turf_decal/road/line/opaque/yellow{
	dir = 1
	},
/obj/effect/decal/cleanable/blood/old,
/turf/open/floor/concrete/pavement,
/area/overmap_encounter/planetoid/wasteplanet/explored)
"tH" = (
/obj/effect/turf_decal/road{
	dir = 4
	},
/obj/effect/decal/cleanable/dirt,
/turf/open/floor/concrete/pavement,
/area/overmap_encounter/planetoid/wasteplanet/explored)
"ub" = (
/obj/effect/turf_decal/siding/white{
	dir = 4
	},
/turf/open/floor/concrete,
/area/ruin/unpowered)
"uf" = (
/obj/effect/turf_decal/road,
/obj/structure/barricade/sandbags,
/turf/open/floor/concrete/pavement,
/area/overmap_encounter/planetoid/wasteplanet/explored)
"uA" = (
/obj/machinery/door/poddoor/shutters,
/turf/open/floor/concrete/tiles,
/area/ruin/unpowered)
"uJ" = (
/obj/effect/turf_decal/road{
	dir = 4
	},
/obj/effect/turf_decal/road/stripes{
	dir = 4
	},
/turf/open/floor/concrete/pavement,
/area/overmap_encounter/planetoid/wasteplanet/explored)
"uO" = (
/obj/effect/turf_decal/road/line/edge/opaque/yellow{
	dir = 4
	},
/obj/effect/decal/cleanable/dirt,
/turf/open/floor/concrete/pavement,
/area/overmap_encounter/planetoid/wasteplanet/explored)
"vp" = (
/obj/effect/turf_decal/road/stop{
	dir = 8
	},
/turf/open/floor/concrete/pavement,
/area/overmap_encounter/planetoid/wasteplanet/explored)
"vT" = (
/obj/effect/turf_decal/road/line/opaque/yellow,
/obj/structure/barricade/sandbags,
/turf/open/floor/concrete/pavement,
/area/overmap_encounter/planetoid/wasteplanet/explored)
"wz" = (
/obj/structure/fence/corner{
	dir = 10
	},
/turf/open/floor/plating/asteroid/wasteplanet,
/area/overmap_encounter/planetoid/wasteplanet/explored)
"wI" = (
/turf/open/floor/concrete,
/area/overmap_encounter/planetoid/wasteplanet/explored)
"wN" = (
/obj/effect/turf_decal/road{
	dir = 8
	},
/obj/effect/decal/cleanable/blood/old,
/turf/open/floor/concrete/pavement,
/area/overmap_encounter/planetoid/wasteplanet/explored)
"wR" = (
/obj/structure/table,
/obj/item/weldingtool/hugetank/empty,
/obj/effect/decal/cleanable/dirt/dust,
/obj/effect/decal/cleanable/dirt/dust,
/obj/effect/decal/cleanable/dirt/dust,
/turf/open/floor/concrete,
/area/ruin/unpowered)
"xt" = (
/obj/effect/turf_decal/road{
	dir = 8
	},
/obj/effect/decal/cleanable/dirt,
/turf/open/floor/concrete/pavement,
/area/overmap_encounter/planetoid/wasteplanet/explored)
"xF" = (
/obj/effect/turf_decal/industrial/warning{
	dir = 1
	},
/turf/open/floor/concrete,
/area/ruin/unpowered)
"xM" = (
/obj/effect/turf_decal/road{
	dir = 4
	},
/turf/open/floor/plating/asteroid/wasteplanet,
/area/overmap_encounter/planetoid/wasteplanet/explored)
"xQ" = (
/turf/template_noop,
/area/template_noop)
"xV" = (
/obj/effect/turf_decal/road,
/turf/open/floor/concrete/pavement,
/area/overmap_encounter/planetoid/wasteplanet/explored)
"xZ" = (
/obj/effect/turf_decal/siding/white{
	dir = 4
	},
/obj/effect/decal/cleanable/dirt/dust,
/turf/open/floor/concrete,
/area/ruin/unpowered)
"yv" = (
/obj/effect/turf_decal/industrial/warning{
	dir = 1
	},
/obj/effect/decal/cleanable/dirt/dust,
/obj/item/paper{
	default_raw_text = "First, take a scoop out of the pit. Go ahead,d try it out! Second, mix it with raw cement. Then simply add some sand to it, doesn't matter. Then you got yourself some pavement. Simply pour it on some catwalk and you got yourself some roadway. More efficent this way too. Enjoy. On a side note, I hear something outside, better check that out. I'll finish his later."
	},
/turf/open/floor/concrete,
/area/ruin/unpowered)
"yG" = (
/obj/effect/turf_decal/road/line/opaque/yellow{
	dir = 1
	},
/obj/effect/decal/cleanable/dirt,
/turf/open/floor/concrete/pavement,
/area/overmap_encounter/planetoid/wasteplanet/explored)
"yW" = (
/obj/machinery/light/dim/directional/east,
/turf/open/floor/concrete,
/area/ruin/unpowered)
"zu" = (
/obj/effect/turf_decal/road/line/opaque/yellow{
	dir = 4
	},
/turf/open/floor/concrete/pavement,
/area/overmap_encounter/planetoid/wasteplanet/explored)
"zU" = (
/obj/effect/turf_decal/number/one{
	dir = 1
	},
/turf/open/floor/plating/asteroid/wasteplanet,
/area/overmap_encounter/planetoid/wasteplanet/explored)
"AO" = (
/obj/machinery/light/dim/directional/west,
/turf/open/floor/concrete,
/area/ruin/unpowered)
"Bk" = (
/obj/effect/decal/cleanable/dirt,
/turf/open/floor/concrete/slab_1,
/area/overmap_encounter/planetoid/wasteplanet/explored)
"BB" = (
/obj/effect/turf_decal/road/line/edge/opaque/yellow,
/obj/item/clothing/head/helmet,
/turf/open/floor/concrete/pavement,
/area/overmap_encounter/planetoid/wasteplanet/explored)
"BS" = (
/obj/structure/flippedtable,
/obj/effect/decal/cleanable/dirt/dust,
/turf/open/floor/concrete,
/area/ruin/unpowered)
"Cj" = (
/obj/structure/barricade/sandbags,
/turf/open/floor/plating/asteroid/wasteplanet,
/area/overmap_encounter/planetoid/wasteplanet/explored)
"Di" = (
/obj/effect/turf_decal/road/line/edge/opaque/yellow{
	dir = 4
	},
/turf/open/floor/concrete/pavement,
/area/overmap_encounter/planetoid/wasteplanet/explored)
"DC" = (
/obj/effect/turf_decal/road{
	dir = 4
	},
/obj/structure/barricade/sandbags,
/obj/effect/decal/cleanable/dirt,
/turf/open/floor/concrete/pavement,
/area/overmap_encounter/planetoid/wasteplanet/explored)
"Eh" = (
/obj/effect/turf_decal/road/edge{
	dir = 1
	},
/turf/open/floor/concrete/pavement,
/area/overmap_encounter/planetoid/wasteplanet/explored)
"Eu" = (
/obj/effect/turf_decal/road{
	dir = 8
	},
/obj/structure/barricade/sandbags,
/turf/open/floor/concrete/pavement,
/area/overmap_encounter/planetoid/wasteplanet/explored)
"EX" = (
/obj/effect/turf_decal/road/stripes{
	dir = 8
	},
/turf/open/floor/concrete/pavement,
/area/overmap_encounter/planetoid/wasteplanet/explored)
"Ff" = (
/obj/structure/sign/warning/fire{
	pixel_y = 32
	},
/obj/structure/reagent_dispensers/fueltank,
/obj/effect/decal/cleanable/dirt/dust,
/turf/open/floor/concrete,
/area/ruin/unpowered)
"GD" = (
/obj/effect/turf_decal/road/line/opaque/yellow,
/obj/effect/decal/cleanable/dirt,
/turf/open/floor/concrete/pavement,
/area/overmap_encounter/planetoid/wasteplanet/explored)
"Hv" = (
/obj/effect/turf_decal/road/line/edge/opaque/yellow{
	dir = 8
	},
/obj/effect/decal/cleanable/dirt,
/obj/item/clothing/head/helmet,
/turf/open/floor/concrete/pavement,
/area/overmap_encounter/planetoid/wasteplanet/explored)
"Hw" = (
/obj/effect/turf_decal/road,
/obj/effect/decal/cleanable/dirt,
/turf/open/floor/concrete/pavement,
/area/overmap_encounter/planetoid/wasteplanet/explored)
"Io" = (
/obj/structure/barricade/sandbags,
/obj/effect/turf_decal/road/stop,
/turf/open/floor/concrete/pavement,
/area/overmap_encounter/planetoid/wasteplanet/explored)
"Jo" = (
/obj/effect/turf_decal/road/line/opaque/yellow,
/obj/effect/decal/cleanable/dirt,
/obj/effect/decal/cleanable/dirt,
/turf/open/floor/concrete/pavement,
/area/overmap_encounter/planetoid/wasteplanet/explored)
"JF" = (
/obj/effect/turf_decal/road/line/edge/opaque/yellow{
	dir = 4
	},
/obj/effect/turf_decal/road/stripes,
/turf/open/floor/concrete/pavement,
/area/overmap_encounter/planetoid/wasteplanet/explored)
"JI" = (
/obj/effect/decal/cleanable/dirt,
/turf/open/floor/plating/asteroid/wasteplanet,
/area/overmap_encounter/planetoid/wasteplanet/explored)
"JZ" = (
/obj/effect/turf_decal/road/line/opaque/yellow{
	dir = 1
	},
/obj/structure/barricade/sandbags,
/turf/open/floor/concrete/pavement,
/area/overmap_encounter/planetoid/wasteplanet/explored)
"Ka" = (
/obj/effect/turf_decal/road/line/edge/opaque/yellow{
	dir = 1
	},
/turf/open/floor/concrete/pavement,
/area/overmap_encounter/planetoid/wasteplanet/explored)
"Kd" = (
/obj/effect/turf_decal/road/line/opaque/yellow{
	dir = 1
	},
/turf/open/floor/concrete/pavement,
/area/overmap_encounter/planetoid/wasteplanet/explored)
"KX" = (
/turf/closed/wall/concrete,
/area/ruin/unpowered)
"Li" = (
/obj/effect/turf_decal/road/line/opaque/yellow{
	dir = 8
	},
/obj/effect/decal/cleanable/dirt,
/turf/open/floor/concrete/pavement,
/area/overmap_encounter/planetoid/wasteplanet/explored)
"Lm" = (
/obj/effect/turf_decal/road{
	dir = 4
	},
/obj/effect/turf_decal/road/stripes{
	dir = 8
	},
/turf/open/floor/concrete/pavement,
/area/overmap_encounter/planetoid/wasteplanet/explored)
"LY" = (
/obj/structure/barricade/sandbags,
/turf/open/floor/concrete,
/area/ruin/unpowered)
"OR" = (
/obj/effect/turf_decal/road/line/edge/opaque/yellow{
	dir = 1
	},
/obj/structure/barricade/sandbags,
/turf/open/floor/concrete/pavement,
/area/overmap_encounter/planetoid/wasteplanet/explored)
"Pu" = (
/obj/effect/turf_decal/road/line/edge/opaque/yellow{
	dir = 8
	},
/obj/effect/decal/cleanable/dirt,
/turf/open/floor/concrete/pavement,
/area/overmap_encounter/planetoid/wasteplanet/explored)
"PD" = (
/obj/effect/turf_decal/road{
	dir = 9
	},
/turf/open/floor/concrete/pavement,
/area/overmap_encounter/planetoid/wasteplanet/explored)
"PF" = (
/obj/effect/turf_decal/siding/white{
	dir = 4
	},
/obj/effect/decal/cleanable/dirt/dust,
/obj/effect/decal/cleanable/dirt/dust,
/turf/open/floor/concrete,
/area/ruin/unpowered)
"Qk" = (
/obj/effect/turf_decal/road/stripes{
	dir = 8
	},
/obj/effect/decal/cleanable/dirt,
/turf/open/floor/concrete/pavement,
/area/overmap_encounter/planetoid/wasteplanet/explored)
"Re" = (
/obj/effect/turf_decal/road{
	dir = 6
	},
/turf/open/floor/concrete/pavement,
/area/overmap_encounter/planetoid/wasteplanet/explored)
"Rw" = (
/obj/effect/turf_decal/number/one{
	dir = 1
	},
/obj/effect/decal/cleanable/dirt,
/turf/open/floor/concrete,
/area/overmap_encounter/planetoid/wasteplanet/explored)
"Ry" = (
/obj/effect/turf_decal/road/line/edge/opaque/yellow{
	dir = 4
	},
/obj/structure/barricade/sandbags,
/turf/open/floor/concrete/pavement,
/area/overmap_encounter/planetoid/wasteplanet/explored)
"RO" = (
/obj/effect/turf_decal/road/stop{
	dir = 4
	},
/turf/open/floor/concrete/pavement,
/area/overmap_encounter/planetoid/wasteplanet/explored)
"RP" = (
/obj/effect/turf_decal/road{
	dir = 1
	},
/obj/effect/turf_decal/road/stripes,
/turf/open/floor/concrete/pavement,
/area/overmap_encounter/planetoid/wasteplanet/explored)
"RT" = (
/obj/structure/table,
/obj/effect/decal/cleanable/dirt/dust,
/turf/open/floor/concrete,
/area/ruin/unpowered)
"Sx" = (
/obj/structure/fence{
	dir = 8
	},
/turf/open/floor/plating/asteroid/wasteplanet,
/area/overmap_encounter/planetoid/wasteplanet/explored)
"Ty" = (
/obj/structure/fence/corner{
	dir = 4
	},
/turf/open/floor/plating/asteroid/wasteplanet,
/area/overmap_encounter/planetoid/wasteplanet/explored)
"UZ" = (
/obj/structure/table,
/obj/item/pickaxe/drill,
/obj/machinery/light/dim/directional/east,
/obj/effect/decal/cleanable/dirt/dust,
/turf/open/floor/concrete,
/area/ruin/unpowered)
"Vf" = (
/obj/structure/barricade/sandbags,
/obj/effect/turf_decal/road/stripes,
/turf/open/floor/concrete/pavement,
/area/overmap_encounter/planetoid/wasteplanet/explored)
"VD" = (
/obj/structure/table,
/turf/open/floor/concrete,
/area/ruin/unpowered)
"VE" = (
/obj/effect/turf_decal/road/line/edge/opaque/yellow,
/obj/effect/turf_decal/road/stripes,
/turf/open/floor/concrete/pavement,
/area/overmap_encounter/planetoid/wasteplanet/explored)
"Wr" = (
/turf/open/floor/plating/asteroid/wasteplanet,
/area/overmap_encounter/planetoid/wasteplanet/explored)
"WP" = (
/obj/effect/turf_decal/road/line/edge/opaque/yellow{
	dir = 1
	},
/obj/effect/decal/cleanable/blood/old,
/obj/item/gun/ballistic/automatic/pistol/commander/no_mag,
/turf/open/floor/concrete/pavement,
/area/overmap_encounter/planetoid/wasteplanet/explored)
"Xn" = (
/obj/effect/turf_decal/road{
	dir = 8
	},
/turf/open/floor/concrete/pavement,
/area/overmap_encounter/planetoid/wasteplanet/explored)
"XC" = (
/obj/effect/decal/cleanable/dirt/dust,
/obj/effect/decal/cleanable/dirt/dust,
/turf/open/floor/concrete,
/area/ruin/unpowered)
"XN" = (
/obj/effect/turf_decal/road{
	dir = 1
	},
/obj/item/clothing/head/helmet,
/turf/open/floor/concrete/pavement,
/area/overmap_encounter/planetoid/wasteplanet/explored)
"XT" = (
/obj/effect/turf_decal/road{
	dir = 8
	},
/obj/effect/turf_decal/road/stripes{
	dir = 8
	},
/turf/open/floor/concrete/pavement,
/area/overmap_encounter/planetoid/wasteplanet/explored)
"Yc" = (
/obj/effect/turf_decal/road{
	dir = 4
	},
/turf/open/floor/concrete/pavement,
/area/overmap_encounter/planetoid/wasteplanet/explored)
"YB" = (
/turf/open/water/tar,
/area/overmap_encounter/planetoid/wasteplanet/explored)
"YO" = (
/obj/effect/turf_decal/road/line/edge/opaque/yellow{
	dir = 4
	},
/obj/item/clothing/head/helmet,
/turf/open/floor/concrete/pavement,
/area/overmap_encounter/planetoid/wasteplanet/explored)
"YX" = (
/turf/open/floor/concrete/slab_1,
/area/overmap_encounter/planetoid/wasteplanet/explored)
"Zc" = (
/obj/effect/decal/cleanable/dirt,
/turf/open/floor/concrete/pavement,
/area/overmap_encounter/planetoid/wasteplanet/explored)
"Zk" = (
/obj/effect/turf_decal/road/edge,
/turf/open/floor/concrete/pavement,
/area/overmap_encounter/planetoid/wasteplanet/explored)
"Zo" = (
/obj/effect/turf_decal/road/line/opaque/yellow{
	dir = 4
	},
/obj/structure/barricade/sandbags,
/turf/open/floor/concrete/pavement,
/area/overmap_encounter/planetoid/wasteplanet/explored)
"ZV" = (
/obj/effect/turf_decal/road/edge{
	dir = 1
	},
/obj/effect/decal/cleanable/dirt,
/turf/open/floor/concrete/pavement,
/area/overmap_encounter/planetoid/wasteplanet/explored)

(1,1,1) = {"
xQ
xQ
xQ
xQ
xQ
xQ
xQ
xQ
xQ
xQ
xQ
xQ
xQ
xQ
xQ
xQ
xQ
xQ
xQ
xQ
xQ
xQ
xQ
xQ
xQ
xQ
xQ
Wr
Xn
xQ
"}
(2,1,1) = {"
xQ
xQ
xQ
xQ
xQ
xQ
xQ
xQ
xQ
xQ
xQ
xQ
xQ
xQ
xQ
xQ
xQ
xQ
xQ
xQ
xQ
xQ
xQ
YX
Wr
Wr
bQ
Wr
Wr
YX
"}
(3,1,1) = {"
xQ
xQ
xQ
xQ
xQ
xQ
xQ
xQ
xQ
xQ
xQ
xQ
xQ
xQ
xQ
xQ
xQ
xQ
xQ
xQ
xQ
xQ
xQ
xQ
Bk
tH
Zc
Wr
Xn
Wr
"}
(4,1,1) = {"
xQ
xQ
xQ
xQ
xQ
xQ
xQ
xQ
xQ
xQ
xQ
xQ
xQ
YX
Wr
YX
YX
Bk
Wr
YX
YX
YX
xQ
YX
YX
uJ
nI
RO
gT
YX
"}
(5,1,1) = {"
xQ
xQ
xQ
xQ
xQ
xQ
xQ
xQ
xQ
xQ
xQ
xQ
Wr
PD
xV
xV
xV
Hw
Hw
Wr
xV
Hw
Hw
xV
cT
Zk
bQ
bQ
Xn
YX
"}
(6,1,1) = {"
xQ
xQ
xQ
xQ
xQ
xQ
xQ
xQ
xQ
xQ
xQ
xQ
YX
Yc
JI
lC
zu
th
lC
zu
Hv
lC
zu
Wr
Io
Wr
bQ
Zc
xt
YX
"}
(7,1,1) = {"
xQ
xQ
xQ
xQ
xQ
xQ
xQ
xQ
xQ
xQ
xQ
xQ
Bk
tH
Zc
Di
rw
Ka
Di
Li
iN
Di
rw
WP
Vf
bQ
bQ
bQ
xt
Wr
"}
(8,1,1) = {"
xQ
xQ
xQ
xQ
xQ
xQ
xQ
xQ
xQ
xQ
xQ
xQ
JI
tH
dl
th
Wr
cS
sE
sE
sE
sE
sE
Wr
qI
Eh
bQ
Wr
Xn
YX
"}
(9,1,1) = {"
xQ
iM
eh
eh
eh
eh
eh
eh
eh
eh
eh
wz
YX
tH
sW
Kd
Xn
Wr
YX
YX
Wr
YX
YX
YX
YX
Lm
vp
EX
XT
YX
"}
(10,1,1) = {"
xQ
Sx
YB
Wr
Wr
YB
YB
Wr
oc
Wr
Wr
Sx
YX
tH
Di
Ka
Xn
YX
kj
Rw
iB
wI
cA
hT
YX
Yc
dl
th
xt
YX
"}
(11,1,1) = {"
xQ
Sx
YB
Wr
YB
YB
YB
YB
Wr
Wr
Wr
ci
YX
tH
dl
Wr
Xn
YX
Wr
wI
iB
iB
wI
ku
Wr
Yc
sW
yG
xt
Wr
"}
(12,1,1) = {"
xQ
Sx
YB
YB
YB
YB
YB
YB
YB
Wr
Wr
Sx
YX
DC
vT
JZ
Eu
Cj
ku
wI
iB
wI
wI
ku
YX
Yc
uO
mr
Xn
YX
"}
(13,1,1) = {"
xQ
Sx
YB
YB
YB
YB
YB
YB
YB
YB
YB
Sx
YX
Yc
rV
mr
xt
qe
ku
wI
iB
wI
wI
ku
Bk
xM
dl
th
Xn
YX
"}
(14,1,1) = {"
xQ
Sx
Wr
YB
YB
YB
YB
YB
YB
YB
Wr
Sx
Wr
Yc
BB
Pu
wN
qe
hT
eC
iB
iB
cA
hT
YX
tH
sW
Kd
Xn
YX
"}
(15,1,1) = {"
xQ
Sx
Wr
YB
YB
YB
YB
YB
YB
YB
Wr
Sx
YX
Yc
sW
Kd
Xn
qe
ku
wI
wI
iB
Wr
ku
YX
tH
Di
Ka
Xn
Wr
"}
(16,1,1) = {"
xQ
Sx
YB
YB
YB
YB
YB
YB
YB
YB
Wr
Sx
YX
Wr
Di
Ka
gj
qe
ku
wI
wI
iB
iB
ku
YX
tH
lC
th
Xn
YX
"}
(17,1,1) = {"
xQ
Sx
YB
YB
YB
YB
YB
YB
YB
YB
Wr
Sx
YX
Yc
dl
th
Xn
YX
ku
iB
wI
wI
wI
ku
YX
Yc
GD
Wr
Xn
YX
"}
(18,1,1) = {"
xQ
Sx
YB
YB
YB
YB
YB
YB
YB
YB
YB
Sx
YX
Yc
Jo
Kd
Xn
YX
hT
Rw
wI
wI
cA
hT
YX
Yc
Di
Ka
Xn
YX
"}
(19,1,1) = {"
xQ
Sx
Wr
YB
YB
YB
YB
YB
YB
Wr
Wr
Sx
YX
tH
uO
Wr
Xn
Wr
ku
JI
iB
wI
wI
ku
Wr
tH
lC
Pu
Xn
Wr
"}
(20,1,1) = {"
xQ
Sx
YB
YB
YB
YB
YB
YB
oc
Wr
oc
ci
Bk
tH
dl
th
Xn
Bk
ku
wI
Wr
iB
Wr
ku
YX
Yc
sW
Kd
Xn
Bk
"}
(21,1,1) = {"
xQ
Sx
Wr
Wr
Wr
Wr
Wr
Wr
YB
Wr
Wr
Sx
YX
tH
Wr
yG
xt
Bk
ku
wI
Wr
wI
wI
ku
YX
Yc
YO
Ka
Xn
Bk
"}
(22,1,1) = {"
xQ
Ty
eh
eh
eh
eh
eh
eh
eh
eh
eh
jf
Bk
tH
Di
mr
Xn
Wr
hT
zU
wI
Wr
cA
hT
Wr
tH
lC
th
Xn
Bk
"}
(23,1,1) = {"
KX
KX
KX
KX
KX
KX
KX
KX
YX
YX
Bk
YX
YX
tH
dl
Pu
Xn
YX
ku
Wr
wI
wI
Wr
Wr
YX
tH
sW
ts
xt
Bk
"}
(24,1,1) = {"
KX
kV
xZ
rb
mk
AO
LY
uA
cb
xV
Hw
Hw
uf
Zk
sW
Kd
Xn
YX
ku
wI
Wr
Wr
wI
ku
Bk
iH
Ry
OR
eN
YX
"}
(25,1,1) = {"
KX
xZ
xZ
yv
XC
mk
LY
uA
VE
zu
th
dl
Zo
th
uO
mr
Xn
Bk
Wr
Wr
wI
wI
Wr
ku
Wr
Yc
dl
th
Xn
YX
"}
(26,1,1) = {"
KX
xZ
PF
rb
VD
BS
LY
uA
JF
rw
Ka
Di
iV
Ka
Zc
bQ
Xn
Bk
Wr
eC
Wr
Wr
cA
hT
Wr
Wr
sW
Kd
Xn
Wr
"}
(27,1,1) = {"
KX
ub
xZ
xF
RT
dp
LY
uA
RP
sE
sE
sE
gn
ZV
bQ
bQ
Xn
Bk
ku
Wr
xQ
xQ
Wr
ku
YX
Yc
Di
mr
xt
Bk
"}
(28,1,1) = {"
KX
Ff
mk
xF
wR
dp
my
KX
ax
YX
dU
YX
ax
Lm
EX
Qk
XT
YX
Wr
xQ
xQ
xQ
xQ
ku
Wr
Wr
dl
Wr
Xn
YX
"}
(29,1,1) = {"
KX
UZ
ff
xF
ff
yW
mk
mM
dU
dU
dU
YX
YX
dA
XN
sE
Re
YX
ku
wI
xQ
xQ
wI
xQ
xQ
Yc
Wr
Kd
Wr
Wr
"}
(30,1,1) = {"
KX
KX
KX
KX
KX
KX
KX
KX
YX
YX
dU
YX
Bk
Bk
Bk
Bk
YX
YX
xQ
xQ
xQ
xQ
xQ
xQ
xQ
xQ
Di
Wr
bQ
YX
"}
