//MAP CONVERTED BY dmm2tgm.py THIS HEADER COMMENT PREVENTS RECONVERSION, DO NOT REMOVE
"ag" = (
/obj/structure/barricade/sandbags,
/turf/open/floor/pod,
/area/space)
"aB" = (
/obj/effect/turf_decal/industrial/caution,
/turf/open/floor/pod,
/area/space)
"bj" = (
/obj/item/stack/sheet/mineral/sandbags{
	amount = 3
	},
/obj/effect/turf_decal/industrial/caution{
	dir = 1
	},
/turf/open/floor/pod,
/area/space)
"bM" = (
/obj/item/stack/sheet/mineral/sandbags,
/obj/structure/door_assembly/door_assembly_com,
/turf/open/floor/pod,
/area/space)
"bY" = (
/obj/structure/girder/displaced,
/turf/open/floor/plating/asteroid/wasteplanet,
/area/space)
"ch" = (
/obj/effect/turf_decal/industrial/warning/full,
/obj/structure/closet/crate,
/obj/item/stack/sheet/mineral/plasma/five,
/obj/item/stack/sheet/mineral/plasma/five,
/obj/item/stack/sheet/mineral/plasma/five,
/turf/open/floor/pod/dark,
/area/space)
"cC" = (
/turf/closed/wall/yesdiag,
/area/space)
"cJ" = (
/turf/open/floor/concrete/pavement,
/area/space)
"cL" = (
/obj/item/stack/sheet/mineral/sandbags{
	amount = 3
	},
/turf/open/floor/plating/asteroid/wasteplanet,
/area/space)
"cW" = (
/obj/structure/barricade/sandbags,
/obj/effect/turf_decal/industrial/warning,
/obj/effect/turf_decal/industrial/warning{
	dir = 1
	},
/turf/open/floor/plating/wasteplanet,
/area/space)
"dB" = (
/obj/effect/turf_decal/industrial/traffic,
/obj/effect/turf_decal/industrial/stand_clear{
	dir = 1
	},
/turf/open/floor/concrete/pavement,
/area/space)
"dD" = (
/obj/structure/flippedtable,
/obj/effect/decal/remains/human,
/obj/item/clothing/shoes/laceup{
	pixel_x = 1;
	pixel_y = -5
	},
/obj/item/gun/ballistic/automatic/pistol/commander,
/turf/open/floor/pod,
/area/space)
"dN" = (
/obj/structure/door_assembly/door_assembly_sec,
/turf/open/floor/pod,
/area/space)
"em" = (
/turf/open/floor/plating/asteroid/wasteplanet,
/area/space)
"en" = (
/turf/closed/wall/rust,
/area/space)
"eF" = (
/obj/effect/decal/cleanable/oil/streak{
	icon_state = "streak4"
	},
/turf/open/floor/concrete/pavement,
/area/space)
"fe" = (
/obj/effect/turf_decal/industrial/traffic{
	dir = 8
	},
/obj/effect/turf_decal/industrial/stand_clear{
	dir = 4
	},
/turf/open/floor/pod,
/area/space)
"gl" = (
/obj/docking_port/stationary{
	dir = 4;
	dwidth = 5;
	width = 10;
	height = 6;
	roundstart_template = /datum/map_template/shuttle/subshuttles/trader
	},
/turf/open/floor/plating/rust/wasteplanet,
/area/space)
"gy" = (
/obj/effect/decal/cleanable/dirt/dust,
/turf/open/floor/plating/rust/wasteplanet,
/area/space)
"gA" = (
/obj/effect/decal/cleanable/molten_object/large,
/turf/open/floor/concrete/pavement,
/area/space)
"hn" = (
/obj/effect/turf_decal/industrial/warning/full,
/obj/structure/extinguisher_cabinet/directional/north,
/turf/open/floor/pod/dark,
/area/space)
"ht" = (
/obj/structure/extinguisher_cabinet/directional/south,
/obj/structure/barricade/sandbags,
/turf/open/floor/pod,
/area/space)
"hJ" = (
/obj/structure/chair{
	dir = 8
	},
/turf/open/floor/pod,
/area/space)
"hU" = (
/obj/effect/turf_decal/industrial/traffic{
	dir = 4
	},
/obj/effect/turf_decal/industrial/stand_clear{
	dir = 8
	},
/turf/open/floor/pod,
/area/space)
"im" = (
/mob/living/simple_animal/hostile/abandoned_minebot,
/turf/open/floor/concrete/pavement,
/area/space)
"iy" = (
/obj/machinery/computer/mech_bay_power_console/retro{
	dir = 8
	},
/turf/open/floor/plasteel/tech/grid,
/area/space)
"jb" = (
/obj/structure/sign/poster/contraband/c20r{
	pixel_y = 28
	},
/turf/open/floor/pod,
/area/space)
"jD" = (
/obj/structure/barricade/sandbags,
/obj/effect/turf_decal/industrial/warning/cee{
	dir = 4
	},
/turf/open/floor/plating/wasteplanet,
/area/space)
"kf" = (
/obj/effect/turf_decal/spline/fancy/opaque/black,
/turf/open/floor/pod,
/area/space)
"kU" = (
/obj/effect/decal/cleanable/dirt/dust,
/turf/open/floor/plating/wasteplanet,
/area/space)
"lQ" = (
/obj/effect/turf_decal/industrial/warning/full,
/obj/structure/reagent_dispensers/watertank,
/turf/open/floor/pod/dark,
/area/space)
"mr" = (
/obj/effect/turf_decal/industrial/caution{
	dir = 1
	},
/obj/structure/sign/warning/gasmask{
	pixel_x = -28
	},
/turf/open/floor/pod,
/area/space)
"mK" = (
/obj/item/bot_assembly/medbot,
/turf/open/floor/pod/light,
/area/space)
"nO" = (
/turf/open/floor/pod/light,
/area/space)
"pc" = (
/obj/item/stack/sheet/mineral/sandbags{
	amount = 2
	},
/turf/open/floor/concrete/pavement,
/area/space)
"pl" = (
/turf/closed/wall,
/area/space)
"pA" = (
/obj/effect/decal/cleanable/molten_object{
	pixel_x = -10;
	pixel_y = -1
	},
/obj/effect/decal/cleanable/molten_object{
	pixel_x = 1;
	pixel_y = 9
	},
/turf/open/floor/concrete/pavement,
/area/space)
"pQ" = (
/obj/effect/turf_decal/industrial/traffic{
	dir = 8
	},
/obj/effect/turf_decal/industrial/caution{
	dir = 4
	},
/turf/open/floor/pod,
/area/space)
"qk" = (
/obj/machinery/door/airlock/command/glass{
	name = "Holopad Access"
	},
/turf/open/floor/plasteel/tech,
/area/space)
"ro" = (
/obj/structure/extinguisher_cabinet/directional/east,
/turf/open/floor/pod,
/area/space)
"ru" = (
/obj/structure/flippedtable,
/turf/open/floor/pod,
/area/space)
"rB" = (
/obj/machinery/door/airlock{
	dir = 4;
	name = "Showers"
	},
/turf/open/floor/plasteel/tech,
/area/space)
"sf" = (
/obj/effect/decal/cleanable/molten_object{
	pixel_x = -10;
	pixel_y = 9
	},
/obj/effect/decal/cleanable/molten_object{
	pixel_x = 9;
	pixel_y = -4
	},
/turf/open/floor/concrete/pavement,
/area/space)
"sy" = (
/obj/effect/turf_decal/industrial/warning{
	dir = 8
	},
/obj/effect/turf_decal/industrial/warning{
	dir = 4
	},
/turf/open/floor/plating/wasteplanet,
/area/space)
"sT" = (
/obj/effect/turf_decal/industrial/warning/full,
/obj/structure/ore_box,
/turf/open/floor/pod/dark,
/area/space)
"tl" = (
/obj/docking_port/stationary{
	dir = 2;
	dwidth = 5;
	width = 10;
	height = 6;
	roundstart_template = /datum/map_template/shuttle/subshuttles/trader
	},
/turf/open/floor/plating/wasteplanet,
/area/space)
"tn" = (
/obj/effect/turf_decal/industrial/warning{
	dir = 9
	},
/obj/effect/turf_decal/industrial/warning/corner,
/turf/open/floor/plating/wasteplanet,
/area/space)
"tp" = (
/obj/effect/turf_decal/spline/fancy/opaque/black{
	dir = 4
	},
/turf/open/floor/pod,
/area/space)
"ts" = (
/obj/machinery/holopad/secure,
/obj/effect/turf_decal/box,
/turf/open/floor/pod,
/area/space)
"tz" = (
/obj/structure/window/reinforced/fulltile,
/obj/structure/grille,
/turf/open/floor/pod,
/area/space)
"tL" = (
/obj/structure/extinguisher_cabinet/directional/west,
/obj/item/bot_assembly/ed209,
/obj/effect/decal/cleanable/robot_debris,
/turf/open/floor/pod,
/area/space)
"tU" = (
/obj/mecha/working/ripley/cargo,
/obj/effect/turf_decal/rechargefloor,
/obj/structure/sign/warning/nosmoking{
	pixel_x = 28
	},
/turf/open/floor/plasteel/tech/grid,
/area/space)
"uf" = (
/obj/effect/turf_decal/industrial/warning/full,
/obj/structure/closet/crate,
/turf/open/floor/pod/dark,
/area/space)
"ug" = (
/obj/structure/barricade/sandbags,
/obj/effect/turf_decal/industrial/warning{
	dir = 1
	},
/obj/effect/turf_decal/industrial/warning,
/turf/open/floor/plating/wasteplanet,
/area/space)
"uL" = (
/mob/living/simple_animal/bot/secbot/ed209/rockplanet,
/turf/open/floor/plating/asteroid/wasteplanet,
/area/space)
"wA" = (
/obj/effect/decal/cleanable/oil/streak{
	icon_state = "streak5"
	},
/turf/open/floor/concrete/pavement,
/area/space)
"wB" = (
/obj/structure/table,
/turf/open/floor/pod,
/area/space)
"wG" = (
/obj/machinery/door/airlock/medical{
	name = "Medbay"
	},
/obj/effect/turf_decal/industrial/warning{
	dir = 1
	},
/obj/effect/turf_decal/industrial/warning,
/turf/open/floor/plasteel/tech,
/area/space)
"wM" = (
/obj/effect/turf_decal/spline/fancy/opaque/black{
	dir = 8
	},
/turf/open/floor/pod/light,
/area/space)
"xQ" = (
/obj/item/stack/sheet/mineral/sandbags{
	pixel_y = 7
	},
/turf/open/floor/pod,
/area/space)
"ya" = (
/obj/structure/extinguisher_cabinet/directional/south,
/turf/open/floor/pod/light,
/area/space)
"ym" = (
/turf/closed/mineral/random/asteroid/wasteplanet,
/area/space)
"ze" = (
/obj/machinery/mech_bay_recharge_port,
/turf/open/floor/plasteel/tech/grid,
/area/space)
"zo" = (
/obj/effect/turf_decal/industrial/traffic,
/obj/effect/turf_decal/industrial/caution{
	dir = 1
	},
/turf/open/floor/concrete/pavement,
/area/space)
"zq" = (
/obj/effect/turf_decal/industrial/warning/full,
/obj/structure/closet/crate,
/obj/structure/sign/warning/gasmask{
	pixel_y = 30
	},
/turf/open/floor/pod/dark,
/area/space)
"zT" = (
/obj/effect/turf_decal/industrial/caution{
	dir = 1
	},
/turf/open/floor/pod/light,
/area/space)
"zY" = (
/obj/item/stack/sheet/mineral/sandbags,
/turf/open/floor/plating/asteroid/wasteplanet,
/area/space)
"Ba" = (
/turf/open/floor/plating/rust/wasteplanet,
/area/space)
"BK" = (
/obj/machinery/shower{
	dir = 1
	},
/obj/structure/curtain,
/turf/open/floor/pod/light,
/area/space)
"CA" = (
/obj/effect/turf_decal/industrial/traffic{
	dir = 4
	},
/turf/open/floor/concrete/pavement,
/area/space)
"CC" = (
/turf/open/floor/plasteel/tech,
/area/space)
"Dl" = (
/obj/machinery/door/airlock{
	dir = 4;
	name = "Trader's Quarters"
	},
/turf/open/floor/plasteel/tech,
/area/space)
"DE" = (
/mob/living/simple_animal/bot/secbot/ed209,
/turf/open/floor/pod,
/area/space)
"Eg" = (
/obj/structure/marker_beacon,
/turf/open/floor/plating/rust/wasteplanet,
/area/space)
"Ex" = (
/obj/item/gun/ballistic/automatic/smg/inteq,
/obj/effect/mob_spawn/human/corpse/inteq/enforcer,
/turf/open/floor/pod,
/area/space)
"Fb" = (
/obj/machinery/door/airlock/command/glass{
	dir = 4;
	name = "Holopad Access"
	},
/turf/open/floor/pod,
/area/space)
"Fc" = (
/turf/open/floor/plating/wasteplanet,
/area/space)
"Fx" = (
/obj/structure/extinguisher_cabinet/directional/west,
/obj/effect/turf_decal/industrial/caution{
	dir = 1
	},
/obj/structure/sign/warning/gasmask{
	pixel_x = -28
	},
/turf/open/floor/pod,
/area/space)
"Gf" = (
/obj/effect/turf_decal/spline/fancy/opaque/black,
/turf/open/floor/pod/light,
/area/space)
"Hb" = (
/obj/effect/decal/cleanable/oil/streak{
	icon_state = "streak2"
	},
/turf/open/floor/concrete/pavement,
/area/space)
"Ig" = (
/obj/structure/rack,
/turf/open/floor/pod/light,
/area/space)
"IF" = (
/obj/structure/door_assembly/door_assembly_com,
/turf/open/floor/plasteel/tech,
/area/space)
"IN" = (
/obj/item/chair{
	pixel_y = -4
	},
/turf/open/floor/pod,
/area/space)
"Jb" = (
/obj/machinery/door/airlock/mining{
	name = "Warehouse"
	},
/obj/effect/turf_decal/industrial/warning,
/obj/effect/turf_decal/industrial/warning{
	dir = 1
	},
/turf/open/floor/plasteel/tech,
/area/space)
"Jh" = (
/obj/structure/barricade/sandbags,
/obj/effect/turf_decal/industrial/warning/cee,
/turf/open/floor/plating/wasteplanet,
/area/space)
"Kc" = (
/obj/effect/mob_spawn/human/corpse/inteq/enforcer,
/turf/open/floor/pod,
/area/space)
"Lm" = (
/obj/structure/chair{
	dir = 1
	},
/turf/open/floor/pod,
/area/space)
"Ln" = (
/obj/structure/girder/displaced,
/turf/open/floor/plating/rust/wasteplanet,
/area/space)
"LO" = (
/obj/effect/decal/cleanable/oil,
/turf/open/floor/concrete/pavement,
/area/space)
"Ma" = (
/turf/open/space/basic,
/area/template_noop)
"Ni" = (
/obj/item/ammo_casing/spent{
	pixel_y = -4;
	pixel_x = -2
	},
/obj/item/ammo_casing/spent{
	pixel_y = -7;
	pixel_x = -9
	},
/obj/item/ammo_casing/spent{
	pixel_y = -11;
	pixel_x = -3
	},
/obj/item/ammo_casing/spent,
/obj/item/ammo_casing/spent{
	pixel_y = -8;
	pixel_x = -7
	},
/obj/item/ammo_casing/spent{
	pixel_y = -4
	},
/turf/open/floor/pod,
/area/space)
"Nl" = (
/turf/closed/wall/rust/yesdiag,
/area/space)
"Np" = (
/turf/open/floor/pod,
/area/space)
"NC" = (
/obj/effect/decal/cleanable/molten_object{
	pixel_x = 1;
	pixel_y = -12
	},
/turf/open/floor/plating/asteroid/wasteplanet,
/area/space)
"ND" = (
/obj/item/stack/sheet/mineral/sandbags{
	amount = 2
	},
/turf/open/floor/pod,
/area/space)
"OV" = (
/obj/item/stack/sheet/mineral/sandbags,
/turf/open/floor/concrete/pavement,
/area/space)
"PV" = (
/obj/effect/turf_decal/industrial/warning{
	dir = 1
	},
/obj/effect/turf_decal/industrial/warning,
/turf/open/floor/plasteel/tech,
/area/space)
"Ri" = (
/obj/structure/filingcabinet/double,
/turf/open/floor/pod,
/area/space)
"RV" = (
/obj/structure/bed/pod,
/obj/item/bedsheet/hos{
	name = "security bedsheet"
	},
/turf/open/floor/pod,
/area/space)
"SE" = (
/obj/effect/decal/cleanable/dirt/dust,
/obj/effect/decal/cleanable/dirt/dust,
/turf/open/floor/plating/wasteplanet,
/area/space)
"SF" = (
/obj/item/gun/ballistic/automatic/smg/inteq,
/turf/open/floor/pod,
/area/space)
"TB" = (
/obj/structure/barricade/sandbags,
/obj/effect/turf_decal/industrial/warning{
	dir = 8
	},
/obj/effect/turf_decal/industrial/warning{
	dir = 4
	},
/turf/open/floor/plating/wasteplanet,
/area/space)
"Uo" = (
/obj/structure/girder/displaced,
/turf/open/floor/plating/wasteplanet,
/area/space)
"Uu" = (
/obj/effect/turf_decal/industrial/warning/full,
/obj/structure/reagent_dispensers/fueltank,
/turf/open/floor/pod/dark,
/area/space)
"Vi" = (
/obj/effect/turf_decal/spline/fancy/opaque/black{
	dir = 4
	},
/turf/open/floor/pod/light,
/area/space)
"Vl" = (
/obj/structure/extinguisher_cabinet/directional/west,
/obj/structure/rack,
/turf/open/floor/pod/light,
/area/space)
"VU" = (
/obj/structure/marker_beacon,
/obj/effect/decal/cleanable/dirt/dust,
/turf/open/floor/plating/rust/wasteplanet,
/area/space)
"WE" = (
/obj/effect/turf_decal/industrial/traffic{
	dir = 8
	},
/turf/open/floor/concrete/pavement,
/area/space)
"WK" = (
/obj/effect/decal/cleanable/molten_object{
	pixel_x = 4;
	pixel_y = 5
	},
/obj/effect/decal/cleanable/molten_object{
	pixel_x = 1;
	pixel_y = -12
	},
/turf/open/floor/concrete/pavement,
/area/space)
"Xc" = (
/obj/effect/turf_decal/industrial/warning/full,
/turf/open/floor/pod/dark,
/area/space)
"Xo" = (
/obj/machinery/door/airlock{
	name = "Bathroom"
	},
/turf/open/floor/plasteel/tech,
/area/space)
"Xw" = (
/obj/structure/barricade/sandbags,
/obj/effect/turf_decal/industrial/warning{
	dir = 10
	},
/obj/effect/turf_decal/industrial/warning/corner{
	dir = 4
	},
/turf/open/floor/plating/wasteplanet,
/area/space)
"Ya" = (
/obj/effect/turf_decal/spline/fancy/opaque/black{
	dir = 1
	},
/turf/open/floor/pod/light,
/area/space)
"Zb" = (
/obj/structure/extinguisher_cabinet/directional/south,
/obj/structure/chair{
	dir = 4
	},
/turf/open/floor/pod,
/area/space)
"Zw" = (
/obj/effect/turf_decal/industrial/traffic{
	dir = 4
	},
/obj/effect/turf_decal/industrial/caution{
	dir = 8
	},
/turf/open/floor/pod,
/area/space)

(1,1,1) = {"
Ma
Ma
Ma
Ma
Ma
Ma
Ma
Ma
Ma
Ma
Ma
Ma
Ma
Ma
Ma
Ma
Ma
Ma
Ma
Ma
Ma
Ma
Ma
Ma
Ma
Ma
Ma
Ma
cJ
cJ
cJ
em
Ma
Ma
Ma
Ma
Ma
Ma
Ma
Ma
Ma
Ma
Ma
Ma
Ma
Ma
"}
(2,1,1) = {"
Ma
Ma
Ma
Ma
Ma
Ma
Ma
Ma
Ma
Ma
Ma
Ma
Ma
Ma
Ma
Ma
Ma
Ma
Ma
Ma
Ma
Ma
Ma
Ma
Ma
Ma
Ma
Ma
em
cJ
Ba
cJ
Ma
Ma
Ma
Ma
Ma
Ma
Ma
Ma
Ma
Ma
Ma
Ma
Ma
Ma
"}
(3,1,1) = {"
Ma
Ma
Ma
Ma
Ma
Ma
Ma
Ma
Ma
Ma
Ma
Ma
Ma
Ma
Ma
Ma
Ma
Ma
Ma
Ma
Ma
Ma
Ma
Ma
Ma
Ma
Ma
Ma
Ba
cJ
cJ
em
Ma
Ma
Ma
Ma
Ma
Ma
Ma
Ma
Ma
Ma
Ma
Ma
Ma
Ma
"}
(4,1,1) = {"
Ma
Ma
Ma
Ma
Ma
Ma
Ma
Ma
Ma
Ma
Ma
Ma
Ma
Ma
Ma
Ma
Ma
Ma
Ma
Ma
Ma
Ma
Ma
Ma
Ma
Ma
Ma
Ma
em
cJ
Ba
cJ
Ma
Ma
Ma
Ma
Ma
Ma
Ma
Ma
Ma
Ma
Ma
Ma
Ma
Ma
"}
(5,1,1) = {"
Ma
Ma
Ma
Ma
Ma
Ma
Ma
Ma
Ma
Ma
Ma
Ma
Ma
Ma
Ma
ym
ym
ym
ym
Ma
Ma
Ma
Ma
Ma
Ma
Ma
Ma
em
em
uL
cJ
Ba
em
Ma
Ma
Ma
Ma
Ma
Ma
Ma
Ma
Ma
Ma
Ma
Ma
Ma
"}
(6,1,1) = {"
Ma
Ma
Ma
Ma
Ma
Ma
Ma
Ma
Ma
Ma
Ma
Ma
Ma
Ma
ym
ym
ym
ym
ym
ym
Ma
Ma
Ma
Ma
Ma
Ma
Ma
em
cJ
Fc
cJ
em
em
em
Ma
Ma
Ma
Ma
Ma
Ma
Ma
Ma
Ma
Ma
Ma
Ma
"}
(7,1,1) = {"
Ma
Ma
Ma
Ma
Ma
Ma
Ma
Ma
Ma
Ma
Ma
Ma
Ma
ym
ym
ym
ym
ym
ym
ym
ym
Ma
Ma
Ma
Ma
Ma
em
em
em
Ba
cJ
Fc
em
Fc
Ma
Ma
Ma
Ma
Ma
Ma
Ma
Ma
Ma
Ma
Ma
Ma
"}
(8,1,1) = {"
Ma
Ma
Ma
Ma
Ma
Ma
Ma
Ma
Ma
Ma
Ma
ym
ym
ym
ym
ym
ym
ym
ym
ym
ym
ym
Ma
Ma
Ma
em
Fc
em
Ba
cJ
Ba
uL
em
em
Ma
Ma
Ma
Ma
Ma
Ma
Ma
Ma
Ma
Ma
Ma
Ma
"}
(9,1,1) = {"
Ma
Ma
Ma
Ma
Ma
Ma
Ma
Ma
Ma
Ma
ym
ym
ym
ym
ym
en
en
en
ym
ym
ym
ym
Ma
Ma
em
em
Ba
em
em
cJ
Ba
cJ
em
em
Ma
Ma
Ma
Ma
Ma
Ma
Ma
Ma
Ma
Ma
Ma
Ma
"}
(10,1,1) = {"
Ma
Ma
Ma
Ma
Ma
Ma
Ma
Ma
ym
ym
ym
ym
en
en
en
Nl
em
Nl
en
en
ym
ym
em
em
Ba
em
em
em
cJ
im
cJ
em
Fc
em
Ma
Ma
Ma
Ma
Ma
Ma
Ma
Ma
Ma
Ma
Ma
Ma
"}
(11,1,1) = {"
Ma
Ma
Ma
Ma
Ma
Ma
Ma
ym
ym
ym
ym
ym
en
em
em
Ba
em
em
em
en
en
en
TB
TB
Xw
em
Ba
em
cJ
cJ
cJ
zY
em
ym
ym
ym
ym
ym
ym
ym
Ma
Ma
Ma
Ma
Ma
Ma
"}
(12,1,1) = {"
Ma
Ma
Ma
Ma
Ma
Ma
Ma
ym
ym
ym
ym
ym
en
Ba
em
em
em
em
em
em
em
NC
gA
cJ
cW
em
em
cJ
OV
cJ
cJ
em
ym
ym
ym
ym
ym
ym
ym
ym
ym
Ma
Ma
Ma
Ma
Ma
"}
(13,1,1) = {"
Ma
Ma
Ma
Ma
Ma
Ma
ym
ym
ym
ym
ym
ym
en
en
en
en
en
en
em
Ba
em
em
sf
cJ
jD
em
cJ
cJ
cJ
cJ
cL
em
en
en
en
ym
ym
ym
ym
ym
ym
ym
Ma
Ma
Ma
Ma
"}
(14,1,1) = {"
Ma
Ma
Ma
Ma
Ma
Ma
ym
ym
ym
ym
ym
en
en
en
en
nO
mK
en
em
em
em
Ba
em
cJ
cJ
cJ
cJ
cJ
pc
tn
sy
Jh
em
em
Nl
en
en
ym
ym
ym
ym
ym
ym
Ma
Ma
Ma
"}
(15,1,1) = {"
Ma
Ma
Ma
Ma
Ma
Ma
ym
ym
ym
ym
en
en
wB
wB
en
nO
ya
en
cJ
em
em
em
em
cJ
cJ
cJ
cJ
cJ
em
ug
cJ
cJ
em
em
em
em
en
ym
ym
ym
ym
ym
ym
Ma
Ma
Ma
"}
(16,1,1) = {"
Ma
Ma
Ma
Ma
Ma
ym
ym
ym
ym
ym
en
RV
Np
hJ
en
nO
zT
wG
cJ
cJ
Fc
Fc
em
cJ
cJ
cJ
cJ
em
em
jD
gA
WK
em
em
Ba
em
en
ym
ym
ym
ym
ym
ym
ym
Ma
Ma
"}
(17,1,1) = {"
Ma
Ma
Ma
Ma
Ma
ym
ym
ym
ym
ym
en
Np
Np
Np
en
en
en
en
cJ
cJ
em
Fc
cJ
cJ
cJ
cJ
em
em
em
em
cJ
pA
Ba
Ba
em
em
Nl
en
en
en
ym
ym
ym
ym
ym
Ma
"}
(18,1,1) = {"
Ma
Ma
Ma
Ma
ym
ym
ym
ym
ym
en
en
RV
Np
Np
Xo
Np
en
em
cJ
cJ
em
cJ
cJ
cJ
cJ
cJ
cJ
cJ
cJ
cJ
cJ
cJ
em
em
em
em
em
em
em
en
ym
ym
ym
ym
ym
Ma
"}
(19,1,1) = {"
Ma
Ma
Ma
Ma
ym
ym
ym
ym
en
Nl
en
Np
Np
Np
en
en
en
cJ
cJ
cJ
cJ
cJ
cJ
cJ
cJ
cJ
cJ
cJ
cJ
cJ
cJ
cJ
em
em
Fc
em
em
Ba
em
Nl
en
ym
ym
ym
ym
Ma
"}
(20,1,1) = {"
Ma
Ma
Ma
ym
ym
ym
ym
ym
en
em
en
RV
Np
dN
Np
mr
PV
cJ
cJ
cJ
cJ
cJ
cJ
cJ
cJ
em
em
em
em
em
em
em
em
em
em
Fc
em
Ba
em
em
Nl
en
ym
ym
ym
ym
"}
(21,1,1) = {"
Ma
Ma
Ma
ym
ym
ym
ym
en
em
em
en
jb
Np
Np
Np
Zb
en
cJ
cJ
cJ
cJ
cJ
cJ
cJ
em
em
bY
Ba
em
em
Uo
em
Ba
em
em
em
em
em
em
em
em
Nl
en
ym
ym
ym
"}
(22,1,1) = {"
Ma
Ma
Ma
ym
ym
ym
en
Nl
em
em
en
RV
Np
Np
wB
wB
en
em
em
cJ
cJ
cJ
cJ
em
em
em
em
em
em
Fc
em
em
em
em
em
em
em
em
em
Ba
em
em
Nl
en
ym
ym
"}
(23,1,1) = {"
Ma
Ma
ym
ym
ym
ym
en
em
em
Ba
en
en
en
en
en
en
en
em
em
cJ
cJ
cJ
cJ
em
em
em
em
Ba
em
Fc
em
em
VU
Ba
kU
kU
gy
kU
Ba
VU
em
em
em
en
ym
ym
"}
(24,1,1) = {"
Ma
Ma
ym
ym
ym
en
Nl
em
Ba
em
em
em
em
em
em
em
em
em
em
cJ
cJ
cJ
em
em
Ba
em
em
em
em
em
em
em
Ba
Fc
Fc
Fc
Fc
Fc
Fc
Ba
em
em
Nl
en
ym
ym
"}
(25,1,1) = {"
Ma
Ma
ym
ym
ym
en
em
em
em
em
em
em
em
Ba
em
em
Fc
em
em
cJ
cJ
cJ
cJ
em
Ba
bY
em
em
em
bY
em
em
Ba
Ba
Fc
Ba
Ba
Fc
Ba
Ba
em
em
en
ym
ym
ym
"}
(26,1,1) = {"
Ma
ym
ym
ym
ym
en
em
em
Fc
em
Ba
em
em
em
em
em
em
Ba
em
em
cJ
cJ
cJ
em
em
em
em
em
em
em
em
em
Fc
Fc
Fc
Ba
Fc
Ba
Fc
Fc
Fc
Ba
en
ym
ym
ym
"}
(27,1,1) = {"
Ma
ym
ym
ym
en
en
en
en
en
en
en
en
en
en
em
Ba
em
em
em
em
cJ
cJ
cJ
cJ
zo
cJ
cJ
cJ
cJ
cJ
Hb
cJ
cJ
Fc
Fc
Ba
Ba
Ba
Fc
Fc
Ba
em
en
ym
ym
ym
"}
(28,1,1) = {"
Ma
ym
ym
en
Nl
Np
Np
Np
Nl
en
nO
Vi
nO
en
en
em
em
em
em
cJ
cJ
cJ
cJ
cJ
dB
cJ
cJ
cJ
wA
eF
LO
cJ
cJ
tl
Ba
Ba
Fc
Ba
Ba
Fc
em
em
en
ym
ym
ym
"}
(29,1,1) = {"
Ma
ym
ym
pl
Np
Np
Np
Np
Np
en
Gf
ts
Ya
nO
en
em
em
Fc
cJ
cJ
cJ
cJ
cJ
cJ
zo
cJ
cJ
cJ
cJ
cJ
cJ
cJ
cJ
Fc
Ba
Ba
Fc
Fc
Ba
Fc
em
em
en
ym
ym
ym
"}
(30,1,1) = {"
ym
ym
ym
pl
Np
Np
Np
Np
Np
pl
nO
wM
nO
nO
en
em
em
em
cJ
cJ
cJ
em
Fc
em
em
CA
CA
CA
em
em
em
em
Fc
Fc
Fc
Ba
Fc
Ba
Fc
Ba
Ba
em
en
ym
ym
ym
"}
(31,1,1) = {"
ym
ym
ym
pl
Np
Np
Np
Np
Np
pl
en
en
Fb
tz
en
em
Fc
em
cJ
cJ
cJ
em
Nl
en
pl
CC
CC
CC
en
en
Nl
em
Ba
Ba
Ba
Fc
Ba
Ba
Fc
Ba
em
em
en
ym
ym
ym
"}
(32,1,1) = {"
ym
ym
ym
en
Np
Np
ro
Np
Nl
en
Np
en
Np
Lm
en
em
em
em
cJ
cJ
cJ
Ba
en
zq
ch
pQ
fe
pQ
Np
uf
en
em
Ba
Fc
Ba
Fc
Fc
Ba
Ba
Ba
em
em
en
ym
ym
ym
"}
(33,1,1) = {"
ym
ym
ym
en
en
en
pl
Dl
en
Np
Np
qk
Np
Lm
en
em
em
em
cJ
cJ
cJ
cJ
Jb
aB
Np
Np
Np
Np
Np
uf
pl
em
Ba
Ba
Fc
Fc
Ba
Ba
Fc
Ba
Ba
Ba
en
ym
ym
ym
"}
(34,1,1) = {"
ym
ym
ym
en
Np
Np
Np
Np
DE
Np
Np
Nl
en
en
en
em
em
em
cJ
cJ
cJ
em
en
hn
Np
lQ
Xc
Uu
Np
tp
en
em
VU
Ba
gy
SE
kU
gy
Ba
Eg
em
em
en
ym
ym
ym
"}
(35,1,1) = {"
Ma
ym
ym
en
Ri
Np
ru
Np
Np
SF
ag
bM
tL
Fx
CC
cJ
cJ
cJ
cJ
cJ
cJ
em
en
Xc
Np
Xc
Xc
Xc
kf
iy
en
em
em
em
em
em
em
em
em
em
Ba
em
en
ym
ym
ym
"}
(36,1,1) = {"
Ma
Ma
ym
en
Ri
IN
dD
Np
Np
Kc
ag
Np
xQ
bj
IF
cJ
cJ
cJ
cJ
cJ
cJ
em
pl
Xc
Np
Np
Np
Np
kf
ze
pl
em
em
em
Fc
em
em
em
em
em
em
Nl
en
ym
ym
ym
"}
(37,1,1) = {"
Ma
Ma
ym
en
en
wB
ru
Np
Np
Np
ag
ND
ag
ht
en
em
em
em
cJ
cJ
cJ
Fc
pl
sT
Zw
hU
Np
Np
kf
tU
pl
em
em
bY
em
em
em
Ba
bY
em
em
en
ym
ym
ym
ym
"}
(38,1,1) = {"
Ma
Ma
ym
ym
en
Np
Np
Np
Np
DE
Np
Np
Np
Ex
en
em
em
em
cJ
cJ
cJ
em
cC
pl
CC
CC
en
en
pl
en
Nl
em
Fc
Ba
em
em
em
em
em
em
Nl
en
ym
ym
ym
Ma
"}
(39,1,1) = {"
Ma
Ma
ym
ym
pl
Np
Np
Np
Np
Np
Np
Np
Ni
Np
en
em
Ba
em
em
cJ
cJ
cJ
zo
cJ
WE
WE
cJ
em
em
em
em
Fc
em
em
em
Ba
em
em
em
em
en
ym
ym
ym
ym
Ma
"}
(40,1,1) = {"
Ma
Ma
Ma
ym
pl
en
pl
en
rB
en
en
Nl
Np
en
en
em
em
em
em
em
cJ
cJ
dB
cJ
cJ
cJ
cJ
em
em
em
em
Fc
em
em
Ba
Ba
em
em
Nl
en
en
ym
ym
ym
ym
Ma
"}
(41,1,1) = {"
Ma
Ma
Ma
ym
ym
ym
en
Vl
nO
nO
BK
en
en
en
em
em
Ba
em
em
em
em
em
em
cJ
cJ
cJ
em
em
em
em
em
Fc
em
Ba
Ba
em
em
Nl
en
ym
ym
ym
ym
ym
ym
Ma
"}
(42,1,1) = {"
Ma
Ma
Ma
Ma
ym
ym
en
Ig
nO
nO
BK
en
em
em
em
Ba
Ba
em
Eg
Ba
Ba
Ba
Ba
cJ
cJ
cJ
Ba
Fc
Fc
Eg
em
em
bY
em
em
em
em
en
ym
ym
ym
ym
ym
ym
Ma
Ma
"}
(43,1,1) = {"
Ma
Ma
Ma
Ma
ym
ym
Nl
en
nO
nO
BK
en
em
Ba
Ba
em
em
em
Ba
Ba
Fc
Ba
Ba
Fc
gl
Ba
Ba
Ba
Fc
Ba
em
em
em
em
em
em
Nl
en
ym
ym
ym
ym
ym
ym
Ma
Ma
"}
(44,1,1) = {"
Ma
Ma
Ma
Ma
ym
ym
ym
en
en
en
en
Nl
em
em
em
em
bY
em
Ba
Ba
Fc
Ba
Fc
Ba
Ba
Ba
Fc
Fc
Fc
Ba
em
Fc
em
em
em
Nl
en
ym
ym
ym
ym
ym
ym
ym
Ma
Ma
"}
(45,1,1) = {"
Ma
Ma
Ma
Ma
Ma
ym
ym
Nl
en
em
em
em
em
bY
em
em
em
em
Fc
Ba
Fc
Ba
Fc
Ba
Fc
Ba
Ba
Ba
Ba
Ba
em
em
em
em
Nl
en
ym
ym
ym
ym
ym
ym
ym
Ma
Ma
Ma
"}
(46,1,1) = {"
Ma
Ma
Ma
Ma
Ma
ym
ym
ym
en
em
em
em
em
em
Ba
Fc
em
em
Fc
Ba
Ba
Ba
Ba
Ba
Fc
Ba
Ba
Fc
Ba
Fc
em
em
em
Nl
en
ym
ym
ym
ym
ym
ym
ym
ym
Ma
Ma
Ma
"}
(47,1,1) = {"
Ma
Ma
Ma
Ma
Ma
Ma
ym
ym
ym
en
em
em
em
Ba
em
em
em
em
Ba
Ba
Ba
Fc
Fc
Ba
Fc
Ba
Ba
Ba
Ba
Fc
em
em
Nl
en
ym
ym
ym
ym
ym
ym
ym
ym
Ma
Ma
Ma
Ma
"}
(48,1,1) = {"
Ma
Ma
Ma
Ma
Ma
Ma
ym
ym
ym
en
Nl
em
em
em
Ba
em
em
em
Ba
Ba
Ba
Ba
Fc
Fc
Ba
Ba
Ba
Ba
Ba
Fc
em
em
en
ym
ym
ym
ym
Ma
ym
ym
ym
ym
Ma
Ma
Ma
Ma
"}
(49,1,1) = {"
Ma
Ma
Ma
Ma
Ma
Ma
Ma
ym
ym
ym
en
en
em
em
Ln
em
em
em
Eg
Ba
Fc
Fc
Ba
Fc
Fc
Ba
Fc
Fc
Fc
Eg
em
em
en
ym
ym
ym
ym
Ma
ym
ym
ym
Ma
Ma
Ma
Ma
Ma
"}
(50,1,1) = {"
Ma
Ma
Ma
Ma
Ma
Ma
Ma
ym
ym
ym
ym
en
Nl
em
em
em
Ln
em
em
em
em
em
em
em
em
em
Fc
Fc
em
em
em
Nl
en
ym
ym
ym
Ma
Ma
Ma
ym
ym
Ma
Ma
Ma
Ma
Ma
"}
(51,1,1) = {"
Ma
Ma
Ma
Ma
Ma
Ma
Ma
Ma
ym
ym
ym
ym
en
Nl
em
em
Ba
em
em
em
em
em
em
Ba
em
em
Fc
em
em
Nl
en
en
ym
ym
ym
ym
Ma
Ma
Ma
Ma
Ma
Ma
Ma
Ma
Ma
Ma
"}
(52,1,1) = {"
Ma
Ma
Ma
Ma
Ma
Ma
Ma
Ma
Ma
ym
ym
ym
ym
en
em
Nl
en
en
en
en
en
en
en
en
en
en
en
en
en
en
ym
ym
ym
ym
ym
Ma
Ma
Ma
Ma
Ma
Ma
Ma
Ma
Ma
Ma
Ma
"}
(53,1,1) = {"
Ma
Ma
Ma
Ma
Ma
Ma
Ma
Ma
Ma
Ma
ym
ym
ym
en
en
en
ym
ym
ym
ym
ym
ym
ym
ym
ym
ym
ym
ym
ym
ym
ym
ym
ym
ym
ym
Ma
Ma
Ma
Ma
Ma
Ma
Ma
Ma
Ma
Ma
Ma
"}
(54,1,1) = {"
Ma
Ma
Ma
Ma
Ma
Ma
Ma
Ma
Ma
Ma
ym
ym
ym
ym
ym
ym
ym
ym
ym
ym
ym
ym
ym
ym
ym
ym
ym
ym
ym
ym
ym
ym
ym
ym
ym
Ma
Ma
Ma
Ma
Ma
Ma
Ma
Ma
Ma
Ma
Ma
"}
(55,1,1) = {"
Ma
Ma
Ma
Ma
Ma
Ma
Ma
Ma
Ma
Ma
Ma
Ma
ym
ym
ym
ym
ym
ym
ym
ym
ym
ym
ym
ym
ym
ym
ym
ym
ym
ym
ym
ym
ym
ym
Ma
Ma
Ma
Ma
Ma
Ma
Ma
Ma
Ma
Ma
Ma
Ma
"}
(56,1,1) = {"
Ma
Ma
Ma
Ma
Ma
Ma
Ma
Ma
Ma
Ma
Ma
Ma
Ma
Ma
Ma
Ma
Ma
Ma
Ma
Ma
Ma
ym
ym
ym
ym
ym
ym
ym
ym
ym
ym
Ma
Ma
Ma
Ma
Ma
Ma
Ma
Ma
Ma
Ma
Ma
Ma
Ma
Ma
Ma
"}
(57,1,1) = {"
Ma
Ma
Ma
Ma
Ma
Ma
Ma
Ma
Ma
Ma
Ma
Ma
Ma
Ma
Ma
Ma
Ma
Ma
Ma
Ma
Ma
Ma
Ma
ym
ym
ym
ym
Ma
Ma
Ma
Ma
Ma
Ma
Ma
Ma
Ma
Ma
Ma
Ma
Ma
Ma
Ma
Ma
Ma
Ma
Ma
"}
