//MAP CONVERTED BY dmm2tgm.py THIS HEADER COMMENT PREVENTS RECONVERSION, DO NOT REMOVE
"a" = (
/obj/structure/fence/corner{
	dir = 9
	},
/turf/open/floor/plating/asteroid/wasteplanet,
/area/overmap_encounter/planetoid/rockplanet/explored)
"b" = (
/obj/machinery/modular_computer/console/preset/civilian,
/obj/effect/decal/cleanable/cobweb,
/turf/open/floor/noslip,
/area/overmap_encounter/planetoid/rockplanet/explored)
"c" = (
/obj/machinery/power/floodlight,
/obj/structure/cable{
	icon_state = "0-4"
	},
/turf/open/floor/plating/asteroid/wasteplanet,
/area/overmap_encounter/planetoid/rockplanet/explored)
"d" = (
/obj/item/grown/bananapeel,
/obj/structure/cable{
	icon_state = "4-8"
	},
/obj/structure/cable{
	icon_state = "1-8"
	},
/turf/open/floor/plating/asteroid/wasteplanet,
/area/overmap_encounter/planetoid/rockplanet/explored)
"e" = (
/obj/machinery/power/smes/shuttle/precharged{
	dir = 1
	},
/obj/structure/window/plasma/reinforced{
	name = "clowning grade window"
	},
/obj/structure/cable{
	icon_state = "0-2"
	},
/turf/open/floor/plating,
/area/overmap_encounter/planetoid/rockplanet/explored)
"f" = (
/obj/effect/decal/cleanable/oil/slippery,
/obj/item/grown/bananapeel,
/obj/structure/cable{
	icon_state = "2-4"
	},
/turf/open/floor/plating/asteroid/wasteplanet,
/area/overmap_encounter/planetoid/rockplanet/explored)
"g" = (
/obj/structure/fence/door,
/obj/item/toy/snappop/phoenix,
/turf/open/floor/plating/asteroid/wasteplanet,
/area/overmap_encounter/planetoid/rockplanet/explored)
"h" = (
/obj/machinery/door/airlock/titanium,
/obj/item/toy/snappop/phoenix,
/turf/open/floor/noslip,
/area/overmap_encounter/planetoid/rockplanet/explored)
"i" = (
/obj/structure/table/reinforced,
/obj/item/flashlight/lamp/bananalamp,
/obj/machinery/power/terminal,
/obj/structure/cable,
/turf/open/floor/noslip,
/area/overmap_encounter/planetoid/rockplanet/explored)
"j" = (
/mob/living/simple_animal/bot/honkbot,
/turf/open/floor/plating/asteroid/wasteplanet,
/area/overmap_encounter/planetoid/rockplanet/explored)
"k" = (
/turf/closed/mineral/random/asteroid/wasteplanet,
/area/overmap_encounter/planetoid/rockplanet/explored)
"l" = (
/obj/item/grown/bananapeel,
/turf/open/floor/plating/asteroid/wasteplanet,
/area/overmap_encounter/planetoid/rockplanet/explored)
"m" = (
/obj/structure/fence/corner{
	dir = 6
	},
/turf/open/floor/plating/asteroid/wasteplanet,
/area/overmap_encounter/planetoid/rockplanet/explored)
"o" = (
/obj/structure/table/reinforced,
/obj/item/bikehorn/airhorn,
/obj/item/nullrod/clown,
/turf/open/floor/plating/asteroid/wasteplanet,
/area/overmap_encounter/planetoid/rockplanet/explored)
"q" = (
/obj/structure/cable{
	icon_state = "0-2"
	},
/obj/effect/turf_decal/box/white,
/turf/open/floor/noslip,
/area/overmap_encounter/planetoid/rockplanet/explored)
"r" = (
/obj/structure/table/reinforced,
/obj/item/stack/ore/bananium,
/turf/open/floor/plating/asteroid,
/area/overmap_encounter/planetoid/rockplanet/explored)
"s" = (
/obj/structure/sign/poster/official/foam_force_ad,
/turf/closed/wall/mineral/titanium,
/area/overmap_encounter/planetoid/rockplanet/explored)
"t" = (
/obj/item/bedsheet/clown,
/obj/structure/bed,
/turf/open/floor/noslip,
/area/overmap_encounter/planetoid/rockplanet/explored)
"u" = (
/obj/structure/mecha_wreckage/honker,
/obj/effect/decal/cleanable/greenglow,
/turf/open/floor/plating/asteroid/wasteplanet,
/area/overmap_encounter/planetoid/rockplanet/explored)
"w" = (
/obj/structure/sign/poster/contraband/clown,
/turf/closed/wall/mineral/titanium,
/area/overmap_encounter/planetoid/rockplanet/explored)
"x" = (
/obj/structure/chair/comfy/shuttle{
	dir = 1
	},
/mob/living/simple_animal/hostile/retaliate/clown,
/turf/open/floor/noslip,
/area/overmap_encounter/planetoid/rockplanet/explored)
"y" = (
/obj/structure/sign/poster/official/high_class_martini,
/turf/closed/wall/mineral/titanium,
/area/overmap_encounter/planetoid/rockplanet/explored)
"z" = (
/obj/structure/window/reinforced/fulltile/shuttle,
/obj/structure/grille,
/turf/open/floor/noslip,
/area/overmap_encounter/planetoid/rockplanet/explored)
"B" = (
/turf/closed/wall/mineral/titanium,
/area/overmap_encounter/planetoid/rockplanet/explored)
"C" = (
/obj/structure/cable{
	icon_state = "1-8"
	},
/obj/structure/cable{
	icon_state = "1-2"
	},
/turf/open/floor/noslip,
/area/overmap_encounter/planetoid/rockplanet/explored)
"D" = (
/obj/item/wrench,
/obj/structure/rack,
/obj/item/stack/sheet/mineral/plasma/five,
/obj/item/stack/sheet/mineral/plasma/five,
/turf/open/floor/plating/asteroid/wasteplanet,
/area/overmap_encounter/planetoid/rockplanet/explored)
"E" = (
/obj/machinery/power/shuttle/engine/electric{
	dir = 1
	},
/obj/structure/cable,
/turf/open/floor/plating,
/area/overmap_encounter/planetoid/rockplanet/explored)
"F" = (
/obj/structure/fence{
	dir = 8
	},
/turf/open/floor/plating/asteroid/wasteplanet,
/area/overmap_encounter/planetoid/rockplanet/explored)
"G" = (
/obj/structure/cable{
	icon_state = "1-8"
	},
/turf/open/floor/plating/asteroid/wasteplanet,
/area/overmap_encounter/planetoid/rockplanet/explored)
"H" = (
/turf/open/floor/plating/asteroid/wasteplanet,
/area/overmap_encounter/planetoid/rockplanet/explored)
"I" = (
/obj/item/clothing/suit/space/hardsuit/clown,
/obj/item/clothing/head/helmet/space/hardsuit/clown,
/obj/structure/rack,
/obj/machinery/power/terminal,
/obj/structure/cable,
/turf/open/floor/noslip,
/area/overmap_encounter/planetoid/rockplanet/explored)
"J" = (
/obj/machinery/power/floodlight,
/obj/structure/cable{
	icon_state = "0-8"
	},
/turf/open/floor/plating/asteroid/wasteplanet,
/area/overmap_encounter/planetoid/rockplanet/explored)
"K" = (
/obj/structure/closet/crate/trashcart,
/obj/effect/spawner/lootdrop/maintenance/seven,
/turf/open/floor/plating/asteroid/wasteplanet,
/area/overmap_encounter/planetoid/rockplanet/explored)
"L" = (
/obj/structure/fence/corner,
/turf/open/floor/plating/asteroid/wasteplanet,
/area/template_noop)
"M" = (
/obj/structure/fence,
/turf/open/floor/plating/asteroid/wasteplanet,
/area/overmap_encounter/planetoid/rockplanet/explored)
"N" = (
/obj/effect/decal/cleanable/oil/slippery,
/turf/open/floor/plating/asteroid/wasteplanet,
/area/overmap_encounter/planetoid/rockplanet/explored)
"O" = (
/obj/structure/table/reinforced,
/obj/item/pickaxe/drill,
/turf/open/floor/plating/asteroid/wasteplanet,
/area/overmap_encounter/planetoid/rockplanet/explored)
"P" = (
/turf/open/floor/noslip,
/area/overmap_encounter/planetoid/rockplanet/explored)
"Q" = (
/turf/template_noop,
/area/template_noop)
"R" = (
/obj/machinery/power/port_gen/pacman,
/obj/structure/cable{
	icon_state = "0-2"
	},
/turf/open/floor/plating/asteroid/wasteplanet,
/area/overmap_encounter/planetoid/rockplanet/explored)
"S" = (
/obj/structure/cable{
	icon_state = "4-8"
	},
/turf/open/floor/plating/asteroid/wasteplanet,
/area/overmap_encounter/planetoid/rockplanet/explored)
"T" = (
/obj/structure/fence/corner{
	dir = 8
	},
/turf/open/floor/plating/asteroid/wasteplanet,
/area/overmap_encounter/planetoid/rockplanet/explored)
"U" = (
/obj/structure/fence{
	dir = 4
	},
/turf/open/floor/plating/asteroid/wasteplanet,
/area/overmap_encounter/planetoid/rockplanet/explored)
"V" = (
/obj/structure/cable{
	icon_state = "2-4"
	},
/turf/open/floor/noslip,
/area/overmap_encounter/planetoid/rockplanet/explored)
"W" = (
/obj/structure/table/reinforced,
/obj/item/seeds/banana/bluespace,
/obj/item/circuitboard/computer/arcade/orion_trail,
/turf/open/floor/plating/asteroid/wasteplanet,
/area/overmap_encounter/planetoid/rockplanet/explored)
"X" = (
/obj/effect/decal/cleanable/oil/slippery,
/obj/structure/cable{
	icon_state = "4-8"
	},
/turf/open/floor/plating/asteroid/wasteplanet,
/area/overmap_encounter/planetoid/rockplanet/explored)
"Y" = (
/obj/structure/statue/bananium/clown,
/obj/effect/decal/cleanable/cobweb/cobweb2,
/obj/structure/window/reinforced/survival_pod{
	dir = 8
	},
/obj/structure/window/reinforced/survival_pod,
/turf/open/floor/noslip,
/area/overmap_encounter/planetoid/rockplanet/explored)
"Z" = (
/obj/structure/table/reinforced,
/obj/item/reagent_containers/food/snacks/honkdae,
/turf/open/floor/plating/asteroid,
/area/overmap_encounter/planetoid/rockplanet/explored)

(1,1,1) = {"
Q
Q
Q
Q
k
k
k
k
k
M
M
a
"}
(2,1,1) = {"
Q
Q
k
k
k
k
u
H
D
H
c
U
"}
(3,1,1) = {"
Q
k
k
k
Z
r
H
H
l
H
X
U
"}
(4,1,1) = {"
k
k
W
l
H
N
H
H
H
H
S
g
"}
(5,1,1) = {"
k
k
B
z
y
h
B
B
B
R
d
U
"}
(6,1,1) = {"
k
B
b
x
P
V
i
e
E
H
S
F
"}
(7,1,1) = {"
k
w
Y
t
q
C
I
e
E
H
S
F
"}
(8,1,1) = {"
k
k
B
z
s
h
B
B
B
K
S
F
"}
(9,1,1) = {"
Q
k
k
o
l
H
H
H
H
f
G
U
"}
(10,1,1) = {"
Q
Q
k
k
O
j
H
H
H
J
T
m
"}
(11,1,1) = {"
Q
Q
Q
k
k
k
M
M
M
M
L
Q
"}
