//MAP CONVERTED BY dmm2tgm.py THIS HEADER COMMENT PREVENTS RECONVERSION, DO NOT REMOVE
"a" = (
/turf/template_noop,
/area/space)
"d" = (
/obj/structure/stone_tile/slab,
/turf/open/lava/smooth/lava_land_surface,
/area/ship/storage)
"h" = (
/obj/structure/stone_tile/slab,
/mob/living/simple_animal/hostile/asteroid/gutlunch/grublunch,
/obj/structure/window/reinforced/tinted,
/obj/structure/window/reinforced/tinted{
	dir = 4
	},
/turf/open/lava/smooth/lava_land_surface,
/area/ship/storage)
"i" = (
/obj/item/clothing/under/costume/gladiator/ash_walker,
/obj/item/clothing/under/costume/gladiator/ash_walker,
/obj/item/clothing/under/costume/gladiator/ash_walker,
/obj/item/clothing/under/costume/gladiator/ash_walker,
/obj/item/clothing/head/helmet/gladiator,
/obj/item/clothing/head/helmet/gladiator,
/obj/item/clothing/head/helmet/gladiator,
/obj/item/clothing/head/helmet/gladiator,
/obj/item/pickaxe/improvised,
/obj/item/pickaxe/improvised,
/obj/item/pickaxe/improvised,
/obj/item/pickaxe/improvised,
/obj/item/mining_scanner,
/obj/item/mining_scanner,
/obj/item/clothing/head/helmet/space/orange,
/obj/item/clothing/head/helmet/space/orange,
/obj/item/clothing/head/helmet/space/orange,
/obj/item/clothing/head/helmet/space/orange,
/obj/item/clothing/suit/space/orange,
/obj/item/clothing/suit/space/orange,
/obj/item/clothing/suit/space/orange,
/obj/item/clothing/suit/space/orange,
/obj/item/tank/internals/emergency_oxygen,
/obj/item/tank/internals/emergency_oxygen,
/obj/item/tank/internals/emergency_oxygen,
/obj/item/tank/internals/emergency_oxygen,
/obj/item/tank/internals/emergency_oxygen,
/obj/item/circuitboard/machine/autolathe,
/obj/item/storage/toolbox/mechanical/old,
/obj/item/clothing/mask/breath,
/obj/item/clothing/mask/breath,
/obj/item/clothing/mask/breath,
/obj/item/clothing/mask/breath,
/obj/item/areaeditor/shuttle,
/obj/item/reagent_containers/glass/beaker/large,
/obj/item/reagent_containers/glass/beaker/large,
/obj/item/storage/bag/plants/portaseeder,
/obj/item/storage/bag/ore,
/obj/item/storage/bag/ore,
/obj/item/storage/bag/ore,
/obj/machinery/atmospherics/components/unary/vent_scrubber/on{
	dir = 8
	},
/obj/machinery/light/floor,
/obj/structure/cable{
	icon_state = "1-8"
	},
/obj/item/storage/bag/ore,
/obj/item/shovel/spoon,
/obj/item/shovel/spoon,
/obj/item/shovel/spoon,
/obj/item/shovel/spoon,
/obj/item/flashlight/lantern,
/obj/item/flashlight/lantern,
/obj/item/flashlight/lantern,
/obj/item/flashlight/lantern,
/obj/item/melee/baseball_bat/bone,
/obj/item/melee/baseball_bat/bone,
/obj/item/melee/baseball_bat/bone,
/obj/item/melee/baseball_bat/bone,
/obj/item/scythe,
/obj/item/scythe,
/obj/item/scythe,
/obj/item/scythe,
/obj/item/stack/sheet/mineral/wood,
/obj/item/stack/sheet/animalhide/goliath_hide,
/obj/item/stack/sheet/sinew,
/obj/item/stack/sheet/bone,
/turf/open/floor/plating/asteroid/basalt/lava_land_surface,
/area/ship/storage)
"l" = (
/obj/structure/stone_tile/slab,
/mob/living/simple_animal/hostile/asteroid/gutlunch/gubbuck,
/obj/structure/window/reinforced/tinted,
/turf/open/lava/smooth/lava_land_surface,
/area/ship/storage)
"n" = (
/obj/machinery/power/shuttle/engine/electric{
	dir = 4
	},
/obj/structure/cable{
	icon_state = "0-4"
	},
/obj/machinery/atmospherics/components/unary/outlet_injector/on{
	dir = 4
	},
/turf/open/floor/plasteel/tech/airless,
/area/ship/storage)
"q" = (
/obj/structure/stone_tile/slab,
/obj/structure/lavaland/ash_walker,
/turf/open/lava/smooth/lava_land_surface,
/area/ship/storage)
"t" = (
/obj/structure/stone_tile/slab,
/mob/living/simple_animal/hostile/asteroid/gutlunch/guthen,
/obj/structure/window/reinforced/tinted{
	dir = 4
	},
/turf/open/lava/smooth/lava_land_surface,
/area/ship/storage)
"u" = (
/obj/structure/stone_tile/slab,
/obj/structure/window/reinforced/tinted{
	dir = 1
	},
/turf/open/lava/smooth/lava_land_surface,
/area/ship/storage)
"C" = (
/obj/structure/stone_tile/slab,
/obj/structure/window/reinforced/tinted{
	dir = 4
	},
/obj/structure/window/reinforced/tinted{
	dir = 1
	},
/turf/open/lava/smooth/lava_land_surface,
/area/ship/storage)
"D" = (
/obj/structure/stone_tile/slab,
/obj/structure/window/reinforced/tinted{
	dir = 1
	},
/obj/item/reagent_containers/glass/bucket/wooden,
/obj/item/reagent_containers/glass/bucket/wooden,
/turf/open/lava/smooth/lava_land_surface,
/area/ship/storage)
"F" = (
/obj/structure/window/reinforced/tinted{
	dir = 8
	},
/obj/structure/window/reinforced/tinted,
/obj/structure/window/reinforced/tinted{
	dir = 1
	},
/obj/machinery/power/apc/auto_name/west{
	pixel_x = -25
	},
/obj/machinery/atmospherics/pipe/simple/scrubbers{
	dir = 8
	},
/obj/structure/cable{
	icon_state = "0-4"
	},
/obj/machinery/cryopod{
	dir = 4
	},
/obj/machinery/computer/cryopod{
	pixel_y = 9
	},
/obj/machinery/airalarm/directional/west,
/obj/structure/cable{
	icon_state = "0-8"
	},
/turf/open/floor/plating/asteroid/basalt/lava_land_surface,
/area/ship/storage)
"J" = (
/obj/machinery/power/port_gen/pacman/mrs,
/obj/structure/cable{
	icon_state = "0-2"
	},
/obj/machinery/computer/helm,
/obj/structure/window/reinforced/tinted{
	dir = 1
	},
/obj/structure/window/reinforced/tinted{
	dir = 8
	},
/turf/open/floor/plating/asteroid/basalt/lava_land_surface,
/area/ship/storage)
"M" = (
/obj/structure/stone_tile/slab,
/obj/structure/window/reinforced/tinted,
/turf/open/lava/smooth/lava_land_surface,
/area/ship/storage)
"U" = (
/obj/docking_port/mobile{
	can_move_docking_ports = 1;
	dir = 8;
	launch_status = 0
	},
/obj/structure/plasticflaps,
/obj/structure/window/reinforced/tinted{
	dir = 8
	},
/obj/structure/window/reinforced/tinted{
	dir = 4
	},
/turf/open/floor/plating/asteroid/basalt/lava_land_surface,
/area/ship/storage)

(1,1,1) = {"
a
n
a
"}
(2,1,1) = {"
a
F
a
"}
(3,1,1) = {"
J
i
U
"}
(4,1,1) = {"
D
d
l
"}
(5,1,1) = {"
u
q
M
"}
(6,1,1) = {"
C
t
h
"}
