//MAP CONVERTED BY dmm2tgm.py THIS HEADER COMMENT PREVENTS RECONVERSION, DO NOT REMOVE
"ab" = (
/turf/open/space/basic,
/area/space)
"ac" = (
/obj/machinery/power/shuttle/engine/electric{
	dir = 4
	},
/obj/structure/window/reinforced/survival_pod/spawner/east,
/turf/open/floor/pod,
/area/ship/crew/hydroponics)
"bL" = (
/obj/structure/cable{
	icon_state = "4-8"
	},
/turf/open/floor/pod,
/area/ship/crew/hydroponics)
"bS" = (
/obj/structure/closet/wall/blue{
	dir = 1;
	pixel_y = -33
	},
/obj/item/kinetic_crusher/old,
/obj/item/clothing/glasses/cheapsuns,
/turf/open/floor/pod,
/area/ship/bridge)
"bT" = (
/obj/machinery/seed_extractor,
/turf/open/floor/pod,
/area/ship/crew/hydroponics)
"bU" = (
/obj/machinery/airalarm/directional/west,
/turf/open/floor/pod,
/area/ship/bridge)
"cJ" = (
/obj/machinery/atmospherics/components/unary/vent_scrubber/on/layer2{
	dir = 4
	},
/turf/open/floor/pod,
/area/ship/cargo)
"cY" = (
/obj/item/gps/computer,
/turf/open/floor/pod,
/area/ship/bridge)
"dn" = (
/obj/structure/cable{
	icon_state = "1-2"
	},
/obj/machinery/atmospherics/pipe/simple/supply/hidden,
/obj/machinery/atmospherics/pipe/simple/scrubbers/hidden/layer2{
	dir = 1
	},
/turf/open/floor/pod,
/area/ship/hallway/central)
"dr" = (
/obj/machinery/atmospherics/components/unary/vent_scrubber/on/layer2,
/turf/open/floor/pod,
/area/ship/bridge)
"dy" = (
/obj/structure/cable{
	icon_state = "4-8"
	},
/obj/machinery/atmospherics/pipe/manifold/supply/hidden,
/obj/machinery/atmospherics/pipe/manifold/scrubbers/hidden/layer2{
	dir = 1
	},
/obj/effect/turf_decal/corner/beige/half{
	color = "#ba774c";
	dir = 8
	},
/turf/open/floor/pod,
/area/ship/hallway/central)
"dP" = (
/turf/open/floor/pod,
/area/ship/crew/hydroponics)
"ed" = (
/obj/structure/cable{
	icon_state = "1-2"
	},
/obj/machinery/atmospherics/pipe/simple/supply/hidden,
/obj/machinery/atmospherics/pipe/simple/scrubbers/hidden/layer2{
	dir = 6
	},
/turf/open/floor/pod,
/area/ship/crew/dorm)
"ek" = (
/obj/machinery/airalarm/directional/east,
/turf/open/floor/pod,
/area/ship/hallway/central)
"ey" = (
/obj/structure/table/reinforced,
/obj/machinery/button/door{
	id = 7
	},
/turf/open/floor/pod,
/area/ship/bridge)
"eF" = (
/obj/structure/cable{
	icon_state = "4-8"
	},
/obj/machinery/atmospherics/pipe/simple/supply/hidden{
	dir = 8
	},
/obj/machinery/atmospherics/pipe/simple/scrubbers/hidden/layer2{
	dir = 8
	},
/turf/open/floor/pod,
/area/ship/hallway/central)
"eV" = (
/obj/structure/closet/crate{
	name = "Mining Supplies"
	},
/obj/item/pickaxe/drill,
/obj/item/pickaxe/drill,
/obj/item/pickaxe/drill,
/obj/item/clothing/suit/hooded/explorer/old,
/obj/item/clothing/suit/hooded/explorer/old,
/obj/item/clothing/suit/hooded/explorer/old,
/obj/item/clothing/mask/gas/explorer/old,
/obj/item/clothing/mask/gas/explorer/old,
/obj/item/clothing/mask/gas/explorer/old,
/obj/item/clothing/gloves/explorer/old,
/obj/item/clothing/gloves/explorer/old,
/obj/item/clothing/gloves/explorer/old,
/obj/item/gun/energy/kinetic_accelerator/old,
/obj/item/gps/mining,
/obj/item/gps/mining,
/obj/item/gps/mining,
/turf/open/floor/pod,
/area/ship/cargo)
"fz" = (
/obj/structure/cable{
	icon_state = "4-8"
	},
/obj/machinery/atmospherics/pipe/simple/supply/hidden{
	dir = 8
	},
/obj/machinery/atmospherics/pipe/simple/scrubbers/hidden/layer2{
	dir = 8
	},
/obj/machinery/atmospherics/pipe/simple/scrubbers/hidden/layer2{
	dir = 8
	},
/obj/structure/transit_tube{
	dir = 4
	},
/turf/open/floor/plating,
/area/ship/hallway/central)
"ga" = (
/obj/machinery/light{
	dir = 1
	},
/obj/machinery/airalarm/directional/north,
/turf/open/floor/pod,
/area/ship/cargo)
"gw" = (
/turf/open/floor/pod,
/area/ship/crew/dorm)
"hj" = (
/obj/machinery/hydroponics/soil,
/turf/open/floor/pod,
/area/ship/crew/hydroponics)
"hY" = (
/obj/machinery/atmospherics/components/unary/tank/air,
/turf/open/floor/pod,
/area/ship/cargo)
"ik" = (
/obj/structure/cable{
	icon_state = "4-8"
	},
/obj/machinery/computer/cryopod{
	pixel_y = 32
	},
/turf/open/floor/pod,
/area/ship/crew/dorm)
"iH" = (
/obj/structure/table/reinforced,
/obj/machinery/computer/med_data/laptop{
	dir = 8
	},
/turf/open/floor/pod,
/area/ship/bridge)
"jV" = (
/obj/machinery/conveyor/auto{
	dir = 1
	},
/obj/structure/window/reinforced/survival_pod/spawner/east,
/turf/open/floor/pod,
/area/ship/cargo)
"kb" = (
/obj/machinery/atmospherics/pipe/simple/supply/hidden{
	dir = 8
	},
/turf/open/floor/pod,
/area/ship/cargo)
"kd" = (
/obj/structure/table/reinforced,
/obj/item/multitool/old,
/obj/item/multitool/old,
/turf/open/floor/pod,
/area/ship/cargo)
"kr" = (
/obj/structure/cable{
	icon_state = "4-8"
	},
/obj/machinery/atmospherics/pipe/manifold/scrubbers/hidden/layer2{
	dir = 1
	},
/turf/open/floor/pod,
/area/ship/cargo)
"lh" = (
/obj/machinery/mineral/mint{
	name = "old coin press";
	desc = "Some kind of machine. Looks old from a long time of no use.";
	input_dir = 2
	},
/turf/open/floor/pod,
/area/ship/cargo)
"lI" = (
/obj/machinery/atmospherics/pipe/manifold/supply/hidden,
/turf/open/floor/pod,
/area/ship/cargo)
"lN" = (
/turf/closed/wall/mineral/titanium/survival/nodiagonal,
/area/ship/crew/hydroponics)
"lY" = (
/obj/machinery/power/shuttle/engine/electric{
	dir = 4
	},
/obj/structure/window/reinforced/survival_pod/spawner/east,
/turf/open/space/basic,
/area/ship/crew/hydroponics)
"mt" = (
/obj/machinery/power/smes/shuttle/precharged{
	dir = 4
	},
/obj/structure/window/reinforced/survival_pod/spawner/west,
/turf/open/floor/pod,
/area/ship/crew/dorm)
"mD" = (
/obj/structure/cable{
	icon_state = "1-2"
	},
/obj/machinery/atmospherics/components/unary/vent_pump/on,
/turf/open/floor/pod,
/area/ship/crew/dorm)
"mP" = (
/turf/closed/wall/mineral/titanium/survival/nodiagonal,
/area/ship/hallway/central)
"mX" = (
/obj/structure/cable,
/obj/machinery/power/apc/auto_name/west,
/turf/open/floor/pod,
/area/ship/bridge)
"nk" = (
/turf/closed/wall/mineral/titanium/survival/nodiagonal,
/area/ship/crew/dorm)
"nu" = (
/obj/machinery/power/smes/shuttle/precharged{
	dir = 4
	},
/obj/structure/window/reinforced/survival_pod/spawner/west,
/turf/open/floor/pod,
/area/ship/crew/hydroponics)
"oh" = (
/obj/structure/table/reinforced,
/obj/machinery/button/door{
	id = 6
	},
/turf/open/floor/pod,
/area/ship/cargo)
"oD" = (
/obj/structure/cable{
	icon_state = "2-4"
	},
/obj/machinery/atmospherics/pipe/simple/scrubbers/hidden/layer2{
	dir = 8
	},
/turf/open/floor/pod,
/area/ship/cargo)
"oM" = (
/obj/structure/cable{
	icon_state = "4-8"
	},
/obj/machinery/atmospherics/pipe/manifold/scrubbers/hidden/layer2{
	dir = 1
	},
/obj/machinery/atmospherics/pipe/manifold/supply/hidden,
/obj/structure/transit_tube{
	dir = 4
	},
/turf/open/floor/plating,
/area/ship/hallway/central)
"oO" = (
/turf/closed/wall/mineral/titanium/survival/nodiagonal,
/area/ship/bridge)
"oT" = (
/obj/structure/cable{
	icon_state = "4-8"
	},
/obj/machinery/hydroponics/soil,
/obj/machinery/airalarm/directional/south,
/turf/open/floor/pod,
/area/ship/crew/hydroponics)
"pI" = (
/obj/structure/cable{
	icon_state = "4-8"
	},
/obj/structure/cable{
	icon_state = "2-8"
	},
/obj/structure/cable{
	icon_state = "0-2"
	},
/obj/machinery/power/apc/auto_name/north,
/turf/open/floor/pod,
/area/ship/crew/dorm)
"pM" = (
/obj/effect/turf_decal/corner/beige/half{
	color = "#ba774c"
	},
/turf/open/floor/pod,
/area/ship/hallway/central)
"pN" = (
/obj/structure/cable{
	icon_state = "4-8"
	},
/obj/machinery/atmospherics/pipe/simple/supply/hidden{
	dir = 8
	},
/obj/machinery/atmospherics/pipe/simple/scrubbers/hidden/layer2{
	dir = 8
	},
/obj/effect/turf_decal/corner/beige/half{
	color = "#ba774c";
	dir = 8
	},
/obj/effect/turf_decal/corner/beige/half{
	color = "#ba774c"
	},
/turf/open/floor/pod,
/area/ship/hallway/central)
"qb" = (
/obj/structure/tank_dispenser/oxygen,
/turf/open/floor/pod,
/area/ship/hallway/central)
"qc" = (
/obj/machinery/atmospherics/components/unary/vent_scrubber/on/layer2{
	dir = 1
	},
/obj/effect/turf_decal/corner/beige/half{
	color = "#ba774c";
	dir = 8
	},
/turf/open/floor/pod,
/area/ship/hallway/central)
"qM" = (
/obj/machinery/power/smes/engineering,
/obj/structure/cable{
	icon_state = "0-8"
	},
/turf/open/floor/pod,
/area/ship/crew/dorm)
"qR" = (
/obj/structure/window/reinforced/survival_pod/spawner,
/obj/machinery/atmospherics/components/unary/vent_scrubber/on/layer2{
	dir = 1
	},
/turf/open/floor/plating,
/area/ship/hallway/central)
"sk" = (
/obj/structure/window/reinforced/survival_pod/spawner,
/turf/open/floor/pod,
/area/ship/hallway/central)
"sz" = (
/obj/machinery/computer/monitor/secret{
	dir = 8
	},
/turf/open/floor/pod,
/area/ship/bridge)
"sC" = (
/obj/structure/cable{
	icon_state = "4-8"
	},
/obj/machinery/atmospherics/pipe/simple/supply/hidden{
	dir = 5
	},
/obj/machinery/atmospherics/pipe/simple/scrubbers/hidden/layer2{
	dir = 8
	},
/obj/structure/transit_tube/station/dispenser/flipped{
	dir = 1
	},
/turf/open/floor/pod,
/area/ship/cargo)
"tf" = (
/obj/machinery/door/poddoor{
	id = 6
	},
/obj/structure/fans/tiny,
/turf/open/floor/pod,
/area/ship/cargo)
"uc" = (
/obj/structure/cable{
	icon_state = "4-8"
	},
/obj/machinery/atmospherics/pipe/manifold/supply/hidden,
/obj/machinery/atmospherics/pipe/simple/scrubbers/hidden/layer2{
	dir = 8
	},
/obj/structure/transit_tube{
	dir = 4
	},
/turf/open/floor/plating,
/area/ship/hallway/central)
"uj" = (
/obj/machinery/atmospherics/components/unary/vent_scrubber/on/layer2{
	dir = 8
	},
/turf/open/floor/pod,
/area/ship/crew/hydroponics)
"uo" = (
/obj/structure/cable,
/obj/machinery/power/apc/auto_name/east,
/turf/open/floor/pod,
/area/ship/hallway/central)
"uv" = (
/turf/open/floor/pod,
/area/ship/cargo)
"vD" = (
/obj/machinery/door/poddoor{
	id = 6
	},
/obj/structure/fans/tiny,
/obj/docking_port/mobile{
	dir = 8
	},
/turf/open/floor/pod,
/area/ship/cargo)
"vK" = (
/obj/machinery/computer/helm{
	dir = 8
	},
/obj/machinery/light{
	dir = 4
	},
/turf/open/floor/pod,
/area/ship/bridge)
"wl" = (
/obj/machinery/atmospherics/pipe/simple/scrubbers/hidden/layer2{
	dir = 8
	},
/turf/open/floor/pod,
/area/ship/cargo)
"wN" = (
/obj/structure/cable{
	icon_state = "4-8"
	},
/obj/machinery/atmospherics/pipe/simple/supply/hidden{
	dir = 8
	},
/obj/machinery/atmospherics/pipe/simple/scrubbers/hidden/layer2{
	dir = 8
	},
/obj/structure/transit_tube{
	dir = 4
	},
/turf/open/floor/plating,
/area/ship/hallway/central)
"wW" = (
/obj/machinery/atmospherics/components/unary/vent_scrubber,
/turf/open/floor/plating,
/area/ship/external)
"xd" = (
/obj/machinery/door/window/survival_pod,
/turf/open/floor/pod,
/area/ship/hallway/central)
"xk" = (
/obj/structure/window/reinforced/survival_pod/spawner/north,
/obj/machinery/atmospherics/components/unary/vent_pump/on,
/turf/open/floor/plating,
/area/ship/hallway/central)
"xx" = (
/obj/structure/cable{
	icon_state = "1-2"
	},
/obj/machinery/atmospherics/pipe/simple/supply/hidden,
/obj/machinery/atmospherics/pipe/simple/scrubbers/hidden/layer2{
	dir = 5
	},
/turf/open/floor/pod,
/area/ship/crew/hydroponics)
"xO" = (
/obj/machinery/atmospherics/components/unary/outlet_injector/on/layer2{
	dir = 1
	},
/turf/open/floor/plating,
/area/ship/external)
"xP" = (
/obj/machinery/autolathe,
/turf/open/floor/pod,
/area/ship/hallway/central)
"yx" = (
/obj/machinery/door/airlock/survival_pod,
/obj/structure/cable{
	icon_state = "4-8"
	},
/obj/machinery/atmospherics/pipe/simple/supply/hidden{
	dir = 8
	},
/obj/machinery/atmospherics/pipe/simple/scrubbers/hidden/layer2{
	dir = 8
	},
/turf/open/floor/pod,
/area/ship/bridge)
"zD" = (
/obj/machinery/power/terminal{
	dir = 8
	},
/obj/structure/cable{
	icon_state = "0-4"
	},
/obj/machinery/hydroponics/soil,
/turf/open/floor/pod,
/area/ship/crew/hydroponics)
"Af" = (
/obj/structure/closet/crate{
	desc = "A rectangular steel crate. There's a note on it that says, 'The crusher's cursed, use this to upgrade it.'";
	name = "Processor Upgrade Crate"
	},
/obj/item/storage/part_replacer/bluespace,
/obj/item/stock_parts/manipulator/femto,
/turf/open/floor/pod,
/area/ship/cargo)
"Ak" = (
/obj/machinery/suit_storage_unit/industrial{
	suit_type = /obj/item/clothing/suit/space/hardsuit/mining;
	name = "Heavy-duty mining gear storage"
	},
/turf/open/floor/pod,
/area/ship/hallway/central)
"AE" = (
/obj/structure/cable{
	icon_state = "4-8"
	},
/obj/machinery/atmospherics/pipe/simple/supply/hidden{
	dir = 8
	},
/obj/machinery/atmospherics/pipe/simple/scrubbers/hidden/layer2{
	dir = 8
	},
/obj/structure/transit_tube{
	dir = 4
	},
/turf/open/floor/pod,
/area/ship/cargo)
"AQ" = (
/obj/structure/cable{
	icon_state = "4-8"
	},
/obj/machinery/atmospherics/pipe/simple/supply/hidden{
	dir = 8
	},
/obj/machinery/atmospherics/pipe/simple/scrubbers/hidden/layer2{
	dir = 8
	},
/obj/structure/transit_tube{
	dir = 4
	},
/turf/open/floor/pod,
/area/ship/hallway/central)
"BA" = (
/obj/machinery/conveyor/auto{
	dir = 5
	},
/obj/structure/window/reinforced/survival_pod/spawner/north,
/turf/open/floor/pod,
/area/ship/cargo)
"CE" = (
/obj/structure/cable{
	icon_state = "0-4"
	},
/obj/structure/cable{
	icon_state = "2-4"
	},
/obj/machinery/power/terminal{
	dir = 8
	},
/turf/open/floor/pod,
/area/ship/crew/dorm)
"CG" = (
/obj/machinery/computer/security{
	dir = 8
	},
/turf/open/floor/pod,
/area/ship/bridge)
"Df" = (
/obj/machinery/mineral/unloading_machine{
	input_dir = 4;
	output_dir = 8
	},
/turf/open/floor/pod,
/area/ship/cargo)
"Ej" = (
/obj/machinery/atmospherics/components/unary/vent_scrubber/on/layer2{
	dir = 8
	},
/turf/open/floor/pod,
/area/ship/crew/dorm)
"Ff" = (
/obj/effect/spawner/structure/window/survival_pod,
/turf/open/space/basic,
/area/ship/cargo)
"Fh" = (
/obj/machinery/atmospherics/pipe/manifold/scrubbers/hidden/layer2{
	dir = 1
	},
/turf/open/floor/pod,
/area/ship/cargo)
"GG" = (
/turf/open/floor/pod,
/area/ship/bridge)
"GH" = (
/obj/structure/window/reinforced/survival_pod/spawner/north,
/turf/open/floor/plating,
/area/ship/hallway/central)
"Hj" = (
/obj/structure/cable{
	icon_state = "1-2"
	},
/obj/machinery/atmospherics/pipe/simple/supply/hidden,
/obj/machinery/atmospherics/pipe/simple/scrubbers/hidden/layer2{
	dir = 1
	},
/obj/effect/turf_decal/corner/beige/half{
	color = "#ba774c"
	},
/turf/open/floor/pod,
/area/ship/hallway/central)
"Hs" = (
/obj/effect/spawner/structure/window/survival_pod,
/obj/machinery/door/poddoor{
	id = 7
	},
/turf/open/floor/plating,
/area/ship/bridge)
"HG" = (
/obj/machinery/atmospherics/components/unary/vent_pump/on{
	dir = 8
	},
/turf/open/floor/pod,
/area/ship/bridge)
"HZ" = (
/obj/machinery/atmospherics/pipe/simple/supply/hidden{
	dir = 10
	},
/obj/structure/table/reinforced,
/obj/item/storage/toolbox/electrical,
/obj/item/storage/toolbox/electrical,
/turf/open/floor/pod,
/area/ship/cargo)
"Ip" = (
/obj/machinery/door/window/survival_pod,
/obj/structure/cable{
	icon_state = "1-2"
	},
/obj/machinery/atmospherics/pipe/simple/supply/hidden,
/obj/machinery/atmospherics/pipe/simple/scrubbers/hidden/layer2{
	dir = 1
	},
/turf/open/floor/pod,
/area/ship/hallway/central)
"Ir" = (
/obj/effect/turf_decal/corner/beige/half{
	color = "#ba774c"
	},
/obj/effect/turf_decal/corner/beige/half{
	color = "#ba774c";
	dir = 8
	},
/turf/open/floor/pod,
/area/ship/hallway/central)
"IK" = (
/obj/machinery/recycler{
	layer = 3;
	desc = "A large crushing machine used to process ores efficiently(?). There are lights on the side.";
	amount_produced = 100;
	name = "Ore Processor"
	},
/obj/structure/window/reinforced/survival_pod,
/obj/structure/window/reinforced/survival_pod/spawner/north,
/obj/machinery/door/window/survival_pod{
	dir = 4
	},
/obj/machinery/conveyor/auto{
	dir = 4
	},
/turf/open/floor/pod,
/area/ship/cargo)
"IP" = (
/turf/closed/wall/mineral/titanium/survival/nodiagonal,
/area/ship/cargo)
"Jt" = (
/obj/structure/cable{
	icon_state = "1-8"
	},
/obj/structure/cable,
/obj/machinery/power/apc/auto_name/south,
/obj/structure/reagent_dispensers/watertank/high,
/turf/open/floor/pod,
/area/ship/crew/hydroponics)
"JB" = (
/turf/open/floor/pod,
/area/ship/hallway/central)
"JD" = (
/obj/machinery/cryopod{
	dir = 1
	},
/turf/open/floor/pod,
/area/ship/crew/dorm)
"JF" = (
/obj/machinery/light{
	dir = 8
	},
/turf/open/floor/pod,
/area/ship/hallway/central)
"Km" = (
/obj/machinery/conveyor/auto{
	dir = 1
	},
/turf/open/floor/pod,
/area/ship/cargo)
"Ku" = (
/obj/structure/cable{
	icon_state = "4-8"
	},
/obj/machinery/atmospherics/pipe/simple/supply/hidden{
	dir = 8
	},
/obj/machinery/atmospherics/pipe/simple/scrubbers/hidden/layer2{
	dir = 8
	},
/obj/structure/transit_tube/station/dispenser,
/turf/open/floor/pod,
/area/ship/hallway/central)
"KX" = (
/obj/structure/cable{
	icon_state = "0-2"
	},
/obj/machinery/power/terminal{
	dir = 1
	},
/turf/open/floor/pod,
/area/ship/crew/dorm)
"Lb" = (
/obj/machinery/atmospherics/components/unary/vent_pump/on,
/obj/effect/turf_decal/corner/beige/half{
	color = "#ba774c";
	dir = 8
	},
/turf/open/floor/pod,
/area/ship/hallway/central)
"Lr" = (
/obj/machinery/door/window/survival_pod{
	dir = 1
	},
/turf/open/floor/pod,
/area/ship/hallway/central)
"Lu" = (
/turf/closed/wall/mineral/titanium/survival,
/area/ship/cargo)
"MA" = (
/obj/structure/cable{
	icon_state = "4-8"
	},
/obj/machinery/atmospherics/pipe/simple/supply/hidden{
	dir = 8
	},
/obj/machinery/atmospherics/pipe/simple/scrubbers/hidden/layer2{
	dir = 8
	},
/obj/effect/turf_decal/corner/beige/half{
	color = "#ba774c";
	dir = 4
	},
/turf/open/floor/pod,
/area/ship/hallway/central)
"Nd" = (
/obj/effect/spawner/structure/window/survival_pod,
/turf/open/floor/pod,
/area/ship/cargo)
"Ne" = (
/obj/structure/window/reinforced/survival_pod/spawner,
/obj/machinery/atmospherics/pipe/simple/scrubbers/hidden/layer2{
	dir = 1
	},
/turf/open/floor/plating,
/area/ship/hallway/central)
"NK" = (
/obj/structure/window/reinforced/survival_pod/spawner/north,
/obj/machinery/atmospherics/pipe/simple/supply/hidden,
/turf/open/floor/plating,
/area/ship/hallway/central)
"NN" = (
/obj/structure/cable{
	icon_state = "1-2"
	},
/turf/open/floor/pod,
/area/ship/cargo)
"OM" = (
/obj/effect/turf_decal/corner/beige/half{
	color = "#ba774c";
	dir = 4
	},
/turf/open/floor/pod,
/area/ship/hallway/central)
"PY" = (
/obj/structure/cable{
	icon_state = "4-8"
	},
/turf/open/floor/pod,
/area/ship/crew/dorm)
"Qe" = (
/obj/machinery/power/shuttle/engine/electric{
	dir = 4
	},
/obj/structure/window/reinforced/survival_pod/spawner/east,
/turf/open/floor/pod,
/area/ship/crew/dorm)
"Qx" = (
/obj/structure/window/reinforced/survival_pod/spawner,
/turf/open/floor/plating,
/area/ship/hallway/central)
"QC" = (
/obj/structure/cable{
	icon_state = "4-8"
	},
/obj/machinery/atmospherics/pipe/simple/supply/hidden{
	dir = 8
	},
/obj/machinery/atmospherics/pipe/manifold/scrubbers/hidden/layer2{
	dir = 1
	},
/obj/structure/transit_tube{
	dir = 4
	},
/turf/open/floor/plating,
/area/ship/hallway/central)
"QM" = (
/obj/structure/window/reinforced/survival_pod/spawner/north,
/turf/open/floor/pod,
/area/ship/hallway/central)
"RN" = (
/obj/machinery/power/port_gen/pacman,
/obj/structure/cable,
/turf/open/floor/pod,
/area/ship/crew/dorm)
"Sw" = (
/obj/machinery/modular_computer/console/preset/civilian{
	dir = 8
	},
/turf/open/floor/pod,
/area/ship/bridge)
"SZ" = (
/obj/structure/cable,
/obj/machinery/power/terminal{
	dir = 8
	},
/turf/open/floor/pod,
/area/ship/crew/dorm)
"Tg" = (
/obj/effect/turf_decal/corner/beige/half{
	color = "#ba774c"
	},
/obj/effect/turf_decal/corner/beige/half{
	color = "#ba774c";
	dir = 4
	},
/turf/open/floor/pod,
/area/ship/hallway/central)
"Ut" = (
/obj/structure/cable{
	icon_state = "4-8"
	},
/obj/structure/cable{
	icon_state = "2-8"
	},
/obj/machinery/atmospherics/pipe/simple/supply/hidden{
	dir = 8
	},
/obj/machinery/atmospherics/pipe/simple/scrubbers/hidden/layer2{
	dir = 8
	},
/turf/open/floor/pod,
/area/ship/hallway/central)
"UA" = (
/obj/structure/cable,
/obj/machinery/power/apc/auto_name/south,
/obj/machinery/light,
/turf/open/floor/pod,
/area/ship/cargo)
"UI" = (
/obj/machinery/light,
/turf/open/floor/pod,
/area/ship/cargo)
"UR" = (
/obj/machinery/light{
	dir = 4
	},
/turf/open/floor/pod,
/area/ship/hallway/central)
"UZ" = (
/obj/structure/cable{
	icon_state = "1-2"
	},
/obj/structure/cable{
	icon_state = "2-4"
	},
/obj/structure/cable{
	icon_state = "1-8"
	},
/obj/machinery/atmospherics/pipe/manifold4w/supply/hidden,
/obj/machinery/atmospherics/pipe/manifold4w/scrubbers/hidden/layer2,
/turf/open/floor/pod,
/area/ship/hallway/central)
"Vz" = (
/obj/machinery/vending/hydronutrients,
/turf/open/floor/pod,
/area/ship/crew/hydroponics)
"VF" = (
/obj/structure/cable{
	icon_state = "2-8"
	},
/obj/machinery/atmospherics/pipe/simple/supply/hidden{
	dir = 8
	},
/obj/machinery/atmospherics/pipe/simple/scrubbers/hidden/layer2{
	dir = 9
	},
/turf/open/floor/pod,
/area/ship/bridge)
"VG" = (
/obj/machinery/vending/hydroseeds,
/turf/open/floor/pod,
/area/ship/crew/hydroponics)
"VP" = (
/obj/structure/cable{
	icon_state = "4-8"
	},
/obj/machinery/atmospherics/pipe/simple/scrubbers/hidden/layer2{
	dir = 8
	},
/turf/open/floor/pod,
/area/ship/cargo)
"Wj" = (
/obj/machinery/door/window/survival_pod{
	dir = 1
	},
/obj/structure/cable{
	icon_state = "1-2"
	},
/obj/machinery/atmospherics/pipe/simple/supply/hidden,
/obj/machinery/atmospherics/pipe/simple/scrubbers/hidden/layer2{
	dir = 1
	},
/turf/open/floor/pod,
/area/ship/hallway/central)
"Wl" = (
/obj/machinery/power/terminal{
	dir = 8
	},
/obj/structure/cable{
	icon_state = "0-4"
	},
/turf/open/floor/pod,
/area/ship/crew/hydroponics)
"WD" = (
/obj/machinery/atmospherics/components/unary/vent_scrubber/on/layer2{
	dir = 1
	},
/turf/open/floor/pod,
/area/ship/cargo)
"WE" = (
/obj/machinery/hydroponics/soil,
/obj/machinery/light,
/turf/open/floor/pod,
/area/ship/crew/hydroponics)
"WP" = (
/obj/structure/ore_box,
/turf/open/floor/pod,
/area/ship/cargo)
"Xg" = (
/obj/structure/closet/crate/hydroponics,
/obj/item/shovel/spade,
/obj/item/cultivator,
/obj/item/storage/bag/plants,
/obj/item/plant_analyzer,
/obj/item/hatchet,
/turf/open/floor/pod,
/area/ship/crew/hydroponics)
"XV" = (
/obj/machinery/light{
	dir = 1
	},
/turf/open/floor/pod,
/area/ship/cargo)
"XY" = (
/obj/machinery/selling_pad,
/turf/open/floor/pod,
/area/ship/cargo)
"Yb" = (
/obj/structure/cable{
	icon_state = "1-2"
	},
/obj/structure/cable{
	icon_state = "1-8"
	},
/obj/machinery/atmospherics/components/unary/vent_pump/on{
	dir = 1
	},
/turf/open/floor/pod,
/area/ship/crew/hydroponics)
"YI" = (
/obj/machinery/atmospherics/components/unary/vent_pump/on,
/turf/open/floor/pod,
/area/ship/cargo)
"YR" = (
/obj/structure/cable{
	icon_state = "4-8"
	},
/obj/machinery/light{
	dir = 1
	},
/obj/machinery/airalarm/directional/north,
/turf/open/floor/pod,
/area/ship/crew/dorm)
"YZ" = (
/obj/machinery/computer/selling_pad_control{
	dir = 1
	},
/turf/open/floor/pod,
/area/ship/cargo)
"Ze" = (
/obj/machinery/smartfridge/survival_pod,
/turf/open/floor/pod,
/area/ship/bridge)

(1,1,1) = {"
ab
ab
ab
ab
ab
ab
ab
ab
ab
ab
ab
ab
IP
IP
IP
IP
IP
IP
IP
IP
IP
ab
ab
ab
ab
ab
ab
ab
ab
ab
"}
(2,1,1) = {"
ab
ab
ab
ab
ab
ab
ab
ab
ab
ab
ab
ab
IP
lh
Af
hY
BA
jV
jV
Km
IP
ab
ab
ab
ab
ab
ab
ab
ab
ab
"}
(3,1,1) = {"
ab
ab
ab
ab
ab
ab
ab
ab
ab
ab
ab
ab
Ff
WP
YI
lI
IK
uv
uv
Df
Nd
ab
ab
ab
ab
ab
ab
ab
ab
ab
"}
(4,1,1) = {"
ab
ab
ab
ab
ab
ab
ab
ab
ab
ab
ab
ab
Ff
WP
uv
kb
cJ
uv
uv
uv
Nd
ab
ab
ab
ab
ab
ab
ab
ab
ab
"}
(5,1,1) = {"
ab
ab
ab
ab
ab
ab
ab
ab
ab
ab
ab
ab
Ff
WP
uv
kb
wl
uv
uv
uv
Nd
ab
ab
ab
ab
ab
ab
ab
ab
ab
"}
(6,1,1) = {"
ab
ab
ab
ab
ab
ab
ab
ab
ab
ab
ab
ab
IP
XV
uv
kb
Fh
WD
uv
UI
IP
ab
ab
ab
ab
ab
ab
ab
ab
ab
"}
(7,1,1) = {"
ab
ab
ab
ab
ab
ab
ab
ab
ab
ab
ab
ab
tf
uv
uv
kb
wl
uv
uv
uv
vD
ab
ab
ab
ab
ab
ab
ab
ab
ab
"}
(8,1,1) = {"
ab
ab
ab
ab
ab
ab
ab
ab
ab
ab
ab
ab
tf
uv
uv
kb
wl
uv
uv
uv
tf
ab
ab
ab
ab
ab
ab
ab
ab
ab
"}
(9,1,1) = {"
ab
ab
ab
ab
ab
ab
ab
ab
ab
ab
ab
ab
tf
uv
uv
kb
wl
uv
uv
uv
tf
ab
ab
ab
ab
ab
ab
ab
ab
ab
"}
(10,1,1) = {"
ab
ab
ab
ab
ab
ab
ab
ab
ab
ab
ab
ab
tf
uv
YI
lI
wl
uv
uv
uv
tf
ab
ab
ab
ab
ab
ab
ab
ab
ab
"}
(11,1,1) = {"
ab
ab
ab
ab
ab
ab
ab
ab
ab
ab
ab
ab
IP
ga
uv
kb
oD
NN
NN
UA
IP
ab
ab
ab
ab
ab
ab
ab
ab
ab
"}
(12,1,1) = {"
ab
ab
ab
ab
ab
ab
ab
ab
ab
ab
ab
ab
Ff
uv
uv
kb
kr
WD
uv
uv
Ff
ab
ab
ab
ab
ab
ab
ab
ab
ab
"}
(13,1,1) = {"
ab
ab
ab
ab
ab
ab
ab
ab
ab
ab
ab
ab
Ff
eV
uv
kb
VP
uv
uv
XY
Ff
ab
ab
ab
ab
ab
ab
ab
ab
ab
"}
(14,1,1) = {"
ab
ab
ab
ab
ab
ab
ab
ab
ab
ab
ab
ab
Ff
kd
uv
kb
VP
uv
uv
YZ
Ff
ab
ab
ab
ab
ab
ab
ab
ab
ab
"}
(15,1,1) = {"
ab
ab
ab
ab
ab
ab
ab
ab
ab
ab
ab
ab
IP
IP
oh
HZ
sC
uv
uv
Lu
Lu
ab
ab
ab
ab
ab
ab
ab
ab
ab
"}
(16,1,1) = {"
ab
ab
ab
ab
ab
ab
ab
ab
ab
ab
ab
ab
ab
IP
IP
IP
AE
IP
IP
IP
ab
ab
ab
ab
ab
ab
ab
ab
ab
ab
"}
(17,1,1) = {"
ab
ab
ab
ab
ab
ab
ab
ab
ab
ab
ab
ab
ab
ab
ab
GH
QC
qR
ab
ab
ab
ab
ab
ab
ab
ab
ab
ab
ab
ab
"}
(18,1,1) = {"
ab
ab
ab
ab
ab
ab
ab
ab
ab
ab
ab
ab
ab
ab
ab
GH
fz
Qx
ab
ab
ab
ab
ab
ab
ab
ab
ab
ab
ab
ab
"}
(19,1,1) = {"
ab
ab
ab
ab
ab
ab
ab
ab
ab
ab
ab
ab
ab
ab
ab
GH
wN
Qx
ab
ab
ab
ab
ab
ab
ab
ab
ab
ab
ab
ab
"}
(20,1,1) = {"
ab
ab
ab
ab
ab
ab
ab
ab
ab
ab
ab
ab
ab
ab
ab
xk
uc
Qx
ab
ab
ab
ab
ab
ab
ab
ab
ab
ab
ab
ab
"}
(21,1,1) = {"
ab
ab
ab
ab
ab
ab
ab
ab
ab
ab
ab
ab
ab
ab
wW
NK
oM
Ne
xO
ab
ab
ab
ab
ab
ab
ab
ab
ab
ab
ab
"}
(22,1,1) = {"
ab
ab
ab
ab
ab
ab
ab
ab
ab
ab
ab
ab
mP
mP
mP
mP
AQ
mP
mP
mP
mP
ab
ab
ab
ab
ab
ab
ab
ab
ab
"}
(23,1,1) = {"
ab
ab
ab
ab
ab
ab
ab
ab
ab
ab
ab
ab
mP
Ak
JB
JF
Ku
JF
JB
JB
mP
ab
ab
ab
ab
ab
ab
ab
ab
ab
"}
(24,1,1) = {"
ab
ab
ab
ab
ab
ab
ab
ab
ab
ab
ab
ab
mP
Ak
JB
JB
eF
JB
JB
JB
mP
ab
ab
ab
ab
ab
ab
ab
ab
ab
"}
(25,1,1) = {"
ab
ab
ab
ab
ab
ab
ab
ab
nk
Qe
Qe
mP
mP
Ak
JB
JB
eF
JB
JB
JB
mP
mP
lY
ac
lN
ab
ab
ab
ab
ab
"}
(26,1,1) = {"
ab
ab
ab
ab
ab
ab
ab
ab
nk
mt
mt
nk
qb
JB
JB
JB
eF
JB
JB
JB
xP
lN
nu
nu
lN
ab
ab
ab
ab
ab
"}
(27,1,1) = {"
ab
ab
ab
ab
ab
ab
ab
ab
nk
CE
SZ
JD
QM
JB
pM
Lb
dy
qc
Ir
JB
sk
Vz
Wl
zD
lN
ab
ab
ab
ab
ab
"}
(28,1,1) = {"
ab
ab
ab
ab
ab
ab
ab
ab
nk
ik
gw
JD
QM
JB
pM
pM
pN
Ir
pM
JB
sk
VG
bL
oT
lN
ab
ab
ab
ab
ab
"}
(29,1,1) = {"
ab
ab
ab
ab
ab
ab
ab
ab
nk
pI
mD
ed
Wj
dn
Hj
dn
UZ
dn
Hj
dn
Ip
xx
Yb
Jt
lN
ab
ab
ab
ab
ab
"}
(30,1,1) = {"
ab
ab
ab
ab
ab
ab
ab
ab
nk
YR
gw
Ej
Lr
JB
pM
pM
pN
Tg
pM
JB
xd
uj
dP
WE
lN
ab
ab
ab
ab
ab
"}
(31,1,1) = {"
ab
ab
ab
ab
ab
ab
ab
ab
nk
PY
gw
gw
QM
JB
pM
OM
MA
OM
Tg
JB
sk
dP
dP
hj
lN
ab
ab
ab
ab
ab
"}
(32,1,1) = {"
ab
ab
ab
ab
ab
ab
ab
ab
nk
qM
KX
RN
QM
JB
UR
JB
Ut
uo
ek
UR
sk
bT
Xg
hj
lN
ab
ab
ab
ab
ab
"}
(33,1,1) = {"
ab
ab
ab
ab
ab
ab
ab
ab
nk
nk
nk
nk
oO
oO
oO
oO
yx
oO
oO
oO
oO
lN
lN
lN
lN
ab
ab
ab
ab
ab
"}
(34,1,1) = {"
ab
ab
ab
ab
ab
ab
ab
ab
ab
ab
oO
oO
oO
ey
bU
dr
VF
mX
GG
bS
oO
oO
oO
ab
ab
ab
ab
ab
ab
ab
"}
(35,1,1) = {"
ab
ab
ab
ab
ab
ab
ab
ab
ab
ab
ab
oO
oO
Ze
GG
GG
HG
GG
GG
GG
oO
oO
ab
ab
ab
ab
ab
ab
ab
ab
"}
(36,1,1) = {"
ab
ab
ab
ab
ab
ab
ab
ab
ab
ab
ab
ab
oO
cY
GG
sz
vK
CG
Sw
iH
oO
ab
ab
ab
ab
ab
ab
ab
ab
ab
"}
(37,1,1) = {"
ab
ab
ab
ab
ab
ab
ab
ab
ab
ab
ab
ab
oO
oO
Hs
Hs
Hs
Hs
Hs
Hs
oO
ab
ab
ab
ab
ab
ab
ab
ab
ab
"}
(38,1,1) = {"
ab
ab
ab
ab
ab
ab
ab
ab
ab
ab
ab
ab
ab
ab
ab
ab
ab
ab
ab
ab
ab
ab
ab
ab
ab
ab
ab
ab
ab
ab
"}
(39,1,1) = {"
ab
ab
ab
ab
ab
ab
ab
ab
ab
ab
ab
ab
ab
ab
ab
ab
ab
ab
ab
ab
ab
ab
ab
ab
ab
ab
ab
ab
ab
ab
"}
