//MAP CONVERTED BY dmm2tgm.py THIS HEADER COMMENT PREVENTS RECONVERSION, DO NOT REMOVE
"a" = (
/turf/template_noop,
/area/template_noop)
"g" = (
/turf/closed/wall,
/area/ship/construction)
"t" = (
/obj/docking_port/mobile{
	dir = 8;
	port_direction = 4;
	preferred_direction = 8
	},
/turf/open/floor/plating/airless,
/area/ship/construction)
"L" = (
/turf/open/floor/plating/airless,
/area/ship/construction)
"P" = (
/turf/closed/wall/mineral/plastitanium,
/area/ship/construction)

(1,1,1) = {"
a
a
a
a
a
g
g
L
L
L
L
L
L
L
L
L
L
L
L
L
L
L
L
L
L
L
g
P
a
"}
(2,1,1) = {"
a
a
a
a
a
g
L
L
L
L
L
L
L
L
L
L
L
L
L
L
L
L
L
L
L
L
L
L
L
"}
(3,1,1) = {"
a
a
a
a
a
L
L
L
L
L
L
L
L
L
L
L
L
L
L
L
L
L
L
L
L
L
L
L
L
"}
(4,1,1) = {"
a
a
a
a
a
g
L
L
L
L
L
L
L
L
L
L
L
L
L
L
L
L
L
L
L
L
L
L
L
"}
(5,1,1) = {"
g
g
L
L
g
g
L
L
L
L
L
L
L
L
L
L
L
L
L
L
L
L
L
L
L
L
L
P
P
"}
(6,1,1) = {"
g
L
L
L
L
L
L
L
L
L
L
L
L
L
L
L
L
L
L
L
L
L
L
L
L
L
L
L
L
"}
(7,1,1) = {"
L
L
L
L
L
L
L
L
L
L
L
L
L
L
L
L
L
L
L
L
L
L
L
L
L
L
L
L
L
"}
(8,1,1) = {"
L
L
L
L
L
L
L
L
L
L
L
L
L
L
L
L
L
L
L
L
L
L
L
L
L
L
L
P
P
"}
(9,1,1) = {"
L
L
L
L
L
L
L
L
L
L
L
L
L
L
L
L
L
L
L
L
L
L
L
L
L
L
L
L
L
"}
(10,1,1) = {"
L
L
L
L
L
L
L
L
L
L
L
L
L
L
L
L
L
L
L
L
L
L
L
L
L
L
L
L
L
"}
(11,1,1) = {"
L
L
L
L
L
L
L
L
L
L
L
L
L
L
L
L
L
L
L
L
L
L
L
L
L
L
L
P
P
"}
(12,1,1) = {"
L
L
L
L
L
L
L
L
L
L
L
L
L
L
L
L
L
L
L
L
L
L
L
L
L
L
L
L
L
"}
(13,1,1) = {"
g
L
L
L
L
L
L
L
L
L
L
L
L
L
L
L
L
L
L
L
L
L
L
L
L
L
L
L
L
"}
(14,1,1) = {"
g
g
L
L
g
g
L
L
L
L
L
L
L
L
L
L
L
L
L
L
L
L
L
L
L
L
L
P
P
"}
(15,1,1) = {"
a
a
a
a
a
g
L
L
L
L
L
L
L
L
L
L
L
L
L
L
L
L
L
L
L
L
L
L
L
"}
(16,1,1) = {"
a
a
a
a
a
L
L
L
L
L
L
L
L
L
L
L
L
L
L
L
L
L
L
L
L
L
L
L
L
"}
(17,1,1) = {"
a
a
a
a
a
g
L
L
L
L
L
L
L
L
L
L
L
L
L
L
L
L
L
L
L
L
L
L
L
"}
(18,1,1) = {"
a
a
a
a
a
g
g
L
L
L
L
L
L
L
L
L
L
t
L
L
L
L
L
L
L
L
g
P
a
"}
