//MAP CONVERTED BY dmm2tgm.py THIS HEADER COMMENT PREVENTS RECONVERSION, DO NOT REMOVE
"a" = (
/turf/open/space/basic,
/area/space)
"c" = (
/obj/machinery/holopad/emergency/command,
/obj/structure/cable{
	icon_state = "0-8"
	},
/turf/open/floor/plating/airless,
/area/ship/construction)
"d" = (
/obj/structure/closet/crate/coffin,
/turf/open/floor/plating,
/area/ship/external)
"e" = (
/obj/docking_port/mobile{
	dir = 8
	},
/turf/open/floor/plating/airless,
/area/ship/external)
"i" = (
/obj/effect/gibspawner/robot,
/turf/open/floor/plating/airless,
/area/ship/construction)
"j" = (
/turf/open/floor/plating/airless,
/area/ship/construction)
"k" = (
/obj/machinery/power/smes/shuttle/precharged{
	dir = 4
	},
/obj/structure/cable{
	icon_state = "0-8"
	},
/obj/structure/cable{
	icon_state = "0-4"
	},
/turf/open/floor/plating/airless,
/area/ship/construction)
"o" = (
/obj/structure/cable{
	icon_state = "0-4"
	},
/obj/machinery/light/dim{
	dir = 1
	},
/obj/machinery/power/rtg/advanced,
/turf/open/floor/plating/airless,
/area/ship/construction)
"p" = (
/obj/structure/closet/crate,
/obj/item/pickaxe,
/obj/item/pickaxe,
/obj/item/pickaxe,
/obj/item/mining_scanner,
/obj/item/mining_scanner,
/obj/item/mining_scanner,
/obj/item/gun/energy/kinetic_accelerator,
/obj/item/gun/energy/kinetic_accelerator,
/obj/item/gun/energy/kinetic_accelerator/old,
/obj/item/gun/energy/kinetic_accelerator,
/obj/item/gun/energy/kinetic_accelerator,
/turf/open/floor/plating/airless,
/area/ship/construction)
"r" = (
/obj/machinery/power/terminal{
	dir = 8
	},
/obj/structure/cable{
	icon_state = "2-5"
	},
/obj/structure/cable{
	icon_state = "0-5"
	},
/obj/structure/reagent_dispensers/fueltank,
/obj/structure/cable{
	icon_state = "2-5"
	},
/obj/structure/cable{
	icon_state = "5-8"
	},
/turf/open/floor/plating/airless,
/area/ship/construction)
"u" = (
/obj/machinery/droneDispenser/preloaded,
/obj/machinery/light/dim,
/turf/open/floor/plating/airless,
/area/ship/construction)
"w" = (
/obj/machinery/autolathe,
/turf/open/floor/plating/airless,
/area/ship/construction)
"x" = (
/obj/item/storage/backpack/duffelbag/captain,
/turf/open/floor/plating/airless,
/area/ship/construction)
"y" = (
/obj/structure/closet/wall,
/obj/item/construction/rcd,
/turf/closed/wall/mineral/plastitanium,
/area/ship/construction)
"z" = (
/obj/machinery/cryopod,
/turf/open/floor/plating,
/area/ship/external)
"A" = (
/turf/closed/wall/mineral/plastitanium/nodiagonal,
/area/ship/construction)
"B" = (
/obj/item/radio/intercom/wideband,
/turf/closed/wall/mineral/plastitanium/nodiagonal,
/area/ship/construction)
"D" = (
/obj/effect/mob_spawn/drone/capdrone,
/turf/open/floor/plating/airless,
/area/ship/construction)
"E" = (
/obj/machinery/power/terminal{
	dir = 8
	},
/obj/structure/cable,
/obj/structure/closet/crate/secure/exo,
/obj/item/clothing/head/HoS/beret/syndicate,
/obj/item/clothing/head/helmet,
/obj/item/clothing/head/caphat/nt,
/obj/item/areaeditor/shuttle,
/obj/effect/spawner/lootdrop/minor/kittyears_or_rabbitears,
/obj/effect/spawner/lootdrop/maintenance/four,
/obj/structure/cable{
	icon_state = "1-8"
	},
/obj/item/dronespeak_manual,
/turf/open/floor/plating/airless,
/area/ship/construction)
"H" = (
/obj/machinery/power/shuttle/engine/electric{
	dir = 4
	},
/obj/structure/cable{
	icon_state = "0-4"
	},
/turf/open/floor/plating/airless,
/area/ship/construction)
"I" = (
/obj/machinery/computer/helm{
	dir = 8
	},
/turf/open/floor/plating/airless,
/area/ship/construction)
"J" = (
/obj/machinery/door/airlock/maintenance{
	locked = 1;
	welded = 1
	},
/turf/open/floor/plating/airless,
/area/ship/construction)
"M" = (
/obj/machinery/computer/cryopod,
/turf/closed/wall/mineral/plastitanium/nodiagonal,
/area/ship/construction)
"N" = (
/obj/structure/cable{
	icon_state = "8-10"
	},
/obj/structure/cable{
	icon_state = "4-8"
	},
/turf/open/floor/plating/airless,
/area/ship/construction)
"O" = (
/obj/structure/grille,
/obj/effect/spawner/structure/window/plasma/reinforced/plastitanium,
/turf/open/floor/plating/airless,
/area/ship/construction)
"Q" = (
/obj/structure/sign/poster/contraband/free_drone,
/turf/closed/wall/mineral/plastitanium,
/area/ship/construction)
"R" = (
/turf/open/floor/plating/airless,
/area/ship/external)
"S" = (
/obj/effect/mob_spawn/drone,
/turf/open/floor/plating/airless,
/area/ship/construction)
"W" = (
/obj/machinery/power/apc,
/turf/closed/wall/mineral/plastitanium/nodiagonal,
/area/ship/construction)
"X" = (
/obj/item/stack/sheet/metal/twenty,
/obj/item/stack/sheet/glass/fifty,
/obj/structure/closet/crate/wooden,
/turf/open/floor/plating/airless,
/area/ship/construction)
"Y" = (
/turf/closed/wall/mineral/plastitanium,
/area/ship/construction)
"Z" = (
/turf/closed/wall/mineral/plastitanium/overspace,
/area/ship/construction)

(1,1,1) = {"
a
z
Y
H
H
Y
d
a
"}
(2,1,1) = {"
a
Z
M
k
k
A
Z
a
"}
(3,1,1) = {"
a
Q
o
r
E
u
Q
a
"}
(4,1,1) = {"
a
y
N
i
j
w
O
a
"}
(5,1,1) = {"
a
W
c
D
S
X
O
a
"}
(6,1,1) = {"
a
Q
I
x
j
p
Q
a
"}
(7,1,1) = {"
a
Z
A
J
J
B
Z
a
"}
(8,1,1) = {"
a
a
Z
e
R
Z
a
a
"}

(1,1,2) = {"
a
a
a
a
a
a
a
a
"}
(2,1,2) = {"
a
a
a
a
a
a
a
a
"}
(3,1,2) = {"
a
a
a
a
a
a
a
a
"}
(4,1,2) = {"
a
a
a
a
a
a
a
a
"}
(5,1,2) = {"
a
a
a
a
a
a
a
a
"}
(6,1,2) = {"
a
a
a
a
a
a
a
a
"}
(7,1,2) = {"
a
a
a
a
a
a
a
a
"}
(8,1,2) = {"
a
a
a
a
a
a
a
a
"}

(1,1,3) = {"
a
a
a
a
a
a
a
a
"}
(2,1,3) = {"
a
a
a
a
a
a
a
a
"}
(3,1,3) = {"
a
a
a
a
a
a
a
a
"}
(4,1,3) = {"
a
a
a
a
a
a
a
a
"}
(5,1,3) = {"
a
a
a
a
a
a
a
a
"}
(6,1,3) = {"
a
a
a
a
a
a
a
a
"}
(7,1,3) = {"
a
a
a
a
a
a
a
a
"}
(8,1,3) = {"
a
a
a
a
a
a
a
a
"}

(1,1,4) = {"
a
a
a
a
a
a
a
a
"}
(2,1,4) = {"
a
a
a
a
a
a
a
a
"}
(3,1,4) = {"
a
a
a
a
a
a
a
a
"}
(4,1,4) = {"
a
a
a
a
a
a
a
a
"}
(5,1,4) = {"
a
a
a
a
a
a
a
a
"}
(6,1,4) = {"
a
a
a
a
a
a
a
a
"}
(7,1,4) = {"
a
a
a
a
a
a
a
a
"}
(8,1,4) = {"
a
a
a
a
a
a
a
a
"}

(1,1,5) = {"
a
a
a
a
a
a
a
a
"}
(2,1,5) = {"
a
a
a
a
a
a
a
a
"}
(3,1,5) = {"
a
a
a
a
a
a
a
a
"}
(4,1,5) = {"
a
a
a
a
a
a
a
a
"}
(5,1,5) = {"
a
a
a
a
a
a
a
a
"}
(6,1,5) = {"
a
a
a
a
a
a
a
a
"}
(7,1,5) = {"
a
a
a
a
a
a
a
a
"}
(8,1,5) = {"
a
a
a
a
a
a
a
a
"}

(1,1,6) = {"
a
a
a
a
a
a
a
a
"}
(2,1,6) = {"
a
a
a
a
a
a
a
a
"}
(3,1,6) = {"
a
a
a
a
a
a
a
a
"}
(4,1,6) = {"
a
a
a
a
a
a
a
a
"}
(5,1,6) = {"
a
a
a
a
a
a
a
a
"}
(6,1,6) = {"
a
a
a
a
a
a
a
a
"}
(7,1,6) = {"
a
a
a
a
a
a
a
a
"}
(8,1,6) = {"
a
a
a
a
a
a
a
a
"}

(1,1,7) = {"
a
a
a
a
a
a
a
a
"}
(2,1,7) = {"
a
a
a
a
a
a
a
a
"}
(3,1,7) = {"
a
a
a
a
a
a
a
a
"}
(4,1,7) = {"
a
a
a
a
a
a
a
a
"}
(5,1,7) = {"
a
a
a
a
a
a
a
a
"}
(6,1,7) = {"
a
a
a
a
a
a
a
a
"}
(7,1,7) = {"
a
a
a
a
a
a
a
a
"}
(8,1,7) = {"
a
a
a
a
a
a
a
a
"}

(1,1,8) = {"
a
a
a
a
a
a
a
a
"}
(2,1,8) = {"
a
a
a
a
a
a
a
a
"}
(3,1,8) = {"
a
a
a
a
a
a
a
a
"}
(4,1,8) = {"
a
a
a
a
a
a
a
a
"}
(5,1,8) = {"
a
a
a
a
a
a
a
a
"}
(6,1,8) = {"
a
a
a
a
a
a
a
a
"}
(7,1,8) = {"
a
a
a
a
a
a
a
a
"}
(8,1,8) = {"
a
a
a
a
a
a
a
a
"}
