"a" = (/turf/open/space/basic,/area/space)
"b" = (/turf/closed/wall/mineral/plastitanium,/area/ship/construction)
"c" = (/obj/structure/cable{icon_state = "4-8"},/obj/machinery/holopad/emergency/command,/turf/open/floor/plating/airless,/area/ship/construction)
"d" = (/obj/structure/closet/crate/coffin,/turf/open/floor/plating,/area/ship/external)
"e" = (/obj/machinery/atmospherics/components/unary/vent_pump/on{dir = 8},/obj/docking_port/mobile{dir = 8},/turf/open/floor/plating/airless,/area/ship/external)
"j" = (/turf/open/floor/plating/airless,/area/ship/construction)
"k" = (/obj/machinery/power/smes/shuttle/precharged{dir = 4},/obj/structure/cable{icon_state = "0-8"},/turf/open/floor/plating/airless,/area/ship/construction)
"o" = (/obj/structure/cable{icon_state = "0-4"},/obj/machinery/light/dim{dir = 1},/obj/machinery/power/rtg,/turf/open/floor/plating/airless,/area/ship/construction)
"p" = (/obj/structure/closet/crate,/obj/item/pickaxe,/obj/item/pickaxe,/obj/item/pickaxe,/obj/item/mining_scanner,/obj/item/mining_scanner,/obj/item/mining_scanner,/obj/item/gun/energy/kinetic_accelerator,/obj/item/gun/energy/kinetic_accelerator,/turf/open/floor/plating/airless,/area/ship/construction)
"r" = (/obj/machinery/power/terminal{dir = 8},/obj/structure/cable{icon_state = "2-5"},/obj/structure/cable{icon_state = "0-5"},/obj/structure/reagent_dispensers/fueltank,/turf/open/floor/plating/airless,/area/ship/construction)
"u" = (/obj/machinery/droneDispenser/preloaded,/obj/machinery/light/dim,/turf/open/floor/plating/airless,/area/ship/construction)
"w" = (/obj/machinery/autolathe,/turf/open/floor/plating/airless,/area/ship/construction)
"y" = (/obj/machinery/power/apc,/turf/closed/wall/mineral/plastitanium,/area/ship/construction)
"z" = (/obj/machinery/cryopod,/turf/open/floor/plating,/area/ship/external)
"B" = (/obj/item/radio/intercom/wideband,/turf/closed/wall/mineral/plastitanium,/area/ship/construction)
"D" = (/obj/machinery/computer/cryopod{pixel_y = 24},/turf/closed/wall/mineral/plastitanium,/area/ship/construction)
"E" = (/obj/machinery/power/terminal{dir = 8},/obj/structure/cable,/obj/structure/closet/crate/secure/exo,/obj/item/clothing/head/HoS/beret/syndicate,/obj/item/clothing/head/helmet,/obj/item/clothing/head/caphat/nt,/turf/open/floor/plating/airless,/area/ship/construction)
"H" = (/obj/machinery/power/shuttle/engine/electric{dir = 4},/obj/structure/cable{icon_state = "0-4"},/turf/open/floor/plating/airless,/area/ship/construction)
"I" = (/obj/machinery/power/terminal{dir = 4},/obj/structure/cable{icon_state = "0-8"},/obj/machinery/computer/helm{dir = 8},/turf/open/floor/plating/airless,/area/ship/construction)
"J" = (/obj/machinery/atmospherics/pipe/simple{dir = 8},/obj/machinery/door/airlock/maintenance{locked = 1; welded = 1},/turf/open/floor/plating/airless,/area/ship/construction)
"K" = (/obj/machinery/atmospherics/components/unary/vent_pump/on{dir = 4},/turf/open/floor/plating/airless,/area/ship/construction)
"M" = (/obj/machinery/computer/cryopod,/turf/closed/wall/mineral/plastitanium,/area/ship/construction)
"N" = (/obj/structure/cable{icon_state = "8-10"},/obj/structure/cable{icon_state = "4-8"},/obj/item/construction/rcd,/obj/structure/closet/crate/rcd,/turf/open/floor/plating/airless,/area/ship/construction)
"O" = (/obj/structure/grille,/obj/effect/spawner/structure/window/plasma/reinforced/plastitanium,/turf/open/floor/plating/airless,/area/ship/construction)
"Q" = (/obj/structure/sign/poster/contraband/free_drone,/turf/closed/wall/mineral/plastitanium,/area/ship/construction)
"R" = (/obj/machinery/atmospherics/components/unary/vent_pump/on{dir = 8},/turf/open/floor/plating/airless,/area/ship/external)
"S" = (/obj/effect/mob_spawn/drone,/turf/open/floor/plating/airless,/area/ship/construction)
"X" = (/obj/item/stack/sheet/metal/twenty,/obj/item/stack/sheet/glass/fifty,/obj/structure/closet/crate/wooden,/turf/open/floor/plating/airless,/area/ship/construction)

(1,1,1) = {"
aaaaaaaa
zbQOOQba
DMoNcIyb
HkrjSKJe
HkEjSKJR
bbuwXpBb
dbQOOQba
aaaaaaaa
"}
(1,1,2) = {"
aaaaaaaa
aaaaaaaa
aaaaaaaa
aaaaaaaa
aaaaaaaa
aaaaaaaa
aaaaaaaa
aaaaaaaa
"}
(1,1,3) = {"
aaaaaaaa
aaaaaaaa
aaaaaaaa
aaaaaaaa
aaaaaaaa
aaaaaaaa
aaaaaaaa
aaaaaaaa
"}
(1,1,4) = {"
aaaaaaaa
aaaaaaaa
aaaaaaaa
aaaaaaaa
aaaaaaaa
aaaaaaaa
aaaaaaaa
aaaaaaaa
"}
(1,1,5) = {"
aaaaaaaa
aaaaaaaa
aaaaaaaa
aaaaaaaa
aaaaaaaa
aaaaaaaa
aaaaaaaa
aaaaaaaa
"}
(1,1,6) = {"
aaaaaaaa
aaaaaaaa
aaaaaaaa
aaaaaaaa
aaaaaaaa
aaaaaaaa
aaaaaaaa
aaaaaaaa
"}
(1,1,7) = {"
aaaaaaaa
aaaaaaaa
aaaaaaaa
aaaaaaaa
aaaaaaaa
aaaaaaaa
aaaaaaaa
aaaaaaaa
"}
(1,1,8) = {"
aaaaaaaa
aaaaaaaa
aaaaaaaa
aaaaaaaa
aaaaaaaa
aaaaaaaa
aaaaaaaa
aaaaaaaa
"}
