//MAP CONVERTED BY dmm2tgm.py THIS HEADER COMMENT PREVENTS RECONVERSION, DO NOT REMOVE
"ao" = (
/obj/machinery/door/window{
	dir = 1
	},
/turf/open/floor/mineral/titanium,
/area/space)
"ay" = (
/obj/machinery/atmospherics/components/binary/circulator{
	dir = 4
	},
/turf/open/floor/plating,
/area/space)
"by" = (
/obj/machinery/suit_storage_unit/radsuit,
/turf/open/floor/plating,
/area/space)
"bI" = (
/obj/machinery/atmospherics/components/binary/pump{
	dir = 1
	},
/turf/open/floor/plating,
/area/space)
"bJ" = (
/obj/structure/window/reinforced/spawner{
	dir = 8
	},
/obj/effect/spawner/structure/window/reinforced,
/obj/structure/lattice/catwalk,
/turf/open/space/basic,
/area/space)
"bX" = (
/obj/structure/reagent_dispensers/beerkeg,
/turf/open/floor/plasteel/grimy,
/area/space)
"cy" = (
/obj/machinery/rnd/production/circuit_imprinter,
/turf/open/floor/plating,
/area/space)
"cG" = (
/obj/structure/particle_accelerator/particle_emitter/right,
/turf/open/floor/plating,
/area/space)
"em" = (
/obj/structure/transit_tube,
/turf/open/floor/plating,
/area/space)
"ew" = (
/obj/structure/bed,
/obj/item/bedsheet/yellow,
/obj/structure/window/reinforced/spawner{
	dir = 1
	},
/turf/open/floor/plating,
/area/space)
"ey" = (
/obj/machinery/vending/engivend,
/turf/open/floor/plating,
/area/space)
"ez" = (
/obj/structure/closet/secure_closet/engineering_personal{
	anchored = 1;
	can_be_unanchored = 1
	},
/obj/structure/window/reinforced/spawner{
	dir = 4
	},
/turf/open/floor/plating,
/area/space)
"eA" = (
/obj/machinery/atmospherics/components/unary/shuttle/heater{
	dir = 1
	},
/obj/structure/window/reinforced/spawner,
/obj/structure/window/reinforced/spawner{
	dir = 4
	},
/obj/structure/window/reinforced/spawner{
	dir = 8
	},
/turf/open/floor/plating,
/area/space)
"eE" = (
/obj/structure/closet/crate/radiation,
/obj/item/circuitboard/machine/rad_collector,
/obj/item/circuitboard/machine/rad_collector,
/obj/item/circuitboard/machine/rad_collector,
/obj/effect/spawner/lootdrop/singularitygen,
/turf/open/floor/plating,
/area/space)
"eX" = (
/obj/machinery/atmospherics/components/binary/pump,
/turf/open/floor/plating,
/area/space)
"fs" = (
/obj/machinery/power/tesla_coil,
/turf/open/floor/plating,
/area/space)
"fM" = (
/obj/machinery/atmospherics/components/unary/tank/oxygen,
/turf/open/floor/plating,
/area/space)
"fW" = (
/obj/item/pipe{
	dir = 10
	},
/turf/open/floor/plating,
/area/space)
"gk" = (
/turf/closed/wall/mineral/plastitanium/nodiagonal,
/area/space)
"gr" = (
/obj/structure/window/plasma/reinforced{
	dir = 8
	},
/obj/structure/window/plasma/reinforced{
	dir = 1
	},
/obj/structure/window/plasma/reinforced,
/obj/structure/window/plasma/reinforced{
	dir = 4
	},
/obj/machinery/atmospherics/components/unary/vent_pump{
	dir = 8
	},
/obj/machinery/atmospherics/components/unary/vent_scrubber{
	dir = 1
	},
/turf/open/floor/plating,
/area/space)
"hu" = (
/obj/structure/bed,
/obj/item/bedsheet/ce,
/obj/structure/window/reinforced/spawner{
	dir = 1
	},
/obj/structure/window/reinforced/spawner{
	dir = 8
	},
/turf/open/floor/plating,
/area/space)
"hE" = (
/obj/structure/particle_accelerator/end_cap,
/turf/open/floor/plating,
/area/space)
"id" = (
/obj/machinery/airalarm/directional/north,
/turf/open/floor/plating,
/area/space)
"iR" = (
/obj/structure/closet/firecloset/wall{
	pixel_y = 28
	},
/turf/open/floor/plating,
/area/space)
"jb" = (
/obj/structure/table/reinforced,
/obj/machinery/chem_dispenser/drinks,
/turf/open/floor/plasteel/grimy,
/area/space)
"jk" = (
/obj/structure/fans/tiny,
/obj/machinery/door/airlock/hatch,
/turf/open/floor/plating,
/area/space)
"jL" = (
/obj/structure/bed,
/obj/item/bedsheet/yellow,
/turf/open/floor/plating,
/area/space)
"jW" = (
/obj/structure/lattice/catwalk,
/obj/structure/transit_tube,
/turf/open/space/basic,
/area/space)
"kp" = (
/obj/machinery/door/window,
/turf/open/floor/plasteel/grimy,
/area/space)
"kM" = (
/obj/structure/lattice/catwalk,
/obj/structure/lattice/catwalk,
/turf/open/space/basic,
/area/space)
"kN" = (
/obj/machinery/atmospherics/components/unary/tank,
/turf/open/floor/plating,
/area/space)
"ld" = (
/obj/machinery/computer/helm{
	dir = 1
	},
/turf/open/floor/mineral/titanium,
/area/space)
"ly" = (
/obj/machinery/door/window{
	dir = 4
	},
/turf/open/floor/plating,
/area/space)
"lM" = (
/obj/machinery/atmospherics/components/unary/vent_scrubber,
/turf/open/space/basic,
/area/space)
"ma" = (
/obj/structure/rack,
/turf/open/floor/plating,
/area/space)
"nn" = (
/obj/structure/closet/secure_closet/engineering_welding{
	anchored = 1;
	can_be_unanchored = 1
	},
/obj/structure/window/reinforced/spawner{
	dir = 1
	},
/obj/structure/window/reinforced/spawner{
	dir = 4
	},
/turf/open/floor/plating,
/area/space)
"nT" = (
/obj/machinery/power/emitter,
/turf/open/floor/plating,
/area/space)
"oP" = (
/obj/structure/window/reinforced/spawner{
	dir = 8
	},
/obj/effect/spawner/structure/window/reinforced,
/obj/structure/lattice/catwalk,
/obj/structure/window/reinforced/spawner{
	dir = 1
	},
/turf/open/space/basic,
/area/space)
"oZ" = (
/obj/machinery/vending/wardrobe/engi_wardrobe,
/turf/open/floor/plating,
/area/space)
"pb" = (
/turf/open/floor/plating,
/area/space)
"pv" = (
/obj/machinery/computer/operating,
/turf/open/floor/plating,
/area/space)
"pF" = (
/obj/structure/lattice/catwalk,
/obj/effect/spawner/structure/window/reinforced,
/obj/structure/window/reinforced/spawner{
	dir = 8
	},
/obj/structure/window/reinforced/spawner,
/turf/open/space/basic,
/area/space)
"qz" = (
/obj/machinery/smartfridge/drinks,
/turf/open/floor/plasteel/grimy,
/area/space)
"qZ" = (
/obj/structure/window/reinforced/spawner{
	dir = 1
	},
/obj/machinery/photocopier/faxmachine{
	pixel_y = -5
	},
/obj/structure/table/wood,
/turf/open/floor/mineral/titanium,
/area/space)
"rd" = (
/obj/machinery/door/window{
	dir = 8
	},
/turf/open/floor/plating,
/area/space)
"rr" = (
/obj/machinery/portable_atmospherics/canister/oxygen,
/turf/open/floor/plating,
/area/space)
"rM" = (
/obj/machinery/power/smes,
/turf/open/floor/plating,
/area/space)
"rS" = (
/obj/item/pipe{
	dir = 5
	},
/turf/open/floor/plating,
/area/space)
"rW" = (
/obj/structure/closet/secure_closet/personal/cabinet{
	name = "Mixology Closet"
	},
/turf/open/floor/plasteel/grimy,
/area/space)
"sb" = (
/obj/machinery/vending/cigarette/beach,
/turf/open/floor/plating,
/area/space)
"se" = (
/obj/structure/window/reinforced/spawner{
	dir = 8
	},
/obj/structure/window/reinforced/spawner,
/obj/effect/spawner/structure/window/reinforced,
/obj/structure/lattice/catwalk,
/turf/open/space/basic,
/area/space)
"sk" = (
/obj/structure/window/reinforced/spawner{
	dir = 8
	},
/obj/effect/spawner/structure/window/reinforced,
/obj/structure/lattice/catwalk,
/obj/structure/window/reinforced/spawner,
/turf/open/space/basic,
/area/space)
"su" = (
/obj/machinery/field/generator,
/turf/open/floor/plating,
/area/space)
"sO" = (
/obj/structure/closet/secure_closet/atmospherics{
	anchored = 1;
	can_be_unanchored = 1
	},
/obj/structure/window/reinforced/spawner{
	dir = 4
	},
/turf/open/floor/plating,
/area/space)
"tj" = (
/obj/machinery/microwave{
	desc = "Musty smelling microwave, old and shitty. If you could describe it, it would be green"
	},
/obj/structure/table/wood/reinforced,
/turf/open/floor/plating,
/area/space)
"ts" = (
/obj/structure/window/plasma/reinforced{
	dir = 4
	},
/obj/structure/window/plasma/reinforced{
	dir = 1
	},
/obj/structure/window/plasma/reinforced,
/obj/structure/window/plasma/reinforced{
	dir = 8
	},
/obj/machinery/atmospherics/components/unary/vent_pump{
	dir = 1
	},
/obj/machinery/atmospherics/components/unary/vent_scrubber{
	dir = 4
	},
/turf/open/floor/plating,
/area/space)
"tM" = (
/obj/structure/table/reinforced,
/obj/machinery/reagentgrinder/constructed,
/turf/open/floor/plasteel/grimy,
/area/space)
"tW" = (
/obj/structure/fireaxecabinet{
	pixel_y = 26
	},
/obj/item/fireaxe,
/turf/open/floor/plating,
/area/space)
"tY" = (
/obj/structure/table/wood,
/turf/open/floor/mineral/titanium,
/area/space)
"uq" = (
/obj/structure/lattice/catwalk,
/turf/open/space/basic,
/area/space)
"uN" = (
/obj/machinery/power/terminal,
/turf/open/floor/plating,
/area/space)
"vw" = (
/obj/structure/chair/bronze,
/turf/open/floor/mineral/titanium,
/area/space)
"vJ" = (
/obj/structure/sink{
	dir = 8;
	pixel_x = 16
	},
/turf/open/floor/plating,
/area/space)
"vL" = (
/obj/structure/window/reinforced/spawner{
	dir = 1
	},
/obj/structure/table/wood,
/turf/open/floor/mineral/titanium,
/area/space)
"wH" = (
/obj/structure/window/reinforced/spawner{
	dir = 8
	},
/obj/structure/window/reinforced/spawner{
	dir = 1
	},
/obj/effect/spawner/structure/window/reinforced,
/obj/structure/lattice/catwalk,
/turf/open/space/basic,
/area/space)
"wP" = (
/obj/machinery/vending/boozeomat/all_access,
/obj/structure/window/reinforced/spawner,
/turf/open/floor/plasteel/grimy,
/area/space)
"xl" = (
/obj/structure/chair/sofa{
	dir = 1
	},
/turf/open/floor/plating,
/area/space)
"xU" = (
/obj/structure/closet/secure_closet/engineering_chief,
/turf/open/floor/mineral/titanium,
/area/space)
"yg" = (
/obj/machinery/shower{
	pixel_y = 13
	},
/obj/structure/curtain,
/turf/open/floor/plating,
/area/space)
"yl" = (
/obj/structure/window/reinforced/spawner{
	dir = 1
	},
/obj/machinery/vending/tool,
/turf/open/floor/plating,
/area/space)
"yn" = (
/obj/machinery/atmospherics/components/unary/tank/carbon_dioxide,
/turf/open/floor/plating,
/area/space)
"yB" = (
/obj/structure/table/wood/reinforced,
/turf/open/floor/plating,
/area/space)
"ze" = (
/obj/structure/mineral_door/wood,
/turf/open/floor/plating,
/area/space)
"zm" = (
/obj/structure/particle_accelerator/power_box,
/turf/open/floor/plating,
/area/space)
"zB" = (
/obj/structure/sink/kitchen{
	dir = 8;
	pixel_x = 16
	},
/turf/open/floor/plasteel/grimy,
/area/space)
"zK" = (
/obj/structure/transit_tube/station,
/turf/open/floor/plating,
/area/space)
"zL" = (
/obj/structure/lattice/catwalk,
/obj/item/pipe{
	dir = 4
	},
/turf/open/floor/plating/airless,
/area/space)
"zO" = (
/obj/machinery/atmospherics/components/unary/tank/nitrogen,
/turf/open/floor/plating,
/area/space)
"Ag" = (
/obj/structure/closet/secure_closet/atmospherics{
	anchored = 1;
	can_be_unanchored = 1
	},
/turf/open/floor/plating,
/area/space)
"Au" = (
/turf/open/floor/plating/airless,
/area/space)
"Ax" = (
/obj/machinery/atmospherics/components/binary/pump{
	dir = 8
	},
/turf/open/floor/plating,
/area/space)
"AA" = (
/obj/machinery/door/window{
	dir = 4;
	name = "Mass Driver";
	req_access_txt = "22"
	},
/turf/open/floor/plating,
/area/space)
"AV" = (
/obj/structure/chair/stool/bar,
/turf/open/floor/plating,
/area/space)
"Bb" = (
/turf/open/floor/mineral/titanium,
/area/space)
"Ck" = (
/obj/structure/closet/crate/freezer,
/obj/item/storage/box/donkpockets/donkpocketpizza,
/obj/item/storage/box/donkpockets/donkpocketspicy,
/obj/item/storage/box/donkpockets/donkpocketteriyaki,
/obj/item/pizzabox/meat,
/obj/item/pizzabox/vegetable,
/turf/open/floor/plating,
/area/space)
"Cw" = (
/obj/structure/bed,
/obj/item/bedsheet/random,
/obj/structure/window/reinforced/spawner{
	dir = 1
	},
/turf/open/floor/plating,
/area/space)
"CA" = (
/obj/machinery/power/smes/shuttle/precharged{
	dir = 1
	},
/obj/structure/window/reinforced/spawner,
/obj/structure/window/reinforced/spawner{
	dir = 4
	},
/obj/structure/window/reinforced/spawner{
	dir = 8
	},
/obj/structure/cable{
	icon_state = "0-2"
	},
/turf/open/floor/plating,
/area/space)
"CI" = (
/obj/machinery/suit_storage_unit/ce,
/turf/open/floor/mineral/titanium,
/area/space)
"CP" = (
/obj/machinery/computer/autopilot{
	dir = 1
	},
/turf/open/floor/mineral/titanium,
/area/space)
"DN" = (
/obj/structure/closet/radiation,
/turf/open/floor/plating,
/area/space)
"DW" = (
/obj/structure/window/reinforced/spawner{
	dir = 8
	},
/turf/open/floor/plating,
/area/space)
"Eq" = (
/obj/machinery/portable_atmospherics/canister/carbon_dioxide,
/turf/open/floor/plating,
/area/space)
"ES" = (
/obj/structure/chair/sofa/right{
	dir = 1
	},
/turf/open/floor/plating,
/area/space)
"Fb" = (
/obj/structure/table/wood/poker,
/turf/open/floor/plasteel/grimy,
/area/space)
"Fr" = (
/obj/machinery/power/generator,
/turf/open/floor/plating,
/area/space)
"Gj" = (
/obj/structure/window/plasma/reinforced{
	dir = 8
	},
/obj/structure/window/plasma/reinforced,
/obj/structure/window/plasma/reinforced{
	dir = 1
	},
/obj/machinery/atmospherics/components/unary/vent_scrubber{
	dir = 8
	},
/turf/open/floor/plating,
/area/space)
"Gv" = (
/obj/structure/bed,
/obj/item/bedsheet/orange,
/turf/open/floor/plating,
/area/space)
"Hb" = (
/turf/open/floor/plasteel/grimy,
/area/space)
"Hg" = (
/obj/structure/table/optable,
/turf/open/floor/plating,
/area/space)
"Hp" = (
/obj/structure/lattice/catwalk,
/obj/item/pipe{
	dir = 6
	},
/turf/open/floor/plating/airless,
/area/space)
"Hx" = (
/obj/effect/spawner/structure/window/reinforced,
/obj/structure/window/reinforced/spawner{
	dir = 8
	},
/obj/structure/window/reinforced/spawner{
	dir = 4
	},
/turf/open/floor/plating,
/area/space)
"HC" = (
/obj/machinery/computer/rdconsole/production{
	dir = 4
	},
/turf/open/floor/plating,
/area/space)
"HI" = (
/obj/machinery/atmospherics/pipe/manifold{
	dir = 8
	},
/turf/open/floor/plating,
/area/space)
"HW" = (
/obj/structure/lattice/catwalk,
/obj/structure/transit_tube/horizontal,
/turf/open/floor/plating/airless,
/area/space)
"If" = (
/obj/structure/toilet{
	dir = 8;
	pixel_x = 9
	},
/turf/open/floor/plating,
/area/space)
"Ij" = (
/turf/open/space/basic,
/area/space)
"Im" = (
/obj/structure/closet/crate/solarpanel_small,
/turf/open/floor/plating,
/area/space)
"Is" = (
/obj/machinery/suit_storage_unit,
/obj/item/clothing/head/helmet/space/fragile,
/obj/item/clothing/suit/space/fragile,
/obj/item/tank/internals/emergency_oxygen/engi,
/turf/open/floor/plating,
/area/space)
"Jf" = (
/obj/machinery/cryopod{
	dir = 1
	},
/turf/open/floor/plating,
/area/space)
"Ji" = (
/obj/machinery/computer/cryopod{
	dir = 8;
	pixel_x = 28
	},
/turf/open/floor/plating,
/area/space)
"Ke" = (
/obj/structure/closet/secure_closet/engineering_electrical{
	anchored = 1;
	can_be_unanchored = 1
	},
/obj/structure/window/reinforced/spawner{
	dir = 1
	},
/turf/open/floor/plating,
/area/space)
"Kw" = (
/obj/machinery/atmospherics/components/binary/circulator{
	dir = 8
	},
/turf/open/floor/plating,
/area/space)
"KV" = (
/obj/structure/particle_accelerator/particle_emitter/center,
/turf/open/floor/plating,
/area/space)
"Le" = (
/obj/machinery/power/shuttle/engine/fueled/plasma{
	dir = 1
	},
/turf/open/floor/plating,
/area/space)
"LW" = (
/obj/machinery/particle_accelerator/control_box,
/turf/open/floor/plating,
/area/space)
"Mp" = (
/obj/structure/chair/stool/bar{
	dir = 1
	},
/turf/open/floor/plating,
/area/space)
"MJ" = (
/obj/machinery/vending/wardrobe/atmos_wardrobe,
/turf/open/floor/plating,
/area/space)
"MR" = (
/obj/effect/spawner/structure/window/reinforced,
/obj/structure/window/reinforced/spawner,
/obj/structure/window/reinforced/spawner{
	dir = 1
	},
/obj/item/pipe,
/turf/open/floor/plating,
/area/space)
"MU" = (
/obj/machinery/atmospherics/pipe/manifold4w,
/turf/open/floor/plating,
/area/space)
"Nb" = (
/obj/structure/transit_tube/horizontal,
/turf/open/floor/plating,
/area/space)
"Nw" = (
/obj/structure/mineral_door/wood,
/turf/open/floor/plasteel/grimy,
/area/space)
"NC" = (
/obj/structure/closet/emcloset/wall{
	pixel_y = 28
	},
/obj/structure/closet/firecloset/wall{
	dir = 8;
	pixel_x = 28
	},
/turf/open/floor/plating,
/area/space)
"NP" = (
/obj/structure/window/plasma/reinforced{
	dir = 1
	},
/turf/open/floor/plating,
/area/space)
"NT" = (
/obj/structure/chair/sofa/corner{
	dir = 1
	},
/turf/open/floor/plating,
/area/space)
"Ol" = (
/obj/effect/spawner/structure/window/reinforced,
/obj/structure/window/reinforced/spawner{
	dir = 8
	},
/obj/structure/window/reinforced/spawner{
	dir = 4
	},
/obj/item/pipe{
	dir = 4
	},
/turf/open/floor/plating,
/area/space)
"OD" = (
/obj/structure/table/wood,
/turf/open/floor/plating,
/area/space)
"OK" = (
/obj/machinery/suit_storage_unit/atmos,
/turf/open/floor/plating,
/area/space)
"PD" = (
/obj/machinery/atmospherics/components/unary/vent_pump{
	dir = 1
	},
/turf/open/space/basic,
/area/space)
"QA" = (
/obj/structure/window/reinforced/spawner{
	dir = 1
	},
/turf/open/floor/mineral/titanium,
/area/space)
"QI" = (
/obj/structure/window/plasma/reinforced{
	dir = 4
	},
/obj/structure/window/plasma/reinforced,
/obj/structure/window/plasma/reinforced{
	dir = 1
	},
/obj/machinery/atmospherics/components/unary/vent_scrubber{
	dir = 4
	},
/turf/open/floor/plating,
/area/space)
"Ra" = (
/obj/machinery/atmospherics/pipe/manifold{
	dir = 4
	},
/turf/open/floor/plating,
/area/space)
"Rn" = (
/obj/structure/table/reinforced,
/turf/open/floor/plasteel/grimy,
/area/space)
"Rq" = (
/obj/item/pipe{
	dir = 9
	},
/turf/open/floor/plating,
/area/space)
"Rt" = (
/obj/structure/particle_accelerator/particle_emitter/left,
/turf/open/floor/plating,
/area/space)
"RA" = (
/obj/item/pipe{
	dir = 6
	},
/turf/open/floor/plating,
/area/space)
"Sb" = (
/obj/structure/closet/cabinet,
/turf/open/floor/plating,
/area/space)
"Si" = (
/obj/item/storage/backpack/duffelbag/med/surgery,
/obj/structure/table/rolling,
/obj/item/storage/firstaid/regular,
/obj/item/storage/firstaid/o2,
/obj/item/storage/firstaid/fire,
/obj/item/storage/firstaid/brute,
/obj/item/defibrillator,
/obj/item/stock_parts/cell/high,
/turf/open/floor/plating,
/area/space)
"Sl" = (
/obj/machinery/power/emitter{
	dir = 4
	},
/turf/open/floor/plating,
/area/space)
"Sm" = (
/obj/machinery/portable_atmospherics/canister/nitrogen,
/turf/open/floor/plating,
/area/space)
"Sw" = (
/obj/machinery/atmospherics/components/unary/thermomachine,
/turf/open/floor/plating,
/area/space)
"SD" = (
/obj/machinery/atmospherics/components/unary/tank/toxins,
/turf/open/floor/plating,
/area/space)
"SM" = (
/obj/structure/bed,
/obj/item/bedsheet/orange,
/obj/structure/window/reinforced/spawner{
	dir = 8
	},
/turf/open/floor/plating,
/area/space)
"Tq" = (
/obj/machinery/suit_storage_unit/independent/engineering,
/turf/open/floor/plating,
/area/space)
"TU" = (
/obj/structure/lattice/catwalk,
/obj/effect/spawner/structure/window/reinforced,
/obj/structure/window/reinforced/spawner{
	dir = 8
	},
/obj/structure/window/reinforced/spawner{
	dir = 1
	},
/turf/open/space/basic,
/area/space)
"Um" = (
/obj/structure/lattice/catwalk,
/obj/effect/spawner/structure/window/reinforced,
/obj/structure/window/reinforced/spawner{
	dir = 8
	},
/turf/open/space/basic,
/area/space)
"UB" = (
/obj/machinery/power/shuttle/engine/electric{
	dir = 1
	},
/obj/structure/cable,
/turf/open/floor/plating,
/area/space)
"UL" = (
/obj/structure/lattice/catwalk,
/obj/item/pipe,
/turf/open/floor/plating/airless,
/area/space)
"UX" = (
/obj/structure/transit_tube/station/flipped{
	dir = 4
	},
/turf/open/floor/plating,
/area/space)
"VE" = (
/obj/machinery/power/supermatter_crystal,
/obj/structure/window/plasma/reinforced,
/obj/structure/window/plasma/reinforced{
	dir = 8
	},
/obj/structure/window/plasma/reinforced{
	dir = 4
	},
/turf/open/floor/plating,
/area/space)
"VH" = (
/obj/item/pipe,
/turf/open/floor/plating,
/area/space)
"VL" = (
/obj/structure/tank_dispenser,
/turf/open/floor/plating,
/area/space)
"VN" = (
/obj/machinery/portable_atmospherics/canister/toxins,
/turf/open/floor/plating,
/area/space)
"WG" = (
/obj/structure/closet/secure_closet/engineering_personal{
	anchored = 1;
	can_be_unanchored = 1
	},
/turf/open/floor/plating,
/area/space)
"XC" = (
/obj/structure/window/reinforced/spawner{
	dir = 4
	},
/obj/structure/window/reinforced/spawner{
	dir = 1
	},
/obj/structure/closet/crate/freezer,
/obj/item/reagent_containers/blood/random,
/obj/item/reagent_containers/blood/OMinus,
/obj/item/reagent_containers/blood{
	pixel_x = -3;
	pixel_y = -3
	},
/turf/open/floor/plating,
/area/space)
"Yf" = (
/obj/structure/sink/kitchen{
	dir = 1;
	pixel_y = -10
	},
/turf/open/floor/plating,
/area/space)
"Yj" = (
/obj/machinery/atmospherics/components/unary/tank/air,
/turf/open/floor/plating,
/area/space)
"Yx" = (
/obj/structure/table/reinforced,
/obj/machinery/chem_dispenser/drinks/beer,
/turf/open/floor/plasteel/grimy,
/area/space)
"Zg" = (
/obj/machinery/power/emitter{
	dir = 8
	},
/turf/open/floor/plating,
/area/space)
"Zn" = (
/obj/machinery/rnd/production/protolathe/department/engineering,
/turf/open/floor/plating,
/area/space)
"Zt" = (
/obj/machinery/vending/wallmed{
	pixel_y = 28
	},
/obj/structure/window/reinforced/spawner{
	dir = 4
	},
/obj/machinery/iv_drip,
/turf/open/floor/plating,
/area/space)
"ZY" = (
/obj/structure/chair/sofa/left{
	dir = 4
	},
/turf/open/floor/plating,
/area/space)

(1,1,1) = {"
Ij
Ij
Ij
Ij
Ij
Ij
Ij
Ij
Ij
Ij
Ij
Ij
Ij
Ij
Ij
Ij
Ij
Ij
Ij
Ij
Ij
Ij
Ij
Ij
Ij
Ij
Ij
Ij
Ij
Ij
Ij
Ij
Ij
Ij
Ij
Ij
Ij
Ij
Ij
Ij
Ij
Ij
Ij
Ij
Ij
Ij
Ij
Ij
Ij
Ij
Ij
Ij
Ij
Ij
Ij
Ij
"}
(2,1,1) = {"
Ij
Ij
Ij
Ij
Ij
Ij
Ij
Ij
Ij
Ij
Ij
Ij
Ij
Ij
Ij
Ij
Ij
Ij
Ij
Ij
Ij
Ij
Ij
Ij
Ij
Ij
Ij
Ij
Ij
Ij
Ij
Ij
Ij
Ij
Ij
Ij
Ij
Ij
Ij
Ij
Ij
Ij
Ij
Ij
Ij
Ij
Ij
Ij
Ij
Ij
Ij
Ij
Ij
Ij
Ij
Ij
"}
(3,1,1) = {"
Ij
Ij
Ij
Ij
Ij
Ij
Ij
Ij
Ij
Ij
Ij
Ij
Ij
Ij
Ij
Ij
Ij
Ij
Ij
Ij
Ij
Ij
Ij
Ij
Ij
Ij
Ij
Ij
Ij
Ij
Ij
Ij
Ij
Ij
Ij
Ij
Ij
Ij
Ij
Ij
Ij
Ij
Ij
Ij
Ij
Ij
Ij
Ij
Ij
Ij
Ij
Ij
Ij
Ij
Ij
Ij
"}
(4,1,1) = {"
Ij
Ij
Ij
Ij
Ij
Ij
Ij
Ij
Ij
Ij
Ij
Ij
Ij
gk
gk
gk
gk
gk
gk
gk
gk
gk
gk
gk
Ij
Ij
Ij
Ij
Ij
Ij
Ij
Ij
Ij
Ij
Ij
Ij
Ij
Ij
Ij
Ij
Ij
Ij
Ij
Ij
Ij
Ij
Ij
Ij
Ij
Ij
Ij
Ij
Ij
Ij
Ij
Ij
"}
(5,1,1) = {"
Ij
Ij
Ij
Ij
Ij
Ij
Ij
Ij
Ij
Ij
Ij
Ij
Ij
gk
rW
Rn
gk
tM
qz
wP
sb
Ck
tj
gk
gk
gk
Ij
Ij
Ij
Ij
Ij
Ij
Ij
Ij
Ij
Ij
Ij
Ij
Ij
Ij
Ij
Ij
Ij
Ij
Ij
Ij
Ij
Ij
Ij
Ij
Ij
Ij
Ij
Ij
Ij
Ij
"}
(6,1,1) = {"
Ij
Ij
Ij
Ij
Ij
Ij
Ij
Ij
Ij
Ij
Ij
Ij
Ij
gk
bX
Hb
Nw
Hb
Hb
kp
pb
pb
pb
ZY
NT
gk
Ij
Ij
Ij
gk
gk
gk
gk
gk
gk
gk
Ij
Ij
Ij
Ij
Ij
Ij
Ij
Ij
Ij
Ij
Ij
Ij
Ij
Ij
Ij
Ij
Ij
Ij
Ij
Ij
"}
(7,1,1) = {"
Ij
Ij
Ij
Ij
Ij
Ij
Ij
Ij
Ij
Ij
Ij
Ij
Ij
gk
gk
gk
gk
Rn
Hb
Fb
Mp
pb
AV
yB
xl
gk
Ij
Ij
Ij
gk
OK
OK
by
Tq
Tq
gk
Ij
Ij
Ij
Ij
Ij
Ij
Ij
Ij
Ij
Ij
Ij
Ij
Ij
Ij
Ij
Ij
Ij
Ij
Ij
Ij
"}
(8,1,1) = {"
Ij
Ij
Ij
Ij
Ij
gk
gk
gk
gk
Ij
Ij
Ij
Ij
Ij
Ij
Ij
gk
jb
Hb
Fb
Mp
pb
AV
yB
xl
gk
gk
gk
gk
gk
pb
pb
pb
pb
pb
gk
Ij
Ij
Ij
Ij
Ij
Ij
Ij
Ij
Ij
Ij
Ij
Ij
Ij
Ij
Ij
Ij
Ij
Ij
Ij
Ij
"}
(9,1,1) = {"
Ij
Ij
Ij
Ij
gk
gk
pb
pb
gk
gk
gk
Ij
Ij
Ij
Ij
Ij
gk
Yx
zB
Fb
Mp
pb
AV
yB
ES
gk
ey
cy
HC
Zn
yl
pb
MJ
pb
oZ
gk
Ij
Ij
Ij
Ij
Ij
Ij
gk
gk
gk
gk
gk
Ij
Ij
Ij
Ij
Ij
Ij
Ij
Ij
Ij
"}
(10,1,1) = {"
Ij
Ij
Ij
Ij
gk
pb
pb
pb
pb
uN
CA
UB
Ij
Ij
Ij
Ij
gk
gk
gk
gk
pb
pb
pb
pb
pb
ze
pb
pb
pb
pb
Ke
pb
WG
pb
Ag
gk
Ij
Ij
Ij
Ij
Ij
Ij
gk
rM
pb
pb
gk
gk
gk
gk
gk
Ij
Ij
Ij
Ij
Ij
"}
(11,1,1) = {"
Ij
Ij
Ij
Ij
gk
pb
pb
pb
pb
pb
eA
Le
Ij
Ij
Ij
Ij
gk
zK
pb
ze
pb
gk
gk
gk
ze
gk
OD
pb
pb
pb
nn
ly
ez
ly
sO
gk
gk
gk
Ij
Ij
Ij
Ij
gk
pb
pb
pb
pb
pb
pb
pb
gk
Ij
Ij
Ij
Ij
Ij
"}
(12,1,1) = {"
Ij
Ij
Ij
Ij
gk
pb
pb
pb
pb
uN
CA
UB
Ij
Ij
Ij
Ij
gk
Nb
gk
gk
jk
gk
yg
If
vJ
gk
VL
pb
pb
pb
pb
pb
pb
pb
pb
ze
pb
gk
gk
gk
gk
gk
gk
pb
pb
pb
pb
pb
pb
pb
gk
Ij
Ij
Ij
Ij
Ij
"}
(13,1,1) = {"
Ij
Ij
Ij
Ij
gk
gk
gk
pb
gk
gk
gk
Ij
Ij
Ij
Ij
Ij
gk
HW
uq
uq
uq
gk
gk
gk
gk
gk
gk
ze
gk
Sb
pb
OD
hu
rd
SM
gk
UX
em
jW
jW
em
UX
gk
pb
pb
pb
pb
pb
pb
pb
gk
Ij
Ij
Ij
Ij
Ij
"}
(14,1,1) = {"
Ij
Ij
Ij
Ij
Ij
Ij
gk
pb
jk
uq
uq
uq
gk
gk
gk
gk
gk
HW
uq
kM
uq
uq
uq
uq
uq
gk
pb
pb
gk
Sb
pb
OD
ew
pb
Gv
gk
gk
gk
uq
uq
gk
pb
gk
pb
pb
pb
pb
pb
pb
pb
gk
Ij
Ij
Ij
Ij
Ij
"}
(15,1,1) = {"
Ij
Ij
Ij
Ij
Ij
Ij
gk
pb
gk
uq
uq
uq
gk
pv
Hg
Si
gk
Nb
gk
gk
gk
gk
gk
uq
uq
gk
zK
pb
gk
Sb
Ji
Jf
Cw
pb
jL
gk
uq
uq
uq
uq
gk
pb
ze
pb
pb
pb
pb
pb
pb
pb
gk
Ij
Ij
Ij
Ij
Ij
"}
(16,1,1) = {"
Ij
Ij
Ij
Ij
Ij
gk
gk
pb
gk
uq
uq
uq
gk
Zt
AA
Yf
gk
zK
pb
vL
tY
CI
gk
gk
Au
gk
Nb
gk
gk
gk
gk
gk
gk
jk
gk
gk
uq
uq
uq
uq
gk
gk
gk
pb
pb
pb
pb
pb
pb
pb
gk
Ij
Ij
Ij
Ij
Ij
"}
(17,1,1) = {"
Ij
Ij
Ij
Ij
Ij
gk
pb
pb
gk
uq
uq
uq
jk
pb
pb
XC
gk
gk
pb
QA
Bb
Bb
ld
gk
uq
uq
HW
uq
uq
uq
uq
uq
Hp
UL
UL
UL
UL
UL
UL
UL
UL
MR
eX
Ra
ay
pb
pb
pb
pb
pb
gk
Ij
Ij
Ij
Ij
Ij
"}
(18,1,1) = {"
Ij
Ij
Ij
Ij
Ij
gk
pb
UX
em
jW
jW
jW
em
UX
pb
pb
pb
ze
pb
ao
Bb
vw
tY
gk
uq
uq
HW
uq
uq
uq
uq
uq
zL
uq
uq
uq
uq
uq
uq
uq
uq
jk
pb
pb
Fr
pb
pb
pb
pb
Sw
gk
Ij
Ij
Ij
Ij
Ij
"}
(19,1,1) = {"
Ij
Ij
Ij
Ij
Ij
gk
pb
gk
gk
gk
uq
uq
gk
gk
NC
Is
gk
gk
pb
QA
Bb
Bb
CP
gk
uq
uq
HW
uq
uq
uq
uq
uq
zL
uq
Hp
UL
UL
UL
UL
UL
UL
MR
eX
HI
Kw
pb
pb
pb
pb
pb
gk
Ij
Ij
Ij
Ij
Ij
"}
(20,1,1) = {"
Ij
Ij
Ij
Ij
Ij
gk
pb
pb
pb
gk
gk
gk
gk
gk
gk
gk
gk
zK
pb
qZ
tY
xU
gk
gk
Au
gk
Nb
gk
gk
gk
gk
gk
Ol
Hx
Ol
gk
uq
uq
uq
uq
gk
gk
gk
id
pb
pb
pb
pb
pb
pb
gk
Ij
Ij
Ij
Ij
Ij
"}
(21,1,1) = {"
Ij
Ij
Ij
Ij
Ij
gk
gk
gk
pb
gk
gk
gk
gk
gk
gk
uq
gk
Nb
gk
gk
gk
gk
gk
uq
uq
gk
zK
pb
gk
kN
pb
pb
Ax
pb
Ax
gk
kM
uq
uq
uq
gk
pb
ze
pb
pb
pb
pb
pb
pb
pb
gk
Ij
Ij
Ij
Ij
Ij
"}
(22,1,1) = {"
Ij
Ij
Ij
Ij
Ij
Ij
Ij
gk
pb
jk
uq
uq
uq
uq
uq
uq
gk
HW
uq
uq
uq
uq
uq
uq
uq
gk
gk
ze
gk
pb
pb
pb
pb
pb
pb
gk
gk
gk
uq
uq
gk
pb
gk
pb
pb
pb
pb
pb
pb
pb
gk
Ij
Ij
Ij
Ij
Ij
"}
(23,1,1) = {"
Ij
Ij
Ij
Ij
gk
gk
gk
gk
pb
gk
gk
uq
uq
uq
uq
uq
gk
HW
uq
uq
uq
uq
uq
uq
uq
gk
tW
pb
pb
pb
pb
pb
pb
pb
pb
gk
UX
em
jW
jW
em
UX
gk
pb
pb
pb
pb
pb
pb
pb
gk
Ij
Ij
Ij
Ij
Ij
"}
(24,1,1) = {"
Ij
Ij
Ij
Ij
gk
pb
pb
pb
pb
uN
CA
UB
Ij
Ij
Ij
Ij
gk
Nb
gk
gk
gk
gk
gk
gk
jk
gk
iR
pb
pb
pb
pb
pb
pb
pb
pb
ze
pb
gk
gk
gk
gk
gk
gk
pb
pb
pb
pb
pb
pb
pb
gk
Ij
Ij
Ij
Ij
Ij
"}
(25,1,1) = {"
Ij
Ij
Ij
Ij
gk
pb
pb
pb
pb
pb
eA
Le
Ij
Ij
Ij
Ij
gk
zK
pb
pb
pb
pb
pb
pb
pb
pb
pb
pb
pb
pb
pb
pb
pb
pb
pb
gk
gk
gk
gk
Ij
Ij
Ij
gk
pb
pb
pb
pb
pb
pb
pb
gk
Ij
Ij
Ij
Ij
Ij
"}
(26,1,1) = {"
Ij
Ij
Ij
Ij
gk
pb
pb
pb
pb
uN
CA
UB
Ij
Ij
Ij
Ij
gk
pb
pb
pb
pb
pb
pb
pb
pb
pb
pb
pb
pb
pb
pb
pb
pb
pb
pb
ze
pb
pb
gk
gk
gk
Ij
gk
rM
pb
pb
gk
gk
gk
gk
gk
Ij
Ij
Ij
Ij
Ij
"}
(27,1,1) = {"
Ij
Ij
Ij
Ij
gk
gk
pb
pb
gk
gk
gk
Ij
Ij
Ij
Ij
Ij
gk
Yj
Yj
gk
wH
bJ
sk
gk
oP
bJ
sk
gk
oP
bJ
se
gk
TU
Um
pF
gk
ma
pb
DN
DN
gk
Ij
gk
gk
gk
gk
gk
Ij
Ij
Ij
Ij
Ij
Ij
Ij
Ij
Ij
"}
(28,1,1) = {"
Ij
Ij
Ij
Ij
Ij
gk
gk
gk
gk
Ij
Ij
Ij
Ij
Ij
Ij
Ij
gk
gk
gk
gk
DW
DW
DW
gk
DW
DW
DW
gk
DW
DW
DW
gk
DW
DW
DW
gk
ma
pb
VN
Eq
gk
Ij
Ij
Ij
Ij
Ij
Ij
Ij
Ij
Ij
Ij
Ij
Ij
Ij
Ij
Ij
"}
(29,1,1) = {"
Ij
Ij
Ij
Ij
Ij
Ij
Ij
Ij
Ij
Ij
Ij
Ij
Ij
Ij
Ij
Ij
Ij
Ij
Ij
gk
pb
zO
pb
gk
pb
fM
pb
gk
pb
yn
pb
gk
pb
SD
pb
gk
ma
pb
Sm
rr
gk
gk
Ij
Ij
Ij
Ij
Ij
Ij
Ij
Ij
Ij
Ij
Ij
Ij
Ij
Ij
"}
(30,1,1) = {"
Ij
Ij
Ij
Ij
Ij
Ij
Ij
Ij
Ij
Ij
Ij
Ij
Ij
Ij
Ij
Ij
Ij
Ij
Ij
gk
pb
pb
pb
gk
pb
pb
pb
gk
pb
pb
pb
gk
pb
pb
pb
gk
ma
pb
su
Im
eE
gk
Ij
Ij
Ij
Ij
Ij
Ij
Ij
Ij
Ij
Ij
Ij
Ij
Ij
Ij
"}
(31,1,1) = {"
Ij
Ij
Ij
Ij
Ij
Ij
Ij
Ij
Ij
Ij
Ij
Ij
Ij
Ij
Ij
Ij
Ij
Ij
Ij
gk
gk
gk
gk
gk
gk
gk
gk
gk
gk
gk
gk
gk
gk
gk
gk
gk
ma
pb
su
fs
fs
gk
Ij
Ij
Ij
Ij
Ij
Ij
Ij
Ij
Ij
Ij
Ij
Ij
Ij
Ij
"}
(32,1,1) = {"
Ij
Ij
Ij
Ij
Ij
Ij
Ij
Ij
Ij
Ij
Ij
Ij
Ij
Ij
Ij
Ij
Ij
Ij
Ij
Ij
Ij
Ij
Ij
Ij
Ij
Ij
Ij
Ij
Ij
Ij
Ij
Ij
Ij
gk
Rt
cG
hE
su
su
nT
fs
gk
Ij
Ij
Ij
Ij
Ij
Ij
Ij
Ij
Ij
Ij
Ij
Ij
Ij
Ij
"}
(33,1,1) = {"
Ij
Ij
Ij
Ij
Ij
Ij
Ij
Ij
Ij
Ij
Ij
Ij
Ij
Ij
Ij
Ij
Ij
Ij
Ij
Ij
Ij
Ij
Ij
Ij
Ij
Ij
Ij
Ij
Ij
Ij
Ij
Ij
Ij
gk
KV
zm
LW
nT
nT
nT
gk
gk
Ij
Ij
Ij
Ij
pb
pb
Sw
pb
pb
pb
pb
pb
pb
Ij
"}
(34,1,1) = {"
Ij
Ij
Ij
Ij
Ij
Ij
Ij
Ij
Ij
Ij
Ij
Ij
Ij
Ij
Ij
Ij
Ij
Ij
Ij
Ij
Ij
Ij
Ij
Ij
Ij
Ij
Ij
Ij
Ij
Ij
Ij
Ij
Ij
gk
gk
gk
gk
gk
gk
gk
gk
Ij
Ij
Ij
Ij
RA
VH
VH
MU
bI
rS
Sl
pb
pb
pb
Ij
"}
(35,1,1) = {"
Ij
Ij
Ij
Ij
Ij
Ij
Ij
Ij
Ij
Ij
Ij
Ij
Ij
Ij
Ij
Ij
Ij
Ij
Ij
Ij
Ij
Ij
Ij
Ij
Ij
Ij
Ij
Ij
Ij
Ij
Ij
Ij
Ij
Ij
Ij
Ij
Ij
Ij
Ij
Ij
Ij
Ij
Ij
Ij
pb
fW
ay
VH
gr
pb
Gj
pb
pb
pb
pb
Ij
"}
(36,1,1) = {"
Ij
Ij
Ij
Ij
Ij
Ij
Ij
Ij
Ij
Ij
Ij
Ij
Ij
Ij
Ij
Ij
Ij
Ij
Ij
Ij
Ij
Ij
Ij
Ij
Ij
Ij
Ij
Ij
Ij
Ij
Ij
Ij
Ij
Ij
Ij
Ij
Ij
Ij
Ij
Ij
Ij
Ij
Ij
Ij
pb
pb
Fr
pb
pb
pb
NP
VE
pb
pb
pb
Ij
"}
(37,1,1) = {"
Ij
Ij
Ij
Ij
Ij
Ij
Ij
Ij
Ij
Ij
Ij
Ij
Ij
Ij
Ij
Ij
Ij
Ij
Ij
Ij
Ij
Ij
Ij
Ij
Ij
Ij
Ij
Ij
Ij
Ij
Ij
Ij
Ij
Ij
Ij
Ij
Ij
Ij
Ij
Ij
Ij
Ij
Ij
Ij
pb
RA
Kw
VH
ts
pb
QI
pb
pb
pb
pb
Ij
"}
(38,1,1) = {"
Ij
Ij
Ij
Ij
Ij
Ij
Ij
Ij
Ij
Ij
Ij
Ij
Ij
Ij
Ij
Ij
Ij
Ij
Ij
Ij
Ij
Ij
Ij
Ij
Ij
Ij
Ij
Ij
Ij
Ij
Ij
Ij
Ij
Ij
Ij
Ij
Ij
Ij
Ij
Ij
Ij
Ij
Ij
Ij
Ij
fW
VH
HI
MU
bI
Rq
Zg
pb
pb
pb
Ij
"}
(39,1,1) = {"
Ij
Ij
Ij
Ij
Ij
Ij
Ij
Ij
Ij
Ij
Ij
Ij
Ij
Ij
Ij
Ij
Ij
Ij
Ij
Ij
Ij
Ij
Ij
Ij
Ij
Ij
Ij
Ij
Ij
Ij
Ij
Ij
Ij
Ij
Ij
Ij
Ij
Ij
Ij
Ij
Ij
Ij
Ij
Ij
Ij
Ij
pb
Sw
Sw
pb
pb
pb
pb
pb
pb
Ij
"}
(40,1,1) = {"
Ij
Ij
Ij
Ij
Ij
Ij
Ij
Ij
Ij
Ij
Ij
Ij
Ij
Ij
Ij
Ij
Ij
Ij
Ij
Ij
Ij
Ij
Ij
Ij
Ij
Ij
Ij
Ij
Ij
Ij
Ij
Ij
Ij
Ij
Ij
Ij
Ij
Ij
Ij
Ij
Ij
Ij
Ij
Ij
Ij
Ij
Ij
PD
lM
Ij
Ij
Ij
Ij
Ij
Ij
Ij
"}
