//MAP CONVERTED BY dmm2tgm.py THIS HEADER COMMENT PREVENTS RECONVERSION, DO NOT REMOVE
"ao" = (
/obj/machinery/door/window{
	dir = 1
	},
/turf/open/floor/mineral/titanium,
/area/space)
"ay" = (
/obj/machinery/atmospherics/components/binary/circulator{
	dir = 4
	},
/turf/open/floor/plating,
/area/space)
"bI" = (
/obj/item/pipe{
	dir = 4
	},
/turf/open/floor/plating,
/area/space)
"bJ" = (
/obj/structure/window/reinforced/spawner{
	dir = 8
	},
/obj/effect/spawner/structure/window/reinforced,
/obj/structure/lattice/catwalk,
/turf/open/space/basic,
/area/space)
"em" = (
/obj/structure/transit_tube,
/turf/open/floor/plating,
/area/space)
"eA" = (
/obj/machinery/atmospherics/components/unary/shuttle/heater{
	dir = 1
	},
/obj/structure/window/reinforced/spawner,
/obj/structure/window/reinforced/spawner{
	dir = 4
	},
/obj/structure/window/reinforced/spawner{
	dir = 8
	},
/turf/open/floor/plating,
/area/space)
"eX" = (
/obj/machinery/atmospherics/components/binary/pump,
/turf/open/floor/plating,
/area/space)
"fM" = (
/obj/machinery/atmospherics/components/unary/tank/oxygen,
/turf/open/floor/plating,
/area/space)
"fW" = (
/obj/item/pipe{
	dir = 10
	},
/turf/open/floor/plating,
/area/space)
"gk" = (
/turf/closed/wall/mineral/plastitanium/nodiagonal,
/area/space)
"jk" = (
/obj/effect/spawner/structure/window/reinforced,
/obj/structure/window/reinforced/spawner,
/obj/structure/window/reinforced/spawner{
	dir = 1
	},
/turf/open/floor/plating,
/area/space)
"jW" = (
/obj/structure/lattice/catwalk,
/obj/structure/transit_tube,
/turf/open/space/basic,
/area/space)
"kN" = (
/obj/machinery/atmospherics/components/unary/tank,
/turf/open/floor/plating,
/area/space)
"ld" = (
/obj/machinery/computer/helm{
	dir = 1
	},
/turf/open/floor/mineral/titanium,
/area/space)
"oP" = (
/obj/structure/window/reinforced/spawner{
	dir = 8
	},
/obj/effect/spawner/structure/window/reinforced,
/obj/structure/lattice/catwalk,
/obj/structure/window/reinforced/spawner{
	dir = 1
	},
/turf/open/space/basic,
/area/space)
"pb" = (
/turf/open/floor/plating,
/area/space)
"pv" = (
/obj/structure/catwalk,
/turf/open/space/basic,
/area/space)
"pF" = (
/obj/structure/lattice/catwalk,
/obj/effect/spawner/structure/window/reinforced,
/obj/structure/window/reinforced/spawner{
	dir = 8
	},
/obj/structure/window/reinforced/spawner,
/turf/open/space/basic,
/area/space)
"qZ" = (
/obj/structure/window/reinforced/spawner{
	dir = 1
	},
/obj/machinery/photocopier/faxmachine{
	pixel_y = -5
	},
/obj/structure/table/wood,
/turf/open/floor/mineral/titanium,
/area/space)
"rS" = (
/obj/structure/window/plasma/reinforced,
/obj/structure/window/plasma/reinforced{
	dir = 1
	},
/turf/open/floor/plating,
/area/space)
"se" = (
/obj/structure/window/reinforced/spawner{
	dir = 8
	},
/obj/structure/window/reinforced/spawner,
/obj/effect/spawner/structure/window/reinforced,
/obj/structure/lattice/catwalk,
/turf/open/space/basic,
/area/space)
"sk" = (
/obj/structure/window/reinforced/spawner{
	dir = 8
	},
/obj/effect/spawner/structure/window/reinforced,
/obj/structure/lattice/catwalk,
/obj/structure/window/reinforced/spawner,
/turf/open/space/basic,
/area/space)
"tY" = (
/obj/structure/table/wood,
/turf/open/floor/mineral/titanium,
/area/space)
"uq" = (
/obj/structure/lattice/catwalk,
/turf/open/space/basic,
/area/space)
"uN" = (
/obj/machinery/power/terminal,
/turf/open/floor/plating,
/area/space)
"vw" = (
/obj/structure/chair/bronze,
/turf/open/floor/mineral/titanium,
/area/space)
"vL" = (
/obj/structure/window/reinforced/spawner{
	dir = 1
	},
/obj/structure/table/wood,
/turf/open/floor/mineral/titanium,
/area/space)
"wH" = (
/obj/structure/window/reinforced/spawner{
	dir = 8
	},
/obj/structure/window/reinforced/spawner{
	dir = 1
	},
/obj/effect/spawner/structure/window/reinforced,
/obj/structure/lattice/catwalk,
/turf/open/space/basic,
/area/space)
"yn" = (
/obj/machinery/atmospherics/components/unary/tank/carbon_dioxide,
/turf/open/floor/plating,
/area/space)
"zK" = (
/obj/structure/transit_tube/station,
/turf/open/floor/plating,
/area/space)
"zL" = (
/obj/structure/lattice/catwalk,
/obj/item/pipe{
	dir = 4
	},
/turf/open/space/basic,
/area/space)
"zO" = (
/obj/machinery/atmospherics/components/unary/tank/nitrogen,
/turf/open/floor/plating,
/area/space)
"Ax" = (
/obj/machinery/atmospherics/components/binary/pump{
	dir = 8
	},
/turf/open/floor/plating,
/area/space)
"Bb" = (
/turf/open/floor/mineral/titanium,
/area/space)
"CA" = (
/obj/machinery/power/smes/shuttle/precharged{
	dir = 1
	},
/obj/structure/window/reinforced/spawner,
/obj/structure/window/reinforced/spawner{
	dir = 4
	},
/obj/structure/window/reinforced/spawner{
	dir = 8
	},
/obj/structure/cable{
	icon_state = "0-2"
	},
/turf/open/floor/plating,
/area/space)
"CI" = (
/obj/machinery/suit_storage_unit/ce,
/turf/open/floor/mineral/titanium,
/area/space)
"CP" = (
/obj/machinery/computer/autopilot{
	dir = 1
	},
/turf/open/floor/mineral/titanium,
/area/space)
"DW" = (
/obj/structure/window/reinforced/spawner{
	dir = 8
	},
/turf/open/floor/plating,
/area/space)
"Fr" = (
/obj/machinery/power/generator,
/turf/open/floor/plating,
/area/space)
"Gj" = (
/obj/structure/window/plasma/reinforced,
/obj/structure/window/plasma/reinforced{
	dir = 1
	},
/obj/structure/window/plasma/reinforced{
	dir = 4
	},
/obj/machinery/atmospherics/components/unary/vent_scrubber{
	dir = 4
	},
/turf/open/floor/plating,
/area/space)
"Hp" = (
/obj/structure/lattice/catwalk,
/obj/item/pipe{
	dir = 6
	},
/turf/open/space/basic,
/area/space)
"Hx" = (
/obj/effect/spawner/structure/window/reinforced,
/obj/structure/window/reinforced/spawner{
	dir = 8
	},
/obj/structure/window/reinforced/spawner{
	dir = 4
	},
/turf/open/floor/plating,
/area/space)
"HI" = (
/obj/machinery/atmospherics/pipe/manifold{
	dir = 8
	},
/turf/open/floor/plating,
/area/space)
"HW" = (
/obj/structure/lattice/catwalk,
/obj/structure/transit_tube/horizontal,
/turf/open/space/basic,
/area/space)
"Ij" = (
/turf/open/space/basic,
/area/space)
"Kw" = (
/obj/machinery/atmospherics/components/binary/circulator{
	dir = 8
	},
/turf/open/floor/plating,
/area/space)
"Le" = (
/obj/machinery/power/shuttle/engine/fueled/plasma{
	dir = 1
	},
/turf/open/floor/plating,
/area/space)
"MR" = (
/obj/effect/spawner/structure/window/reinforced,
/obj/structure/window/reinforced/spawner,
/obj/structure/window/reinforced/spawner{
	dir = 1
	},
/obj/item/pipe,
/turf/open/floor/plating,
/area/space)
"Nb" = (
/obj/structure/transit_tube/horizontal,
/turf/open/floor/plating,
/area/space)
"NP" = (
/obj/machinery/atmospherics/pipe/manifold{
	dir = 1
	},
/turf/open/floor/plating,
/area/space)
"Ol" = (
/obj/effect/spawner/structure/window/reinforced,
/obj/structure/window/reinforced/spawner{
	dir = 8
	},
/obj/structure/window/reinforced/spawner{
	dir = 4
	},
/obj/item/pipe{
	dir = 4
	},
/turf/open/floor/plating,
/area/space)
"QA" = (
/obj/structure/window/reinforced/spawner{
	dir = 1
	},
/turf/open/floor/mineral/titanium,
/area/space)
"QI" = (
/obj/structure/window/plasma/reinforced,
/obj/structure/window/plasma/reinforced{
	dir = 1
	},
/obj/structure/window/plasma/reinforced{
	dir = 4
	},
/obj/machinery/atmospherics/components/unary/vent_pump{
	dir = 1
	},
/turf/open/floor/plating,
/area/space)
"Ra" = (
/obj/machinery/atmospherics/pipe/manifold{
	dir = 4
	},
/turf/open/floor/plating,
/area/space)
"Rq" = (
/obj/item/pipe{
	dir = 9
	},
/turf/open/floor/plating,
/area/space)
"RA" = (
/obj/item/pipe{
	dir = 6
	},
/turf/open/floor/plating,
/area/space)
"Sl" = (
/obj/structure/window/plasma/reinforced,
/obj/structure/window/plasma/reinforced{
	dir = 1
	},
/obj/structure/window/plasma/reinforced{
	dir = 8
	},
/obj/machinery/atmospherics/components/unary/vent_scrubber{
	dir = 8
	},
/turf/open/floor/plating,
/area/space)
"Sw" = (
/obj/machinery/atmospherics/components/unary/thermomachine,
/turf/open/floor/plating,
/area/space)
"SD" = (
/obj/machinery/atmospherics/components/unary/tank/toxins,
/turf/open/floor/plating,
/area/space)
"TU" = (
/obj/structure/lattice/catwalk,
/obj/effect/spawner/structure/window/reinforced,
/obj/structure/window/reinforced/spawner{
	dir = 8
	},
/obj/structure/window/reinforced/spawner{
	dir = 1
	},
/turf/open/space/basic,
/area/space)
"Um" = (
/obj/structure/lattice/catwalk,
/obj/effect/spawner/structure/window/reinforced,
/obj/structure/window/reinforced/spawner{
	dir = 8
	},
/turf/open/space/basic,
/area/space)
"UB" = (
/obj/machinery/power/shuttle/engine/electric{
	dir = 1
	},
/obj/structure/cable,
/turf/open/floor/plating,
/area/space)
"UL" = (
/obj/structure/lattice/catwalk,
/obj/item/pipe,
/turf/open/space/basic,
/area/space)
"UX" = (
/obj/structure/transit_tube/station/flipped{
	dir = 4
	},
/turf/open/floor/plating,
/area/space)
"VE" = (
/obj/structure/window/plasma/reinforced,
/obj/structure/window/plasma/reinforced{
	dir = 1
	},
/obj/structure/window/plasma/reinforced{
	dir = 8
	},
/obj/machinery/atmospherics/components/unary/vent_pump{
	dir = 1
	},
/turf/open/floor/plating,
/area/space)
"VH" = (
/obj/item/pipe,
/turf/open/floor/plating,
/area/space)
"Yj" = (
/obj/machinery/atmospherics/components/unary/tank/air,
/turf/open/floor/plating,
/area/space)
"Zg" = (
/obj/item/pipe{
	dir = 5
	},
/turf/open/floor/plating,
/area/space)
"Zt" = (
/obj/machinery/airalarm/directional/north,
/turf/open/floor/plating,
/area/space)

(1,1,1) = {"
Ij
Ij
Ij
Ij
Ij
Ij
Ij
Ij
Ij
Ij
Ij
Ij
Ij
Ij
Ij
Ij
Ij
Ij
Ij
Ij
Ij
Ij
Ij
Ij
Ij
Ij
Ij
Ij
Ij
Ij
Ij
Ij
Ij
Ij
Ij
Ij
Ij
Ij
Ij
Ij
Ij
Ij
Ij
Ij
Ij
Ij
Ij
Ij
Ij
Ij
Ij
Ij
Ij
Ij
Ij
Ij
"}
(2,1,1) = {"
Ij
Ij
Ij
Ij
Ij
Ij
Ij
Ij
Ij
Ij
Ij
Ij
Ij
Ij
Ij
Ij
Ij
Ij
Ij
Ij
Ij
Ij
Ij
Ij
Ij
Ij
Ij
Ij
Ij
Ij
Ij
Ij
Ij
Ij
Ij
Ij
Ij
Ij
Ij
Ij
Ij
Ij
Ij
Ij
Ij
Ij
Ij
Ij
Ij
Ij
Ij
Ij
Ij
Ij
Ij
Ij
"}
(3,1,1) = {"
Ij
Ij
Ij
Ij
Ij
Ij
Ij
Ij
Ij
Ij
Ij
Ij
Ij
Ij
Ij
Ij
Ij
Ij
Ij
Ij
Ij
Ij
Ij
Ij
Ij
Ij
Ij
Ij
Ij
Ij
Ij
Ij
Ij
Ij
Ij
Ij
Ij
Ij
Ij
Ij
Ij
Ij
Ij
Ij
Ij
Ij
Ij
Ij
Ij
Ij
Ij
Ij
Ij
Ij
Ij
Ij
"}
(4,1,1) = {"
Ij
Ij
Ij
Ij
Ij
Ij
Ij
Ij
Ij
Ij
Ij
Ij
Ij
Ij
Ij
Ij
Ij
Ij
Ij
Ij
Ij
Ij
Ij
Ij
Ij
Ij
Ij
Ij
Ij
Ij
Ij
Ij
Ij
Ij
Ij
Ij
Ij
Ij
Ij
Ij
Ij
Ij
Ij
Ij
Ij
Ij
Ij
Ij
Ij
Ij
Ij
Ij
Ij
Ij
Ij
Ij
"}
(5,1,1) = {"
Ij
Ij
Ij
Ij
Ij
Ij
Ij
Ij
Ij
Ij
Ij
Ij
Ij
Ij
Ij
Ij
Ij
gk
gk
gk
gk
gk
gk
gk
gk
gk
gk
Ij
Ij
Ij
Ij
Ij
Ij
Ij
Ij
Ij
Ij
Ij
Ij
Ij
Ij
Ij
Ij
Ij
Ij
Ij
Ij
Ij
Ij
Ij
Ij
Ij
Ij
Ij
Ij
Ij
"}
(6,1,1) = {"
Ij
Ij
Ij
Ij
Ij
Ij
Ij
Ij
Ij
Ij
Ij
Ij
Ij
Ij
Ij
Ij
Ij
gk
pb
pb
pb
pb
pb
pb
pb
pb
gk
gk
Ij
Ij
Ij
Ij
Ij
Ij
Ij
Ij
Ij
Ij
Ij
Ij
Ij
Ij
Ij
Ij
Ij
Ij
Ij
Ij
Ij
Ij
Ij
Ij
Ij
Ij
Ij
Ij
"}
(7,1,1) = {"
Ij
Ij
Ij
Ij
Ij
Ij
Ij
Ij
Ij
Ij
Ij
Ij
Ij
Ij
Ij
Ij
gk
gk
pb
pb
pb
pb
pb
pb
pb
pb
pb
gk
gk
Ij
Ij
Ij
Ij
Ij
Ij
Ij
Ij
Ij
Ij
Ij
Ij
Ij
Ij
Ij
Ij
Ij
Ij
Ij
Ij
Ij
Ij
Ij
Ij
Ij
Ij
Ij
"}
(8,1,1) = {"
Ij
Ij
Ij
Ij
Ij
gk
gk
gk
gk
Ij
Ij
Ij
Ij
Ij
Ij
Ij
gk
pb
pb
pb
pb
pb
pb
pb
pb
pb
pb
pb
gk
gk
gk
Ij
Ij
Ij
Ij
Ij
Ij
Ij
Ij
Ij
Ij
Ij
Ij
Ij
Ij
Ij
Ij
Ij
Ij
Ij
Ij
Ij
Ij
Ij
Ij
Ij
"}
(9,1,1) = {"
Ij
Ij
Ij
Ij
gk
gk
pb
pb
gk
gk
gk
Ij
Ij
Ij
Ij
Ij
gk
pb
pb
pb
pb
pb
pb
pb
pb
pb
pb
pb
pb
pb
gk
gk
gk
Ij
Ij
Ij
Ij
Ij
Ij
Ij
Ij
Ij
gk
gk
gk
gk
gk
Ij
Ij
Ij
Ij
Ij
Ij
Ij
Ij
Ij
"}
(10,1,1) = {"
Ij
Ij
Ij
Ij
gk
pb
pb
pb
pb
uN
CA
UB
Ij
Ij
Ij
Ij
gk
pb
pb
pb
pb
pb
pb
pb
pb
pb
pb
pb
pb
pb
pb
pb
gk
gk
gk
gk
Ij
Ij
Ij
Ij
Ij
Ij
gk
pb
pb
pb
gk
gk
gk
gk
gk
Ij
Ij
Ij
Ij
Ij
"}
(11,1,1) = {"
Ij
Ij
Ij
Ij
gk
pb
pb
pb
pb
pb
eA
Le
Ij
Ij
Ij
Ij
gk
zK
pb
pb
pb
pb
pb
pb
pb
pb
pb
pb
pb
pb
pb
pb
pb
pb
pb
gk
gk
gk
Ij
Ij
Ij
Ij
gk
pb
pb
RA
VH
Zg
pb
pb
gk
Ij
Ij
Ij
Ij
Ij
"}
(12,1,1) = {"
Ij
Ij
Ij
Ij
gk
pb
pb
pb
pb
uN
CA
UB
Ij
Ij
Ij
Ij
gk
Nb
gk
gk
gk
gk
gk
gk
pb
pb
pb
pb
pb
pb
pb
pb
pb
pb
pb
pb
pb
gk
Ij
Ij
gk
gk
gk
pb
pb
bI
pb
bI
pb
pb
gk
Ij
Ij
Ij
Ij
Ij
"}
(13,1,1) = {"
Ij
Ij
Ij
Ij
gk
gk
gk
pb
gk
gk
gk
Ij
Ij
Ij
Ij
Ij
gk
HW
Ij
Ij
Ij
Ij
Ij
gk
gk
gk
pb
pb
pb
pb
pb
pb
pb
pb
pb
gk
UX
em
jW
jW
em
UX
pb
pb
pb
Sl
pb
NP
Sw
pb
gk
Ij
Ij
Ij
Ij
Ij
"}
(14,1,1) = {"
Ij
Ij
Ij
Ij
Ij
Ij
gk
pb
gk
Ij
Ij
Ij
Ij
Ij
Ij
Ij
gk
HW
Ij
Ij
Ij
Ij
Ij
Ij
Ij
gk
gk
pb
gk
pb
pb
pb
pb
pb
pb
gk
gk
gk
Ij
Ij
gk
pb
pb
pb
pb
rS
pb
bI
pb
pb
gk
Ij
Ij
Ij
Ij
Ij
"}
(15,1,1) = {"
Ij
Ij
Ij
Ij
Ij
Ij
gk
pb
gk
Ij
Ij
Ij
Ij
Ij
Ij
Ij
gk
Nb
gk
gk
gk
gk
gk
Ij
Ij
gk
zK
pb
gk
pb
pb
pb
pb
pb
pb
gk
Ij
Ij
Ij
Ij
gk
pb
pb
RA
VH
QI
pb
NP
Sw
pb
gk
Ij
Ij
Ij
Ij
Ij
"}
(16,1,1) = {"
Ij
Ij
Ij
Ij
Ij
gk
gk
pb
gk
Ij
Ij
Ij
gk
gk
gk
gk
gk
zK
pb
vL
tY
CI
gk
gk
gk
gk
Nb
gk
gk
gk
gk
gk
gk
gk
gk
gk
gk
gk
gk
gk
gk
gk
Zt
bI
pb
pb
pb
bI
pb
pb
gk
Ij
Ij
Ij
Ij
Ij
"}
(17,1,1) = {"
Ij
Ij
Ij
Ij
Ij
gk
pb
pb
gk
Ij
Ij
Ij
gk
pb
pb
pb
pb
pb
pb
QA
Bb
Bb
ld
gk
Ij
Ij
HW
Ij
Ij
Ij
Ij
Ij
Hp
UL
UL
UL
UL
UL
UL
UL
UL
MR
eX
Ra
ay
VH
VH
Rq
pb
pb
gk
Ij
Ij
Ij
Ij
Ij
"}
(18,1,1) = {"
Ij
Ij
Ij
Ij
Ij
gk
pb
UX
em
jW
jW
jW
em
UX
pb
pb
pb
pb
pb
ao
Bb
vw
tY
gk
Ij
Ij
HW
Ij
Ij
Ij
Ij
Ij
zL
uq
uq
uq
uq
uq
uq
uq
uq
jk
pb
pb
Fr
pb
pb
pb
pb
pb
gk
Ij
Ij
Ij
Ij
Ij
"}
(19,1,1) = {"
Ij
Ij
Ij
Ij
Ij
gk
pb
gk
gk
gk
Ij
Ij
gk
gk
pb
pb
pb
pb
pb
QA
Bb
Bb
CP
gk
Ij
Ij
HW
Ij
Ij
Ij
Ij
Ij
zL
uq
Hp
UL
UL
UL
UL
UL
UL
MR
eX
HI
Kw
VH
VH
Zg
pb
pb
gk
Ij
Ij
Ij
Ij
Ij
"}
(20,1,1) = {"
Ij
Ij
Ij
Ij
Ij
gk
pb
pb
pb
gk
gk
gk
gk
gk
gk
gk
gk
zK
pb
qZ
tY
tY
gk
gk
gk
gk
Nb
gk
gk
gk
gk
gk
Ol
Hx
Ol
gk
gk
gk
gk
gk
gk
gk
pb
bI
pb
pb
pb
NP
Sw
pb
gk
Ij
Ij
Ij
Ij
Ij
"}
(21,1,1) = {"
Ij
Ij
Ij
Ij
Ij
gk
gk
gk
pb
gk
gk
gk
gk
gk
gk
Ij
gk
HW
gk
gk
gk
gk
gk
Ij
Ij
gk
zK
pb
gk
kN
pb
pb
Ax
pb
Ax
gk
Ij
Ij
Ij
Ij
gk
pb
pb
fW
VH
VE
pb
NP
Sw
pb
gk
Ij
Ij
Ij
Ij
Ij
"}
(22,1,1) = {"
Ij
Ij
Ij
Ij
Ij
Ij
Ij
gk
pb
gk
Ij
Ij
Ij
Ij
Ij
Ij
gk
HW
Ij
Ij
Ij
Ij
Ij
Ij
Ij
gk
gk
pb
gk
pb
pb
pb
pb
pb
pb
gk
gk
gk
Ij
Ij
gk
pb
pb
pb
pb
rS
pb
NP
Sw
pb
gk
Ij
Ij
Ij
Ij
Ij
"}
(23,1,1) = {"
Ij
Ij
Ij
Ij
gk
gk
gk
gk
pb
gk
gk
Ij
Ij
Ij
Ij
Ij
gk
HW
Ij
Ij
Ij
Ij
Ij
Ij
Ij
gk
pb
pb
pb
pb
pb
pb
pb
pb
pb
gk
UX
em
jW
jW
em
UX
pb
pb
pb
Gj
pb
NP
Sw
pb
gk
Ij
Ij
Ij
Ij
Ij
"}
(24,1,1) = {"
Ij
Ij
Ij
Ij
gk
pb
pb
pb
pb
uN
CA
UB
Ij
Ij
Ij
Ij
gk
Nb
gk
gk
gk
gk
gk
gk
gk
gk
pb
pb
pb
pb
pb
pb
pb
pb
pb
pb
pb
gk
Ij
Ij
gk
gk
gk
pb
pb
bI
pb
NP
Sw
pb
gk
Ij
Ij
Ij
Ij
Ij
"}
(25,1,1) = {"
Ij
Ij
Ij
Ij
gk
pb
pb
pb
pb
pb
eA
Le
Ij
Ij
Ij
Ij
gk
zK
pb
pb
pb
pb
pb
pb
pb
pb
pb
pb
pb
pb
pb
pb
pb
pb
pb
gk
gk
gk
gk
Ij
Ij
Ij
gk
pb
pb
fW
VH
Rq
pb
pb
gk
Ij
Ij
Ij
Ij
Ij
"}
(26,1,1) = {"
Ij
Ij
Ij
Ij
gk
pb
pb
pb
pb
uN
CA
UB
Ij
Ij
Ij
Ij
gk
pb
pb
pb
pb
pb
pb
pb
pb
pb
pb
pb
pb
pb
pb
pb
pb
pb
pb
pb
pb
pb
gk
gk
gk
Ij
gk
pb
pb
pb
gk
gk
gk
gk
gk
Ij
Ij
Ij
Ij
Ij
"}
(27,1,1) = {"
Ij
Ij
Ij
Ij
gk
gk
pb
pb
gk
gk
gk
Ij
Ij
Ij
Ij
Ij
gk
Yj
Yj
gk
wH
bJ
sk
gk
oP
bJ
sk
gk
oP
bJ
se
gk
TU
Um
pF
gk
pb
pb
pb
pb
gk
Ij
gk
gk
gk
gk
gk
Ij
Ij
Ij
Ij
Ij
Ij
Ij
Ij
Ij
"}
(28,1,1) = {"
Ij
Ij
Ij
Ij
Ij
gk
gk
gk
gk
Ij
Ij
Ij
Ij
Ij
Ij
Ij
gk
gk
gk
gk
DW
DW
DW
gk
DW
DW
DW
gk
DW
DW
DW
gk
DW
DW
DW
gk
pb
pb
pb
pb
gk
Ij
Ij
Ij
Ij
Ij
Ij
Ij
Ij
Ij
Ij
Ij
Ij
Ij
Ij
Ij
"}
(29,1,1) = {"
Ij
Ij
Ij
Ij
Ij
Ij
Ij
Ij
Ij
Ij
Ij
Ij
Ij
Ij
Ij
Ij
Ij
Ij
Ij
gk
pb
zO
pb
gk
pb
fM
pb
gk
pb
yn
pb
gk
pb
SD
pb
gk
pb
pb
pb
pb
gk
Ij
Ij
Ij
Ij
Ij
Ij
Ij
Ij
Ij
Ij
Ij
Ij
Ij
Ij
Ij
"}
(30,1,1) = {"
Ij
Ij
Ij
Ij
Ij
Ij
Ij
Ij
Ij
Ij
Ij
Ij
Ij
Ij
Ij
Ij
Ij
Ij
Ij
gk
pb
pb
pb
gk
pb
pb
pb
gk
pb
pb
pb
gk
pb
pb
pb
gk
pb
pb
pb
pb
gk
Ij
Ij
Ij
Ij
Ij
Ij
Ij
Ij
Ij
Ij
Ij
Ij
Ij
Ij
Ij
"}
(31,1,1) = {"
Ij
Ij
Ij
Ij
Ij
Ij
Ij
Ij
Ij
Ij
Ij
Ij
Ij
Ij
Ij
Ij
Ij
Ij
Ij
gk
gk
gk
gk
gk
gk
gk
gk
gk
gk
gk
gk
gk
gk
gk
gk
gk
gk
gk
gk
gk
gk
Ij
Ij
Ij
Ij
Ij
Ij
Ij
Ij
Ij
Ij
Ij
Ij
Ij
Ij
Ij
"}
(32,1,1) = {"
Ij
Ij
Ij
Ij
Ij
Ij
Ij
Ij
Ij
Ij
Ij
Ij
Ij
Ij
Ij
Ij
Ij
Ij
Ij
Ij
Ij
Ij
Ij
Ij
Ij
Ij
Ij
Ij
Ij
Ij
Ij
Ij
Ij
Ij
Ij
Ij
Ij
Ij
Ij
Ij
Ij
Ij
Ij
Ij
Ij
Ij
Ij
Ij
Ij
Ij
Ij
Ij
Ij
Ij
Ij
Ij
"}
(33,1,1) = {"
Ij
Ij
Ij
Ij
Ij
Ij
Ij
Ij
Ij
Ij
Ij
Ij
Ij
Ij
Ij
Ij
Ij
Ij
Ij
Ij
Ij
Ij
Ij
Ij
Ij
Ij
Ij
Ij
Ij
Ij
Ij
Ij
Ij
Ij
Ij
Ij
Ij
Ij
Ij
Ij
Ij
Ij
Ij
Ij
Ij
Ij
Ij
Ij
Ij
Ij
Ij
Ij
Ij
Ij
Ij
Ij
"}
(34,1,1) = {"
Ij
Ij
Ij
Ij
Ij
Ij
Ij
Ij
Ij
Ij
Ij
Ij
Ij
Ij
Ij
Ij
Ij
Ij
Ij
Ij
Ij
Ij
Ij
Ij
Ij
Ij
Ij
Ij
Ij
Ij
Ij
Ij
Ij
Ij
Ij
Ij
Ij
Ij
Ij
Ij
Ij
Ij
Ij
Ij
Ij
Ij
Ij
Ij
Ij
Ij
Ij
Ij
Ij
Ij
Ij
Ij
"}
(35,1,1) = {"
Ij
Ij
Ij
Ij
Ij
Ij
Ij
Ij
Ij
Ij
Ij
Ij
Ij
Ij
Ij
Ij
Ij
Ij
Ij
Ij
Ij
Ij
Ij
Ij
Ij
Ij
Ij
Ij
Ij
Ij
Ij
Ij
Ij
Ij
Ij
Ij
Ij
Ij
Ij
Ij
Ij
Ij
Ij
Ij
Ij
Ij
Ij
Ij
Ij
Ij
Ij
Ij
Ij
Ij
Ij
Ij
"}
(36,1,1) = {"
Ij
Ij
Ij
Ij
Ij
Ij
Ij
Ij
Ij
Ij
Ij
Ij
Ij
Ij
Ij
Ij
Ij
Ij
Ij
Ij
Ij
Ij
Ij
Ij
Ij
Ij
Ij
Ij
Ij
Ij
Ij
Ij
Ij
Ij
Ij
Ij
Ij
Ij
Ij
Ij
Ij
Ij
Ij
Ij
Ij
Ij
Ij
Ij
Ij
Ij
Ij
Ij
Ij
Ij
Ij
Ij
"}
(37,1,1) = {"
Ij
Ij
Ij
Ij
Ij
Ij
Ij
Ij
Ij
Ij
Ij
Ij
Ij
Ij
Ij
Ij
Ij
Ij
Ij
Ij
Ij
Ij
Ij
Ij
Ij
Ij
Ij
Ij
Ij
Ij
Ij
Ij
Ij
Ij
Ij
Ij
Ij
Ij
Ij
Ij
Ij
Ij
Ij
Ij
Ij
Ij
Ij
Ij
Ij
Ij
Ij
Ij
Ij
Ij
Ij
Ij
"}
(38,1,1) = {"
Ij
Ij
Ij
Ij
Ij
Ij
Ij
Ij
Ij
Ij
Ij
Ij
Ij
Ij
Ij
Ij
Ij
Ij
Ij
Ij
Ij
Ij
Ij
Ij
Ij
Ij
Ij
Ij
Ij
Ij
Ij
Ij
Ij
Ij
Ij
Ij
Ij
Ij
Ij
Ij
Ij
Ij
Ij
Ij
Ij
Ij
Ij
Ij
Ij
Ij
Ij
Ij
Ij
Ij
Ij
gk
"}
(39,1,1) = {"
Ij
Ij
Ij
Ij
Ij
Ij
Ij
Ij
Ij
Ij
Ij
Ij
Ij
Ij
Ij
Ij
Ij
Ij
Ij
Ij
Ij
Ij
Ij
Ij
Ij
Ij
Ij
Ij
Ij
Ij
Ij
Ij
Ij
Ij
Ij
Ij
Ij
Ij
Ij
Ij
Ij
Ij
Ij
Ij
Ij
Ij
Ij
Ij
Ij
Ij
Ij
Ij
Ij
Ij
Ij
pv
"}
(40,1,1) = {"
Ij
Ij
Ij
Ij
Ij
Ij
Ij
Ij
Ij
Ij
Ij
Ij
Ij
Ij
Ij
Ij
Ij
Ij
Ij
Ij
Ij
Ij
Ij
Ij
Ij
Ij
Ij
Ij
Ij
Ij
Ij
Ij
Ij
Ij
Ij
Ij
Ij
Ij
Ij
Ij
Ij
Ij
Ij
Ij
Ij
Ij
Ij
Ij
Ij
Ij
Ij
Ij
Ij
Ij
Ij
pb
"}
