"aj" = (/obj/effect/turf_decal/stripes/corner,/obj/structure/closet/crate,/obj/item/circuitboard/machine/ore_silo,/obj/item/circuitboard/machine/ore_redemption{pixel_y = -4},/obj/item/areaeditor/shuttle{pixel_x = -8},/obj/machinery/atmospherics/components/unary/vent_pump/on/layer4{dir = 1},/turf/open/floor/plasteel,/area/ship/hallway/central)
"bj" = (/obj/machinery/light{dir = 4},/obj/structure/rack,/obj/item/storage/toolbox/mechanical{pixel_y = 5},/obj/item/storage/toolbox/electrical,/obj/item/multitool,/obj/machinery/power/apc/auto_name/east,/obj/effect/spawner/lootdrop/donkpockets,/obj/effect/spawner/lootdrop/donkpockets,/turf/open/floor/plating,/area/ship/engineering)
"dV" = (/turf/closed/wall/mineral/plastitanium,/area/ship/bridge)
"eP" = (/obj/machinery/atmospherics/components/unary/outlet_injector/on/layer2{dir = 1},/obj/effect/turf_decal/stripes/line{dir = 10},/turf/open/floor/plating,/area/ship/external)
"gF" = (/turf/closed/wall/mineral/plastitanium/nodiagonal,/area/ship/hallway/central)
"jU" = (/obj/structure/cable{icon_state = "4-8"},/obj/machinery/cryopod/latejoin{dir = 1},/turf/open/floor/plasteel,/area/ship/hallway/central)
"ls" = (/turf/closed/wall/mineral/plastitanium,/area/ship/hallway/central)
"lt" = (/obj/effect/turf_decal/stripes/line{dir = 1},/obj/effect/landmark/start/assistant,/turf/open/floor/plasteel,/area/ship/hallway/central)
"lJ" = (/turf/closed/wall/mineral/plastitanium/nodiagonal,/area/ship/engineering)
"mc" = (/obj/machinery/power/terminal{dir = 4},/obj/structure/cable{icon_state = "0-8"},/turf/open/floor/plating,/area/ship/engineering)
"mO" = (/obj/structure/cable{icon_state = "1-8"},/obj/structure/cable{icon_state = "4-8"},/obj/machinery/atmospherics/pipe/simple/supply/hidden/layer4{dir = 10},/obj/machinery/atmospherics/pipe/simple/scrubbers/hidden/layer2{dir = 4},/obj/machinery/holopad/emergency/command,/turf/open/floor/plasteel,/area/ship/hallway/central)
"nI" = (/obj/structure/chair/comfy/shuttle{dir = 1; name = "Helm"},/turf/open/floor/plasteel,/area/ship/hallway/central)
"oa" = (/obj/machinery/power/terminal{dir = 4},/obj/structure/cable{icon_state = "0-8"},/obj/machinery/atmospherics/pipe/simple/supply/hidden/layer4{dir = 10},/turf/open/floor/plating,/area/ship/engineering)
"ob" = (/obj/structure/cable{icon_state = "1-2"},/turf/open/floor/plasteel,/area/ship/hallway/central)
"qr" = (/obj/machinery/atmospherics/components/unary/tank/air{dir = 1; piping_layer = 4},/obj/effect/turf_decal/stripes/corner{dir = 8},/turf/open/floor/plating,/area/ship/engineering)
"qs" = (/obj/machinery/atmospherics/pipe/simple/scrubbers/hidden/layer2,/obj/structure/grille,/obj/structure/window/plasma/reinforced/plastitanium,/turf/open/floor/plating,/area/ship/hallway/central)
"rF" = (/obj/structure/chair/comfy/shuttle{dir = 8; name = "Helm"},/obj/machinery/atmospherics/pipe/simple/supply/hidden/layer4{dir = 4},/obj/machinery/atmospherics/pipe/simple/scrubbers/hidden/layer2{dir = 6},/turf/open/floor/plasteel,/area/ship/bridge)
"so" = (/obj/effect/turf_decal/stripes/line,/turf/open/floor/plasteel,/area/ship/hallway/central)
"sp" = (/obj/machinery/atmospherics/pipe/manifold/supply/hidden/layer4{dir = 8},/turf/open/floor/plasteel,/area/ship/hallway/central)
"ux" = (/obj/machinery/computer/autopilot{dir = 1},/obj/structure/window/reinforced/spawner,/obj/machinery/atmospherics/components/unary/vent_scrubber/on/layer2{dir = 1},/turf/open/floor/plasteel,/area/ship/bridge)
"vl" = (/obj/machinery/power/shuttle/engine/electric{dir = 8},/obj/structure/cable{icon_state = "0-8"},/turf/open/floor/plating,/area/ship/engineering)
"vr" = (/obj/machinery/power/terminal,/obj/structure/cable{icon_state = "0-8"},/obj/structure/cable{icon_state = "4-8"},/obj/machinery/atmospherics/pipe/simple/supply/hidden/layer4{dir = 4},/obj/machinery/atmospherics/pipe/simple/scrubbers/hidden/layer2{dir = 4},/obj/machinery/door/firedoor/border_only{dir = 4},/turf/open/floor/plasteel,/area/ship/hallway/central)
"wv" = (/obj/machinery/power/smes/shuttle/precharged{dir = 8},/obj/structure/window/reinforced/spawner/east,/obj/machinery/door/window/westleft,/obj/structure/cable{icon_state = "0-4"},/turf/open/floor/plating,/area/ship/engineering)
"yQ" = (/obj/machinery/autolathe,/obj/item/stack/sheet/metal/twenty,/obj/item/stack/sheet/glass{amount = 20},/obj/structure/cable{icon_state = "4-8"},/obj/machinery/atmospherics/components/unary/vent_scrubber/on/layer2{dir = 8},/turf/open/floor/plasteel,/area/ship/hallway/central)
"zd" = (/obj/item/radio/intercom/wideband{pixel_x = -26},/obj/machinery/suit_storage_unit/standard_unit,/turf/open/floor/plating,/area/ship/hallway/central)
"zS" = (/obj/machinery/computer/helm{dir = 4},/obj/structure/window/reinforced/spawner/west,/obj/machinery/atmospherics/components/unary/vent_pump/on/layer4{dir = 4},/turf/open/floor/plasteel,/area/ship/bridge)
"Ax" = (/obj/machinery/power/apc/auto_name/west,/obj/structure/cable{icon_state = "0-2"},/obj/effect/turf_decal/stripes/corner{dir = 4},/obj/structure/closet/crate,/obj/item/storage/bag/ore,/obj/item/storage/bag/ore,/obj/item/pickaxe/silver,/obj/item/pickaxe/silver,/obj/item/mining_scanner,/obj/item/mining_scanner,/turf/open/floor/plasteel,/area/ship/hallway/central)
"Bx" = (/obj/structure/frame/computer,/obj/structure/window/reinforced/spawner/north,/obj/machinery/light/small{dir = 4},/turf/open/floor/plasteel,/area/ship/bridge)
"BI" = (/obj/structure/cable{icon_state = "2-4"},/obj/structure/chair/comfy/shuttle{dir = 1; name = "Helm"},/turf/open/floor/plasteel,/area/ship/hallway/central)
"CF" = (/obj/machinery/light{dir = 1},/obj/machinery/door/firedoor/border_only{dir = 4},/obj/machinery/firealarm{pixel_x = -10; pixel_y = 28},/obj/machinery/suit_storage_unit/standard_unit,/turf/open/floor/plating,/area/ship/hallway/central)
"CM" = (/obj/machinery/power/smes/shuttle/precharged{dir = 8},/obj/structure/window/reinforced/spawner/east,/obj/machinery/door/window/westright,/obj/structure/cable{icon_state = "0-4"},/turf/open/floor/plating,/area/ship/engineering)
"Dr" = (/obj/structure/cable{icon_state = "4-8"},/obj/structure/cable{icon_state = "2-4"},/obj/machinery/atmospherics/pipe/simple/supply/hidden/layer4{dir = 4},/obj/machinery/atmospherics/pipe/manifold/scrubbers/hidden/layer2{dir = 1},/turf/open/floor/plasteel,/area/ship/hallway/central)
"Hf" = (/obj/structure/cable,/obj/machinery/power/port_gen/pacman/super,/obj/machinery/atmospherics/pipe/simple/scrubbers/hidden/layer2,/obj/item/stack/sheet/mineral/uranium/twenty,/turf/open/floor/plating,/area/ship/hallway/central)
"JT" = (/turf/closed/wall/mineral/plastitanium/nodiagonal,/area/ship/bridge)
"LE" = (/obj/effect/turf_decal/stripes/line,/obj/machinery/button/door{id = "explorerdoors2"; pixel_x = -24; pixel_y = -24},/turf/open/floor/plasteel,/area/ship/hallway/central)
"Mp" = (/turf/closed/wall/mineral/plastitanium,/area/ship/engineering)
"Mx" = (/turf/template_noop,/area/template_noop)
"Ob" = (/obj/structure/cable{icon_state = "1-4"},/obj/machinery/atmospherics/pipe/simple/supply/hidden/layer4{dir = 4},/obj/structure/chair/comfy/shuttle,/turf/open/floor/plasteel,/area/ship/hallway/central)
"OG" = (/obj/structure/fans/tiny,/obj/effect/turf_decal/stripes/line{dir = 1},/obj/machinery/door/poddoor{id = "explorerdoors1"; name = "cargo bay blast door"},/turf/open/floor/plating,/area/ship/hallway/central)
"PP" = (/obj/machinery/power/apc/auto_name/south,/obj/structure/cable{icon_state = "0-4"},/obj/machinery/atmospherics/pipe/simple/supply/hidden/layer4{dir = 4},/obj/machinery/atmospherics/pipe/simple/scrubbers/hidden/layer2{dir = 4},/obj/machinery/airalarm/directional/north,/obj/effect/landmark/start/captain,/turf/open/floor/plasteel,/area/ship/bridge)
"Rw" = (/obj/effect/turf_decal/stripes/corner{dir = 1},/obj/structure/table,/obj/machinery/microwave,/obj/machinery/airalarm/directional/north,/turf/open/floor/plating,/area/ship/engineering)
"RZ" = (/obj/structure/cable{icon_state = "1-8"},/obj/structure/cable{icon_state = "2-8"},/obj/structure/tank_dispenser/oxygen,/turf/open/floor/plasteel,/area/ship/hallway/central)
"TI" = (/obj/machinery/door/airlock/command/glass,/obj/structure/cable{icon_state = "4-8"},/obj/machinery/atmospherics/pipe/simple/supply/hidden/layer4{dir = 4},/obj/machinery/atmospherics/pipe/simple/scrubbers/hidden/layer2{dir = 4},/turf/open/floor/plasteel,/area/ship/bridge)
"VW" = (/obj/effect/spawner/structure/window/reinforced,/turf/open/floor/plasteel,/area/ship/bridge)
"Wg" = (/obj/machinery/light,/obj/machinery/power/smes/engineering,/obj/machinery/door/firedoor/border_only{dir = 4},/turf/open/floor/plating,/area/ship/hallway/central)
"WC" = (/obj/effect/turf_decal/stripes/line,/obj/effect/landmark/start/assistant,/turf/open/floor/plasteel,/area/ship/hallway/central)
"Xd" = (/obj/structure/grille,/obj/structure/window/plasma/reinforced/plastitanium,/turf/open/floor/plating,/area/ship/hallway/central)
"Xf" = (/obj/effect/turf_decal/stripes/line{dir = 9},/turf/open/floor/plating,/area/ship/external)
"Xh" = (/obj/structure/fans/tiny,/obj/effect/turf_decal/stripes/line,/obj/machinery/door/poddoor{id = "explorerdoors2"; name = "cargo bay blast door"},/obj/docking_port/mobile{launch_status = 0; port_direction = 2},/turf/open/floor/plating,/area/ship/hallway/central)
"Xi" = (/obj/machinery/atmospherics/pipe/simple/supply/hidden/layer4{dir = 4},/obj/structure/chair/comfy/shuttle,/turf/open/floor/plasteel,/area/ship/hallway/central)
"YL" = (/obj/effect/turf_decal/stripes/line{dir = 1},/turf/open/floor/plasteel,/area/ship/hallway/central)
"ZD" = (/obj/structure/fans/tiny,/obj/effect/turf_decal/stripes/line,/obj/machinery/door/poddoor{id = "explorerdoors2"; name = "cargo bay blast door"},/turf/open/floor/plating,/area/ship/hallway/central)

(1,1,1) = {"
MxMxMxMxXflsgFOGOGOGlJMpMx
MxMxMxdVXdgFAxYLltYLRwlJMp
VWBxJTJTzdCFobnInIBImcCMvl
zSrFPPTIDrvrmOyQjURZbjlJlJ
VWuxJTJTHfWgspXiXiOboawvvl
MxMxMxdVqsgFajLEWCsoqrlJMp
MxMxMxMxePlsgFZDXhZDlJMpMx
"}
