//MAP CONVERTED BY dmm2tgm.py THIS HEADER COMMENT PREVENTS RECONVERSION, DO NOT REMOVE
"az" = (
/turf/closed/wall,
/area/ship/external)
"aO" = (
/obj/effect/turf_decal/box/corners{
	dir = 4
	},
/obj/machinery/portable_atmospherics/canister/air,
/turf/open/floor/plating/airless,
/area/ship/construction)
"ci" = (
/obj/item/stock_parts/cell/high,
/obj/machinery/light_switch{
	dir = 1;
	pixel_x = 10;
	pixel_y = -20
	},
/turf/open/floor/plating,
/area/ship/construction)
"ck" = (
/obj/structure/closet/crate/engineering{
	name = "Engineering Equipment Crate"
	},
/obj/item/clothing/suit/hazardvest,
/obj/item/clothing/suit/hazardvest,
/obj/item/storage/belt/utility,
/obj/item/storage/belt/utility,
/obj/item/storage/belt/utility,
/obj/item/stack/tape/industrial,
/obj/item/stack/tape/industrial,
/obj/item/stack/tape/industrial/pro,
/obj/item/clothing/head/welding,
/obj/item/clothing/head/welding,
/obj/item/clothing/glasses/welding,
/obj/item/storage/bag/construction,
/obj/item/storage/bag/construction,
/obj/item/storage/bag/construction,
/obj/item/storage/bag/construction,
/turf/open/floor/plating/airless,
/area/ship/construction)
"dz" = (
/obj/effect/turf_decal/industrial/warning{
	dir = 1
	},
/turf/open/floor/plating/airless,
/area/ship/construction)
"ev" = (
/obj/structure/plasticflaps,
/turf/open/floor/plating/airless,
/area/ship/construction)
"eQ" = (
/obj/machinery/portable_atmospherics/canister/air,
/turf/open/floor/plating/airless,
/area/ship/construction)
"fF" = (
/obj/structure/railing{
	dir = 8
	},
/obj/effect/turf_decal/industrial/warning/corner{
	dir = 8
	},
/turf/open/floor/plating/airless,
/area/ship/construction)
"gL" = (
/obj/item/floor_painter{
	pixel_x = 5;
	pixel_y = 5
	},
/obj/item/decal_painter,
/obj/item/airlock_painter{
	pixel_x = -5;
	pixel_y = -5
	},
/obj/structure/railing{
	dir = 1
	},
/obj/structure/closet/crate,
/turf/open/floor/plating/airless,
/area/ship/construction)
"hS" = (
/obj/effect/turf_decal/industrial/warning/corner{
	dir = 4
	},
/obj/structure/railing{
	dir = 4
	},
/turf/open/floor/plating/airless,
/area/ship/construction)
"iE" = (
/obj/effect/turf_decal/box/corners{
	dir = 8
	},
/obj/structure/closet/crate/engineering{
	name = "Engine parts"
	},
/obj/item/circuitboard/machine/shuttle/smes,
/obj/item/circuitboard/machine/shuttle/smes,
/obj/item/circuitboard/machine/shuttle/smes,
/obj/item/circuitboard/machine/shuttle/smes,
/obj/item/circuitboard/machine/shuttle/engine/electric,
/obj/item/circuitboard/machine/shuttle/engine/electric,
/obj/item/circuitboard/machine/shuttle/engine/electric,
/obj/item/circuitboard/machine/shuttle/engine/electric,
/obj/item/circuitboard/machine/shuttle/heater,
/obj/item/circuitboard/machine/shuttle/heater,
/obj/item/circuitboard/machine/shuttle/heater,
/obj/item/circuitboard/machine/shuttle/heater,
/obj/item/circuitboard/machine/shuttle/engine/plasma,
/obj/item/circuitboard/machine/shuttle/engine/plasma,
/obj/item/circuitboard/machine/shuttle/engine/plasma,
/obj/item/circuitboard/machine/shuttle/engine/plasma,
/obj/item/areaeditor/shuttle,
/turf/open/floor/plating/airless,
/area/ship/construction)
"jj" = (
/obj/structure/closet/crate/solarpanel_small,
/turf/open/floor/plating/airless,
/area/ship/construction)
"ke" = (
/obj/structure/railing{
	dir = 1
	},
/turf/open/floor/plating/airless,
/area/ship/construction)
"kh" = (
/obj/effect/turf_decal/box/corners{
	dir = 1
	},
/obj/structure/tank_dispenser/plasma,
/turf/open/floor/plating/airless,
/area/ship/construction)
"mJ" = (
/obj/effect/turf_decal/box/corners,
/obj/machinery/portable_atmospherics/canister/toxins,
/turf/open/floor/plating/airless,
/area/ship/construction)
"nq" = (
/obj/structure/railing,
/turf/open/floor/plating/airless,
/area/ship/construction)
"nv" = (
/obj/effect/turf_decal/industrial/warning{
	dir = 8
	},
/turf/open/floor/plating/airless,
/area/ship/construction)
"nx" = (
/obj/docking_port/mobile{
	callTime = 250;
	can_move_docking_ports = 1;
	dir = 2;
	launch_status = 0;
	port_direction = 8;
	preferred_direction = 4
	},
/turf/open/floor/plating/airless,
/area/ship/construction)
"of" = (
/obj/structure/railing,
/obj/effect/turf_decal/industrial/warning/corner{
	dir = 8
	},
/turf/open/floor/plating/airless,
/area/ship/construction)
"pi" = (
/obj/structure/railing{
	dir = 4
	},
/obj/effect/turf_decal/industrial/warning/corner,
/turf/open/floor/plating/airless,
/area/ship/construction)
"qM" = (
/obj/structure/railing{
	dir = 10
	},
/turf/open/floor/plating/airless,
/area/ship/construction)
"rj" = (
/obj/structure/railing{
	dir = 9
	},
/turf/open/floor/plating/airless,
/area/ship/construction)
"rS" = (
/obj/item/storage/toolbox/mechanical{
	pixel_x = -2;
	pixel_y = -1
	},
/turf/open/floor/plating,
/area/ship/construction)
"uq" = (
/obj/machinery/cryopod{
	dir = 4
	},
/obj/machinery/computer/cryopod/directional/west,
/turf/open/floor/plating,
/area/ship/construction)
"uC" = (
/obj/structure/railing,
/obj/effect/turf_decal/industrial/warning/corner,
/turf/open/floor/plating/airless,
/area/ship/construction)
"vo" = (
/obj/item/stack/tile/carpet/royalblack/fifty,
/obj/item/stack/tile/carpet/royalblue/fifty,
/obj/item/stack/tile/carpet/purple/fifty,
/obj/item/stack/tile/carpet/red/fifty,
/obj/item/stack/tile/carpet/orange/fifty,
/obj/item/stack/tile/carpet/green/fifty,
/obj/item/stack/tile/carpet/fifty,
/obj/item/stack/tile/carpet/cyan/fifty,
/obj/item/stack/tile/carpet/blue/fifty,
/obj/item/stack/tile/carpet/black/fifty,
/obj/item/stack/sheet/mineral/wood/fifty,
/obj/item/stack/sheet/mineral/wood/fifty,
/obj/effect/turf_decal/box/corners{
	dir = 4
	},
/obj/structure/closet/crate/large{
	name = "wood and carpeting crate"
	},
/turf/open/floor/plating/airless,
/area/ship/construction)
"vs" = (
/obj/item/toy/crayon/spraycan/infinite{
	name = "stencil tool"
	},
/obj/effect/landmark/observer_start,
/turf/open/floor/plating,
/area/ship/construction)
"vt" = (
/obj/item/tank/internals/oxygen/yellow,
/obj/item/tank/internals/oxygen/yellow,
/obj/item/clothing/shoes/magboots,
/obj/item/clothing/shoes/magboots,
/obj/item/clothing/suit/space/engineer,
/obj/item/clothing/suit/space/engineer,
/obj/item/clothing/head/helmet/space/light/engineer,
/obj/item/clothing/head/helmet/space/light/engineer,
/obj/structure/closet/crate/internals{
	name = "EVA Suit Crate"
	},
/turf/open/floor/plating/airless,
/area/ship/construction)
"vK" = (
/obj/structure/railing{
	dir = 1
	},
/obj/effect/turf_decal/industrial/warning/corner{
	dir = 4
	},
/obj/structure/reagent_dispensers/fueltank,
/turf/open/floor/plating/airless,
/area/ship/construction)
"wd" = (
/obj/structure/railing{
	dir = 6
	},
/turf/open/floor/plating/airless,
/area/ship/construction)
"yQ" = (
/obj/machinery/portable_atmospherics/canister/air,
/obj/effect/turf_decal/box/corners,
/turf/open/floor/plating/airless,
/area/ship/construction)
"zu" = (
/obj/structure/lattice/catwalk,
/turf/template_noop,
/area/ship/external)
"AS" = (
/obj/effect/turf_decal/box/corners,
/obj/structure/closet/crate/engineering{
	name = "tools crate"
	},
/obj/item/pipe_dispenser,
/obj/item/construction/rcd,
/obj/item/storage/toolbox/mechanical{
	pixel_x = 5;
	pixel_y = 5
	},
/obj/item/storage/toolbox/mechanical{
	pixel_x = -5;
	pixel_y = -5
	},
/obj/item/multitool,
/obj/item/rcd_ammo/large,
/obj/item/rcd_ammo/large,
/obj/item/rcd_ammo/large,
/obj/item/rcd_ammo/large,
/obj/item/rcd_ammo/large,
/obj/item/rcd_ammo/large,
/obj/item/construction/rcd,
/turf/open/floor/plating/airless,
/area/ship/construction)
"BL" = (
/obj/structure/railing{
	dir = 4
	},
/turf/open/floor/plating/airless,
/area/ship/construction)
"Ct" = (
/obj/structure/closet/crate/engineering{
	name = "autolathe crate"
	},
/obj/item/storage/box/stockparts/basic,
/obj/item/storage/box/stockparts/basic,
/obj/item/circuitboard/machine/autolathe,
/turf/open/floor/plating/airless,
/area/ship/construction)
"Ds" = (
/obj/item/stack/rods/fifty{
	pixel_x = 8
	},
/obj/item/stack/rods/fifty{
	pixel_x = -8
	},
/obj/item/stack/rods/fifty,
/obj/structure/closet/crate/large{
	name = "rebar crate"
	},
/turf/open/floor/plating/airless,
/area/ship/construction)
"Fj" = (
/turf/closed/wall,
/area/ship/construction)
"FI" = (
/obj/structure/closet/crate{
	name = "Communications Equipment Crate"
	},
/obj/item/wallframe/intercom/wideband,
/obj/item/circuitboard/machine/holopad,
/obj/item/circuitboard/computer/cargo/express,
/obj/item/spacecash/bundle/loadsamoney,
/obj/item/spacecash/bundle/loadsamoney,
/obj/item/spacecash/bundle/loadsamoney,
/turf/open/floor/plating/airless,
/area/ship/construction)
"Gb" = (
/obj/structure/railing{
	dir = 1
	},
/obj/effect/turf_decal/industrial/warning/corner{
	dir = 1
	},
/turf/open/floor/plating/airless,
/area/ship/construction)
"GN" = (
/obj/effect/turf_decal/industrial/warning{
	dir = 4
	},
/turf/open/floor/plating/airless,
/area/ship/construction)
"HK" = (
/obj/machinery/portable_atmospherics/canister/air,
/obj/effect/turf_decal/box/corners{
	dir = 4
	},
/turf/open/floor/plating/airless,
/area/ship/construction)
"HP" = (
/obj/effect/turf_decal/box/corners{
	dir = 1
	},
/obj/item/stack/sheet/metal/fifty{
	pixel_x = -5;
	pixel_y = -5
	},
/obj/item/stack/sheet/mineral/titanium/fifty{
	pixel_x = 5;
	pixel_y = -5
	},
/obj/item/stack/sheet/metal/fifty{
	pixel_x = -5;
	pixel_y = -2
	},
/obj/item/stack/sheet/mineral/titanium/fifty{
	pixel_x = 5;
	pixel_y = -2
	},
/obj/item/stack/sheet/metal/fifty{
	pixel_x = -5;
	pixel_y = 1
	},
/obj/item/stack/sheet/mineral/titanium/fifty{
	pixel_x = 5;
	pixel_y = 1
	},
/obj/item/stack/sheet/metal/fifty{
	pixel_x = -5;
	pixel_y = 4
	},
/obj/item/stack/sheet/mineral/titanium/fifty{
	pixel_x = 5;
	pixel_y = 4
	},
/obj/structure/closet/crate/large{
	name = "sheet metal crate"
	},
/obj/item/stack/sheet/plasteel/fifty,
/turf/open/floor/plating/airless,
/area/ship/construction)
"JY" = (
/obj/structure/closet/crate/engineering/electrical{
	name = "electrical crate"
	},
/obj/item/storage/toolbox/electrical{
	pixel_x = 1;
	pixel_y = 6
	},
/obj/item/storage/toolbox/electrical,
/obj/item/storage/toolbox/electrical{
	pixel_x = -6;
	pixel_y = -6
	},
/obj/item/stack/tape/industrial/electrical,
/obj/item/clothing/gloves/color/yellow,
/obj/item/multitool,
/obj/item/rcl/pre_loaded,
/obj/item/stack/cable_coil/red,
/obj/item/stack/cable_coil/red,
/obj/item/stack/cable_coil/red,
/obj/item/stack/cable_coil/yellow,
/obj/item/stack/cable_coil/yellow,
/obj/item/stack/cable_coil/yellow,
/obj/item/circuitboard/machine/smes,
/obj/item/circuitboard/machine/cell_charger,
/obj/item/stock_parts/cell/high/empty,
/obj/item/stock_parts/cell/high/empty,
/obj/item/stock_parts/cell/high/empty,
/obj/item/stock_parts/cell/high/empty,
/obj/item/stock_parts/cell/high/empty,
/obj/item/storage/box/lights/mixed,
/turf/open/floor/plating/airless,
/area/ship/construction)
"Kq" = (
/obj/structure/railing{
	dir = 1
	},
/obj/item/pickaxe,
/obj/item/pickaxe,
/obj/item/mining_scanner,
/obj/item/mining_scanner,
/obj/structure/closet/crate{
	name = "Mining Equipment"
	},
/turf/open/floor/plating/airless,
/area/ship/construction)
"Ld" = (
/obj/structure/frame/computer,
/obj/item/circuitboard/computer/shuttle/helm,
/turf/open/floor/plating/airless,
/area/ship/construction)
"LK" = (
/obj/item/tank/internals/oxygen/yellow,
/obj/item/tank/internals/oxygen/yellow,
/obj/item/clothing/shoes/magboots,
/obj/item/clothing/shoes/magboots,
/obj/item/clothing/suit/space/engineer,
/obj/item/clothing/suit/space/engineer,
/obj/item/clothing/head/helmet/space/light/engineer,
/obj/item/clothing/head/helmet/space/light/engineer,
/obj/structure/closet/crate/internals{
	name = "EVA Suit Crate"
	},
/turf/open/floor/plating,
/area/ship/construction)
"MA" = (
/turf/open/floor/plating/airless,
/area/ship/construction)
"MO" = (
/obj/effect/turf_decal/industrial/warning,
/turf/open/floor/plating/airless,
/area/ship/construction)
"ND" = (
/obj/structure/lattice,
/turf/template_noop,
/area/ship/external)
"Pd" = (
/obj/structure/railing{
	dir = 8
	},
/turf/open/floor/plating/airless,
/area/ship/construction)
"Qj" = (
/obj/structure/closet/crate/large{
	name = "glass crate"
	},
/obj/item/stack/sheet/glass/fifty{
	pixel_x = -5;
	pixel_y = -5
	},
/obj/item/stack/sheet/titaniumglass{
	amount = 50;
	pixel_x = 5;
	pixel_y = -5
	},
/obj/item/stack/sheet/glass/fifty,
/obj/item/stack/sheet/plastic/twenty,
/turf/open/floor/plating/airless,
/area/ship/construction)
"Qz" = (
/obj/structure/girder,
/turf/open/floor/plating/airless,
/area/ship/construction)
"RZ" = (
/obj/machinery/power/apc/auto_name/directional/east{
	cell_type = /obj/item/stock_parts/cell/high/plus
	},
/obj/structure/cable/yellow{
	icon_state = "0-8"
	},
/turf/open/floor/plating/airless,
/area/ship/external)
"SA" = (
/turf/template_noop,
/area/template_noop)
"SK" = (
/obj/item/circuitboard/machine/medical_kiosk,
/obj/item/circuitboard/machine/sleeper,
/obj/item/circuitboard/computer/operating,
/obj/item/circuitboard/computer/med_data,
/obj/item/circuitboard/machine/microwave,
/obj/structure/railing{
	dir = 1
	},
/obj/structure/closet/crate/science{
	name = "technology crate"
	},
/obj/item/stack/circuit_stack/full,
/obj/item/stack/circuit_stack/full,
/obj/item/circuitboard/machine/ore_redemption,
/obj/item/circuitboard/machine/shieldwallgen/atmos,
/obj/item/circuitboard/machine/shieldwallgen/atmos,
/obj/item/circuitboard/machine/circuit_imprinter/department,
/obj/item/circuitboard/machine/rdserver,
/obj/item/circuitboard/computer/rdconsole,
/obj/item/research_notes/loot/genius,
/turf/open/floor/plating/airless,
/area/ship/construction)
"SN" = (
/obj/structure/railing{
	dir = 8
	},
/obj/effect/turf_decal/industrial/warning/corner{
	dir = 1
	},
/obj/machinery/power/apc/auto_name/directional/east{
	cell_type = /obj/item/stock_parts/cell/high/plus
	},
/obj/structure/cable/yellow{
	icon_state = "0-8"
	},
/obj/item/stock_parts/cell/high,
/turf/open/floor/plating/airless,
/area/ship/construction)
"Tc" = (
/obj/structure/railing/corner,
/turf/open/floor/plating/airless,
/area/ship/construction)
"Tp" = (
/obj/item/reagent_containers/food/snacks/canned/beans{
	pixel_x = -5;
	pixel_y = 3
	},
/obj/item/reagent_containers/food/snacks/canned/beans{
	pixel_x = 2;
	pixel_y = 3
	},
/obj/item/reagent_containers/food/snacks/canned/beans{
	pixel_x = -2
	},
/obj/item/reagent_containers/food/drinks/waterbottle/large{
	pixel_x = 5
	},
/obj/item/reagent_containers/food/drinks/waterbottle/large{
	pixel_x = 1;
	pixel_y = -3
	},
/obj/item/reagent_containers/food/drinks/waterbottle/large{
	pixel_x = 8;
	pixel_y = -3
	},
/obj/structure/closet/crate{
	name = "food crate"
	},
/obj/item/storage/cans/sixbeer,
/obj/item/reagent_containers/food/snacks/rationpack,
/obj/item/reagent_containers/food/snacks/rationpack,
/obj/item/reagent_containers/food/snacks/rationpack,
/obj/item/reagent_containers/food/snacks/rationpack,
/obj/item/reagent_containers/food/snacks/rationpack,
/obj/item/reagent_containers/food/snacks/rationpack,
/turf/open/floor/plating/airless,
/area/ship/construction)
"Vu" = (
/obj/effect/turf_decal/box/corners{
	dir = 8
	},
/obj/machinery/power/port_gen/pacman,
/obj/item/stack/sheet/mineral/plasma/five,
/obj/structure/closet/crate/engineering/electrical{
	name = "portable generator crate"
	},
/turf/open/floor/plating/airless,
/area/ship/construction)
"VH" = (
/obj/structure/railing{
	dir = 5
	},
/turf/open/floor/plating/airless,
/area/ship/construction)
"XT" = (
/obj/item/storage/firstaid/fire{
	pixel_y = 10
	},
/obj/structure/bedsheetbin,
/turf/open/floor/plating,
/area/ship/construction)

(1,1,1) = {"
SA
SA
SA
SA
SA
SA
zu
zu
zu
SA
SA
SA
SA
SA
SA
"}
(2,1,1) = {"
SA
ND
ND
ND
ND
ND
ND
zu
ND
ND
ND
ND
ND
RZ
SA
"}
(3,1,1) = {"
SA
ND
SA
SA
SA
SA
ND
zu
ND
SA
SA
SA
SA
az
SA
"}
(4,1,1) = {"
SA
ND
SA
SA
SA
SA
ND
zu
ND
SA
SA
SA
SA
ND
SA
"}
(5,1,1) = {"
SA
ND
SA
SA
SA
SA
ND
zu
ND
SA
SA
SA
SA
ND
SA
"}
(6,1,1) = {"
SA
ND
SA
SA
ND
ND
ND
zu
ND
SA
SA
SA
SA
ND
SA
"}
(7,1,1) = {"
SA
ND
SA
SA
zu
zu
zu
zu
ND
SA
SA
SA
SA
ND
SA
"}
(8,1,1) = {"
SA
rj
Pd
fF
nv
SN
Pd
qM
ND
SA
SA
SA
SA
ND
SA
"}
(9,1,1) = {"
SA
ke
Tp
Fj
Fj
Fj
Ld
nq
ND
SA
SA
SA
SA
ND
SA
"}
(10,1,1) = {"
SA
gL
HP
Fj
uq
Fj
Vu
nq
ND
SA
SA
SA
SA
ND
SA
"}
(11,1,1) = {"
SA
SK
Qj
Fj
rS
Fj
jj
nq
ND
SA
SA
SA
SA
ND
SA
"}
(12,1,1) = {"
SA
Kq
Ds
Fj
XT
Fj
JY
nq
ND
SA
SA
SA
SA
ND
SA
"}
(13,1,1) = {"
Qz
vK
vo
Fj
ci
Fj
AS
uC
zu
ND
ND
ND
ND
ND
zu
"}
(14,1,1) = {"
nx
dz
MA
ev
vs
ev
MA
MO
zu
zu
zu
zu
zu
zu
zu
"}
(15,1,1) = {"
Qz
Gb
kh
Fj
LK
Fj
iE
of
zu
ND
ND
ND
ND
ND
zu
"}
(16,1,1) = {"
SA
ke
vt
Fj
Fj
Fj
Ct
nq
ND
SA
SA
SA
SA
ND
SA
"}
(17,1,1) = {"
SA
ke
aO
eQ
FI
ck
mJ
nq
ND
SA
SA
SA
SA
ND
SA
"}
(18,1,1) = {"
SA
ke
MA
HK
MA
yQ
Tc
wd
ND
SA
SA
SA
SA
ND
SA
"}
(19,1,1) = {"
SA
VH
BL
pi
GN
hS
wd
ND
ND
SA
SA
SA
SA
ND
SA
"}
(20,1,1) = {"
SA
ND
SA
zu
zu
zu
zu
zu
ND
SA
SA
SA
SA
ND
SA
"}
(21,1,1) = {"
SA
ND
SA
SA
ND
SA
ND
zu
ND
SA
SA
SA
SA
ND
SA
"}
(22,1,1) = {"
SA
ND
SA
SA
SA
SA
ND
zu
ND
SA
SA
SA
SA
ND
SA
"}
(23,1,1) = {"
SA
ND
SA
SA
SA
SA
ND
zu
ND
SA
SA
SA
SA
ND
SA
"}
(24,1,1) = {"
SA
ND
SA
SA
SA
SA
ND
zu
ND
SA
SA
SA
SA
ND
SA
"}
(25,1,1) = {"
SA
ND
ND
ND
ND
ND
ND
zu
ND
ND
ND
ND
ND
ND
SA
"}
(26,1,1) = {"
SA
SA
SA
SA
SA
SA
zu
zu
zu
SA
SA
SA
SA
SA
SA
"}
