//MAP CONVERTED BY dmm2tgm.py THIS HEADER COMMENT PREVENTS RECONVERSION, DO NOT REMOVE
"ao" = (
/turf/closed/wall/mineral/plastitanium/nodiagonal,
/area/ship/engineering/communications)
"aH" = (
/turf/open/floor/plating,
/area/ship/engineering/atmospherics)
"ce" = (
/obj/structure/sign/warning/vacuum/external,
/turf/closed/wall/mineral/plastitanium/nodiagonal,
/area/ship/hallway/central)
"cA" = (
/obj/effect/turf_decal/borderfloor{
	dir = 1
	},
/obj/machinery/door/airlock/engineering{
	name = "Engineering"
	},
/turf/open/floor/plasteel/tech,
/area/ship/engineering/atmospherics)
"cC" = (
/obj/effect/turf_decal/industrial/warning{
	dir = 8
	},
/turf/open/floor/plasteel/tech,
/area/ship/crew/dorm)
"cL" = (
/turf/open/floor/plating,
/area/ship/cargo/port)
"cV" = (
/turf/closed/wall/mineral/plastitanium,
/area/ship/storage)
"dk" = (
/obj/effect/turf_decal/industrial/warning{
	dir = 4
	},
/obj/effect/turf_decal/siding/white{
	dir = 1
	},
/turf/open/floor/plasteel/tech,
/area/ship/crew/dorm)
"dE" = (
/obj/structure/chair/comfy/shuttle{
	dir = 4;
	name = "Helm"
	},
/turf/open/floor/plasteel/dark,
/area/ship/bridge)
"ej" = (
/obj/machinery/atmospherics/components/unary/shuttle/heater{
	dir = 4
	},
/turf/open/floor/plating,
/area/ship/engineering/atmospherics)
"eu" = (
/obj/machinery/cryopod{
	dir = 4
	},
/turf/open/floor/plasteel/tech/grid,
/area/ship/crew/dorm)
"eV" = (
/obj/effect/turf_decal/industrial/warning/fulltile,
/obj/machinery/door/airlock/maintenance_hatch,
/turf/open/floor/plating/airless,
/area/ship/cargo/starboard)
"fh" = (
/obj/effect/turf_decal/industrial/traffic,
/turf/open/floor/plasteel/patterned,
/area/ship/cargo)
"ft" = (
/obj/effect/turf_decal/borderfloor{
	dir = 4
	},
/obj/machinery/door/airlock/engineering{
	name = "Engineering"
	},
/turf/open/floor/plasteel/tech,
/area/ship/engineering)
"fA" = (
/obj/effect/turf_decal/industrial/warning/fulltile,
/turf/open/floor/engine/airless,
/area/ship/engineering/atmospherics)
"fC" = (
/turf/closed/wall/mineral/plastitanium,
/area/space)
"fK" = (
/turf/closed/wall/mineral/plastitanium/nodiagonal,
/area/ship/cargo/starboard)
"fQ" = (
/obj/effect/turf_decal/industrial/warning/fulltile,
/obj/machinery/door/airlock/hatch,
/turf/open/floor/plating/airless,
/area/ship/cargo/starboard)
"gB" = (
/obj/structure/table/reinforced,
/turf/open/floor/plasteel/dark,
/area/ship/bridge)
"gE" = (
/obj/machinery/power/shuttle/engine/fueled/plasma{
	dir = 4
	},
/turf/open/floor/plating,
/area/ship/engineering)
"hp" = (
/obj/structure/catwalk,
/turf/closed/wall/mineral/plastitanium,
/area/ship/engineering/communications)
"hT" = (
/turf/closed/wall/mineral/plastitanium/nodiagonal,
/area/ship/hallway/central)
"id" = (
/turf/open/floor/plasteel/tech,
/area/ship/engineering/atmospherics)
"iM" = (
/obj/machinery/power/smes/shuttle/precharged{
	dir = 4
	},
/obj/structure/cable{
	icon_state = "0-8"
	},
/turf/open/floor/plating,
/area/ship/engineering/atmospherics)
"jj" = (
/obj/structure/sign/warning/vacuum,
/turf/closed/wall/mineral/plastitanium/nodiagonal,
/area/ship/maintenance/port)
"jm" = (
/obj/effect/turf_decal/industrial/warning/fulltile,
/obj/machinery/door/airlock/hatch,
/turf/open/floor/plating/airless,
/area/ship/cargo/port)
"js" = (
/obj/effect/turf_decal/industrial/warning/fulltile,
/obj/machinery/door/airlock/maintenance_hatch,
/turf/open/floor/plating/airless,
/area/ship/cargo/port)
"jx" = (
/turf/open/floor/plasteel/tech,
/area/ship/crew/dorm)
"jP" = (
/obj/effect/turf_decal/siding/white{
	dir = 1
	},
/turf/open/floor/plasteel/tech,
/area/ship/crew/dorm)
"kD" = (
/turf/open/floor/plasteel/dark,
/area/ship/crew/canteen)
"la" = (
/turf/closed/wall/mineral/plastitanium/nodiagonal,
/area/ship/crew/toilet)
"ll" = (
/obj/machinery/power/shuttle/engine/electric{
	dir = 4
	},
/obj/structure/cable{
	icon_state = "0-4"
	},
/turf/open/floor/plating,
/area/ship/engineering)
"lw" = (
/turf/open/floor/plasteel/dark,
/area/ship/security)
"lC" = (
/turf/closed/wall/mineral/plastitanium/nodiagonal,
/area/ship/hallway/port)
"lM" = (
/turf/open/floor/plasteel/tech,
/area/ship/maintenance/port)
"mi" = (
/turf/open/floor/plasteel/patterned/grid,
/area/ship/hallway/central)
"mw" = (
/obj/effect/turf_decal/borderfloor{
	dir = 1
	},
/obj/machinery/door/airlock/command/glass{
	name = "Bridge";
	req_access_txt = "58"
	},
/turf/open/floor/plasteel/tech,
/area/ship/bridge)
"mK" = (
/turf/closed/wall/mineral/plastitanium/nodiagonal,
/area/ship/security)
"mX" = (
/turf/closed/wall/mineral/plastitanium/nodiagonal,
/area/ship/bridge)
"ne" = (
/turf/open/floor/plasteel/showroomfloor,
/area/ship/crew/toilet)
"nl" = (
/turf/open/floor/plasteel/grimy,
/area/ship/crew)
"no" = (
/obj/structure/bed,
/obj/structure/curtain/bounty,
/obj/item/bedsheet/hos{
	name = "vanguard's bedsheet"
	},
/turf/open/floor/plasteel/dark,
/area/ship/bridge)
"od" = (
/obj/structure/sign/warning/vacuum/external,
/turf/closed/wall/mineral/plastitanium/nodiagonal,
/area/ship/cargo/port)
"oi" = (
/obj/structure/sign/warning/incident{
	pixel_y = 32
	},
/turf/open/floor/plasteel/patterned/cargo_one,
/area/ship/cargo)
"ok" = (
/obj/machinery/modular_computer/console/preset/command{
	dir = 8
	},
/turf/open/floor/plasteel/dark,
/area/ship/bridge)
"ot" = (
/turf/open/floor/plasteel/tech/grid,
/area/ship/hallway/central)
"pm" = (
/obj/machinery/power/terminal{
	dir = 8
	},
/obj/structure/cable{
	icon_state = "0-4"
	},
/turf/open/floor/plating,
/area/ship/engineering/atmospherics)
"pU" = (
/turf/closed/wall/mineral/plastitanium/nodiagonal,
/area/ship/engineering/atmospherics)
"pX" = (
/obj/effect/turf_decal/borderfloor{
	dir = 1
	},
/obj/machinery/door/airlock/highsecurity{
	name = "Communications"
	},
/turf/open/floor/plasteel/tech,
/area/ship/engineering/communications)
"qM" = (
/turf/open/floor/plasteel/dark,
/area/ship/bridge)
"rt" = (
/obj/effect/turf_decal/industrial/warning{
	dir = 8
	},
/turf/open/floor/engine/hull,
/area/ship/cargo)
"rw" = (
/turf/open/floor/plating/airless,
/area/ship/maintenance/starboard)
"rI" = (
/obj/structure/catwalk,
/obj/structure/marker_beacon,
/turf/open/floor/plating,
/area/ship/external/dark)
"si" = (
/obj/structure/sign/warning/vacuum,
/turf/closed/wall/mineral/plastitanium/nodiagonal,
/area/ship/maintenance/starboard)
"sw" = (
/turf/open/space/basic,
/area/space)
"sy" = (
/turf/closed/wall/mineral/plastitanium,
/area/ship/cargo/starboard)
"sV" = (
/turf/closed/wall/mineral/plastitanium/nodiagonal,
/area/ship/storage)
"sW" = (
/turf/closed/wall/mineral/plastitanium/nodiagonal,
/area/ship/crew/dorm)
"tn" = (
/obj/machinery/computer/helm{
	dir = 8
	},
/turf/open/floor/plasteel/dark,
/area/ship/bridge)
"tA" = (
/turf/closed/wall/mineral/plastitanium,
/area/ship/engineering)
"tL" = (
/obj/machinery/door/airlock/hatch,
/obj/effect/turf_decal/industrial/warning/fulltile,
/turf/open/floor/plasteel/tech,
/area/ship/maintenance/port)
"ug" = (
/turf/open/floor/plasteel/tech,
/area/ship/security/armory)
"uC" = (
/obj/machinery/power/smes/shuttle/precharged{
	dir = 4
	},
/obj/structure/cable{
	icon_state = "0-8"
	},
/turf/open/floor/plating,
/area/ship/engineering)
"uI" = (
/turf/closed/wall/mineral/plastitanium/nodiagonal,
/area/ship/maintenance/starboard)
"uY" = (
/obj/machinery/power/shuttle/engine/electric{
	dir = 4
	},
/obj/structure/cable{
	icon_state = "0-4"
	},
/turf/open/floor/plating,
/area/ship/engineering/atmospherics)
"vp" = (
/turf/closed/wall/mineral/plastitanium,
/area/ship/engineering/communications)
"vE" = (
/turf/closed/wall/mineral/plastitanium,
/area/ship/engineering/atmospherics)
"xf" = (
/obj/effect/turf_decal/industrial/traffic{
	dir = 1
	},
/turf/open/floor/plasteel/patterned,
/area/ship/cargo)
"xI" = (
/turf/closed/wall/mineral/plastitanium/nodiagonal,
/area/ship/crew/canteen)
"yp" = (
/turf/closed/wall/mineral/plastitanium/nodiagonal,
/area/ship/maintenance/port)
"za" = (
/turf/open/floor/plating,
/area/ship/engineering)
"ze" = (
/obj/machinery/power/shuttle/engine/fueled/plasma{
	dir = 4
	},
/turf/open/floor/plating,
/area/ship/engineering/atmospherics)
"zh" = (
/obj/machinery/holopad,
/turf/open/floor/carpet/orange,
/area/ship/bridge)
"zw" = (
/obj/effect/turf_decal/industrial/warning/fulltile,
/obj/machinery/door/airlock/external,
/turf/open/floor/plasteel/tech,
/area/ship/hallway/central)
"zE" = (
/obj/effect/spawner/structure/window/plasma/reinforced/plastitanium,
/turf/open/floor/plating,
/area/ship/hallway/port)
"Ah" = (
/obj/effect/turf_decal/box/corners{
	dir = 4
	},
/turf/open/floor/plasteel/patterned/cargo_one,
/area/ship/cargo)
"Ap" = (
/turf/closed/wall/mineral/plastitanium,
/area/ship/cargo/port)
"AS" = (
/obj/effect/turf_decal/borderfloor{
	dir = 4
	},
/obj/machinery/door/airlock{
	name = "Restroom"
	},
/turf/open/floor/plasteel/tech,
/area/ship/crew/toilet)
"AV" = (
/obj/machinery/computer/cargo/express{
	dir = 8
	},
/turf/open/floor/plasteel/dark,
/area/ship/bridge)
"Bq" = (
/turf/closed/wall/mineral/plastitanium,
/area/ship/security)
"Bv" = (
/turf/closed/wall/mineral/plastitanium/nodiagonal,
/area/ship/crew)
"Bz" = (
/turf/open/floor/plasteel/tech/grid,
/area/ship/maintenance/port)
"Cy" = (
/obj/machinery/cryopod{
	dir = 8
	},
/turf/open/floor/plasteel/tech/grid,
/area/ship/crew/dorm)
"CF" = (
/turf/closed/wall/mineral/plastitanium/nodiagonal,
/area/ship/cargo)
"CK" = (
/obj/effect/turf_decal/industrial/warning{
	dir = 8
	},
/obj/effect/turf_decal/siding/white{
	dir = 1
	},
/turf/open/floor/plasteel/tech,
/area/ship/crew/dorm)
"CP" = (
/obj/effect/turf_decal/borderfloor,
/obj/machinery/door/airlock/engineering{
	name = "Storage Bay"
	},
/turf/open/floor/plasteel/tech,
/area/ship/storage)
"DO" = (
/turf/closed/wall/mineral/plastitanium,
/area/ship/maintenance/starboard)
"DQ" = (
/obj/effect/turf_decal/borderfloor{
	dir = 1
	},
/obj/machinery/door/airlock/public/glass{
	name = "Office"
	},
/turf/open/floor/plasteel/tech,
/area/ship/security)
"Fe" = (
/turf/open/floor/plasteel/tech,
/area/ship/hallway/central)
"FL" = (
/obj/structure/catwalk/over/plated_catwalk,
/turf/open/floor/plasteel/tech/grid,
/area/ship/crew/dorm)
"Gs" = (
/turf/open/floor/plasteel/tech,
/area/ship/engineering)
"Gu" = (
/turf/open/floor/plasteel/tech/grid,
/area/ship/maintenance/starboard)
"Hq" = (
/turf/closed/wall/mineral/plastitanium/nodiagonal,
/area/ship/security/armory)
"Ic" = (
/obj/effect/turf_decal/box/corners{
	dir = 8
	},
/turf/open/floor/plasteel/patterned/cargo_one,
/area/ship/cargo)
"ID" = (
/obj/machinery/door/airlock/public/glass{
	name = "Cryogenic Storage"
	},
/obj/effect/turf_decal/borderfloor{
	dir = 1
	},
/turf/open/floor/plasteel/tech,
/area/ship/crew/dorm)
"IF" = (
/turf/open/floor/plating/airless,
/area/ship/cargo/port)
"Je" = (
/turf/open/floor/engine/airless,
/area/ship/engineering/atmospherics)
"Jk" = (
/turf/open/floor/plating/airless,
/area/ship/cargo/starboard)
"Jz" = (
/turf/open/floor/plasteel/patterned/grid,
/area/ship/hallway/port)
"JT" = (
/turf/closed/wall/mineral/plastitanium,
/area/ship/crew)
"Kx" = (
/obj/effect/turf_decal/industrial/warning/fulltile,
/obj/machinery/door/airlock/hatch,
/turf/open/floor/plasteel/tech,
/area/ship/maintenance/port)
"KI" = (
/obj/machinery/power/terminal{
	dir = 8
	},
/obj/structure/cable{
	icon_state = "0-4"
	},
/turf/open/floor/plating,
/area/ship/engineering)
"KK" = (
/obj/machinery/door/airlock/public/glass{
	name = "Canteen"
	},
/obj/effect/turf_decal/borderfloor{
	dir = 4
	},
/turf/open/floor/plasteel/tech,
/area/ship/crew/canteen)
"KY" = (
/obj/effect/turf_decal/borderfloor,
/obj/machinery/door/airlock/public/glass{
	name = "Crew Quarters"
	},
/turf/open/floor/plasteel/tech,
/area/ship/crew)
"Lc" = (
/obj/effect/spawner/structure/window/plasma/reinforced/plastitanium,
/turf/open/floor/plating,
/area/ship/bridge)
"LN" = (
/obj/effect/turf_decal/industrial/warning/fulltile,
/obj/machinery/door/airlock/grunge{
	name = "Cargo Bay"
	},
/turf/open/floor/plasteel/tech,
/area/ship/cargo)
"Mh" = (
/obj/effect/turf_decal/box/corners{
	dir = 1
	},
/turf/open/floor/plasteel/patterned/cargo_one,
/area/ship/cargo)
"MV" = (
/obj/structure/catwalk,
/turf/open/floor/plating,
/area/ship/external/dark)
"Ne" = (
/obj/effect/turf_decal/borderfloor{
	dir = 4
	},
/obj/machinery/door/airlock/public/glass{
	name = "Crew Quarters"
	},
/turf/open/floor/plasteel/tech,
/area/ship/crew)
"Oc" = (
/turf/open/floor/plasteel/patterned/cargo_one,
/area/ship/cargo)
"Oi" = (
/turf/open/floor/plating,
/area/ship/engineering/communications)
"Ok" = (
/turf/open/floor/plating,
/area/ship/storage)
"OF" = (
/turf/closed/wall/mineral/plastitanium/nodiagonal,
/area/ship/engineering)
"ON" = (
/obj/structure/table/reinforced,
/obj/machinery/photocopier/faxmachine/longrange,
/turf/open/floor/plasteel/dark,
/area/ship/bridge)
"Pp" = (
/turf/closed/wall/mineral/plastitanium/nodiagonal,
/area/ship/cargo/port)
"QD" = (
/obj/structure/sign/warning/coldtemp,
/turf/closed/wall/mineral/plastitanium/nodiagonal,
/area/ship/engineering/communications)
"Rr" = (
/obj/effect/turf_decal/industrial/warning{
	dir = 4
	},
/turf/open/floor/plasteel/tech,
/area/ship/crew/dorm)
"RT" = (
/turf/open/floor/plating/airless,
/area/ship/maintenance/port)
"So" = (
/obj/machinery/atmospherics/components/unary/shuttle/heater{
	dir = 4
	},
/turf/open/floor/plating,
/area/ship/engineering)
"Tb" = (
/obj/structure/catwalk/over/plated_catwalk,
/obj/structure/railing,
/turf/open/floor/plasteel/tech/grid,
/area/ship/crew/dorm)
"Tq" = (
/obj/effect/turf_decal/box/corners,
/turf/open/floor/plasteel/patterned/cargo_one,
/area/ship/cargo)
"Uq" = (
/turf/open/floor/plasteel/tech,
/area/ship/maintenance/starboard)
"UC" = (
/obj/effect/turf_decal/borderfloor{
	dir = 4
	},
/obj/machinery/door/airlock/security{
	name = "Armory";
	req_access_txt = "1"
	},
/turf/open/floor/plasteel/tech,
/area/ship/security/armory)
"UD" = (
/turf/closed/wall/mineral/plastitanium,
/area/ship/maintenance/port)
"Vz" = (
/obj/effect/spawner/structure/window/plasma/reinforced/plastitanium,
/turf/open/floor/plating,
/area/ship/crew)
"Wf" = (
/obj/effect/spawner/structure/window/plasma/reinforced/plastitanium,
/turf/open/floor/plating,
/area/ship/security)
"Wg" = (
/obj/structure/sign/warning/vacuum/external,
/turf/closed/wall/mineral/plastitanium/nodiagonal,
/area/ship/cargo/starboard)
"WR" = (
/turf/open/floor/carpet/orange,
/area/ship/bridge)
"Xb" = (
/obj/effect/turf_decal/industrial/warning/fulltile,
/obj/machinery/door/airlock/hatch,
/turf/open/floor/plasteel/tech,
/area/ship/maintenance/starboard)
"XB" = (
/obj/effect/turf_decal/industrial/warning/fulltile,
/obj/machinery/door/airlock/maintenance_hatch,
/turf/open/floor/plating/airless,
/area/ship/maintenance/port)
"XW" = (
/obj/machinery/door/airlock/hatch,
/obj/effect/turf_decal/industrial/warning/fulltile,
/turf/open/floor/plasteel/tech,
/area/ship/maintenance/starboard)
"Yp" = (
/obj/effect/spawner/structure/window/plasma/reinforced,
/turf/open/floor/plating,
/area/ship/engineering/atmospherics)
"ZL" = (
/obj/effect/turf_decal/industrial/warning/fulltile,
/obj/machinery/door/airlock/maintenance_hatch,
/turf/open/floor/plating/airless,
/area/ship/maintenance/starboard)

(1,1,1) = {"
sw
sw
sw
sw
sw
sw
tA
OF
gE
ll
ll
ll
OF
tA
sw
sw
sw
sw
vE
pU
uY
uY
uY
ze
pU
vE
sw
sw
sw
sw
sw
sw
"}
(2,1,1) = {"
sw
sw
sw
sw
sw
sw
OF
OF
So
uC
uC
uC
OF
OF
sw
sw
sw
sw
pU
pU
iM
iM
iM
ej
pU
pU
sw
sw
sw
rI
sw
sw
"}
(3,1,1) = {"
sw
sw
sw
sw
sw
sw
OF
za
za
KI
KI
KI
za
OF
fA
fA
pU
pU
pU
aH
pm
pm
pm
aH
aH
pU
sw
sw
sw
MV
sw
sw
"}
(4,1,1) = {"
sw
sw
sw
sw
sw
tA
OF
Gs
Gs
Gs
Gs
Gs
Gs
OF
Je
Je
Yp
id
id
id
id
id
id
id
id
pU
vE
sw
sw
MV
sw
sw
"}
(5,1,1) = {"
sw
cV
sV
sV
sV
sV
sV
sV
Gs
Gs
Gs
Gs
Gs
OF
Je
Je
Yp
id
id
id
id
id
id
id
ao
ao
ao
ao
ao
ao
vp
sw
"}
(6,1,1) = {"
cV
sV
Ok
Ok
Ok
Ok
Ok
sV
Gs
Gs
Gs
Gs
Gs
OF
Je
Je
Yp
id
id
id
id
id
id
id
ao
Oi
Oi
Oi
Oi
Oi
ao
vp
"}
(7,1,1) = {"
sV
Ok
Ok
Ok
Ok
Ok
Ok
sV
Gs
Gs
Gs
Gs
Gs
pU
pU
pU
pU
id
id
id
id
id
id
id
ao
Oi
Oi
Oi
Oi
Oi
Oi
ao
"}
(8,1,1) = {"
sV
Ok
Ok
Ok
Ok
Ok
Ok
CP
Gs
Gs
Gs
Gs
Gs
cA
id
id
id
id
id
id
id
id
id
id
pX
Oi
Oi
Oi
Oi
Oi
Oi
ao
"}
(9,1,1) = {"
sV
Ok
Ok
Ok
Ok
Ok
Ok
sV
Gs
Gs
Gs
Gs
Gs
pU
id
id
id
id
id
id
id
id
id
id
QD
Oi
Oi
Oi
Oi
Oi
Oi
ao
"}
(10,1,1) = {"
cV
sV
Ok
Ok
Ok
Ok
Ok
sV
Gs
Gs
Gs
Gs
Gs
xI
xI
xI
xI
xI
xI
xI
xI
xI
id
id
ao
Oi
Oi
Oi
Oi
Oi
ao
hp
"}
(11,1,1) = {"
sw
cV
sV
sV
Ok
Ok
Ok
sV
Gs
Gs
Gs
Gs
Gs
xI
kD
kD
kD
kD
kD
kD
kD
xI
id
id
ao
Oi
Oi
Oi
ao
ao
vp
MV
"}
(12,1,1) = {"
sw
sw
sw
cV
sV
sV
sV
sV
OF
OF
OF
OF
ft
xI
kD
kD
kD
kD
kD
kD
kD
xI
pU
pU
ao
ao
ao
ao
vp
MV
sw
MV
"}
(13,1,1) = {"
sw
sw
sw
sw
Bv
nl
nl
nl
nl
nl
Bv
mi
mi
xI
kD
kD
kD
kD
kD
kD
kD
xI
ne
ne
ne
ne
la
sw
sw
MV
sw
MV
"}
(14,1,1) = {"
sw
sw
sw
JT
Bv
nl
nl
nl
nl
nl
Bv
mi
mi
xI
kD
kD
kD
kD
kD
kD
kD
xI
ne
ne
ne
ne
la
sw
sw
MV
sw
rI
"}
(15,1,1) = {"
sw
sw
sw
Vz
nl
nl
nl
nl
nl
nl
Bv
mi
mi
xI
kD
kD
kD
kD
kD
kD
kD
xI
ne
ne
hT
hT
hT
hT
sw
MV
sw
sw
"}
(16,1,1) = {"
sw
sw
sw
Vz
nl
nl
nl
nl
nl
nl
Bv
mi
mi
xI
kD
kD
kD
kD
kD
kD
kD
xI
ne
ne
hT
ot
ot
hT
sw
rI
sw
sw
"}
(17,1,1) = {"
sw
sw
sw
Bv
nl
nl
nl
nl
nl
nl
Bv
mi
mi
xI
xI
xI
xI
KK
xI
xI
xI
xI
AS
la
hT
Fe
Fe
zw
sw
sw
sw
sw
"}
(18,1,1) = {"
sw
sw
sw
Vz
nl
nl
nl
nl
nl
nl
KY
mi
mi
mi
mi
mi
mi
mi
mi
mi
mi
mi
mi
mi
zw
Fe
Fe
hT
sw
sw
sw
sw
"}
(19,1,1) = {"
sw
sw
sw
Vz
nl
nl
nl
nl
nl
nl
Bv
mi
mi
mi
mi
mi
mi
mi
mi
mi
mi
mi
mi
mi
ce
ot
ot
hT
sw
sw
sw
sw
"}
(20,1,1) = {"
sw
sw
sw
JT
Bv
nl
nl
nl
mX
mX
mX
mX
mX
CF
CF
LN
LN
CF
CF
hT
mi
mi
hT
hT
hT
hT
hT
hT
sw
sw
sw
sw
"}
(21,1,1) = {"
sw
sw
sw
sw
JT
Bv
Ne
Bv
mX
no
qM
qM
mX
Mh
Ic
xf
fh
Mh
Ic
hT
mi
mi
Hq
ug
ug
ug
Hq
sw
sw
sw
sw
sw
"}
(22,1,1) = {"
sw
sw
sw
sw
sw
lC
Jz
Jz
mX
WR
WR
WR
Lc
Ah
Tq
xf
fh
Ah
Tq
hT
mi
mi
Hq
ug
ug
ug
Hq
sw
sw
sw
sw
sw
"}
(23,1,1) = {"
sw
sw
sw
sw
sw
lC
Jz
Jz
mw
WR
zh
WR
Lc
Mh
Ic
xf
fh
Mh
Ic
hT
mi
mi
Hq
ug
ug
ug
Hq
sw
sw
sw
sw
sw
"}
(24,1,1) = {"
sw
sw
sw
sw
sw
lC
Jz
Jz
mX
WR
WR
WR
mX
oi
Oc
xf
fh
Oc
Oc
hT
mi
mi
Hq
ug
ug
ug
Hq
sw
sw
sw
sw
sw
"}
(25,1,1) = {"
sw
sw
sw
sw
sw
lC
Jz
Jz
mX
ON
qM
qM
Lc
Ah
Tq
xf
fh
Ah
Tq
hT
mi
mi
Hq
ug
ug
ug
Hq
sw
sw
sw
sw
sw
"}
(26,1,1) = {"
sw
sw
sw
sw
sw
lC
Jz
Jz
mX
gB
dE
qM
Lc
Mh
Ic
xf
fh
Mh
Ic
hT
mi
mi
Hq
ug
ug
ug
Hq
sw
sw
sw
sw
sw
"}
(27,1,1) = {"
sw
sw
sw
sw
sw
lC
Jz
Jz
mX
ok
tn
AV
mX
Ah
Tq
xf
fh
Ah
Tq
hT
mi
mi
Hq
ug
ug
ug
Hq
sw
sw
sw
sw
sw
"}
(28,1,1) = {"
sw
sw
sw
lC
lC
lC
Jz
Jz
mX
mX
mX
mX
mX
CF
rt
rt
rt
rt
CF
hT
mi
mi
Hq
Hq
UC
Hq
Hq
mK
mK
sw
sw
sw
"}
(29,1,1) = {"
sw
sw
sw
zE
Jz
Jz
Jz
Jz
sW
Tb
eu
eu
sW
sw
sw
sw
sw
sw
sw
hT
mi
mi
mK
lw
lw
lw
lw
lw
Wf
sw
sw
sw
"}
(30,1,1) = {"
sw
sw
sw
lC
Jz
Jz
Jz
Jz
sW
Tb
CK
cC
sW
sw
sw
sw
sw
sw
sw
hT
mi
mi
mK
lw
lw
lw
lw
lw
mK
sw
sw
sw
"}
(31,1,1) = {"
sw
sw
sw
zE
Jz
Jz
Jz
Jz
ID
FL
jP
jx
sW
sw
sw
sw
sw
sw
sw
hT
mi
mi
DQ
lw
lw
lw
lw
lw
Wf
sw
sw
sw
"}
(32,1,1) = {"
sw
sw
sw
lC
Jz
Jz
Jz
Jz
sW
Tb
dk
Rr
sW
sw
sw
sw
sw
sw
sw
hT
mi
mi
mK
lw
lw
lw
lw
lw
mK
sw
sw
sw
"}
(33,1,1) = {"
sw
sw
sw
fC
yp
jj
tL
yp
sW
Tb
Cy
Cy
sW
sw
sw
sw
sw
sw
sw
uI
si
XW
uI
lw
lw
lw
lw
mK
Bq
sw
sw
sw
"}
(34,1,1) = {"
sw
sw
sw
sw
yp
Bz
lM
yp
yp
yp
yp
yp
yp
sw
sw
sw
sw
sw
sw
uI
Gu
Uq
uI
uI
uI
uI
uI
uI
sw
sw
sw
sw
"}
(35,1,1) = {"
sw
sw
sw
sw
yp
Bz
lM
yp
RT
RT
RT
RT
yp
sw
sw
sw
sw
sw
sw
uI
Gu
Uq
uI
rw
rw
rw
rw
uI
sw
sw
sw
sw
"}
(36,1,1) = {"
sw
sw
sw
sw
yp
yp
Kx
yp
RT
RT
RT
RT
yp
sw
sw
sw
sw
sw
sw
uI
uI
Xb
uI
rw
rw
rw
rw
uI
sw
sw
sw
sw
"}
(37,1,1) = {"
sw
sw
sw
sw
yp
RT
RT
RT
RT
RT
RT
RT
yp
sw
sw
sw
sw
sw
sw
uI
rw
rw
rw
rw
rw
rw
rw
uI
sw
sw
sw
sw
"}
(38,1,1) = {"
sw
sw
sw
sw
yp
RT
RT
RT
RT
RT
RT
RT
yp
sw
sw
sw
sw
sw
sw
uI
rw
rw
rw
rw
rw
rw
rw
uI
sw
sw
sw
sw
"}
(39,1,1) = {"
sw
sw
sw
sw
UD
yp
yp
yp
XB
yp
yp
yp
yp
sw
sw
sw
sw
sw
sw
uI
uI
uI
uI
ZL
uI
uI
uI
DO
sw
sw
sw
sw
"}
(40,1,1) = {"
sw
sw
sw
sw
sw
yp
RT
RT
RT
RT
RT
RT
yp
sw
sw
sw
sw
sw
sw
uI
rw
rw
rw
rw
rw
rw
uI
sw
sw
sw
sw
sw
"}
(41,1,1) = {"
sw
sw
sw
sw
sw
yp
RT
RT
RT
RT
RT
RT
yp
sw
sw
sw
sw
sw
sw
uI
rw
rw
rw
rw
rw
rw
uI
sw
sw
sw
sw
sw
"}
(42,1,1) = {"
sw
sw
sw
sw
sw
yp
RT
RT
RT
RT
RT
RT
yp
sw
sw
sw
sw
sw
sw
uI
rw
rw
rw
rw
rw
rw
uI
sw
sw
sw
sw
sw
"}
(43,1,1) = {"
sw
sw
sw
sw
sw
Pp
Pp
Pp
Pp
js
Pp
Pp
Pp
sw
sw
sw
sw
sw
sw
fK
fK
fK
eV
fK
fK
fK
fK
sw
sw
sw
sw
sw
"}
(44,1,1) = {"
sw
sw
sw
sw
sw
Pp
IF
IF
IF
IF
IF
IF
Pp
sw
sw
sw
sw
sw
sw
fK
Jk
Jk
Jk
Jk
Jk
Jk
fK
sw
sw
sw
sw
sw
"}
(45,1,1) = {"
sw
sw
sw
sw
sw
Pp
IF
IF
IF
IF
IF
IF
Pp
sw
sw
sw
sw
sw
sw
fK
Jk
Jk
Jk
Jk
Jk
Jk
fK
sw
sw
sw
sw
sw
"}
(46,1,1) = {"
sw
sw
sw
sw
sw
Pp
IF
IF
IF
IF
IF
IF
Pp
sw
sw
sw
sw
sw
sw
fK
Jk
Jk
Jk
Jk
Jk
Jk
fK
sw
sw
sw
sw
sw
"}
(47,1,1) = {"
sw
sw
sw
sw
sw
Ap
Pp
Pp
js
Pp
Pp
Pp
Pp
sw
sw
sw
sw
sw
sw
fK
fK
fK
fK
eV
fK
fK
sy
sw
sw
sw
sw
sw
"}
(48,1,1) = {"
sw
sw
sw
sw
sw
sw
Pp
IF
IF
IF
IF
IF
Pp
sw
sw
sw
sw
sw
sw
fK
Jk
Jk
Jk
Jk
Jk
fK
sw
sw
sw
sw
sw
sw
"}
(49,1,1) = {"
sw
sw
sw
sw
sw
sw
Pp
IF
IF
IF
cL
IF
Pp
sw
sw
sw
sw
sw
sw
fK
Jk
Jk
Jk
Jk
Jk
fK
sw
sw
sw
sw
sw
sw
"}
(50,1,1) = {"
sw
sw
sw
sw
sw
sw
Pp
IF
IF
IF
IF
IF
Pp
sw
sw
sw
sw
sw
sw
fK
Jk
Jk
Jk
Jk
Jk
fK
sw
sw
sw
sw
sw
sw
"}
(51,1,1) = {"
sw
sw
sw
sw
sw
sw
Ap
Pp
IF
IF
IF
Pp
Ap
sw
sw
sw
sw
sw
sw
sy
fK
Jk
Jk
Jk
fK
sy
sw
sw
sw
sw
sw
sw
"}
(52,1,1) = {"
sw
sw
sw
sw
sw
sw
sw
Pp
IF
IF
Pp
Ap
sw
sw
sw
sw
sw
sw
sw
sw
sy
fK
Jk
Jk
fK
sw
sw
sw
sw
sw
sw
sw
"}
(53,1,1) = {"
sw
sw
sw
sw
sw
sw
sw
Ap
od
jm
Pp
sw
sw
sw
sw
sw
sw
sw
sw
sw
sw
fK
fQ
Wg
sy
sw
sw
sw
sw
sw
sw
sw
"}
