//MAP CONVERTED BY dmm2tgm.py THIS HEADER COMMENT PREVENTS RECONVERSION, DO NOT REMOVE
"aa" = (
/obj/machinery/button/door{
	id = "tidedoors";
	name = "Blast Door Control";
	pixel_y = -24
	},
/obj/machinery/suit_storage_unit/mining/eva,
/turf/open/floor/plating,
/area/ship/cargo)
"ad" = (
/obj/effect/decal/cleanable/oil/streak,
/obj/item/trash/boritos,
/obj/effect/decal/cleanable/dirt/dust,
/obj/effect/decal/cleanable/glass,
/obj/machinery/airalarm/directional/east,
/obj/machinery/atmospherics/components/unary/vent_scrubber/on/layer2{
	dir = 1
	},
/obj/effect/landmark/start/assistant,
/turf/open/floor/plating,
/area/ship/maintenance/port)
"aq" = (
/obj/effect/landmark/start/assistant,
/obj/effect/decal/cleanable/glass,
/turf/open/floor/plating,
/area/ship/maintenance/aft)
"as" = (
/obj/machinery/power/apc/auto_name/north,
/obj/structure/cable{
	icon_state = "0-4"
	},
/obj/machinery/atmospherics/pipe/simple/scrubbers/hidden/layer2{
	dir = 6
	},
/turf/open/floor/plating,
/area/ship/maintenance/port)
"aF" = (
/obj/structure/cable{
	icon_state = "4-8"
	},
/obj/machinery/door/airlock/maintenance_hatch,
/obj/machinery/atmospherics/pipe/simple/scrubbers/hidden/layer2{
	dir = 4
	},
/turf/open/floor/plating,
/area/ship/maintenance/aft)
"be" = (
/turf/closed/wall/rust,
/area/ship/maintenance/aft)
"bw" = (
/obj/machinery/door/window/northright,
/obj/structure/cable{
	icon_state = "0-2"
	},
/obj/machinery/power/smes/shuttle/precharged{
	dir = 1
	},
/obj/structure/window,
/turf/open/floor/plating,
/area/ship/maintenance/central)
"ch" = (
/obj/structure/fans/tiny,
/obj/machinery/door/airlock/maintenance_hatch,
/obj/docking_port/mobile{
	dir = 4;
	launch_status = 0;
	port_direction = 8
	},
/turf/open/floor/plating,
/area/ship/maintenance/aft)
"dx" = (
/obj/machinery/power/apc/auto_name/south,
/obj/structure/cable{
	icon_state = "0-8"
	},
/obj/effect/decal/cleanable/dirt/dust,
/obj/effect/decal/cleanable/blood/gibs/limb,
/obj/machinery/light,
/obj/machinery/airalarm/directional/east,
/obj/machinery/atmospherics/components/unary/vent_scrubber/on/layer2{
	dir = 8
	},
/obj/item/cigbutt/cigarbutt,
/obj/effect/decal/cleanable/ash,
/turf/open/floor/plating,
/area/ship/maintenance/fore)
"dR" = (
/obj/effect/landmark/start/assistant,
/mob/living/simple_animal/hostile/cockroach,
/turf/open/floor/plating,
/area/ship/maintenance/port)
"dT" = (
/obj/structure/cable{
	icon_state = "1-2"
	},
/obj/structure/cable{
	icon_state = "2-4"
	},
/obj/effect/decal/cleanable/dirt/dust,
/obj/machinery/atmospherics/pipe/manifold/scrubbers/hidden/layer2{
	dir = 8
	},
/turf/open/floor/plating,
/area/ship/maintenance/central)
"ei" = (
/turf/open/floor/plating,
/area/ship/maintenance/starboard)
"el" = (
/obj/machinery/power/apc/auto_name/east,
/obj/structure/cable,
/obj/structure/cable{
	icon_state = "1-2"
	},
/obj/structure/cable{
	icon_state = "1-8"
	},
/obj/effect/decal/cleanable/insectguts,
/obj/machinery/atmospherics/pipe/simple/scrubbers/hidden/layer2,
/turf/open/floor/plating,
/area/ship/maintenance/central)
"fU" = (
/obj/machinery/power/terminal{
	dir = 4
	},
/obj/structure/cable/yellow{
	icon_state = "0-8"
	},
/obj/effect/spawner/lootdrop/grille_or_trash,
/turf/open/floor/plating,
/area/ship/maintenance/starboard)
"gS" = (
/obj/effect/decal/cleanable/oil/streak,
/obj/machinery/airalarm/directional/east,
/obj/machinery/atmospherics/components/unary/vent_scrubber/on/layer2{
	dir = 1
	},
/turf/open/floor/plating,
/area/ship/maintenance/aft)
"hf" = (
/obj/effect/decal/cleanable/glass,
/obj/machinery/portable_atmospherics/canister/oxygen,
/turf/open/floor/plating,
/area/ship/maintenance/starboard)
"ho" = (
/obj/machinery/computer/helm,
/turf/open/floor/plating,
/area/ship/maintenance/fore)
"hq" = (
/obj/machinery/power/shuttle/engine/electric{
	dir = 1
	},
/obj/structure/cable,
/turf/open/floor/plating,
/area/ship/external)
"hy" = (
/obj/machinery/power/apc/auto_name/north,
/obj/structure/cable{
	icon_state = "0-4"
	},
/obj/effect/decal/cleanable/oil,
/obj/structure/frame/machine,
/obj/effect/decal/cleanable/glass,
/turf/open/floor/plating,
/area/ship/maintenance/aft)
"hI" = (
/obj/effect/decal/cleanable/oil/streak,
/obj/effect/decal/cleanable/cobweb/cobweb2,
/obj/effect/decal/cleanable/glass,
/obj/item/pipe_dispenser,
/obj/item/construction/rcd,
/obj/item/trash/syndi_cakes,
/obj/machinery/airalarm/directional/north,
/obj/effect/spawner/lootdrop/maintenance/eight,
/obj/item/reagent_containers/food/snacks/canned/peaches/maint,
/obj/structure/closet/secure_closet/engineering_personal,
/mob/living/simple_animal/hostile/cockroach/glockroach,
/turf/open/floor/plating,
/area/ship/maintenance/starboard)
"jc" = (
/obj/machinery/computer/autopilot,
/turf/open/floor/plating,
/area/ship/maintenance/fore)
"jZ" = (
/obj/effect/landmark/start/assistant,
/obj/effect/decal/cleanable/dirt,
/turf/open/floor/plating,
/area/ship/cargo)
"kh" = (
/obj/structure/table,
/obj/item/trash/cheesie,
/obj/item/reagent_containers/food/snacks/kebab/rat{
	pixel_y = -6
	},
/obj/item/reagent_containers/food/snacks/kebab/rat/double{
	pixel_x = 2;
	pixel_y = 6
	},
/obj/item/reagent_containers/food/snacks/burger/rat,
/obj/item/cigbutt,
/turf/open/floor/plating,
/area/ship/maintenance/port)
"kF" = (
/obj/effect/spawner/lootdrop/maintenance/four,
/obj/structure/light_construct/small{
	dir = 8
	},
/obj/machinery/power/terminal,
/obj/structure/cable{
	icon_state = "0-4"
	},
/mob/living/simple_animal/hostile/cockroach/glockroach,
/turf/open/floor/plating,
/area/ship/maintenance/central)
"kT" = (
/obj/structure/cable{
	icon_state = "4-8"
	},
/obj/machinery/door/airlock/engineering{
	req_access = list(11)
	},
/obj/machinery/atmospherics/pipe/simple/scrubbers/hidden/layer2{
	dir = 4
	},
/turf/open/floor/plating,
/area/ship/maintenance/starboard)
"kV" = (
/obj/machinery/autolathe/hacked,
/obj/machinery/light/broken,
/turf/open/floor/plating,
/area/ship/maintenance/aft)
"li" = (
/obj/structure/cable{
	icon_state = "1-2"
	},
/obj/effect/decal/cleanable/blood/footprints,
/obj/machinery/light/broken{
	dir = 4
	},
/obj/machinery/atmospherics/pipe/simple/scrubbers/hidden/layer2,
/turf/open/floor/plating,
/area/ship/maintenance/central)
"ll" = (
/obj/structure/cable{
	icon_state = "4-8"
	},
/obj/machinery/door/airlock/maintenance_hatch,
/turf/open/floor/plating,
/area/ship/maintenance/central)
"lz" = (
/obj/machinery/atmospherics/pipe/simple/scrubbers/hidden/layer2{
	dir = 6
	},
/turf/closed/wall/rust,
/area/ship/maintenance/central)
"lR" = (
/obj/structure/cable{
	icon_state = "4-8"
	},
/obj/machinery/door/airlock/maintenance_hatch,
/obj/machinery/atmospherics/pipe/simple/scrubbers/hidden/layer2{
	dir = 4
	},
/turf/open/floor/plating,
/area/ship/maintenance/starboard)
"mw" = (
/obj/structure/cable{
	icon_state = "1-2"
	},
/obj/effect/spawner/lootdrop/grille_or_trash,
/obj/machinery/atmospherics/pipe/simple/scrubbers/hidden/layer2,
/turf/open/floor/plating,
/area/ship/maintenance/central)
"mB" = (
/obj/structure/table/optable,
/obj/effect/decal/cleanable/blood/old,
/turf/open/floor/plating,
/area/ship/maintenance/starboard)
"mH" = (
/obj/effect/decal/cleanable/greenglow,
/turf/open/floor/plating,
/area/ship/maintenance/starboard)
"ng" = (
/obj/machinery/door/window/northright,
/obj/structure/window,
/obj/effect/decal/cleanable/glass,
/obj/machinery/atmospherics/components/unary/shuttle/heater{
	dir = 1
	},
/turf/open/floor/plating,
/area/ship/maintenance/central)
"nn" = (
/turf/closed/wall,
/area/ship/maintenance/starboard)
"nA" = (
/obj/structure/cable{
	icon_state = "1-8"
	},
/obj/effect/decal/cleanable/oil,
/obj/machinery/atmospherics/pipe/simple/scrubbers/hidden/layer2{
	dir = 9
	},
/obj/item/shard{
	pixel_x = -6;
	pixel_y = 4
	},
/obj/item/wirerod{
	pixel_y = -4
	},
/turf/open/floor/plating,
/area/ship/maintenance/starboard)
"nX" = (
/obj/structure/cable{
	icon_state = "1-2"
	},
/obj/structure/cable{
	icon_state = "1-8"
	},
/obj/effect/decal/cleanable/oil,
/obj/machinery/atmospherics/pipe/manifold/scrubbers/hidden/layer2{
	dir = 4
	},
/obj/effect/decal/cleanable/glass,
/turf/open/floor/plating,
/area/ship/maintenance/central)
"rg" = (
/obj/machinery/power/apc/auto_name/north,
/obj/structure/cable{
	icon_state = "0-2"
	},
/obj/effect/decal/cleanable/cobweb,
/obj/effect/decal/cleanable/robot_debris,
/obj/structure/light_construct{
	dir = 1
	},
/obj/effect/decal/cleanable/dirt,
/obj/item/cigbutt,
/turf/open/floor/plating,
/area/ship/cargo)
"rD" = (
/obj/structure/cable{
	icon_state = "2-8"
	},
/obj/item/storage/firstaid/fire,
/obj/effect/decal/cleanable/dirt,
/obj/structure/light_construct{
	dir = 1
	},
/obj/machinery/atmospherics/pipe/simple/scrubbers/hidden/layer2{
	dir = 10
	},
/obj/effect/landmark/start/assistant,
/turf/open/floor/plating,
/area/ship/maintenance/starboard)
"rH" = (
/obj/effect/decal/cleanable/cobweb,
/obj/effect/decal/cleanable/generic,
/turf/open/floor/plating,
/area/ship/maintenance/aft)
"rW" = (
/turf/closed/wall,
/area/ship/maintenance/aft)
"sn" = (
/turf/closed/wall/rust,
/area/ship/maintenance/starboard)
"sF" = (
/obj/structure/cable{
	icon_state = "1-8"
	},
/obj/effect/decal/cleanable/oil/streak,
/obj/item/trash/can/food/beans,
/obj/machinery/atmospherics/pipe/simple/scrubbers/hidden/layer2{
	dir = 9
	},
/obj/effect/decal/cleanable/glass,
/turf/open/floor/plating,
/area/ship/cargo)
"tt" = (
/obj/effect/decal/cleanable/dirt,
/obj/machinery/cryopod/latejoin,
/turf/open/floor/plating,
/area/ship/maintenance/port)
"tN" = (
/turf/closed/wall,
/area/ship/maintenance/central)
"uw" = (
/obj/item/storage/backpack/duffelbag/med/surgery,
/obj/structure/closet/secure_closet/medical2,
/obj/effect/decal/cleanable/dirt,
/obj/machinery/light/broken,
/obj/item/defibrillator/loaded,
/obj/effect/spawner/lootdrop/maintenance/eight,
/turf/open/floor/plating,
/area/ship/maintenance/starboard)
"wh" = (
/obj/structure/window/fulltile,
/obj/structure/grille,
/turf/open/floor/plating,
/area/ship/maintenance/port)
"xg" = (
/turf/template_noop,
/area/space)
"xS" = (
/obj/machinery/suit_storage_unit/mining/eva,
/turf/open/floor/plating,
/area/ship/cargo)
"yJ" = (
/obj/effect/decal/cleanable/dirt/dust,
/turf/open/floor/plating,
/area/ship/cargo)
"yY" = (
/obj/machinery/atmospherics/components/unary/tank/toxins,
/obj/effect/decal/cleanable/cobweb,
/obj/effect/decal/cleanable/cobweb/cobweb2,
/obj/effect/decal/cleanable/glass,
/turf/open/floor/plating,
/area/ship/maintenance/central)
"zl" = (
/turf/closed/wall/rust,
/area/ship/maintenance/port)
"AN" = (
/obj/structure/cable{
	icon_state = "1-2"
	},
/obj/effect/decal/cleanable/dirt,
/obj/machinery/airalarm/directional/east,
/obj/machinery/atmospherics/pipe/simple/scrubbers/hidden/layer2,
/obj/effect/decal/cleanable/glass,
/turf/open/floor/plating,
/area/ship/maintenance/central)
"AT" = (
/obj/structure/cable{
	icon_state = "2-4"
	},
/obj/item/storage/toolbox/mechanical/old,
/obj/effect/decal/cleanable/blood/old,
/obj/effect/decal/cleanable/blood/drip,
/obj/effect/decal/cleanable/blood/footprints,
/obj/effect/decal/cleanable/blood/gibs/down,
/obj/effect/decal/cleanable/blood/gibs/limb,
/obj/machinery/atmospherics/pipe/simple/scrubbers/hidden/layer2{
	dir = 6
	},
/obj/item/areaeditor/shuttle,
/obj/machinery/holopad/emergency/command,
/turf/open/floor/plating,
/area/ship/maintenance/fore)
"Bg" = (
/obj/effect/turf_decal{
	dir = 4
	},
/obj/effect/decal/cleanable/glass,
/turf/open/floor/plating,
/area/ship/external)
"Bx" = (
/obj/machinery/mineral/ore_redemption,
/turf/open/floor/plating,
/area/ship/cargo)
"Cs" = (
/turf/closed/wall/rust,
/area/ship/cargo)
"CM" = (
)
"CZ" = (
/obj/machinery/light{
	dir = 1
	},
/obj/machinery/power/apc/auto_name/north,
/obj/structure/cable{
	icon_state = "0-2"
	},
/obj/structure/tank_dispenser/oxygen,
/turf/open/floor/plating,
/area/ship/maintenance/starboard)
"Da" = (
/obj/machinery/door/window/northright,
/obj/machinery/power/smes/shuttle/precharged{
	dir = 1
	},
/obj/structure/window,
/obj/structure/cable{
	icon_state = "0-2"
	},
/turf/open/floor/plating,
/area/ship/maintenance/central)
"Dj" = (
/obj/structure/cable{
	icon_state = "1-2"
	},
/obj/effect/decal/cleanable/dirt/dust,
/obj/machinery/airalarm/directional/west,
/obj/machinery/atmospherics/components/unary/vent_scrubber/on/layer2,
/turf/open/floor/plating,
/area/ship/cargo)
"Fu" = (
/obj/structure/cable{
	icon_state = "1-2"
	},
/obj/structure/cable{
	icon_state = "1-8"
	},
/obj/effect/decal/cleanable/oil/slippery,
/obj/effect/decal/cleanable/blood/footprints,
/obj/effect/decal/cleanable/blood/tracks,
/obj/machinery/atmospherics/pipe/manifold/scrubbers/hidden/layer2{
	dir = 4
	},
/obj/item/trash/semki,
/turf/open/floor/plating,
/area/ship/maintenance/central)
"FE" = (
/obj/effect/decal/cleanable/dirt,
/obj/machinery/light/broken,
/obj/item/bedsheet/random,
/obj/structure/bed,
/obj/structure/curtain/bounty,
/turf/open/floor/plating,
/area/ship/maintenance/port)
"FJ" = (
/turf/closed/wall,
/area/ship/cargo)
"FM" = (
/obj/effect/decal/cleanable/oil,
/obj/effect/decal/cleanable/oil/streak,
/obj/effect/decal/cleanable/dirt,
/obj/effect/decal/cleanable/glass,
/mob/living/simple_animal/hostile/cockroach,
/obj/structure/cable{
	icon_state = "4-8"
	},
/obj/machinery/atmospherics/components/binary/pump{
	name = "engine fuel pump"
	},
/turf/open/floor/plating,
/area/ship/maintenance/central)
"FR" = (
/obj/effect/decal/cleanable/oil,
/turf/open/floor/plating,
/area/ship/cargo)
"Gh" = (
/obj/effect/turf_decal{
	dir = 8
	},
/obj/effect/turf_decal,
/obj/machinery/atmospherics/components/unary/outlet_injector/on/layer2{
	dir = 1
	},
/turf/open/floor/plating,
/area/ship/maintenance/central)
"GE" = (
/obj/structure/window/fulltile,
/obj/structure/grille,
/turf/open/floor/plating,
/area/ship/maintenance/fore)
"GN" = (
/turf/closed/wall/rust,
/area/ship/maintenance/central)
"Hz" = (
/obj/item/pickaxe/emergency,
/obj/structure/closet/crate,
/obj/item/storage/bag/ore,
/obj/item/mining_scanner,
/obj/item/shovel/spoon,
/obj/machinery/light,
/obj/item/shovel/spoon,
/obj/item/mining_scanner,
/obj/item/storage/bag/ore,
/obj/item/pickaxe/emergency,
/obj/effect/spawner/lootdrop/maintenance/eight,
/turf/open/floor/plating,
/area/ship/cargo)
"HH" = (
/obj/structure/cable{
	icon_state = "1-4"
	},
/obj/effect/decal/cleanable/dirt,
/obj/effect/decal/cleanable/glass,
/obj/effect/spawner/lootdrop/grille_or_trash,
/obj/structure/cable,
/turf/open/floor/plating,
/area/ship/maintenance/starboard)
"HU" = (
/obj/machinery/power/port_gen/pacman,
/obj/item/stack/sheet/mineral/plasma/twenty,
/obj/structure/cable/yellow{
	icon_state = "0-4"
	},
/turf/open/floor/plating,
/area/ship/maintenance/starboard)
"Ig" = (
/obj/structure/cable{
	icon_state = "1-4"
	},
/obj/item/screwdriver/old,
/obj/item/multitool/old,
/obj/item/crowbar/old,
/obj/machinery/atmospherics/pipe/simple/scrubbers/hidden/layer2{
	dir = 5
	},
/obj/item/clothing/gloves/color/fyellow,
/turf/open/floor/plating,
/area/ship/maintenance/starboard)
"IV" = (
/obj/structure/falsewall,
/turf/open/floor/plating,
/area/ship/maintenance/starboard)
"IY" = (
/obj/effect/spawner/lootdrop/maintenance,
/obj/structure/closet/crate,
/obj/effect/decal/cleanable/glass,
/obj/item/storage/toolbox/mechanical/old,
/obj/item/reagent_containers/food/snacks/canned/beans,
/turf/open/floor/plating,
/area/ship/maintenance/aft)
"Jd" = (
/obj/structure/cable{
	icon_state = "4-8"
	},
/obj/effect/decal/cleanable/oil,
/obj/effect/spawner/lootdrop/grille_or_trash,
/obj/machinery/atmospherics/components/unary/vent_scrubber/on/layer2{
	dir = 8
	},
/obj/machinery/power/terminal,
/obj/structure/cable{
	icon_state = "0-8"
	},
/obj/item/cigbutt,
/turf/open/floor/plating,
/area/ship/maintenance/central)
"KY" = (
/obj/structure/fans/tiny,
/obj/machinery/door/poddoor{
	id = "tidedoors";
	name = "cargo bay blast door"
	},
/turf/open/floor/plating,
/area/ship/cargo)
"LI" = (
/obj/machinery/ore_silo,
/obj/effect/decal/cleanable/dirt,
/turf/open/floor/plating,
/area/ship/cargo)
"LX" = (
/obj/structure/fans/tiny,
/obj/machinery/door/poddoor{
	id = "tidedoors";
	name = "cargo bay blast door"
	},
/obj/effect/decal/cleanable/glass,
/turf/open/floor/plating,
/area/ship/cargo)
"Mw" = (
/obj/structure/cable{
	icon_state = "4-8"
	},
/obj/machinery/door/airlock/maintenance_hatch,
/obj/machinery/atmospherics/pipe/simple/scrubbers/hidden/layer2{
	dir = 4
	},
/turf/open/floor/plating,
/area/ship/maintenance/port)
"Nt" = (
/obj/structure/cable{
	icon_state = "4-8"
	},
/obj/effect/decal/cleanable/dirt,
/obj/structure/light_construct{
	dir = 1
	},
/obj/machinery/atmospherics/pipe/simple/scrubbers/hidden/layer2{
	dir = 6
	},
/turf/open/floor/plating,
/area/ship/maintenance/aft)
"Nz" = (
/obj/structure/cable{
	icon_state = "0-2"
	},
/obj/item/reagent_containers/food/snacks/deadmouse{
	pixel_y = 14
	},
/obj/item/stack/cable_coil/cut/red,
/obj/machinery/atmospherics/pipe/simple/scrubbers/hidden/layer2,
/obj/effect/decal/cleanable/ash,
/turf/open/floor/plating,
/area/ship/maintenance/starboard)
"NP" = (
/obj/effect/decal/cleanable/dirt,
/obj/effect/decal/cleanable/glass,
/obj/machinery/power/terminal,
/obj/structure/cable{
	icon_state = "0-8"
	},
/obj/item/trash/tray,
/turf/open/floor/plating,
/area/ship/maintenance/central)
"Of" = (
/obj/structure/frame/computer,
/turf/open/floor/plating,
/area/ship/maintenance/fore)
"Oj" = (
/obj/structure/cable{
	icon_state = "1-2"
	},
/obj/effect/decal/cleanable/dirt/dust,
/obj/machinery/atmospherics/pipe/simple/scrubbers/hidden/layer2,
/obj/item/trash/can/food/peaches/maint,
/turf/open/floor/plating,
/area/ship/maintenance/central)
"OC" = (
/obj/structure/cable{
	icon_state = "0-2"
	},
/obj/machinery/power/smes,
/turf/open/floor/plating,
/area/ship/maintenance/starboard)
"OR" = (
/obj/effect/decal/cleanable/dirt,
/obj/machinery/atmospherics/components/unary/vent_scrubber/on/layer2,
/obj/structure/cable{
	icon_state = "1-2"
	},
/obj/structure/cable{
	icon_state = "2-8"
	},
/mob/living/simple_animal/hostile/cockroach,
/turf/open/floor/plating,
/area/ship/maintenance/starboard)
"Pu" = (
/obj/effect/turf_decal{
	dir = 4
	},
/obj/effect/turf_decal{
	dir = 1
	},
/turf/open/floor/plating,
/area/ship/external)
"Px" = (
/obj/effect/turf_decal{
	dir = 4
	},
/turf/open/floor/plating,
/area/ship/external)
"PN" = (
/obj/structure/chair/comfy/shuttle{
	dir = 1;
	name = "Helm"
	},
/obj/effect/decal/cleanable/blood/splatter,
/obj/machinery/light/broken,
/obj/effect/landmark/start/assistant,
/obj/item/radio/intercom/wideband{
	pixel_x = -26
	},
/turf/open/floor/plating,
/area/ship/maintenance/fore)
"Qc" = (
/obj/structure/fans/tiny,
/obj/machinery/door/poddoor{
	id = "tidedoors";
	name = "cargo bay blast door"
	},
/obj/machinery/door/poddoor{
	id = "tidedoors";
	name = "cargo bay blast door"
	},
/obj/effect/decal/cleanable/glass,
/turf/open/floor/plating,
/area/ship/cargo)
"QF" = (
/turf/closed/wall,
/area/ship/maintenance/port)
"RP" = (
/obj/machinery/atmospherics/pipe/simple/scrubbers/hidden/layer2,
/turf/closed/wall/rust,
/area/ship/maintenance/central)
"RV" = (
/turf/closed/wall,
/area/ship/maintenance/fore)
"Tm" = (
/turf/closed/wall/rust,
/area/ship/maintenance/fore)
"TO" = (
/obj/structure/cable{
	icon_state = "1-2"
	},
/obj/effect/decal/cleanable/dirt/dust,
/obj/machinery/light{
	dir = 4
	},
/obj/machinery/atmospherics/pipe/simple/scrubbers/hidden/layer2,
/turf/open/floor/plating,
/area/ship/maintenance/central)
"VO" = (
/obj/structure/window/fulltile,
/obj/structure/grille,
/turf/open/floor/plating,
/area/ship/maintenance/starboard)
"We" = (
/obj/structure/cable{
	icon_state = "1-4"
	},
/obj/effect/decal/cleanable/oil/streak,
/obj/item/trash/can/food,
/obj/machinery/light/broken,
/obj/machinery/atmospherics/pipe/manifold/scrubbers/hidden/layer2,
/turf/open/floor/plating,
/area/ship/maintenance/central)
"Wi" = (
/obj/structure/cable{
	icon_state = "4-8"
	},
/obj/machinery/door/airlock/maintenance_hatch,
/obj/machinery/atmospherics/pipe/simple/scrubbers/hidden/layer2{
	dir = 4
	},
/turf/open/floor/plating,
/area/ship/cargo)
"XE" = (
/obj/structure/cable{
	icon_state = "1-2"
	},
/obj/machinery/door/airlock/maintenance_hatch,
/obj/effect/decal/cleanable/blood/footprints,
/obj/effect/decal/cleanable/blood/tracks,
/turf/open/floor/plating,
/area/ship/maintenance/fore)
"XN" = (
/obj/structure/cable{
	icon_state = "4-8"
	},
/obj/effect/decal/cleanable/oil/streak,
/obj/item/trash/semki,
/obj/machinery/atmospherics/pipe/simple/scrubbers/hidden/layer2{
	dir = 4
	},
/turf/open/floor/plating,
/area/ship/maintenance/starboard)
"Zr" = (
/obj/effect/spawner/lootdrop/memeorgans,
/obj/structure/closet/crate/freezer,
/obj/item/reagent_containers/blood/AMinus,
/obj/item/reagent_containers/blood/BPlus,
/obj/item/reagent_containers/blood/ethereal,
/obj/item/reagent_containers/blood/random,
/obj/item/organ/ears/cat,
/obj/item/organ/tail/cat,
/turf/open/floor/plating,
/area/ship/maintenance/starboard)
"ZA" = (
/obj/item/storage/box/rndboards{
	desc = "Smells feighntly of plastic.";
	name = "research equipment"
	},
/obj/effect/spawner/lootdrop/maintenance,
/obj/effect/decal/cleanable/dirt,
/obj/item/trash/sosjerky,
/obj/item/cigbutt,
/obj/item/circuitboard/machine/rdserver,
/obj/structure/closet/secure_closet{
	req_access = list(11)
	},
/turf/open/floor/plating,
/area/ship/maintenance/aft)
"ZL" = (
/obj/machinery/power/shuttle/engine/fueled/plasma{
	dir = 1
	},
/turf/open/floor/plating,
/area/ship/external)
"ZM" = (
/obj/structure/window/fulltile,
/obj/structure/grille,
/turf/closed/wall/material,
/area/ship/maintenance/starboard)

(1,1,1) = {"
xg
xg
xg
xg
xg
xg
xg
xg
rW
ch
be
xg
xg
xg
xg
xg
CM
"}
(2,1,1) = {"
xg
xg
xg
xg
QF
wh
zl
rW
rW
rH
kV
rW
xg
GN
tN
tN
xg
"}
(3,1,1) = {"
xg
xg
xg
QF
kh
dR
FE
rW
hy
aq
ZA
rW
tN
kF
bw
hq
xg
"}
(4,1,1) = {"
xg
Tm
RV
QF
as
ad
tt
be
Nt
gS
IY
be
yY
FM
ng
ZL
xg
"}
(5,1,1) = {"
GE
jc
PN
RV
Mw
QF
QF
rW
aF
rW
rW
rW
tN
ll
lz
RP
Gh
"}
(6,1,1) = {"
GE
ho
AT
XE
Fu
li
dT
Oj
nX
mw
TO
dT
AN
el
We
tN
GN
"}
(7,1,1) = {"
GE
Of
dx
RV
Cs
FJ
Wi
FJ
sn
IV
nn
lR
sn
tN
Jd
Da
hq
"}
(8,1,1) = {"
xg
RV
RV
FJ
rg
Dj
sF
Hz
nn
HU
nn
XN
hf
nn
NP
Da
hq
"}
(9,1,1) = {"
xg
xg
xg
Cs
Bx
jZ
yJ
xS
nn
fU
nn
rD
Ig
nn
GN
GN
tN
"}
(10,1,1) = {"
xg
xg
xg
FJ
LI
FR
yJ
aa
nn
OC
HH
sn
kT
nn
nn
xg
xg
"}
(11,1,1) = {"
xg
xg
xg
FJ
KY
KY
LX
Qc
nn
CZ
OR
Nz
nA
uw
nn
xg
xg
"}
(12,1,1) = {"
xg
xg
xg
xg
Pu
Px
Px
Bg
sn
hI
Zr
ei
mH
mB
sn
xg
xg
"}
(13,1,1) = {"
xg
xg
xg
xg
xg
xg
xg
xg
sn
nn
ZM
VO
VO
nn
sn
xg
xg
"}
