//MAP CONVERTED BY dmm2tgm.py THIS HEADER COMMENT PREVENTS RECONVERSION, DO NOT REMOVE
"a" = (
/turf/closed/wall/mineral/titanium,
/area/space)
"F" = (
/turf/open/space/basic,
/area/space)

(1,1,1) = {"
F
F
F
F
F
F
F
F
F
F
F
F
F
F
F
F
F
F
F
F
F
F
F
F
F
F
F
F
F
F
F
F
F
F
F
F
F
F
F
F
"}
(2,1,1) = {"
F
F
F
F
F
F
F
F
F
F
F
F
F
F
F
F
F
F
F
F
F
F
F
F
F
F
F
F
F
F
F
F
F
F
F
F
F
F
F
F
"}
(3,1,1) = {"
F
F
F
F
F
F
F
F
F
F
F
F
F
a
a
a
a
a
a
a
a
a
a
a
a
a
a
F
F
F
F
F
F
F
F
F
F
F
F
F
"}
(4,1,1) = {"
F
F
a
a
F
F
F
a
a
F
F
a
a
a
F
F
F
F
F
F
F
F
F
F
F
F
a
a
a
F
F
a
a
F
F
F
a
a
F
F
"}
(5,1,1) = {"
F
F
a
F
F
F
F
F
a
F
F
a
F
F
F
F
F
F
F
F
F
F
F
F
F
F
F
F
a
F
F
a
F
F
F
F
F
a
F
F
"}
(6,1,1) = {"
F
F
a
F
F
F
F
F
a
F
F
a
F
F
F
F
F
F
F
F
F
F
F
F
F
F
F
F
a
F
F
a
F
F
F
F
F
a
F
F
"}
(7,1,1) = {"
F
F
a
F
F
F
F
F
F
F
F
F
F
F
F
F
F
F
F
F
F
F
F
F
F
F
F
F
F
F
F
F
F
F
F
F
F
a
F
F
"}
(8,1,1) = {"
F
F
a
F
F
F
F
F
F
F
F
F
F
F
F
F
F
F
F
F
F
F
F
F
F
F
F
F
F
F
F
F
F
F
F
F
F
a
F
F
"}
(9,1,1) = {"
F
F
a
F
F
F
F
F
a
F
F
a
F
F
F
F
F
F
F
F
F
F
F
F
F
F
F
F
a
F
F
a
F
F
F
F
F
a
F
F
"}
(10,1,1) = {"
F
F
a
a
F
F
F
a
a
F
F
a
a
F
F
F
F
F
F
F
F
F
F
F
F
F
F
a
a
F
F
a
a
F
F
F
a
a
F
F
"}
(11,1,1) = {"
F
F
F
a
F
F
F
a
F
F
F
F
a
F
F
F
F
F
F
F
F
F
F
F
F
F
F
a
F
F
F
F
a
F
F
F
a
F
F
F
"}
(12,1,1) = {"
F
F
F
a
F
F
F
a
F
F
F
F
a
F
F
F
F
F
F
F
F
F
F
F
F
F
F
a
F
F
F
F
a
F
F
F
a
F
F
F
"}
(13,1,1) = {"
F
F
F
a
a
a
a
a
F
F
F
F
F
F
F
F
F
F
F
F
F
F
F
F
F
F
F
F
F
F
F
F
a
a
a
a
a
F
F
F
"}
(14,1,1) = {"
F
F
F
F
F
F
F
F
F
F
F
F
a
F
F
F
F
F
F
F
F
F
F
F
F
F
F
a
F
F
F
F
F
F
F
F
F
F
F
F
"}
(15,1,1) = {"
F
F
F
F
F
F
F
F
F
F
F
F
a
F
F
F
F
F
F
F
F
F
F
F
F
F
F
a
F
F
F
F
F
F
F
F
F
F
F
F
"}
(16,1,1) = {"
F
F
F
F
F
F
F
F
F
F
F
F
a
F
F
F
F
F
F
F
F
F
F
F
F
F
F
a
F
F
F
F
F
F
F
F
F
F
F
F
"}
(17,1,1) = {"
F
F
F
F
F
F
F
F
F
F
F
F
a
F
F
F
F
F
F
F
F
F
F
F
F
F
F
a
F
F
F
F
F
F
F
F
F
F
F
F
"}
(18,1,1) = {"
F
F
F
F
F
F
F
F
F
F
F
F
a
F
F
F
F
F
F
F
F
F
F
F
F
F
F
a
F
F
F
F
F
F
F
F
F
F
F
F
"}
(19,1,1) = {"
F
F
F
F
F
F
F
F
F
F
F
F
a
F
F
F
F
F
F
F
F
F
F
F
F
F
F
a
F
F
F
F
F
F
F
F
F
F
F
F
"}
(20,1,1) = {"
F
F
F
F
F
F
F
F
F
F
F
F
a
F
F
F
F
F
F
F
F
F
F
F
F
F
F
a
F
F
F
F
F
F
F
F
F
F
F
F
"}
(21,1,1) = {"
F
F
F
F
F
F
F
F
F
F
F
F
a
F
F
F
F
F
F
F
F
F
F
F
F
F
F
a
F
F
F
F
F
F
F
F
F
F
F
F
"}
(22,1,1) = {"
F
F
F
F
F
F
F
F
F
F
F
F
a
F
F
F
F
F
F
F
F
F
F
F
F
F
F
a
F
F
F
F
F
F
F
F
F
F
F
F
"}
(23,1,1) = {"
F
F
F
F
F
F
F
F
F
F
F
F
a
F
F
F
F
F
F
F
F
F
F
F
F
F
F
a
F
F
F
F
F
F
F
F
F
F
F
F
"}
(24,1,1) = {"
F
F
F
F
F
F
F
F
F
F
a
a
a
a
F
F
F
F
F
F
F
F
F
F
F
F
a
a
a
a
F
F
F
F
F
F
F
F
F
F
"}
(25,1,1) = {"
F
F
F
F
F
F
F
F
F
a
a
F
F
F
F
F
F
F
F
F
F
F
F
F
F
F
F
F
F
a
a
F
F
F
F
F
F
F
F
F
"}
(26,1,1) = {"
F
F
F
F
F
F
F
F
F
a
F
F
F
a
F
F
F
F
F
F
F
F
F
F
F
F
a
F
F
F
a
F
F
F
F
F
F
F
F
F
"}
(27,1,1) = {"
F
F
F
F
F
F
F
F
F
a
F
F
F
a
F
F
F
F
F
F
F
F
F
F
F
F
a
F
F
F
a
F
F
F
F
F
F
F
F
F
"}
(28,1,1) = {"
F
F
F
F
F
F
F
F
F
F
F
F
F
F
F
F
F
F
F
F
F
F
F
F
F
F
F
F
F
F
F
F
F
F
F
F
F
F
F
F
"}
(29,1,1) = {"
F
F
F
F
F
F
F
F
F
F
F
F
F
F
F
F
F
F
F
F
F
F
F
F
F
F
F
F
F
F
F
F
F
F
F
F
F
F
F
F
"}
(30,1,1) = {"
F
F
F
F
F
F
F
F
F
F
F
F
F
F
F
F
F
F
F
F
F
F
F
F
F
F
F
F
F
F
F
F
F
F
F
F
F
F
F
F
"}
(31,1,1) = {"
F
F
F
F
F
F
F
F
F
F
F
F
F
F
F
F
F
F
F
F
F
F
F
F
F
F
F
F
F
F
F
F
F
F
F
F
F
F
F
F
"}
(32,1,1) = {"
F
F
F
F
F
F
F
F
F
F
F
F
F
F
F
F
F
F
F
F
F
F
F
F
F
F
F
F
F
F
F
F
F
F
F
F
F
F
F
F
"}
(33,1,1) = {"
F
F
F
F
F
F
F
F
F
F
F
F
F
F
F
F
F
F
F
F
F
F
F
F
F
F
F
F
F
F
F
F
F
F
F
F
F
F
F
F
"}
(34,1,1) = {"
F
F
F
F
F
F
F
F
F
a
F
F
F
a
F
F
F
F
F
F
F
F
F
F
F
F
a
F
F
F
a
F
F
F
F
F
F
F
F
F
"}
(35,1,1) = {"
F
F
F
F
F
F
F
F
F
a
F
F
F
a
F
F
F
F
F
F
F
F
F
F
F
F
a
F
F
F
a
F
F
F
F
F
F
F
F
F
"}
(36,1,1) = {"
F
F
F
F
F
F
F
F
F
a
a
F
F
F
F
F
F
F
F
F
F
F
F
F
F
F
F
F
F
a
a
F
F
F
F
F
F
F
F
F
"}
(37,1,1) = {"
F
F
F
F
F
F
F
F
F
a
a
a
a
a
F
F
F
F
F
F
F
F
F
F
F
F
a
a
a
a
a
F
F
F
F
F
F
F
F
F
"}
(38,1,1) = {"
F
F
F
F
F
F
F
F
F
F
F
F
F
F
F
F
F
F
F
F
F
F
F
F
F
F
F
F
F
F
F
F
F
F
F
F
F
F
F
F
"}
(39,1,1) = {"
F
F
F
F
F
F
F
F
F
F
F
F
F
F
F
F
F
F
F
F
F
F
F
F
F
F
F
F
F
F
F
F
F
F
F
F
F
F
F
F
"}
(40,1,1) = {"
F
F
F
F
F
F
F
F
F
F
F
F
F
F
F
F
F
F
F
F
F
F
F
F
F
F
F
F
F
F
F
F
F
F
F
F
F
F
F
F
"}
(41,1,1) = {"
F
F
F
F
F
F
F
F
F
F
F
F
F
F
F
F
F
F
F
F
F
F
F
F
F
F
F
F
F
F
F
F
F
F
F
F
F
F
F
F
"}
(42,1,1) = {"
F
F
F
F
F
F
F
F
F
a
a
a
a
a
F
F
F
F
F
F
F
F
F
F
F
F
a
a
a
a
a
F
F
F
F
F
F
F
F
F
"}
(43,1,1) = {"
F
F
F
F
F
F
F
F
F
F
F
F
F
a
F
F
F
F
F
F
F
F
F
F
F
F
a
F
F
F
F
F
F
F
F
F
F
F
F
F
"}
(44,1,1) = {"
F
F
F
F
F
F
F
F
F
F
F
F
F
a
F
F
F
F
F
F
F
F
F
F
F
F
a
F
F
F
F
F
F
F
F
F
F
F
F
F
"}
(45,1,1) = {"
F
F
F
F
F
F
F
F
F
F
F
F
F
a
F
F
F
F
F
F
F
F
F
F
F
F
a
F
F
F
F
F
F
F
F
F
F
F
F
F
"}
(46,1,1) = {"
F
F
F
F
F
F
F
F
F
F
F
F
F
a
F
F
F
F
F
F
F
F
F
F
F
F
a
F
F
F
F
F
F
F
F
F
F
F
F
F
"}
(47,1,1) = {"
F
F
F
F
F
F
F
F
F
F
F
F
F
a
a
F
F
F
F
F
F
F
F
F
F
a
a
F
F
F
F
F
F
F
F
F
F
F
F
F
"}
(48,1,1) = {"
F
F
F
F
F
F
F
F
F
F
F
F
F
F
a
F
F
F
F
F
F
F
F
F
F
a
F
F
F
F
F
F
F
F
F
F
F
F
F
F
"}
(49,1,1) = {"
F
F
F
F
F
F
F
F
F
F
F
F
F
F
a
F
F
a
F
a
F
a
F
a
F
a
F
F
F
F
F
F
F
F
F
F
F
F
F
F
"}
(50,1,1) = {"
F
F
F
F
F
F
F
F
F
F
F
F
F
F
a
F
F
F
F
F
F
F
F
F
F
a
F
F
F
F
F
F
F
F
F
F
F
F
F
F
"}
(51,1,1) = {"
F
F
F
F
F
F
F
F
F
F
F
F
F
F
a
F
F
F
F
F
F
F
F
F
F
a
F
F
F
F
F
F
F
F
F
F
F
F
F
F
"}
(52,1,1) = {"
F
F
F
F
F
F
F
F
F
F
F
F
F
F
a
a
a
a
F
a
F
a
F
a
a
a
F
F
F
F
F
F
F
F
F
F
F
F
F
F
"}
(53,1,1) = {"
F
F
F
F
F
F
F
F
F
F
F
F
F
F
F
F
F
F
F
F
F
F
F
F
F
F
F
F
F
F
F
F
F
F
F
F
F
F
F
F
"}
(54,1,1) = {"
F
F
F
F
F
F
F
F
F
F
F
F
F
F
F
F
F
F
F
F
F
F
F
F
F
F
F
F
F
F
F
F
F
F
F
F
F
F
F
F
"}
(55,1,1) = {"
F
F
F
F
F
F
F
F
F
F
F
F
F
F
F
F
F
F
F
F
F
F
F
F
F
F
F
F
F
F
F
F
F
F
F
F
F
F
F
F
"}
(56,1,1) = {"
F
F
F
F
F
F
F
F
F
F
F
F
F
F
F
F
F
F
F
F
F
F
F
F
F
F
F
F
F
F
F
F
F
F
F
F
F
F
F
F
"}
