//MAP CONVERTED BY dmm2tgm.py THIS HEADER COMMENT PREVENTS RECONVERSION, DO NOT REMOVE
"bb" = (
/obj/structure/cable{
	icon_state = "4-8"
	},
/obj/machinery/atmospherics/pipe/simple/supply/hidden/layer4{
	dir = 6
	},
/obj/effect/landmark/start/assistant,
/turf/open/floor/plating,
/area/ship/maintenance/starboard)
"bT" = (
/obj/structure/cable{
	icon_state = "1-8"
	},
/turf/open/floor/plating,
/area/ship/maintenance/aft)
"ct" = (
/obj/machinery/atmospherics/pipe/simple/orange/visible,
/obj/machinery/light/broken{
	dir = 4
	},
/turf/open/floor/plating,
/area/ship/maintenance/aft)
"cG" = (
/obj/machinery/advanced_airlock_controller{
	dir = 4;
	pixel_x = -24
	},
/obj/machinery/atmospherics/components/binary/dp_vent_pump{
	dir = 8
	},
/turf/open/floor/plating,
/area/ship/engineering)
"cH" = (
/obj/item/wrench/old,
/obj/machinery/atmospherics/pipe/simple/supply/hidden/layer4{
	dir = 4
	},
/obj/effect/turf_decal/corner/yellow{
	dir = 4
	},
/obj/effect/landmark/start/station_engineer,
/turf/open/floor/plasteel,
/area/ship/engineering)
"cV" = (
/obj/structure/cable{
	icon_state = "0-4"
	},
/obj/machinery/power/apc/auto_name/south,
/turf/open/floor/plasteel,
/area/ship/bridge)
"ec" = (
/obj/structure/fans/tiny,
/obj/effect/turf_decal/siding/thinplating,
/obj/machinery/door/poddoor{
	id = "bubbledoors";
	name = "cargo bay blast door"
	},
/turf/open/floor/plating,
/area/ship/cargo)
"ef" = (
/obj/structure/cable{
	icon_state = "1-2"
	},
/obj/structure/cable{
	icon_state = "2-8"
	},
/turf/open/floor/plating,
/area/ship/maintenance/aft)
"ep" = (
/obj/machinery/atmospherics/components/unary/tank/toxins,
/turf/open/floor/plating,
/area/ship/maintenance/aft)
"eU" = (
/obj/structure/cable{
	icon_state = "1-8"
	},
/obj/machinery/atmospherics/pipe/manifold/scrubbers/hidden/layer2,
/obj/machinery/atmospherics/pipe/manifold/supply/hidden/layer4,
/obj/effect/turf_decal/corner/blue/border{
	dir = 4
	},
/turf/open/floor/plasteel/mono,
/area/ship/hallway/central)
"fs" = (
/obj/item/stack/sheet/metal/five,
/obj/machinery/atmospherics/pipe/simple/scrubbers/hidden/layer2,
/obj/item/stack/sheet/glass,
/obj/effect/turf_decal/corner/purple{
	dir = 10
	},
/turf/open/floor/plasteel,
/area/ship/science)
"gl" = (
/obj/effect/turf_decal/industrial/warning{
	dir = 1
	},
/turf/open/floor/plating,
/area/ship/external)
"gz" = (
/obj/effect/turf_decal/corner/brown{
	dir = 4
	},
/obj/structure/cable{
	icon_state = "2-4"
	},
/obj/structure/cable{
	icon_state = "1-4"
	},
/obj/machinery/atmospherics/pipe/simple/scrubbers/hidden/layer2{
	dir = 10
	},
/obj/machinery/atmospherics/pipe/simple/supply/hidden/layer4{
	dir = 1
	},
/turf/open/floor/plasteel,
/area/ship/cargo)
"gM" = (
/obj/machinery/vending/clothing,
/turf/open/floor/carpet,
/area/ship/crew/dorm)
"hh" = (
/obj/effect/spawner/structure/window/reinforced/shutters,
/turf/open/floor/plating,
/area/ship/bridge)
"hq" = (
/obj/structure/frame/computer{
	dir = 8
	},
/obj/machinery/atmospherics/components/unary/vent_pump/on/layer4,
/obj/effect/turf_decal/corner/blue/three_quarters{
	dir = 8
	},
/obj/machinery/airalarm/directional/north,
/turf/open/floor/plasteel,
/area/ship/bridge)
"hs" = (
/obj/machinery/atmospherics/components/unary/shuttle/heater{
	dir = 4
	},
/obj/structure/window/reinforced/spawner/west,
/obj/machinery/door/window/eastright,
/obj/structure/window/reinforced/spawner/north,
/obj/structure/window/reinforced/spawner,
/turf/open/floor/plating,
/area/ship/maintenance/aft)
"hE" = (
/obj/structure/sign/poster/official/nanotrasen_logo{
	pixel_x = 32
	},
/obj/effect/turf_decal/corner/yellow/border,
/obj/effect/turf_decal/corner/blue/border{
	dir = 4
	},
/turf/open/floor/plasteel,
/area/ship/hallway/central)
"hU" = (
/obj/structure/frame/computer{
	dir = 8
	},
/obj/machinery/atmospherics/components/unary/vent_scrubber/on/layer2{
	dir = 1
	},
/obj/effect/turf_decal/corner/blue/three_quarters,
/obj/machinery/firealarm{
	dir = 1;
	pixel_y = -24
	},
/turf/open/floor/plasteel,
/area/ship/bridge)
"im" = (
/obj/structure/cable{
	icon_state = "4-8"
	},
/obj/machinery/atmospherics/pipe/simple/scrubbers/hidden/layer2{
	dir = 4
	},
/obj/machinery/atmospherics/pipe/simple/supply/hidden/layer4{
	dir = 4
	},
/turf/open/floor/plasteel/mono,
/area/ship/hallway/central)
"jr" = (
/obj/item/bedsheet/dorms,
/obj/structure/bed,
/obj/structure/curtain/bounty,
/obj/effect/turf_decal/siding/wood{
	dir = 8
	},
/turf/open/floor/wood,
/area/ship/crew/dorm)
"jA" = (
/obj/machinery/light{
	dir = 1
	},
/obj/effect/turf_decal/corner/green/border{
	dir = 1
	},
/turf/open/floor/plasteel,
/area/ship/hallway/central)
"jI" = (
/obj/structure/cable{
	icon_state = "4-8"
	},
/obj/structure/cable{
	icon_state = "1-4"
	},
/turf/open/floor/plating,
/area/ship/maintenance/aft)
"jM" = (
/obj/machinery/atmospherics/components/binary/pump{
	dir = 8;
	name = "engine fuel pump"
	},
/turf/open/floor/plating,
/area/ship/maintenance/aft)
"jW" = (
/obj/machinery/computer/helm{
	dir = 8
	},
/obj/machinery/atmospherics/pipe/simple/scrubbers/hidden/layer2{
	dir = 10
	},
/obj/machinery/atmospherics/pipe/simple/supply/hidden/layer4{
	dir = 9
	},
/obj/effect/turf_decal/corner/blue/half{
	dir = 4
	},
/turf/open/floor/plasteel,
/area/ship/bridge)
"kn" = (
/obj/machinery/ore_silo,
/obj/item/multitool,
/obj/effect/turf_decal/corner/brown/half{
	dir = 8
	},
/obj/machinery/airalarm/directional/west,
/turf/open/floor/plasteel,
/area/ship/cargo)
"kW" = (
/obj/structure/window/reinforced/spawner/east,
/obj/machinery/autolathe,
/obj/effect/turf_decal/corner/purple{
	dir = 8
	},
/turf/open/floor/plasteel,
/area/ship/science)
"ln" = (
/obj/machinery/power/terminal{
	dir = 1
	},
/obj/structure/cable/yellow{
	icon_state = "0-2"
	},
/obj/machinery/atmospherics/pipe/manifold/scrubbers/hidden/layer2{
	dir = 4
	},
/obj/machinery/atmospherics/pipe/simple/supply/hidden/layer4{
	dir = 4
	},
/turf/open/floor/plasteel,
/area/ship/engineering)
"lt" = (
/obj/structure/cable{
	icon_state = "1-2"
	},
/obj/machinery/atmospherics/pipe/simple/scrubbers/hidden/layer2,
/obj/machinery/atmospherics/pipe/simple/supply/hidden/layer4,
/turf/open/floor/carpet,
/area/ship/crew/dorm)
"lM" = (
/obj/structure/cable{
	icon_state = "0-2"
	},
/obj/machinery/power/apc/auto_name/east,
/obj/machinery/atmospherics/pipe/simple/supply/hidden/layer4{
	dir = 1
	},
/obj/effect/turf_decal/corner/brown{
	dir = 6
	},
/obj/machinery/suit_storage_unit/independent/mining,
/turf/open/floor/plasteel,
/area/ship/cargo)
"mJ" = (
/obj/machinery/power/terminal{
	dir = 8
	},
/obj/structure/cable{
	icon_state = "0-2"
	},
/turf/open/floor/plating,
/area/ship/maintenance/aft)
"mV" = (
/turf/closed/wall,
/area/ship/cargo)
"mY" = (
/obj/machinery/atmospherics/pipe/simple/supply/hidden{
	dir = 9
	},
/turf/closed/wall,
/area/ship/engineering)
"mZ" = (
/obj/machinery/atmospherics/pipe/simple/orange/visible{
	dir = 4
	},
/obj/structure/cable{
	icon_state = "1-2"
	},
/turf/open/floor/plating,
/area/ship/maintenance/aft)
"ny" = (
/obj/structure/window/reinforced/spawner/east,
/obj/structure/frame/machine,
/obj/machinery/atmospherics/components/unary/vent_pump/on/layer4,
/turf/open/floor/plasteel,
/area/ship/science)
"nH" = (
/turf/closed/wall,
/area/ship/science)
"nS" = (
/turf/open/floor/plasteel,
/area/ship/cargo)
"nV" = (
/obj/machinery/door/airlock{
	name = "Dormitories"
	},
/obj/structure/cable{
	icon_state = "1-2"
	},
/obj/machinery/atmospherics/pipe/simple/scrubbers/hidden/layer2,
/obj/machinery/atmospherics/pipe/simple/supply/hidden/layer4,
/obj/effect/turf_decal/corner/green/mono,
/turf/open/floor/plasteel/mono,
/area/ship/crew/dorm)
"op" = (
/turf/closed/wall,
/area/ship/maintenance/port)
"oI" = (
/obj/machinery/door/airlock/maintenance_hatch,
/obj/effect/turf_decal/siding/thinplating{
	dir = 4
	},
/obj/structure/cable{
	icon_state = "4-8"
	},
/turf/open/floor/plating,
/area/ship/cargo)
"oR" = (
/obj/structure/cable{
	icon_state = "1-2"
	},
/obj/machinery/light{
	dir = 4
	},
/turf/open/floor/plating,
/area/ship/maintenance/aft)
"qk" = (
/obj/machinery/atmospherics/pipe/simple/orange/visible,
/turf/open/floor/plating,
/area/ship/maintenance/aft)
"qq" = (
/obj/machinery/atmospherics/components/unary/vent_scrubber/on/layer2{
	dir = 4
	},
/obj/effect/turf_decal/corner/purple/border,
/turf/open/floor/plasteel,
/area/ship/hallway/central)
"rj" = (
/obj/structure/cable{
	icon_state = "2-8"
	},
/obj/machinery/power/apc/auto_name/east,
/obj/structure/cable{
	icon_state = "0-8"
	},
/obj/item/toy/plush/lizardplushie{
	color = "cyan"
	},
/obj/item/clothing/head/wig/random{
	pixel_x = -1;
	pixel_y = -4
	},
/turf/open/floor/plating,
/area/ship/maintenance/port)
"sk" = (
/obj/structure/cable{
	icon_state = "1-2"
	},
/obj/structure/cable{
	icon_state = "2-4"
	},
/obj/machinery/atmospherics/pipe/simple/scrubbers/hidden/layer2,
/obj/machinery/atmospherics/pipe/simple/supply/hidden/layer4,
/obj/effect/turf_decal/corner/green/border{
	dir = 1
	},
/turf/open/floor/plasteel,
/area/ship/hallway/central)
"sI" = (
/obj/machinery/firealarm{
	dir = 1;
	pixel_y = -24
	},
/obj/effect/turf_decal/corner/purple/border,
/turf/open/floor/plasteel,
/area/ship/hallway/central)
"sV" = (
/obj/effect/turf_decal/siding/thinplating{
	dir = 4
	},
/obj/machinery/door/airlock/maintenance_hatch,
/obj/structure/cable{
	icon_state = "4-8"
	},
/turf/open/floor/plating,
/area/ship/maintenance/aft)
"uw" = (
/obj/item/pipe_dispenser,
/obj/structure/closet/crate,
/obj/item/construction/plumbing,
/obj/item/construction/rcd/arcd,
/obj/item/stack/sheet/plasteel/fifty,
/obj/item/construction/rcd/combat,
/turf/open/floor/plating,
/area/ship/maintenance/aft)
"uE" = (
/obj/machinery/atmospherics/pipe/simple/scrubbers/hidden/layer2{
	dir = 4
	},
/obj/machinery/atmospherics/pipe/simple/supply/hidden/layer4{
	dir = 4
	},
/obj/machinery/holopad/emergency/command,
/turf/open/floor/plasteel,
/area/ship/bridge)
"uL" = (
/obj/effect/turf_decal/corner/yellow/border,
/turf/open/floor/plasteel,
/area/ship/hallway/central)
"vz" = (
/obj/machinery/power/smes/engineering,
/obj/structure/cable{
	icon_state = "0-4"
	},
/obj/machinery/atmospherics/components/unary/vent_scrubber/on/layer2,
/obj/machinery/light{
	dir = 1
	},
/turf/open/floor/plasteel,
/area/ship/engineering)
"vB" = (
/obj/machinery/atmospherics/pipe/manifold/scrubbers/hidden/layer2{
	dir = 1
	},
/obj/machinery/atmospherics/pipe/simple/supply/hidden/layer4{
	dir = 4
	},
/turf/open/floor/plasteel,
/area/ship/science)
"vR" = (
/obj/machinery/atmospherics/pipe/simple/scrubbers/hidden/layer2,
/turf/closed/wall,
/area/ship/science)
"wz" = (
/obj/effect/turf_decal/corner/brown/half{
	dir = 4
	},
/obj/machinery/button/door{
	id = "bubbledoors";
	name = "Blast Door Control";
	pixel_x = 24
	},
/obj/machinery/atmospherics/components/unary/vent_pump/on/layer4,
/obj/machinery/suit_storage_unit/independent/mining,
/turf/open/floor/plasteel,
/area/ship/cargo)
"wH" = (
/obj/machinery/power/shuttle/engine/electric{
	dir = 4
	},
/obj/structure/cable{
	icon_state = "0-4"
	},
/turf/open/floor/plating,
/area/ship/external)
"wO" = (
/obj/structure/fans/tiny,
/obj/effect/turf_decal/siding/thinplating,
/obj/machinery/door/poddoor{
	id = "bubbledoors";
	name = "cargo bay blast door"
	},
/obj/effect/turf_decal/industrial/warning/corner{
	dir = 1
	},
/turf/open/floor/plating,
/area/ship/cargo)
"wY" = (
/obj/machinery/cryopod{
	dir = 4
	},
/obj/machinery/computer/cryopod{
	pixel_y = 32
	},
/turf/open/floor/carpet,
/area/ship/crew/dorm)
"xm" = (
/obj/structure/chair/comfy/shuttle{
	dir = 4;
	name = "Helm"
	},
/obj/structure/cable{
	icon_state = "1-2"
	},
/obj/machinery/atmospherics/pipe/simple/scrubbers/hidden/layer2{
	dir = 4
	},
/obj/machinery/atmospherics/pipe/manifold/supply/hidden/layer4{
	dir = 1
	},
/obj/effect/landmark/start/captain,
/turf/open/floor/plasteel,
/area/ship/bridge)
"xu" = (
/obj/structure/cable{
	icon_state = "1-2"
	},
/turf/open/floor/plating,
/area/ship/maintenance/aft)
"xC" = (
/obj/effect/turf_decal/industrial/warning{
	dir = 5
	},
/turf/open/floor/plating,
/area/ship/external)
"yb" = (
/obj/machinery/door/airlock/research/glass,
/obj/structure/cable{
	icon_state = "1-2"
	},
/obj/machinery/atmospherics/pipe/simple/scrubbers/hidden/layer2,
/obj/machinery/atmospherics/pipe/simple/supply/hidden/layer4,
/obj/effect/turf_decal/corner/purple/mono,
/turf/open/floor/plasteel/mono,
/area/ship/science)
"yw" = (
/obj/structure/cable{
	icon_state = "4-8"
	},
/turf/open/floor/plasteel/mono,
/area/ship/hallway/central)
"zu" = (
/obj/machinery/door/airlock/engineering/glass,
/obj/effect/turf_decal/corner/yellow/mono,
/turf/open/floor/plasteel/mono,
/area/ship/engineering)
"zy" = (
/turf/closed/wall,
/area/ship/maintenance/starboard)
"Ay" = (
/obj/structure/cable{
	icon_state = "4-8"
	},
/obj/machinery/atmospherics/pipe/simple/scrubbers/hidden/layer2{
	dir = 4
	},
/obj/machinery/atmospherics/pipe/manifold/supply/hidden/layer4,
/obj/effect/landmark/start/assistant,
/turf/open/floor/plasteel/mono,
/area/ship/hallway/central)
"AC" = (
/obj/structure/cable{
	icon_state = "4-8"
	},
/obj/machinery/atmospherics/components/unary/vent_pump/on/layer4,
/obj/structure/cable{
	icon_state = "2-8"
	},
/obj/machinery/firealarm{
	pixel_y = 24
	},
/turf/open/floor/plasteel,
/area/ship/engineering)
"AR" = (
/obj/machinery/door/airlock/external,
/obj/docking_port/mobile{
	launch_status = 0;
	port_direction = 4
	},
/turf/open/floor/plating,
/area/ship/engineering)
"BJ" = (
/obj/structure/sign/departments/cargo{
	pixel_y = 32
	},
/obj/effect/turf_decal/corner/brown/border{
	dir = 1
	},
/turf/open/floor/plasteel,
/area/ship/hallway/central)
"Cc" = (
/obj/structure/cable{
	icon_state = "1-2"
	},
/obj/machinery/atmospherics/pipe/simple/scrubbers/hidden/layer2,
/obj/machinery/atmospherics/pipe/simple/supply/hidden/layer4,
/turf/open/floor/plasteel,
/area/ship/science)
"CP" = (
/turf/closed/wall,
/area/ship/bridge)
"Dj" = (
/obj/machinery/atmospherics/pipe/simple/scrubbers/hidden/layer2{
	dir = 4
	},
/obj/machinery/light,
/turf/open/floor/plasteel,
/area/ship/cargo)
"DL" = (
/obj/effect/turf_decal/industrial/warning{
	dir = 10
	},
/obj/machinery/atmospherics/components/unary/outlet_injector/on/layer2{
	dir = 1
	},
/turf/open/floor/plating,
/area/ship/science)
"DP" = (
/obj/structure/cable{
	icon_state = "1-2"
	},
/obj/machinery/atmospherics/pipe/simple/scrubbers/hidden/layer2,
/obj/machinery/atmospherics/pipe/simple/supply/hidden/layer4{
	dir = 1
	},
/obj/machinery/airalarm/directional/east,
/obj/effect/turf_decal/corner/brown/border{
	dir = 1
	},
/obj/effect/turf_decal/corner/blue/border{
	dir = 4
	},
/turf/open/floor/plasteel,
/area/ship/hallway/central)
"FF" = (
/obj/machinery/power/apc/auto_name/east,
/obj/structure/cable{
	icon_state = "1-8"
	},
/obj/structure/cable,
/obj/machinery/atmospherics/pipe/simple/supply/hidden/layer4{
	dir = 9
	},
/turf/open/floor/plating,
/area/ship/maintenance/starboard)
"FK" = (
/obj/machinery/atmospherics/components/binary/pump{
	name = "engine fuel pump"
	},
/turf/open/floor/plating,
/area/ship/maintenance/aft)
"Gf" = (
/obj/machinery/power/shuttle/engine/fueled/plasma{
	dir = 4
	},
/turf/open/floor/plating,
/area/ship/external)
"Gl" = (
/turf/open/floor/plating,
/area/ship/external)
"Gp" = (
/obj/effect/turf_decal/industrial/warning{
	dir = 4
	},
/turf/open/floor/plating,
/area/ship/external)
"GD" = (
/obj/machinery/power/smes/shuttle/precharged{
	dir = 4
	},
/obj/structure/window/reinforced/spawner/west,
/obj/machinery/door/window/eastright,
/obj/structure/cable{
	icon_state = "0-8"
	},
/turf/open/floor/plating,
/area/ship/maintenance/aft)
"GF" = (
/obj/machinery/atmospherics/components/unary/vent_pump/on/layer4,
/obj/effect/turf_decal/corner/brown/border{
	dir = 1
	},
/turf/open/floor/plasteel,
/area/ship/hallway/central)
"HH" = (
/obj/machinery/light,
/obj/effect/turf_decal/corner/purple/border,
/turf/open/floor/plasteel,
/area/ship/hallway/central)
"If" = (
/obj/structure/cable{
	icon_state = "4-8"
	},
/obj/effect/landmark/start/assistant,
/turf/open/floor/plating,
/area/ship/maintenance/port)
"Iw" = (
/obj/machinery/door/airlock/maintenance_hatch,
/obj/effect/turf_decal/siding/thinplating{
	dir = 1
	},
/obj/structure/cable{
	icon_state = "1-2"
	},
/obj/machinery/atmospherics/pipe/simple/supply/hidden/layer4,
/turf/open/floor/plating,
/area/ship/bridge)
"IA" = (
/obj/machinery/door/airlock/maintenance_hatch,
/obj/effect/turf_decal/siding/thinplating{
	dir = 8
	},
/obj/structure/cable{
	icon_state = "4-8"
	},
/turf/open/floor/plating,
/area/ship/engineering)
"IL" = (
/obj/effect/turf_decal/industrial/warning{
	dir = 1
	},
/obj/structure/cable/yellow{
	icon_state = "1-4"
	},
/obj/machinery/power/port_gen/pacman/super,
/obj/machinery/atmospherics/pipe/simple/scrubbers/hidden/layer2,
/obj/structure/cable/yellow,
/turf/open/floor/plating,
/area/ship/engineering)
"Je" = (
/obj/effect/landmark/start/shaft_miner,
/turf/open/floor/plasteel,
/area/ship/cargo)
"Js" = (
/obj/machinery/door/airlock/maintenance_hatch,
/obj/effect/turf_decal/siding/thinplating,
/obj/structure/cable{
	icon_state = "1-2"
	},
/turf/open/floor/plating,
/area/ship/bridge)
"Jt" = (
/obj/structure/rack,
/obj/item/storage/bag/ore,
/obj/item/pickaxe,
/obj/item/mining_scanner,
/obj/item/pickaxe,
/obj/item/storage/bag/ore,
/obj/item/mining_scanner,
/obj/machinery/firealarm{
	dir = 4;
	pixel_x = -24
	},
/obj/effect/turf_decal/corner/brown{
	dir = 9
	},
/turf/open/floor/plasteel,
/area/ship/cargo)
"JF" = (
/obj/structure/cable,
/obj/machinery/power/apc/auto_name/south,
/obj/effect/turf_decal/corner/purple{
	dir = 10
	},
/turf/open/floor/plasteel,
/area/ship/science)
"JG" = (
/obj/structure/fans/tiny,
/obj/effect/turf_decal/siding/thinplating,
/obj/machinery/door/poddoor{
	id = "bubbledoors";
	name = "cargo bay blast door"
	},
/obj/effect/turf_decal/industrial/warning/corner{
	dir = 4
	},
/turf/open/floor/plating,
/area/ship/cargo)
"JZ" = (
/obj/structure/cable{
	icon_state = "1-2"
	},
/obj/machinery/atmospherics/pipe/simple/scrubbers/hidden/layer2{
	dir = 10
	},
/obj/machinery/atmospherics/pipe/simple/supply/hidden/layer4{
	dir = 6
	},
/obj/effect/landmark/start/assistant,
/turf/open/floor/carpet,
/area/ship/crew/dorm)
"Ke" = (
/obj/structure/cable{
	icon_state = "1-2"
	},
/obj/structure/cable{
	icon_state = "2-8"
	},
/obj/machinery/atmospherics/pipe/simple/supply/hidden/layer4,
/turf/open/floor/plasteel,
/area/ship/bridge)
"Kh" = (
/obj/machinery/atmospherics/pipe/simple/orange/visible{
	dir = 9
	},
/obj/structure/cable{
	icon_state = "2-4"
	},
/turf/open/floor/plating,
/area/ship/maintenance/aft)
"KD" = (
/obj/structure/cable{
	icon_state = "1-2"
	},
/obj/machinery/atmospherics/pipe/manifold/scrubbers/hidden/layer2{
	dir = 4
	},
/obj/machinery/atmospherics/pipe/simple/supply/hidden/layer4,
/obj/effect/turf_decal/corner/purple/border,
/turf/open/floor/plasteel,
/area/ship/hallway/central)
"KG" = (
/obj/structure/frame/machine,
/obj/effect/turf_decal/corner/purple/three_quarters{
	dir = 1
	},
/turf/open/floor/plasteel,
/area/ship/science)
"KQ" = (
/obj/machinery/door/window/eastright,
/obj/machinery/atmospherics/pipe/simple/scrubbers/hidden/layer2{
	dir = 4
	},
/obj/machinery/atmospherics/pipe/manifold/supply/hidden/layer4,
/turf/open/floor/plasteel,
/area/ship/science)
"Lk" = (
/obj/structure/frame/machine,
/obj/machinery/airalarm/directional/north,
/obj/effect/turf_decal/corner/purple{
	dir = 9
	},
/turf/open/floor/plasteel,
/area/ship/science)
"Ls" = (
/obj/effect/turf_decal/industrial/warning{
	dir = 1
	},
/obj/structure/cable/yellow{
	icon_state = "4-8"
	},
/turf/open/floor/plating,
/area/ship/engineering)
"LA" = (
/obj/machinery/cryopod{
	dir = 4
	},
/obj/machinery/atmospherics/components/unary/vent_scrubber/on/layer2{
	dir = 4
	},
/obj/machinery/light{
	dir = 8
	},
/turf/open/floor/carpet,
/area/ship/crew/dorm)
"LK" = (
/obj/item/bedsheet/dorms,
/obj/structure/bed,
/obj/structure/curtain/bounty,
/obj/effect/turf_decal/siding/wood{
	dir = 8
	},
/obj/machinery/atmospherics/components/unary/vent_pump/on/layer4{
	dir = 8
	},
/turf/open/floor/wood,
/area/ship/crew/dorm)
"MJ" = (
/turf/closed/wall,
/area/ship/engineering)
"MW" = (
/obj/effect/landmark/start/assistant,
/turf/open/floor/plating,
/area/ship/maintenance/aft)
"MY" = (
/obj/machinery/mineral/ore_redemption,
/obj/machinery/door/firedoor,
/turf/open/floor/plasteel,
/area/ship/cargo)
"NX" = (
/obj/effect/turf_decal/industrial/warning,
/turf/open/floor/plating,
/area/ship/external)
"Ob" = (
/turf/closed/wall,
/area/ship/maintenance/aft)
"OY" = (
/obj/structure/cable{
	icon_state = "1-2"
	},
/turf/open/floor/plasteel,
/area/ship/bridge)
"PK" = (
/obj/structure/frame/computer{
	dir = 4
	},
/obj/machinery/atmospherics/components/unary/vent_scrubber/on/layer2{
	dir = 4
	},
/obj/machinery/firealarm{
	dir = 4;
	pixel_x = -24
	},
/obj/effect/turf_decal/corner/purple{
	dir = 9
	},
/turf/open/floor/plasteel,
/area/ship/science)
"Rk" = (
/obj/machinery/atmospherics/pipe/simple/scrubbers/hidden{
	dir = 5
	},
/turf/closed/wall,
/area/ship/engineering)
"Sx" = (
/obj/structure/closet/crate,
/obj/item/stack/sheet/mineral/plasma/fifty,
/obj/item/stack/sheet/mineral/uranium/five,
/obj/machinery/atmospherics/pipe/manifold/supply/hidden/layer4{
	dir = 4
	},
/obj/structure/cable,
/obj/machinery/power/apc/auto_name/east,
/turf/open/floor/plasteel,
/area/ship/engineering)
"TP" = (
/obj/structure/cable{
	icon_state = "4-8"
	},
/obj/effect/turf_decal/corner/yellow{
	dir = 8
	},
/turf/open/floor/plasteel,
/area/ship/engineering)
"Ua" = (
/obj/structure/sign/poster/official/build{
	pixel_y = 32
	},
/obj/structure/tank_dispenser/oxygen,
/obj/effect/turf_decal/corner/green/border{
	dir = 1
	},
/turf/open/floor/plasteel,
/area/ship/hallway/central)
"Ul" = (
/obj/machinery/atmospherics/components/unary/tank/air{
	dir = 1;
	piping_layer = 4
	},
/turf/open/floor/plating,
/area/ship/maintenance/starboard)
"UC" = (
/obj/effect/turf_decal/industrial/warning{
	dir = 1
	},
/obj/structure/cable/yellow{
	icon_state = "0-8"
	},
/obj/machinery/power/port_gen/pacman,
/obj/machinery/atmospherics/pipe/simple/supply/hidden/layer4,
/obj/machinery/airalarm/directional/east,
/turf/open/floor/plating,
/area/ship/engineering)
"UE" = (
/obj/structure/cable{
	icon_state = "0-8"
	},
/obj/machinery/power/apc/auto_name/north,
/obj/effect/turf_decal/corner/green/border{
	dir = 1
	},
/turf/open/floor/plasteel,
/area/ship/hallway/central)
"Vf" = (
/obj/structure/cable{
	icon_state = "0-2"
	},
/obj/machinery/power/apc/auto_name/north,
/obj/effect/landmark/start/assistant,
/turf/open/floor/carpet,
/area/ship/crew/dorm)
"Vt" = (
/obj/machinery/atmospherics/pipe/layer_manifold,
/turf/closed/wall,
/area/ship/engineering)
"Vw" = (
/obj/structure/cable{
	icon_state = "4-8"
	},
/obj/machinery/atmospherics/pipe/simple/scrubbers/hidden/layer2{
	dir = 4
	},
/obj/machinery/atmospherics/pipe/simple/supply/hidden/layer4{
	dir = 4
	},
/obj/effect/landmark/start/assistant,
/turf/open/floor/plasteel/mono,
/area/ship/hallway/central)
"Vy" = (
/obj/item/kirbyplants/random,
/obj/item/storage/box/rndboards{
	desc = "Smells feighntly of plastic.";
	name = "research equipment"
	},
/obj/machinery/light{
	dir = 1
	},
/obj/item/radio/intercom/wideband{
	pixel_x = -26
	},
/turf/open/floor/plasteel,
/area/ship/bridge)
"VA" = (
/obj/machinery/power/terminal{
	dir = 8
	},
/obj/structure/cable{
	icon_state = "0-4"
	},
/turf/open/floor/plating,
/area/ship/maintenance/aft)
"VB" = (
/turf/template_noop,
/area/space)
"VI" = (
/obj/effect/turf_decal/corner/brown{
	dir = 1
	},
/obj/item/storage/toolbox/mechanical,
/obj/machinery/atmospherics/components/unary/vent_scrubber/on/layer2{
	dir = 4
	},
/turf/open/floor/plasteel,
/area/ship/cargo)
"VO" = (
/obj/structure/table/wood,
/obj/effect/turf_decal/siding/wood{
	dir = 8
	},
/obj/machinery/airalarm/directional/east,
/obj/machinery/firealarm{
	dir = 1;
	pixel_y = -24
	},
/obj/item/areaeditor/shuttle,
/turf/open/floor/wood,
/area/ship/crew/dorm)
"VQ" = (
/turf/closed/wall,
/area/ship/crew/dorm)
"WN" = (
/obj/effect/turf_decal/industrial/warning{
	dir = 8
	},
/turf/open/floor/plating,
/area/ship/external)
"Xi" = (
/obj/machinery/door/airlock/command/glass,
/obj/machinery/atmospherics/pipe/simple/scrubbers/hidden/layer2{
	dir = 4
	},
/obj/machinery/atmospherics/pipe/simple/supply/hidden/layer4{
	dir = 4
	},
/obj/effect/turf_decal/corner/blue/mono,
/turf/open/floor/plasteel/mono,
/area/ship/bridge)
"Xn" = (
/obj/effect/turf_decal/industrial/warning{
	dir = 9
	},
/turf/open/floor/plating,
/area/ship/external)
"Xy" = (
/obj/machinery/door/airlock/mining/glass,
/obj/structure/cable{
	icon_state = "1-2"
	},
/obj/machinery/atmospherics/pipe/simple/scrubbers/hidden/layer2,
/obj/machinery/atmospherics/pipe/simple/supply/hidden/layer4{
	dir = 1
	},
/obj/effect/turf_decal/corner/brown/mono,
/turf/open/floor/plasteel/mono,
/area/ship/cargo)
"XH" = (
/obj/structure/cable{
	icon_state = "1-2"
	},
/obj/structure/cable{
	icon_state = "1-8"
	},
/turf/open/floor/plating,
/area/ship/maintenance/aft)
"Yi" = (
/obj/effect/spawner/lootdrop/maintenance,
/obj/structure/closet/firecloset/full,
/turf/open/floor/plating,
/area/ship/maintenance/port)
"Zg" = (
/obj/structure/cable{
	icon_state = "2-4"
	},
/obj/structure/cable{
	icon_state = "1-4"
	},
/obj/structure/cable{
	icon_state = "4-8"
	},
/obj/machinery/atmospherics/pipe/manifold/scrubbers/hidden/layer2{
	dir = 8
	},
/obj/machinery/atmospherics/pipe/manifold/supply/hidden/layer4{
	dir = 8
	},
/turf/open/floor/plasteel/mono,
/area/ship/hallway/central)
"ZB" = (
/obj/machinery/power/smes/shuttle/precharged{
	dir = 4
	},
/obj/structure/window/reinforced/spawner/west,
/obj/machinery/door/window/eastleft,
/obj/structure/cable{
	icon_state = "0-8"
	},
/turf/open/floor/plating,
/area/ship/maintenance/aft)
"ZM" = (
/obj/structure/cable{
	icon_state = "1-2"
	},
/obj/machinery/atmospherics/pipe/manifold/scrubbers/hidden/layer2,
/obj/machinery/atmospherics/pipe/simple/supply/hidden/layer4{
	dir = 5
	},
/obj/effect/landmark/start/scientist,
/turf/open/floor/plasteel,
/area/ship/science)
"ZQ" = (
/obj/machinery/door/airlock/external,
/turf/open/floor/plating,
/area/ship/engineering)
"ZR" = (
/obj/structure/rack,
/obj/item/storage/toolbox/mechanical{
	pixel_y = 5
	},
/obj/item/storage/toolbox/electrical,
/obj/item/multitool,
/obj/machinery/light{
	dir = 1
	},
/turf/open/floor/plasteel,
/area/ship/science)

(1,1,1) = {"
VB
VB
VB
VB
VB
VB
VB
wH
Gf
wH
VB
VB
VB
VB
VB
VB
VB
"}
(2,1,1) = {"
VB
VB
VB
VB
VB
wH
Ob
ZB
hs
GD
Ob
wH
VB
VB
VB
VB
VB
"}
(3,1,1) = {"
VB
VB
VB
VB
Ob
ZB
Ob
VA
jM
VA
Ob
ZB
Ob
VB
VB
VB
VB
"}
(4,1,1) = {"
VB
VB
VB
Ob
Ob
mJ
xu
ef
mZ
jI
MW
VA
Ob
Ob
VB
VB
VB
"}
(5,1,1) = {"
VB
VB
VB
Ob
ep
FK
ct
qk
Kh
XH
oR
bT
uw
Ob
VB
VB
VB
"}
(6,1,1) = {"
VB
VB
VQ
VQ
VQ
VQ
VQ
Ob
sV
Ob
nH
nH
nH
nH
nH
VB
VB
"}
(7,1,1) = {"
VB
VB
VQ
wY
LA
gM
VQ
Ua
yw
qq
nH
Lk
PK
KG
nH
VB
VB
"}
(8,1,1) = {"
VB
VB
VQ
Vf
JZ
lt
nV
sk
Zg
KD
yb
Cc
ZM
JF
nH
VB
VB
"}
(9,1,1) = {"
VB
Xn
VQ
jr
LK
VO
VQ
UE
Vw
sI
nH
ZR
vB
fs
vR
DL
VB
"}
(10,1,1) = {"
VB
gl
VQ
VQ
VQ
VQ
VQ
jA
im
HH
nH
ny
KQ
kW
nH
NX
VB
"}
(11,1,1) = {"
Xn
WN
wO
kn
Jt
VI
MY
GF
Ay
uL
MJ
vz
ln
IL
Vt
Rk
MJ
"}
(12,1,1) = {"
gl
Gl
ec
nS
Je
Dj
mV
BJ
im
uL
zu
TP
cH
Ls
ZQ
cG
AR
"}
(13,1,1) = {"
xC
Gp
JG
wz
lM
gz
Xy
DP
eU
hE
MJ
AC
Sx
UC
Vt
mY
MJ
"}
(14,1,1) = {"
VB
VB
mV
mV
mV
oI
mV
CP
Xi
CP
CP
IA
MJ
MJ
MJ
VB
VB
"}
(15,1,1) = {"
VB
VB
VB
op
Yi
If
CP
Vy
uE
cV
CP
bb
Ul
zy
VB
VB
VB
"}
(16,1,1) = {"
VB
VB
VB
op
op
rj
Js
OY
xm
Ke
Iw
FF
zy
zy
VB
VB
VB
"}
(17,1,1) = {"
VB
VB
VB
VB
op
op
CP
hq
jW
hU
CP
zy
zy
VB
VB
VB
VB
"}
(18,1,1) = {"
VB
VB
VB
VB
VB
VB
CP
hh
hh
hh
CP
VB
VB
VB
VB
VB
VB
"}
