//MAP CONVERTED BY dmm2tgm.py THIS HEADER COMMENT PREVENTS RECONVERSION, DO NOT REMOVE
"bh" = (
/obj/machinery/computer/aifixer{
	dir = 8
	},
/obj/effect/turf_decal/corner/transparent/ntblue/full,
/turf/open/floor/mineral/titanium,
/area/ship/bridge)
"bs" = (
/obj/effect/turf_decal/chapel{
	dir = 8
	},
/obj/effect/turf_decal/borderfloor{
	dir = 10
	},
/obj/effect/turf_decal/siding/blue{
	dir = 10
	},
/turf/open/floor/mineral/titanium,
/area/ship/bridge)
"cj" = (
/obj/structure/table/reinforced,
/obj/effect/turf_decal/borderfloor{
	dir = 5
	},
/obj/item/radio/intercom/wideband{
	pixel_y = 26
	},
/turf/open/floor/mineral/titanium/tiled/blue,
/area/ship/bridge)
"cH" = (
/obj/structure/catwalk/over,
/turf/open/floor/plating/airless,
/area/ship/external)
"fa" = (
/obj/effect/turf_decal/borderfloor{
	dir = 8
	},
/turf/open/floor/mineral/titanium/tiled/blue,
/area/ship/bridge)
"fO" = (
/obj/effect/turf_decal/corner/transparent/purple{
	dir = 9
	},
/obj/effect/turf_decal/rechargefloor,
/turf/open/floor/mineral/titanium/white,
/area/ship/science)
"gc" = (
/obj/machinery/computer/secure_data{
	dir = 4
	},
/obj/effect/turf_decal/corner/transparent/ntblue/full,
/turf/open/floor/mineral/titanium,
/area/ship/bridge)
"gf" = (
/obj/machinery/mech_bay_recharge_port{
	dir = 2
	},
/obj/effect/turf_decal/corner/transparent/purple{
	dir = 9
	},
/turf/open/floor/mineral/titanium/white,
/area/ship/science)
"hd" = (
/obj/effect/turf_decal/corner/transparent/purple/mono,
/obj/effect/turf_decal/borderfloorwhite,
/turf/open/floor/mineral/titanium/tiled/white,
/area/ship/science)
"he" = (
/obj/effect/turf_decal/corner/transparent/purple,
/obj/structure/table,
/obj/item/stack/sheet/glass/twenty{
	pixel_y = 2;
	pixel_x = 4
	},
/obj/item/stack/sheet/metal/ten{
	pixel_y = -2;
	pixel_x = -2
	},
/turf/open/floor/mineral/titanium/white,
/area/ship/science)
"hC" = (
/turf/closed/wall/mineral/titanium/nodiagonal,
/area/ship/science)
"hU" = (
/obj/machinery/mecha_part_fabricator,
/obj/effect/turf_decal/corner/transparent/purple/mono,
/turf/open/floor/mineral/titanium/tiled/white,
/area/ship/science)
"jk" = (
/obj/effect/turf_decal/industrial/defective{
	dir = 1
	},
/turf/open/floor/mineral/titanium/tiled,
/area/ship/science/ai_chamber)
"jF" = (
/obj/effect/turf_decal/corner_steel_grid{
	dir = 6
	},
/obj/effect/decal/cleanable/dirt/dust,
/obj/item/storage/toolbox/mechanical,
/turf/open/floor/engine,
/area/ship/science/ai_chamber)
"jQ" = (
/obj/effect/turf_decal/corner/transparent/grey/full,
/obj/effect/turf_decal/borderfloor{
	dir = 8
	},
/obj/effect/turf_decal/siding/blue{
	dir = 8
	},
/turf/open/floor/mineral/titanium,
/area/ship/bridge)
"ke" = (
/obj/structure/chair/office{
	dir = 8
	},
/obj/effect/turf_decal/borderfloor{
	dir = 8
	},
/turf/open/floor/mineral/titanium/tiled/blue,
/area/ship/bridge)
"lq" = (
/obj/machinery/computer/helm,
/obj/effect/turf_decal/corner/transparent/ntblue/full,
/turf/open/floor/mineral/titanium,
/area/ship/bridge)
"me" = (
/obj/effect/turf_decal/industrial/defective/corner{
	dir = 4
	},
/turf/open/floor/mineral/titanium/tiled,
/area/ship/science/ai_chamber)
"mv" = (
/obj/structure/AIcore/deactivated,
/obj/effect/decal/cleanable/dirt/dust,
/obj/effect/turf_decal/industrial/hatch/blue,
/turf/open/floor/engine,
/area/ship/science/ai_chamber)
"mH" = (
/turf/closed/wall/mineral/titanium,
/area/ship/science)
"oI" = (
/turf/closed/wall/mineral/titanium/nodiagonal,
/area/ship/bridge)
"qh" = (
/obj/structure/chair/office{
	dir = 1
	},
/obj/effect/turf_decal/corner/transparent/ntblue/full,
/turf/open/floor/mineral/titanium,
/area/ship/bridge)
"qN" = (
/obj/effect/turf_decal/corner_steel_grid/full{
	dir = 1
	},
/obj/effect/decal/cleanable/dirt/dust,
/turf/open/floor/engine,
/area/ship/science/ai_chamber)
"rh" = (
/obj/effect/turf_decal/industrial/defective{
	dir = 8
	},
/turf/open/floor/mineral/titanium/tiled,
/area/ship/science/ai_chamber)
"ri" = (
/obj/machinery/ore_silo,
/obj/effect/turf_decal/industrial/warning,
/obj/machinery/door/window,
/turf/open/floor/engine,
/area/ship/cargo)
"rA" = (
/obj/effect/turf_decal/borderfloorwhite{
	dir = 8
	},
/obj/machinery/recharge_station,
/turf/open/floor/plating,
/area/ship/science)
"sM" = (
/obj/effect/turf_decal/industrial/warning{
	dir = 4
	},
/obj/machinery/suit_storage_unit/mining/eva,
/turf/open/floor/engine,
/area/ship/cargo)
"tv" = (
/obj/machinery/computer/mech_bay_power_console{
	dir = 4
	},
/obj/effect/turf_decal/corner/transparent/purple{
	dir = 9
	},
/turf/open/floor/mineral/titanium/white,
/area/ship/science)
"uJ" = (
/obj/structure/table/reinforced,
/obj/effect/turf_decal/borderfloor{
	dir = 8
	},
/obj/item/areaeditor/shuttle{
	pixel_y = 3
	},
/turf/open/floor/mineral/titanium/tiled/blue,
/area/ship/bridge)
"vD" = (
/obj/effect/turf_decal/corner_steel_grid{
	dir = 10
	},
/turf/open/floor/engine,
/area/ship/science/ai_chamber)
"wd" = (
/obj/effect/turf_decal/corner/transparent/grey/full,
/obj/effect/turf_decal/borderfloor{
	dir = 1
	},
/obj/effect/turf_decal/siding/blue{
	dir = 1
	},
/turf/open/floor/mineral/titanium,
/area/ship/bridge)
"wU" = (
/obj/structure/table/reinforced,
/obj/effect/turf_decal/borderfloor{
	dir = 4
	},
/turf/open/floor/mineral/titanium/tiled/blue,
/area/ship/bridge)
"xu" = (
/obj/effect/turf_decal/borderfloor{
	dir = 1
	},
/obj/machinery/door/airlock/shuttle/glass{
	name = "Bridge"
	},
/turf/open/floor/mineral/titanium/tiled,
/area/ship/bridge)
"xA" = (
/obj/effect/turf_decal/corner/transparent/bar/mono,
/obj/machinery/holopad/emergency/command,
/turf/open/floor/mineral/titanium/tiled,
/area/ship/bridge)
"yF" = (
/obj/effect/turf_decal/corner_steel_grid{
	dir = 5
	},
/obj/effect/decal/cleanable/dirt/dust,
/obj/item/mmi/posibrain,
/turf/open/floor/engine,
/area/ship/science/ai_chamber)
"yT" = (
/turf/closed/wall/mineral/titanium,
/area/ship/bridge)
"zW" = (
/obj/machinery/piratepad,
/obj/effect/turf_decal/industrial/warning{
	dir = 5
	},
/turf/open/floor/engine,
/area/ship/cargo)
"Ai" = (
/obj/effect/turf_decal/corner/transparent/grey/full,
/obj/effect/turf_decal/borderfloor{
	dir = 4
	},
/obj/effect/turf_decal/siding/blue{
	dir = 4
	},
/turf/open/floor/mineral/titanium,
/area/ship/bridge)
"AF" = (
/obj/effect/turf_decal/corner/transparent/purple{
	dir = 8
	},
/turf/open/floor/mineral/titanium/white,
/area/ship/science)
"AN" = (
/obj/structure/reagent_dispensers/water_cooler,
/obj/effect/turf_decal/borderfloor{
	dir = 8
	},
/turf/open/floor/mineral/titanium/tiled/blue,
/area/ship/bridge)
"Bf" = (
/obj/machinery/door/airlock/shuttle/glass,
/obj/effect/turf_decal/borderfloor{
	dir = 4
	},
/turf/open/floor/mineral/titanium/tiled,
/area/ship/cargo)
"Br" = (
/obj/structure/table/reinforced,
/obj/effect/turf_decal/borderfloor{
	dir = 9
	},
/obj/item/paper_bin/carbon{
	pixel_y = -4;
	pixel_x = 6
	},
/obj/item/radio/intercom{
	pixel_y = 26
	},
/obj/item/flashlight/lamp{
	pixel_y = 13;
	pixel_x = -5
	},
/obj/item/pen,
/turf/open/floor/mineral/titanium/tiled/blue,
/area/ship/bridge)
"BR" = (
/obj/effect/turf_decal/corner_steel_grid/full{
	dir = 8
	},
/obj/effect/decal/cleanable/oil,
/obj/effect/decal/cleanable/dirt/dust,
/turf/open/floor/engine,
/area/ship/science/ai_chamber)
"Cf" = (
/obj/machinery/door/airlock/shuttle/glass{
	name = "Engines"
	},
/turf/open/floor/mineral/titanium/tiled,
/area/ship/science/ai_chamber)
"Dg" = (
/obj/effect/turf_decal/industrial/defective/corner{
	dir = 8
	},
/turf/open/floor/mineral/titanium/tiled,
/area/ship/science/ai_chamber)
"EE" = (
/obj/structure/rack,
/obj/effect/turf_decal/corner/transparent/purple/mono,
/obj/effect/turf_decal/borderfloorwhite,
/obj/item/storage/toolbox/electrical{
	pixel_y = 7
	},
/obj/item/storage/toolbox/mechanical,
/obj/item/storage/belt/utility/full/engi{
	pixel_y = -2
	},
/turf/open/floor/mineral/titanium/tiled/white,
/area/ship/science)
"EH" = (
/obj/effect/turf_decal/corner_steel_grid/full{
	dir = 4
	},
/obj/effect/decal/cleanable/oil/streak,
/turf/open/floor/engine,
/area/ship/science/ai_chamber)
"EU" = (
/turf/open/floor/mineral/titanium/white,
/area/ship/science)
"FM" = (
/obj/effect/turf_decal/industrial/defective{
	dir = 4
	},
/turf/open/floor/mineral/titanium/tiled,
/area/ship/science/ai_chamber)
"FZ" = (
/obj/machinery/recharge_station,
/obj/effect/turf_decal/borderfloorwhite{
	dir = 10
	},
/obj/structure/railing,
/turf/open/floor/plating,
/area/ship/science)
"Hv" = (
/turf/closed/wall/mineral/titanium/nodiagonal,
/area/ship/cargo)
"IG" = (
/obj/machinery/computer/piratepad_control{
	dir = 4
	},
/obj/effect/turf_decal/industrial/warning{
	dir = 4
	},
/turf/open/floor/engine,
/area/ship/cargo)
"Kc" = (
/obj/effect/turf_decal/borderfloor{
	dir = 1
	},
/turf/open/floor/mineral/titanium/tiled/blue,
/area/ship/bridge)
"LG" = (
/obj/effect/turf_decal/chapel,
/obj/effect/turf_decal/borderfloor{
	dir = 6
	},
/obj/effect/turf_decal/siding/blue{
	dir = 6
	},
/turf/open/floor/mineral/titanium,
/area/ship/bridge)
"LW" = (
/obj/machinery/computer/crew{
	dir = 4
	},
/obj/effect/turf_decal/corner/transparent/ntblue/full,
/turf/open/floor/mineral/titanium,
/area/ship/bridge)
"NW" = (
/obj/machinery/door/airlock/shuttle/glass{
	name = "Research"
	},
/obj/effect/turf_decal/borderfloorwhite{
	dir = 8
	},
/turf/open/floor/mineral/titanium/tiled,
/area/ship/science)
"Oq" = (
/obj/effect/turf_decal/industrial/defective/corner,
/turf/open/floor/mineral/titanium/tiled,
/area/ship/science/ai_chamber)
"Ou" = (
/obj/effect/turf_decal/corner_steel_grid{
	dir = 9
	},
/turf/open/floor/engine,
/area/ship/science/ai_chamber)
"OL" = (
/obj/machinery/computer/cargo/express{
	dir = 8
	},
/obj/effect/turf_decal/corner/transparent/ntblue/full,
/turf/open/floor/mineral/titanium,
/area/ship/bridge)
"Pi" = (
/obj/machinery/computer/med_data{
	dir = 4
	},
/obj/effect/turf_decal/corner/transparent/ntblue/full,
/turf/open/floor/mineral/titanium,
/area/ship/bridge)
"PF" = (
/obj/effect/turf_decal/industrial/traffic{
	dir = 8
	},
/obj/effect/turf_decal/industrial/traffic{
	dir = 4
	},
/obj/structure/fans/tiny,
/obj/machinery/door/poddoor{
	id = "cargo_chumtoad";
	name = "Cargo Bay"
	},
/turf/open/floor/plating,
/area/ship/cargo)
"PR" = (
/obj/machinery/door/airlock/shuttle/glass{
	name = "Engines"
	},
/turf/open/floor/mineral/titanium,
/area/ship/cargo)
"PW" = (
/obj/effect/turf_decal/industrial/defective,
/turf/open/floor/mineral/titanium/tiled,
/area/ship/science/ai_chamber)
"Qw" = (
/turf/closed/wall/mineral/titanium,
/area/ship/cargo)
"RL" = (
/obj/machinery/modular_computer/console/preset/id{
	dir = 8
	},
/obj/effect/turf_decal/corner/transparent/ntblue/full,
/turf/open/floor/mineral/titanium,
/area/ship/bridge)
"Sp" = (
/obj/machinery/button/door{
	id = "cargo_chumtoad";
	name = "cargobay doors";
	dir = 8;
	pixel_x = 27
	},
/turf/open/floor/mineral/titanium,
/area/ship/cargo)
"Sv" = (
/turf/open/floor/mineral/titanium,
/area/ship/cargo)
"Tp" = (
/obj/effect/turf_decal/corner/transparent/purple{
	dir = 6
	},
/obj/structure/table,
/turf/open/floor/mineral/titanium/white,
/area/ship/science)
"Tt" = (
/turf/template_noop,
/area/template_noop)
"Tw" = (
/obj/structure/chair/office{
	dir = 4
	},
/obj/effect/turf_decal/borderfloor{
	dir = 4
	},
/turf/open/floor/mineral/titanium/tiled/blue,
/area/ship/bridge)
"TB" = (
/obj/effect/turf_decal/borderfloor{
	dir = 4
	},
/turf/open/floor/mineral/titanium/tiled/blue,
/area/ship/bridge)
"VN" = (
/turf/open/floor/mineral/titanium/tiled/blue,
/area/ship/bridge)
"Wx" = (
/obj/structure/tank_dispenser/oxygen,
/turf/open/floor/mineral/titanium,
/area/ship/cargo)
"WJ" = (
/obj/effect/turf_decal/corner_steel_grid/full,
/obj/effect/decal/cleanable/dirt/dust,
/turf/open/floor/engine,
/area/ship/science/ai_chamber)
"WS" = (
/obj/effect/turf_decal/borderfloor{
	dir = 4
	},
/obj/item/toy/plush/lizardplushie,
/obj/item/kirbyplants/random,
/turf/open/floor/mineral/titanium/tiled/blue,
/area/ship/bridge)
"Xp" = (
/obj/effect/turf_decal/chapel{
	dir = 1
	},
/obj/effect/turf_decal/borderfloor{
	dir = 9
	},
/obj/effect/turf_decal/siding/blue{
	dir = 9
	},
/turf/open/floor/mineral/titanium,
/area/ship/bridge)
"Xr" = (
/obj/effect/turf_decal/industrial/defective/corner{
	dir = 1
	},
/turf/open/floor/mineral/titanium/tiled,
/area/ship/science/ai_chamber)
"Xw" = (
/turf/closed/wall/mineral/titanium,
/area/ship/science/ai_chamber)
"XJ" = (
/obj/effect/spawner/structure/window/shuttle,
/turf/open/floor/plating,
/area/ship/science)
"Yn" = (
/obj/effect/turf_decal/borderfloorwhite{
	dir = 1
	},
/obj/machinery/door/airlock/shuttle/glass{
	name = "Engines"
	},
/turf/open/floor/mineral/titanium/tiled,
/area/ship/science)
"YG" = (
/obj/effect/turf_decal/corner/transparent/grey/full,
/obj/effect/turf_decal/borderfloor{
	dir = 2
	},
/obj/effect/turf_decal/siding/blue,
/turf/open/floor/mineral/titanium,
/area/ship/bridge)
"YZ" = (
/obj/effect/turf_decal/industrial/warning{
	dir = 6
	},
/obj/machinery/suit_storage_unit/mining/eva,
/turf/open/floor/engine,
/area/ship/cargo)
"ZK" = (
/obj/effect/spawner/structure/window/shuttle,
/turf/open/floor/plating,
/area/ship/bridge)
"ZN" = (
/obj/effect/turf_decal/chapel{
	dir = 4
	},
/obj/effect/turf_decal/borderfloor{
	dir = 5
	},
/obj/effect/turf_decal/siding/blue{
	dir = 5
	},
/turf/open/floor/mineral/titanium,
/area/ship/bridge)

(1,1,1) = {"
Tt
Tt
Tt
Tt
Tt
Tt
Tt
Tt
Tt
Tt
Tt
Tt
Tt
Tt
Tt
Tt
Tt
Tt
Tt
Tt
Tt
Tt
Tt
Tt
Tt
Tt
Tt
Tt
Tt
Tt
Tt
Tt
Tt
Tt
Tt
Tt
Tt
Tt
Tt
Tt
Tt
Tt
Tt
Tt
Tt
Tt
Tt
Tt
Tt
Tt
Tt
Tt
Tt
Tt
Tt
Tt
"}
(2,1,1) = {"
Tt
Tt
Tt
Tt
Tt
Tt
Tt
Tt
Tt
Tt
Tt
Tt
Tt
Tt
Tt
Tt
Tt
Tt
Tt
Tt
Tt
Tt
Tt
Tt
Tt
Tt
Tt
Tt
Tt
Tt
Tt
Tt
Tt
Tt
Tt
Tt
Tt
Tt
Tt
Tt
Tt
Tt
Tt
Tt
Tt
Tt
Tt
Tt
Tt
Tt
Tt
Tt
Tt
Tt
Tt
Tt
"}
(3,1,1) = {"
Tt
Tt
Tt
Tt
Tt
Tt
Tt
Tt
Tt
Tt
Tt
Tt
Tt
Tt
Tt
Tt
Tt
Tt
Tt
Tt
Tt
Tt
Tt
Tt
Tt
Tt
Tt
Tt
Tt
Tt
Tt
Tt
Tt
Tt
Tt
Tt
Tt
Tt
Tt
Tt
Tt
Tt
Tt
Tt
Tt
Tt
Tt
Tt
Tt
Tt
Tt
Tt
Tt
Tt
Tt
Tt
"}
(4,1,1) = {"
Tt
Tt
Tt
Tt
Tt
Tt
Tt
Tt
Tt
Tt
Tt
Tt
Tt
Tt
Tt
Tt
Tt
Tt
Tt
Tt
Tt
Tt
Tt
Tt
Tt
Tt
Tt
Tt
Tt
Tt
Tt
Tt
Tt
Tt
Tt
Tt
Tt
Tt
Tt
Tt
Tt
Tt
Tt
Tt
Tt
Tt
Tt
Tt
Tt
Tt
Tt
Tt
Tt
Tt
Tt
Tt
"}
(5,1,1) = {"
Tt
Tt
Tt
Tt
Tt
Tt
Tt
Tt
Tt
Tt
Tt
Tt
Tt
Tt
Tt
Tt
Tt
Tt
Tt
Tt
Tt
Tt
Tt
Tt
Tt
Tt
Tt
Tt
Tt
Tt
Tt
Tt
Tt
Tt
Tt
Tt
Tt
Tt
Tt
Tt
Tt
Tt
Tt
Tt
Tt
Tt
Tt
Tt
Tt
Tt
Tt
Tt
Tt
Tt
Tt
Tt
"}
(6,1,1) = {"
Tt
Tt
Tt
Tt
Tt
Tt
Tt
Tt
Tt
Tt
Tt
Tt
Tt
Tt
Tt
Tt
Tt
Tt
Tt
Tt
Tt
Tt
Tt
Tt
Tt
Tt
Tt
Tt
Tt
Tt
Tt
Tt
Tt
Tt
Tt
Tt
Tt
Tt
Tt
Tt
Tt
Tt
Tt
Tt
Tt
Tt
Tt
Tt
Tt
Tt
Tt
Tt
Tt
Tt
Tt
Tt
"}
(7,1,1) = {"
Tt
Tt
Tt
Tt
Tt
Tt
Tt
Tt
Tt
Tt
Tt
Tt
Tt
Tt
Tt
Tt
Tt
Tt
Tt
Tt
Tt
Tt
Tt
Tt
Tt
Tt
Tt
Tt
Tt
Tt
Tt
Tt
Tt
Tt
Tt
Tt
Tt
Tt
Tt
Tt
Tt
Tt
Tt
Tt
Tt
Tt
Tt
Tt
Tt
Tt
Tt
Tt
Tt
Tt
Tt
Tt
"}
(8,1,1) = {"
Tt
Tt
Tt
Tt
Tt
Tt
Tt
Tt
Tt
Tt
Tt
Tt
Tt
Tt
Tt
Tt
Tt
Tt
Tt
Tt
Tt
Tt
Tt
Tt
Tt
Tt
Tt
Tt
Tt
Tt
Tt
Tt
Tt
Tt
Tt
Tt
Tt
Tt
Tt
Tt
Tt
Tt
Tt
Tt
Tt
Tt
Tt
Tt
Tt
Tt
Tt
Tt
Tt
Tt
Tt
Tt
"}
(9,1,1) = {"
Tt
Tt
Tt
Tt
Tt
Tt
Tt
Tt
Tt
Tt
Tt
Tt
Tt
Tt
Tt
Tt
Tt
Tt
Tt
Tt
Tt
Tt
Tt
Tt
Tt
Tt
Tt
Tt
Tt
Tt
Tt
Tt
Tt
Tt
Tt
Tt
Tt
Tt
Tt
Tt
Tt
Tt
Tt
Tt
Tt
Tt
Tt
Tt
Tt
Tt
Tt
Tt
Tt
Tt
Tt
Tt
"}
(10,1,1) = {"
Tt
Tt
Tt
Tt
Tt
Tt
Tt
Tt
Tt
Tt
Tt
Tt
Tt
Tt
Tt
Tt
Tt
Tt
Tt
Tt
Tt
Tt
Tt
Tt
Tt
Tt
Tt
Tt
Tt
Tt
Tt
Tt
Tt
Tt
Tt
Tt
Tt
Tt
Tt
Tt
Tt
Tt
Tt
Tt
Tt
Tt
Tt
Tt
Tt
Tt
Tt
Tt
Tt
Tt
Tt
Tt
"}
(11,1,1) = {"
Tt
Tt
Tt
Tt
Tt
Tt
Tt
Tt
Tt
Tt
Tt
Tt
Tt
Tt
Tt
Tt
Tt
Tt
Tt
Tt
Tt
Tt
Tt
Tt
Tt
Tt
Tt
Tt
Tt
Tt
Tt
Tt
Tt
Tt
Tt
Tt
Tt
Tt
Tt
Tt
Tt
Tt
Tt
Tt
Tt
Tt
Tt
Tt
Tt
Tt
Tt
Tt
Tt
Tt
Tt
Tt
"}
(12,1,1) = {"
Tt
Tt
Tt
Tt
Tt
Tt
Tt
Tt
Tt
Tt
Tt
Tt
Tt
Tt
Tt
Tt
Tt
Tt
Tt
Tt
Tt
Tt
Tt
Tt
Tt
Tt
Tt
Tt
Tt
Tt
Tt
Tt
Tt
Tt
Tt
Tt
Tt
Tt
Tt
Tt
Tt
Tt
Tt
Tt
Tt
Tt
Tt
Tt
Tt
Tt
Tt
Tt
Tt
Tt
Tt
Tt
"}
(13,1,1) = {"
Tt
Tt
Tt
Tt
Tt
Tt
Tt
Tt
Tt
cH
cH
cH
Tt
Tt
Tt
Tt
Tt
Tt
Tt
Tt
Tt
Tt
Tt
Tt
Tt
Tt
Tt
Tt
Tt
Tt
Tt
Tt
Tt
Tt
Tt
Tt
Tt
Tt
Tt
Tt
Tt
Tt
Tt
Tt
Tt
Tt
Tt
Tt
Tt
Tt
Tt
Tt
Tt
Tt
Tt
Tt
"}
(14,1,1) = {"
Tt
Tt
Tt
Tt
Tt
Tt
Tt
mH
mH
XJ
XJ
XJ
mH
mH
Tt
Tt
Tt
Tt
Tt
Tt
Tt
Tt
Tt
Tt
Tt
Tt
Tt
Tt
Tt
Tt
Tt
Tt
Tt
Tt
Tt
Tt
Tt
Tt
Tt
Tt
Tt
Tt
Tt
Tt
Tt
Tt
Tt
Tt
Tt
Tt
Tt
Tt
Tt
Tt
Tt
Tt
"}
(15,1,1) = {"
Tt
Tt
Tt
Tt
Tt
Tt
mH
hC
EE
AF
gf
fO
tv
hC
mH
Tt
Tt
Tt
Tt
Tt
Tt
Tt
Tt
Tt
Tt
Tt
Tt
Tt
Tt
Tt
Tt
Tt
Tt
Tt
Tt
Tt
Tt
Tt
Tt
Tt
Tt
Tt
Tt
Tt
Tt
Tt
Tt
Tt
Tt
Tt
Tt
Tt
Tt
Tt
Tt
Tt
"}
(16,1,1) = {"
Tt
Tt
Tt
Tt
Tt
Tt
mH
hU
hd
EU
EU
EU
EU
EU
Yn
Tt
Tt
Tt
Tt
Tt
Tt
Tt
Tt
Tt
Tt
Tt
Tt
Tt
Tt
Tt
Tt
Tt
Tt
Tt
Tt
Tt
Tt
Tt
Tt
Tt
Tt
Tt
Tt
Tt
Tt
Tt
Tt
Tt
Tt
Tt
Tt
Tt
Tt
Tt
Tt
Tt
"}
(17,1,1) = {"
Tt
Tt
Tt
Tt
Tt
yT
yT
yT
oI
rA
FZ
EU
he
Tp
mH
Tt
Tt
Tt
Tt
Tt
Tt
Tt
Tt
Tt
Tt
Tt
Tt
Tt
Tt
Tt
Tt
Tt
Tt
Tt
Tt
Tt
Tt
Tt
Tt
Tt
Tt
Tt
Tt
Tt
Tt
Tt
Tt
Tt
Tt
Tt
Tt
Tt
Tt
Tt
Tt
Tt
"}
(18,1,1) = {"
Tt
Tt
yT
ZK
ZK
oI
gc
Pi
yT
mH
mH
NW
mH
mH
mH
Tt
Tt
Tt
Tt
Tt
Tt
Tt
Tt
Tt
Tt
Tt
Tt
Tt
Tt
Tt
Tt
Tt
Tt
Tt
Tt
Tt
Tt
Tt
Tt
Tt
Tt
Tt
Tt
Tt
Tt
Tt
Tt
Tt
Tt
Tt
Tt
Tt
Tt
Tt
Tt
Tt
"}
(19,1,1) = {"
Tt
ZK
oI
Br
uJ
AN
ke
fa
yT
Oq
FM
FM
FM
me
Xw
Tt
Tt
Tt
Tt
Tt
Tt
Tt
Tt
Tt
Tt
Tt
Tt
Tt
Tt
Tt
Tt
Tt
Tt
Tt
Tt
Tt
Tt
Tt
Tt
Tt
Tt
Tt
Tt
Tt
Tt
Tt
Tt
Tt
Tt
Tt
Tt
Tt
Tt
Tt
Tt
Tt
"}
(20,1,1) = {"
ZK
ZK
LW
Kc
Xp
jQ
bs
VN
yT
PW
BR
Ou
WJ
jk
Xw
Tt
Tt
Tt
Tt
Tt
Tt
Tt
Tt
Tt
Tt
Tt
Tt
Tt
Tt
Tt
Tt
Tt
Tt
Tt
Tt
Tt
Tt
Tt
Tt
Tt
Tt
Tt
Tt
Tt
Tt
Tt
Tt
Tt
Tt
Tt
Tt
Tt
Tt
Tt
Tt
Tt
"}
(21,1,1) = {"
ZK
lq
qh
Kc
wd
xA
YG
VN
xu
PW
yF
mv
vD
jk
Cf
Tt
Tt
Tt
Tt
Tt
Tt
Tt
Tt
Tt
Tt
Tt
Tt
Tt
Tt
Tt
Tt
Tt
Tt
Tt
Tt
Tt
Tt
Tt
Tt
Tt
Tt
Tt
Tt
Tt
Tt
Tt
Tt
Tt
Tt
Tt
Tt
Tt
Tt
Tt
Tt
Tt
"}
(22,1,1) = {"
ZK
ZK
RL
Kc
ZN
Ai
LG
VN
yT
PW
qN
jF
EH
jk
Xw
Tt
Tt
Tt
Tt
Tt
Tt
Tt
Tt
Tt
Tt
Tt
Tt
Tt
Tt
Tt
Tt
Tt
Tt
Tt
Tt
Tt
Tt
Tt
Tt
Tt
Tt
Tt
Tt
Tt
Tt
Tt
Tt
Tt
Tt
Tt
Tt
Tt
Tt
Tt
Tt
Tt
"}
(23,1,1) = {"
Tt
ZK
oI
cj
wU
WS
TB
Tw
yT
Dg
rh
rh
rh
Xr
Xw
Tt
Tt
Tt
Tt
Tt
Tt
Tt
Tt
Tt
Tt
Tt
Tt
Tt
Tt
Tt
Tt
Tt
Tt
Tt
Tt
Tt
Tt
Tt
Tt
Tt
Tt
Tt
Tt
Tt
Tt
Tt
Tt
Tt
Tt
Tt
Tt
Tt
Tt
Tt
Tt
Tt
"}
(24,1,1) = {"
Tt
Tt
yT
ZK
ZK
oI
bh
OL
yT
Qw
Qw
Bf
Qw
Qw
Qw
Tt
Tt
Tt
Tt
Tt
Tt
Tt
Tt
Tt
Tt
Tt
Tt
Tt
Tt
Tt
Tt
Tt
Tt
Tt
Tt
Tt
Tt
Tt
Tt
Tt
Tt
Tt
Tt
Tt
Tt
Tt
Tt
Tt
Tt
Tt
Tt
Tt
Tt
Tt
Tt
Tt
"}
(25,1,1) = {"
Tt
Tt
Tt
Tt
Tt
yT
yT
yT
oI
sM
YZ
Sv
zW
IG
Qw
Tt
Tt
Tt
Tt
Tt
Tt
Tt
Tt
Tt
Tt
Tt
Tt
Tt
Tt
Tt
Tt
Tt
Tt
Tt
Tt
Tt
Tt
Tt
Tt
Tt
Tt
Tt
Tt
Tt
Tt
Tt
Tt
Tt
Tt
Tt
Tt
Tt
Tt
Tt
Tt
Tt
"}
(26,1,1) = {"
Tt
Tt
Tt
Tt
Tt
Tt
Qw
ri
Sv
Sv
Sv
Sv
Sv
Sv
PR
Tt
Tt
Tt
Tt
Tt
Tt
Tt
Tt
Tt
Tt
Tt
Tt
Tt
Tt
Tt
Tt
Tt
Tt
Tt
Tt
Tt
Tt
Tt
Tt
Tt
Tt
Tt
Tt
Tt
Tt
Tt
Tt
Tt
Tt
Tt
Tt
Tt
Tt
Tt
Tt
Tt
"}
(27,1,1) = {"
Tt
Tt
Tt
Tt
Tt
Tt
Qw
Hv
Sp
Sv
Sv
Sv
Wx
Qw
Qw
Tt
Tt
Tt
Tt
Tt
Tt
Tt
Tt
Tt
Tt
Tt
Tt
Tt
Tt
Tt
Tt
Tt
Tt
Tt
Tt
Tt
Tt
Tt
Tt
Tt
Tt
Tt
Tt
Tt
Tt
Tt
Tt
Tt
Tt
Tt
Tt
Tt
Tt
Tt
Tt
Tt
"}
(28,1,1) = {"
Tt
Tt
Tt
Tt
Tt
Tt
Tt
Qw
Qw
PF
PF
PF
Qw
Qw
Tt
Tt
Tt
Tt
Tt
Tt
Tt
Tt
Tt
Tt
Tt
Tt
Tt
Tt
Tt
Tt
Tt
Tt
Tt
Tt
Tt
Tt
Tt
Tt
Tt
Tt
Tt
Tt
Tt
Tt
Tt
Tt
Tt
Tt
Tt
Tt
Tt
Tt
Tt
Tt
Tt
Tt
"}
(29,1,1) = {"
Tt
Tt
Tt
Tt
Tt
Tt
Tt
Tt
Tt
cH
cH
cH
Tt
Tt
Tt
Tt
Tt
Tt
Tt
Tt
Tt
Tt
Tt
Tt
Tt
Tt
Tt
Tt
Tt
Tt
Tt
Tt
Tt
Tt
Tt
Tt
Tt
Tt
Tt
Tt
Tt
Tt
Tt
Tt
Tt
Tt
Tt
Tt
Tt
Tt
Tt
Tt
Tt
Tt
Tt
Tt
"}
(30,1,1) = {"
Tt
Tt
Tt
Tt
Tt
Tt
Tt
Tt
Tt
Tt
Tt
Tt
Tt
Tt
Tt
Tt
Tt
Tt
Tt
Tt
Tt
Tt
Tt
Tt
Tt
Tt
Tt
Tt
Tt
Tt
Tt
Tt
Tt
Tt
Tt
Tt
Tt
Tt
Tt
Tt
Tt
Tt
Tt
Tt
Tt
Tt
Tt
Tt
Tt
Tt
Tt
Tt
Tt
Tt
Tt
Tt
"}
(31,1,1) = {"
Tt
Tt
Tt
Tt
Tt
Tt
Tt
Tt
Tt
Tt
Tt
Tt
Tt
Tt
Tt
Tt
Tt
Tt
Tt
Tt
Tt
Tt
Tt
Tt
Tt
Tt
Tt
Tt
Tt
Tt
Tt
Tt
Tt
Tt
Tt
Tt
Tt
Tt
Tt
Tt
Tt
Tt
Tt
Tt
Tt
Tt
Tt
Tt
Tt
Tt
Tt
Tt
Tt
Tt
Tt
Tt
"}
(32,1,1) = {"
Tt
Tt
Tt
Tt
Tt
Tt
Tt
Tt
Tt
Tt
Tt
Tt
Tt
Tt
Tt
Tt
Tt
Tt
Tt
Tt
Tt
Tt
Tt
Tt
Tt
Tt
Tt
Tt
Tt
Tt
Tt
Tt
Tt
Tt
Tt
Tt
Tt
Tt
Tt
Tt
Tt
Tt
Tt
Tt
Tt
Tt
Tt
Tt
Tt
Tt
Tt
Tt
Tt
Tt
Tt
Tt
"}
(33,1,1) = {"
Tt
Tt
Tt
Tt
Tt
Tt
Tt
Tt
Tt
Tt
Tt
Tt
Tt
Tt
Tt
Tt
Tt
Tt
Tt
Tt
Tt
Tt
Tt
Tt
Tt
Tt
Tt
Tt
Tt
Tt
Tt
Tt
Tt
Tt
Tt
Tt
Tt
Tt
Tt
Tt
Tt
Tt
Tt
Tt
Tt
Tt
Tt
Tt
Tt
Tt
Tt
Tt
Tt
Tt
Tt
Tt
"}
(34,1,1) = {"
Tt
Tt
Tt
Tt
Tt
Tt
Tt
Tt
Tt
Tt
Tt
Tt
Tt
Tt
Tt
Tt
Tt
Tt
Tt
Tt
Tt
Tt
Tt
Tt
Tt
Tt
Tt
Tt
Tt
Tt
Tt
Tt
Tt
Tt
Tt
Tt
Tt
Tt
Tt
Tt
Tt
Tt
Tt
Tt
Tt
Tt
Tt
Tt
Tt
Tt
Tt
Tt
Tt
Tt
Tt
Tt
"}
(35,1,1) = {"
Tt
Tt
Tt
Tt
Tt
Tt
Tt
Tt
Tt
Tt
Tt
Tt
Tt
Tt
Tt
Tt
Tt
Tt
Tt
Tt
Tt
Tt
Tt
Tt
Tt
Tt
Tt
Tt
Tt
Tt
Tt
Tt
Tt
Tt
Tt
Tt
Tt
Tt
Tt
Tt
Tt
Tt
Tt
Tt
Tt
Tt
Tt
Tt
Tt
Tt
Tt
Tt
Tt
Tt
Tt
Tt
"}
(36,1,1) = {"
Tt
Tt
Tt
Tt
Tt
Tt
Tt
Tt
Tt
Tt
Tt
Tt
Tt
Tt
Tt
Tt
Tt
Tt
Tt
Tt
Tt
Tt
Tt
Tt
Tt
Tt
Tt
Tt
Tt
Tt
Tt
Tt
Tt
Tt
Tt
Tt
Tt
Tt
Tt
Tt
Tt
Tt
Tt
Tt
Tt
Tt
Tt
Tt
Tt
Tt
Tt
Tt
Tt
Tt
Tt
Tt
"}
(37,1,1) = {"
Tt
Tt
Tt
Tt
Tt
Tt
Tt
Tt
Tt
Tt
Tt
Tt
Tt
Tt
Tt
Tt
Tt
Tt
Tt
Tt
Tt
Tt
Tt
Tt
Tt
Tt
Tt
Tt
Tt
Tt
Tt
Tt
Tt
Tt
Tt
Tt
Tt
Tt
Tt
Tt
Tt
Tt
Tt
Tt
Tt
Tt
Tt
Tt
Tt
Tt
Tt
Tt
Tt
Tt
Tt
Tt
"}
(38,1,1) = {"
Tt
Tt
Tt
Tt
Tt
Tt
Tt
Tt
Tt
Tt
Tt
Tt
Tt
Tt
Tt
Tt
Tt
Tt
Tt
Tt
Tt
Tt
Tt
Tt
Tt
Tt
Tt
Tt
Tt
Tt
Tt
Tt
Tt
Tt
Tt
Tt
Tt
Tt
Tt
Tt
Tt
Tt
Tt
Tt
Tt
Tt
Tt
Tt
Tt
Tt
Tt
Tt
Tt
Tt
Tt
Tt
"}
(39,1,1) = {"
Tt
Tt
Tt
Tt
Tt
Tt
Tt
Tt
Tt
Tt
Tt
Tt
Tt
Tt
Tt
Tt
Tt
Tt
Tt
Tt
Tt
Tt
Tt
Tt
Tt
Tt
Tt
Tt
Tt
Tt
Tt
Tt
Tt
Tt
Tt
Tt
Tt
Tt
Tt
Tt
Tt
Tt
Tt
Tt
Tt
Tt
Tt
Tt
Tt
Tt
Tt
Tt
Tt
Tt
Tt
Tt
"}
(40,1,1) = {"
Tt
Tt
Tt
Tt
Tt
Tt
Tt
Tt
Tt
Tt
Tt
Tt
Tt
Tt
Tt
Tt
Tt
Tt
Tt
Tt
Tt
Tt
Tt
Tt
Tt
Tt
Tt
Tt
Tt
Tt
Tt
Tt
Tt
Tt
Tt
Tt
Tt
Tt
Tt
Tt
Tt
Tt
Tt
Tt
Tt
Tt
Tt
Tt
Tt
Tt
Tt
Tt
Tt
Tt
Tt
Tt
"}
