//MAP CONVERTED BY dmm2tgm.py THIS HEADER COMMENT PREVENTS RECONVERSION, DO NOT REMOVE
"aa" = (
/obj/machinery/atmospherics/pipe/simple/supply/hidden/layer2{
	dir = 9
	},
/obj/machinery/atmospherics/pipe/simple/scrubbers/hidden/layer4{
	dir = 10
	},
/obj/structure/cable{
	icon_state = "1-8"
	},
/turf/open/floor/plasteel/white,
/area/ship/bridge)
"ah" = (
/obj/machinery/power/apc/auto_name/west,
/obj/structure/cable{
	icon_state = "0-2"
	},
/turf/open/floor/plasteel/tech/techmaint,
/area/ship/hallway/central)
"aQ" = (
/turf/closed/wall/mineral/plastitanium,
/area/space)
"aT" = (
/turf/open/floor/plasteel/white,
/area/ship/bridge)
"bA" = (
/obj/structure/table/wood,
/turf/open/floor/carpet/blue,
/area/ship/crew)
"bI" = (
/obj/machinery/cryopod{
	dir = 8
	},
/obj/machinery/atmospherics/components/unary/vent_pump/on/layer2{
	dir = 8
	},
/obj/effect/turf_decal/industrial/hatch/blue,
/turf/open/floor/plasteel/tech/grid,
/area/ship/crew)
"bO" = (
/turf/closed/wall/mineral/plastitanium,
/area/ship/bridge)
"co" = (
/obj/machinery/atmospherics/pipe/simple/supply/hidden/layer2{
	dir = 4
	},
/obj/machinery/atmospherics/pipe/simple/scrubbers/hidden/layer4{
	dir = 8
	},
/obj/structure/cable{
	icon_state = "4-8"
	},
/turf/open/floor/plasteel/tech/techmaint,
/area/ship/hallway/central)
"cw" = (
/turf/open/space/basic,
/area/space)
"cL" = (
/obj/structure/cable{
	icon_state = "1-8"
	},
/obj/structure/cable{
	icon_state = "1-2"
	},
/obj/machinery/atmospherics/pipe/simple/scrubbers/hidden/layer4,
/obj/machinery/atmospherics/pipe/manifold/supply/hidden/layer2{
	dir = 8
	},
/obj/machinery/power/terminal{
	dir = 8
	},
/turf/open/floor/plating,
/area/ship/engineering)
"cY" = (
/obj/machinery/porta_turret/centcom_shuttle/weak,
/turf/closed/wall/mineral/plastitanium,
/area/ship/bridge)
"dj" = (
/obj/structure/chair/comfy/brown{
	dir = 8
	},
/turf/open/floor/plating,
/area/ship/engineering)
"dq" = (
/obj/machinery/door/airlock/command{
	name = "Bridge"
	},
/obj/machinery/door/poddoor/shutters/preopen{
	id = "intelfucky"
	},
/obj/machinery/atmospherics/pipe/simple/supply/hidden/layer2{
	dir = 4
	},
/obj/machinery/atmospherics/pipe/simple/scrubbers/hidden/layer4{
	dir = 8
	},
/obj/structure/cable{
	icon_state = "4-8"
	},
/turf/open/floor/plasteel/tech/techmaint,
/area/ship/bridge)
"dr" = (
/obj/structure/window/reinforced/spawner/north,
/obj/structure/rack,
/obj/item/pickaxe,
/obj/item/pickaxe,
/obj/effect/spawner/lootdrop/maintenance/three,
/turf/open/floor/plating,
/area/ship/cargo)
"dx" = (
/obj/machinery/atmospherics/pipe/simple/scrubbers/hidden/layer4{
	dir = 5
	},
/turf/open/floor/wood,
/area/ship/crew)
"dA" = (
/obj/structure/table/wood,
/obj/machinery/photocopier/faxmachine/longrange,
/obj/item/toy/figure/detective{
	name = "Intel Buddy";
	pixel_y = 10;
	pixel_x = 5
	},
/turf/open/floor/wood,
/area/ship/cargo/office)
"dN" = (
/obj/machinery/power/smes/shuttle/precharged{
	dir = 4
	},
/obj/structure/window/reinforced{
	dir = 8
	},
/turf/closed/wall/mineral/plastitanium,
/area/ship/engineering)
"dZ" = (
/obj/machinery/cryopod{
	dir = 8
	},
/obj/machinery/atmospherics/components/unary/vent_scrubber/on/layer4{
	dir = 8
	},
/obj/effect/turf_decal/industrial/hatch/blue,
/turf/open/floor/plasteel/tech/grid,
/area/ship/crew)
"ej" = (
/obj/machinery/atmospherics/pipe/manifold/supply/hidden/layer2,
/obj/machinery/atmospherics/pipe/simple/scrubbers/hidden/layer4{
	dir = 8
	},
/obj/structure/cable{
	icon_state = "4-8"
	},
/obj/machinery/airalarm/all_access{
	dir = 1;
	pixel_y = -25
	},
/turf/open/floor/plasteel/tech/techmaint,
/area/ship/hallway/central)
"ev" = (
/obj/machinery/door/window{
	dir = 1
	},
/obj/machinery/atmospherics/pipe/simple/supply/hidden/layer2,
/obj/machinery/atmospherics/pipe/simple/scrubbers/hidden/layer4,
/obj/structure/cable{
	icon_state = "1-2"
	},
/turf/open/floor/plasteel/stairs,
/area/ship/cargo)
"fk" = (
/obj/machinery/door/airlock/centcom{
	name = "Restroom"
	},
/turf/open/floor/plasteel/tech/techmaint,
/area/ship/crew)
"fy" = (
/obj/structure/chair/greyscale{
	dir = 4
	},
/turf/open/floor/plasteel/dark,
/area/ship/bridge)
"gj" = (
/obj/structure/cable{
	icon_state = "2-8"
	},
/obj/structure/cable{
	icon_state = "1-2"
	},
/obj/machinery/atmospherics/pipe/simple/supply/hidden/layer2,
/obj/machinery/atmospherics/pipe/simple/supply/hidden/layer2,
/obj/machinery/atmospherics/pipe/simple/scrubbers/hidden/layer4{
	dir = 6
	},
/obj/machinery/power/terminal{
	dir = 8
	},
/obj/structure/cable{
	icon_state = "2-4"
	},
/turf/open/floor/plating,
/area/ship/engineering)
"gP" = (
/obj/machinery/door/poddoor{
	id = "scbay"
	},
/obj/structure/fans/tiny,
/turf/open/floor/plating,
/area/ship/cargo)
"hr" = (
/obj/structure/cable{
	icon_state = "2-8"
	},
/obj/machinery/atmospherics/components/unary/vent_pump/on/layer2,
/obj/machinery/power/terminal{
	dir = 8
	},
/turf/open/floor/plating,
/area/ship/engineering)
"hT" = (
/obj/structure/closet/wall{
	pixel_y = -28;
	dir = 1
	},
/obj/item/storage/firstaid,
/obj/item/storage/firstaid,
/turf/open/floor/wood,
/area/ship/crew)
"ii" = (
/obj/machinery/power/apc/auto_name/east,
/obj/structure/cable{
	icon_state = "1-8"
	},
/obj/structure/cable{
	icon_state = "0-8"
	},
/obj/effect/decal/cleanable/oil,
/turf/open/floor/plating,
/area/ship/engineering)
"im" = (
/obj/machinery/computer/cargo/express{
	dir = 8
	},
/obj/machinery/button{
	id = "intelfucky";
	pixel_y = -24;
	pixel_x = -4;
	name = "Privacy Lock"
	},
/turf/open/floor/plasteel/dark,
/area/ship/bridge)
"in" = (
/obj/machinery/power/apc/auto_name/north,
/obj/structure/cable{
	icon_state = "0-2"
	},
/obj/structure/chair/sofa/left,
/turf/open/floor/wood,
/area/ship/crew)
"iL" = (
/obj/machinery/atmospherics/pipe/simple/supply/hidden/layer2{
	dir = 4
	},
/obj/machinery/atmospherics/pipe/simple/supply/hidden/layer2{
	dir = 4
	},
/obj/machinery/atmospherics/pipe/simple/scrubbers/hidden/layer4{
	dir = 8
	},
/obj/structure/cable{
	icon_state = "4-8"
	},
/turf/open/floor/plasteel/tech/techmaint,
/area/ship/engineering)
"iN" = (
/obj/structure/table/wood,
/obj/item/toy/cards/deck,
/obj/machinery/light/small/broken{
	dir = 1
	},
/turf/open/floor/plating,
/area/ship/engineering)
"iY" = (
/obj/machinery/atmospherics/pipe/simple/supply/hidden/layer2{
	dir = 5
	},
/obj/structure/table,
/obj/machinery/airalarm/all_access{
	dir = 4;
	pixel_x = -25
	},
/obj/item/storage/toolbox/mechanical{
	pixel_y = 8
	},
/obj/item/storage/toolbox/electrical,
/turf/open/floor/plating,
/area/ship/engineering)
"jj" = (
/turf/closed/wall/mineral/plastitanium,
/area/ship/cargo)
"jH" = (
/obj/structure/cable{
	icon_state = "4-8"
	},
/obj/machinery/door/window{
	dir = 4
	},
/obj/machinery/light/small{
	dir = 1
	},
/turf/open/floor/wood,
/area/ship/cargo/office)
"jW" = (
/obj/machinery/atmospherics/components/unary/tank/air,
/obj/effect/turf_decal/box,
/turf/open/floor/plating,
/area/ship/engineering)
"kb" = (
/obj/machinery/atmospherics/components/unary/vent_pump/on/layer2,
/turf/open/floor/plasteel/tech/techmaint,
/area/ship/hallway/central)
"kL" = (
/obj/structure/window/reinforced/spawner/north,
/obj/structure/rack,
/obj/structure/railing{
	dir = 4
	},
/obj/item/clothing/glasses/heat,
/obj/item/clothing/glasses/heat,
/obj/item/clothing/glasses/cold,
/obj/item/clothing/glasses/cold,
/obj/effect/spawner/lootdrop/maintenance/five,
/turf/open/floor/plating,
/area/ship/cargo)
"kM" = (
/turf/closed/wall/mineral/plastitanium,
/area/ship/crew)
"lJ" = (
/obj/structure/bed/pod,
/obj/structure/curtain,
/obj/item/bedsheet/blue,
/turf/open/floor/wood,
/area/ship/crew)
"lP" = (
/obj/structure/curtain/cloth,
/obj/machinery/shower{
	pixel_y = 15
	},
/turf/open/floor/carpet/blue,
/area/ship/crew)
"mD" = (
/obj/structure/grille,
/obj/effect/spawner/structure/window/plasma/reinforced/plastitanium,
/turf/closed/wall/mineral/plastitanium,
/area/ship/cargo/office)
"ni" = (
/obj/machinery/power/shuttle/engine/electric{
	dir = 4
	},
/turf/open/floor/plating,
/area/ship/engineering)
"nA" = (
/obj/machinery/atmospherics/pipe/simple/scrubbers/hidden/layer4{
	dir = 6
	},
/obj/structure/table/wood,
/turf/open/floor/carpet/blue,
/area/ship/crew)
"nF" = (
/obj/machinery/atmospherics/pipe/simple/scrubbers/hidden/layer4{
	dir = 8
	},
/turf/open/floor/plating,
/area/ship/cargo)
"nO" = (
/obj/machinery/atmospherics/components/unary/passive_vent/layer4{
	dir = 1
	},
/turf/open/floor/plating,
/area/ship/external)
"oN" = (
/obj/machinery/atmospherics/pipe/manifold/supply/hidden/layer2{
	dir = 1
	},
/obj/machinery/atmospherics/pipe/manifold/scrubbers/hidden/layer4{
	dir = 1
	},
/obj/structure/cable{
	icon_state = "4-8"
	},
/obj/structure/cable{
	icon_state = "2-8"
	},
/turf/open/floor/plasteel/tech/techmaint,
/area/ship/hallway/central)
"pM" = (
/turf/closed/wall/mineral/plastitanium,
/area/ship/cargo/office)
"qo" = (
/obj/machinery/atmospherics/pipe/simple/supply/hidden/layer2,
/obj/structure/cable{
	icon_state = "1-8"
	},
/turf/open/floor/wood,
/area/ship/cargo/office)
"qz" = (
/obj/machinery/atmospherics/components/unary/portables_connector/layer2,
/obj/effect/decal/cleanable/oil,
/obj/effect/decal/cleanable/glass,
/turf/open/floor/plating,
/area/ship/engineering)
"qR" = (
/obj/machinery/power/port_gen/pacman/super,
/obj/machinery/power/terminal,
/obj/effect/turf_decal/box,
/turf/open/floor/plating,
/area/ship/engineering)
"qS" = (
/turf/open/floor/plating,
/area/ship/cargo)
"rh" = (
/obj/structure/cable{
	icon_state = "1-2"
	},
/obj/machinery/atmospherics/pipe/simple/supply/hidden/layer2,
/obj/machinery/atmospherics/pipe/simple/scrubbers/hidden/layer4,
/turf/open/floor/plating,
/area/ship/engineering)
"rj" = (
/obj/machinery/atmospherics/components/unary/vent_scrubber/on/layer4{
	dir = 4
	},
/turf/open/floor/plating,
/area/ship/cargo)
"ru" = (
/turf/closed/wall/mineral/plastitanium,
/area/ship/engineering)
"so" = (
/obj/machinery/atmospherics/components/unary/vent_pump/on/layer2{
	dir = 1
	},
/obj/machinery/light/small,
/turf/open/floor/plating,
/area/ship/engineering)
"sR" = (
/obj/machinery/atmospherics/pipe/simple/supply/hidden/layer2,
/obj/machinery/atmospherics/pipe/simple/scrubbers/hidden/layer4,
/obj/structure/cable{
	icon_state = "1-2"
	},
/obj/machinery/door/airlock/centcom{
	name = "Officer's Office"
	},
/turf/open/floor/plasteel/tech/techmaint,
/area/ship/cargo/office)
"tD" = (
/obj/structure/cable{
	icon_state = "1-8"
	},
/obj/structure/cable{
	icon_state = "1-2"
	},
/obj/machinery/atmospherics/pipe/simple/supply/hidden/layer2,
/obj/machinery/atmospherics/pipe/manifold/scrubbers/hidden/layer4{
	dir = 8
	},
/obj/machinery/power/terminal{
	dir = 8
	},
/turf/open/floor/plating,
/area/ship/engineering)
"ue" = (
/obj/machinery/atmospherics/pipe/simple/supply/hidden/layer2{
	dir = 4
	},
/obj/machinery/atmospherics/pipe/simple/scrubbers/hidden/layer4{
	dir = 8
	},
/obj/structure/cable{
	icon_state = "4-8"
	},
/obj/machinery/suit_storage_unit/solgov,
/obj/structure/window/reinforced{
	dir = 4
	},
/obj/machinery/door/window/brigdoor,
/obj/structure/window/reinforced{
	dir = 8
	},
/turf/open/floor/plasteel/tech/techmaint,
/area/ship/hallway/central)
"uq" = (
/turf/open/floor/plasteel/dark,
/area/ship/bridge)
"vL" = (
/obj/machinery/atmospherics/components/binary/pump/layer2,
/obj/machinery/light/small{
	dir = 8
	},
/turf/open/floor/plating,
/area/ship/engineering)
"vN" = (
/obj/structure/table/reinforced,
/obj/item/binoculars,
/obj/machinery/button{
	id = "scbay";
	name = "Cargo Bay Doors";
	pixel_y = 9;
	pixel_x = -6
	},
/obj/machinery/button{
	pixel_y = 9;
	pixel_x = 6;
	name = "Bridge Blast Doors"
	},
/obj/machinery/power/apc/auto_name/west,
/obj/machinery/atmospherics/components/unary/vent_pump/on/layer2,
/obj/structure/cable{
	icon_state = "0-2"
	},
/turf/open/floor/plasteel/dark,
/area/ship/bridge)
"yl" = (
/turf/open/floor/plating,
/area/ship/hallway/central)
"yw" = (
/obj/machinery/atmospherics/components/unary/vent_scrubber/on/layer4{
	dir = 8
	},
/obj/structure/cable{
	icon_state = "1-2"
	},
/obj/machinery/light/dim{
	dir = 4
	},
/turf/open/floor/wood,
/area/ship/crew)
"yF" = (
/obj/machinery/atmospherics/pipe/simple/supply/hidden/layer2{
	dir = 6
	},
/obj/structure/closet/wall{
	pixel_y = 28
	},
/obj/machinery/computer/cryopod{
	pixel_x = -28
	},
/turf/open/floor/plasteel/tech/techmaint,
/area/ship/crew)
"yG" = (
/obj/machinery/power/apc/auto_name/west,
/obj/structure/cable,
/obj/structure/chair/office{
	dir = 4
	},
/turf/open/floor/wood,
/area/ship/cargo/office)
"zH" = (
/obj/machinery/atmospherics/components/binary/pump/on/layer4{
	dir = 4
	},
/turf/open/floor/plating,
/area/ship/engineering)
"zO" = (
/obj/structure/chair/office{
	dir = 4;
	name = "Intel Officer's Chair"
	},
/obj/item/radio/intercom/wideband{
	reach = 2;
	pixel_y = -28
	},
/obj/effect/turf_decal/trimline/opaque/solgovblue,
/turf/open/floor/plasteel/dark,
/area/ship/bridge)
"zY" = (
/obj/structure/cable{
	icon_state = "1-4"
	},
/obj/structure/cable{
	icon_state = "1-2"
	},
/obj/machinery/atmospherics/pipe/manifold/supply/hidden/layer2{
	dir = 8
	},
/obj/machinery/atmospherics/pipe/manifold/scrubbers/hidden/layer4{
	dir = 8
	},
/turf/open/floor/plating,
/area/ship/engineering)
"As" = (
/obj/structure/sign/poster/contraband/syndicate_pistol,
/turf/closed/wall/mineral/plastitanium,
/area/ship/engineering)
"AM" = (
/obj/structure/cable{
	icon_state = "2-4"
	},
/obj/item/storage/secure/safe{
	pixel_x = -24
	},
/obj/machinery/airalarm/all_access{
	pixel_y = 25
	},
/turf/open/floor/wood,
/area/ship/cargo/office)
"BS" = (
/turf/open/floor/wood,
/area/ship/crew)
"CU" = (
/obj/machinery/power/smes/shuttle/precharged{
	dir = 4
	},
/obj/structure/window/reinforced{
	dir = 8
	},
/turf/open/floor/plating,
/area/ship/engineering)
"DU" = (
/obj/machinery/atmospherics/pipe/simple/scrubbers/hidden/layer4{
	dir = 10
	},
/obj/structure/cable{
	icon_state = "1-2"
	},
/obj/machinery/airalarm/all_access{
	dir = 8;
	pixel_x = 25
	},
/turf/open/floor/wood,
/area/ship/crew)
"Ee" = (
/obj/machinery/porta_turret/centcom_shuttle/weak{
	dir = 1
	},
/turf/closed/wall/mineral/plastitanium,
/area/ship/bridge)
"Ew" = (
/obj/structure/table,
/obj/item/stack/sheet/mineral/uranium/five{
	pixel_y = 8
	},
/obj/item/stack/sheet/mineral/uranium/five{
	pixel_y = 8
	},
/obj/item/stack/sheet/mineral/uranium/five{
	pixel_x = -3
	},
/turf/open/floor/plating,
/area/ship/engineering)
"EX" = (
/obj/machinery/atmospherics/pipe/simple/supply/hidden/layer2{
	dir = 6
	},
/obj/machinery/atmospherics/pipe/simple/scrubbers/hidden/layer4{
	dir = 6
	},
/obj/structure/cable{
	icon_state = "2-4"
	},
/obj/machinery/suit_storage_unit/solgov,
/obj/structure/window/reinforced{
	dir = 8
	},
/obj/machinery/door/window/brigdoor,
/obj/structure/window/reinforced{
	dir = 4
	},
/turf/open/floor/plasteel/tech/techmaint,
/area/ship/hallway/central)
"Fw" = (
/obj/machinery/door/airlock/external,
/turf/open/floor/plating,
/area/ship/hallway/central)
"FT" = (
/obj/effect/decal/cleanable/oil/streak,
/obj/structure/reagent_dispensers/watertank,
/obj/effect/turf_decal/box,
/turf/open/floor/plating,
/area/ship/engineering)
"FY" = (
/obj/machinery/atmospherics/pipe/simple/scrubbers/hidden/layer4{
	dir = 10
	},
/turf/closed/wall/mineral/plastitanium,
/area/ship/hallway/central)
"Gb" = (
/obj/machinery/atmospherics/components/unary/vent_scrubber/on/layer4{
	dir = 8
	},
/obj/structure/cable{
	icon_state = "4-8"
	},
/obj/machinery/light/small,
/turf/open/floor/plating,
/area/ship/engineering)
"GV" = (
/obj/machinery/porta_turret/centcom_shuttle/weak{
	dir = 4
	},
/turf/closed/wall/mineral/plastitanium,
/area/ship/bridge)
"Hd" = (
/obj/effect/turf_decal/trimline/opaque/solgovblue/filled/warning,
/turf/open/floor/plasteel/tech/techmaint,
/area/ship/hallway/central)
"Hz" = (
/obj/machinery/atmospherics/components/unary/vent_pump/on/layer2{
	dir = 1
	},
/obj/machinery/atmospherics/pipe/simple/scrubbers/hidden/layer4{
	dir = 9
	},
/obj/structure/cable,
/obj/machinery/power/apc/auto_name/south,
/turf/open/floor/plating,
/area/ship/cargo)
"Ig" = (
/obj/machinery/power/smes,
/obj/structure/cable{
	icon_state = "0-2"
	},
/turf/open/floor/plating,
/area/ship/engineering)
"IJ" = (
/obj/machinery/advanced_airlock_controller{
	pixel_x = -28
	},
/obj/machinery/atmospherics/pipe/simple/supply/hidden/layer2,
/turf/open/floor/plating,
/area/ship/hallway/central)
"Jp" = (
/obj/machinery/atmospherics/pipe/manifold/supply/hidden/layer2,
/obj/machinery/atmospherics/pipe/manifold4w/scrubbers/hidden/layer4,
/obj/structure/cable{
	icon_state = "4-8"
	},
/obj/structure/cable{
	icon_state = "1-8"
	},
/turf/open/floor/plasteel/tech/techmaint,
/area/ship/hallway/central)
"Jt" = (
/obj/machinery/atmospherics/pipe/simple/supply/hidden/layer2{
	dir = 4
	},
/obj/machinery/atmospherics/pipe/simple/scrubbers/hidden/layer4{
	dir = 8
	},
/obj/structure/cable{
	icon_state = "4-8"
	},
/turf/open/floor/plasteel/tech/techmaint,
/area/ship/engineering)
"KP" = (
/obj/structure/closet/wall{
	pixel_y = 28
	},
/obj/structure/chair/sofa/right,
/turf/open/floor/wood,
/area/ship/crew)
"Ld" = (
/obj/machinery/atmospherics/pipe/simple/scrubbers/hidden/layer4,
/obj/machinery/atmospherics/pipe/simple/supply/hidden/layer2,
/obj/machinery/door/airlock{
	name = "Cryopods"
	},
/turf/open/floor/plasteel/tech/techmaint,
/area/ship/crew)
"Lr" = (
/obj/machinery/atmospherics/pipe/simple/scrubbers/hidden/layer4,
/obj/structure/cable{
	icon_state = "1-2"
	},
/obj/machinery/door/airlock/glass{
	name = "Crew Quarters"
	},
/turf/open/floor/plasteel/tech/techmaint,
/area/ship/crew)
"Mb" = (
/obj/structure/chair/office{
	dir = 4;
	name = "Captain's Chair"
	},
/obj/machinery/turretid{
	pixel_y = 28
	},
/obj/effect/turf_decal/trimline/opaque/solgovblue,
/turf/open/floor/plasteel/dark,
/area/ship/bridge)
"MS" = (
/obj/structure/window/reinforced/spawner/north,
/obj/structure/rack,
/obj/item/reagent_containers/food/snacks/canned/beans,
/obj/item/reagent_containers/food/snacks/canned/beans,
/obj/item/reagent_containers/food/snacks/canned/beans,
/obj/item/reagent_containers/food/snacks/canned/beans,
/obj/item/reagent_containers/food/snacks/canned/beans,
/obj/item/reagent_containers/food/snacks/canned/beans,
/obj/item/reagent_containers/food/snacks/canned/beans,
/obj/item/reagent_containers/food/snacks/canned/beans,
/obj/item/reagent_containers/food/snacks/canned/beans,
/obj/item/reagent_containers/food/snacks/canned/beans,
/obj/item/reagent_containers/food/snacks/canned/beans,
/obj/effect/spawner/lootdrop/maintenance/two,
/turf/open/floor/plating,
/area/ship/cargo)
"NR" = (
/turf/open/floor/plasteel/tech/techmaint,
/area/ship/hallway/central)
"NW" = (
/obj/structure/table/reinforced,
/obj/machinery/atmospherics/components/unary/vent_scrubber/on/layer4{
	dir = 1
	},
/obj/machinery/airalarm/all_access{
	dir = 4;
	pixel_x = -25
	},
/obj/item/binoculars,
/turf/open/floor/plasteel/dark,
/area/ship/bridge)
"Od" = (
/obj/machinery/atmospherics/pipe/simple/scrubbers/hidden/layer4,
/turf/closed/wall/mineral/plastitanium,
/area/ship/engineering)
"Or" = (
/obj/machinery/atmospherics/pipe/simple/supply/hidden/layer2{
	dir = 9
	},
/obj/machinery/atmospherics/pipe/simple/scrubbers/hidden/layer4{
	dir = 9
	},
/obj/structure/cable{
	icon_state = "1-8"
	},
/turf/open/floor/plasteel/tech/techmaint,
/area/ship/hallway/central)
"OD" = (
/obj/effect/decal/cleanable/glass,
/turf/open/floor/plating,
/area/ship/engineering)
"OP" = (
/obj/machinery/atmospherics/pipe/simple/supply/hidden/layer2,
/obj/machinery/atmospherics/pipe/simple/scrubbers/hidden/layer4,
/obj/structure/cable{
	icon_state = "1-2"
	},
/obj/effect/turf_decal/trimline/opaque/solgovblue/filled/warning,
/turf/open/floor/plasteel/tech/techmaint,
/area/ship/hallway/central)
"OW" = (
/obj/machinery/door/airlock/external,
/obj/machinery/atmospherics/pipe/simple/supply/hidden/layer2,
/turf/open/floor/plasteel/tech/techmaint,
/area/ship/hallway/central)
"Pk" = (
/obj/structure/cable{
	icon_state = "1-2"
	},
/obj/machinery/atmospherics/pipe/simple/scrubbers/hidden/layer4,
/obj/machinery/atmospherics/pipe/manifold/supply/hidden/layer2{
	dir = 4
	},
/turf/open/floor/plating,
/area/ship/engineering)
"Qa" = (
/obj/machinery/holopad/emergency/command,
/turf/open/floor/plasteel/white,
/area/ship/bridge)
"Ql" = (
/obj/machinery/atmospherics/components/binary/pump/layer2{
	dir = 8
	},
/turf/open/floor/plating,
/area/ship/engineering)
"QB" = (
/obj/machinery/atmospherics/pipe/simple/supply/hidden/layer2{
	dir = 4
	},
/obj/machinery/atmospherics/pipe/simple/scrubbers/hidden/layer4{
	dir = 8
	},
/obj/structure/cable{
	icon_state = "4-8"
	},
/obj/machinery/door/airlock/engineering{
	name = "Engineering"
	},
/turf/open/floor/plasteel/tech/techmaint,
/area/ship/hallway/central)
"QN" = (
/obj/machinery/atmospherics/components/unary/vent_scrubber/on/layer4{
	dir = 1
	},
/obj/effect/turf_decal/trimline/opaque/solgovblue/filled/corner,
/turf/open/floor/plasteel/tech/techmaint,
/area/ship/hallway/central)
"QO" = (
/obj/machinery/atmospherics/components/unary/vent_scrubber/on/layer4{
	dir = 8
	},
/obj/machinery/light/small{
	dir = 1
	},
/turf/open/floor/plating,
/area/ship/engineering)
"Ri" = (
/turf/closed/wall/mineral/plastitanium,
/area/ship/hallway/central)
"Rj" = (
/obj/machinery/door/window{
	dir = 1
	},
/turf/open/floor/plasteel/stairs,
/area/ship/cargo)
"Rr" = (
/obj/machinery/button{
	id = "scbay";
	pixel_x = -28;
	name = "Cargo Bay Doors"
	},
/turf/open/floor/plating,
/area/ship/cargo)
"Rv" = (
/obj/machinery/atmospherics/pipe/simple/scrubbers/hidden/layer4{
	dir = 6
	},
/obj/machinery/atmospherics/pipe/simple/supply/hidden/layer2,
/turf/open/floor/plasteel/tech/techmaint,
/area/ship/crew)
"Rz" = (
/obj/effect/spawner/structure/window/plasma/reinforced/plastitanium,
/obj/structure/grille,
/obj/machinery/door/poddoor{
	id = "scbridge"
	},
/turf/open/floor/plating,
/area/ship/bridge)
"RX" = (
/obj/machinery/atmospherics/components/unary/vent_pump/on/layer2{
	dir = 4
	},
/obj/structure/bed/pod,
/obj/structure/curtain,
/obj/item/bedsheet/blue,
/turf/open/floor/wood,
/area/ship/crew)
"RY" = (
/obj/structure/toilet{
	pixel_y = 14
	},
/obj/structure/sink{
	dir = 8;
	pixel_x = 12
	},
/obj/machinery/light/small{
	dir = 4;
	pixel_y = 8
	},
/turf/open/floor/carpet/blue,
/area/ship/crew)
"Sx" = (
/obj/structure/cable{
	icon_state = "2-8"
	},
/obj/structure/cable{
	icon_state = "1-2"
	},
/obj/machinery/atmospherics/pipe/simple/supply/hidden/layer2,
/obj/machinery/power/terminal{
	dir = 8
	},
/turf/open/floor/plating,
/area/ship/engineering)
"SL" = (
/obj/structure/cable{
	icon_state = "1-8"
	},
/obj/machinery/atmospherics/pipe/simple/supply/hidden/layer2,
/obj/machinery/atmospherics/pipe/simple/scrubbers/hidden/layer4{
	dir = 5
	},
/obj/machinery/power/terminal{
	dir = 8
	},
/turf/open/floor/plating,
/area/ship/engineering)
"Ul" = (
/obj/machinery/atmospherics/pipe/manifold4w/scrubbers/hidden/layer4,
/obj/machinery/atmospherics/pipe/manifold4w/supply/hidden/layer2,
/obj/structure/cable{
	icon_state = "4-8"
	},
/obj/structure/cable{
	icon_state = "2-8"
	},
/turf/open/floor/plasteel/tech/techmaint,
/area/ship/hallway/central)
"UZ" = (
/obj/structure/chair/comfy/brown{
	dir = 4
	},
/obj/effect/decal/cleanable/glass,
/turf/open/floor/plating,
/area/ship/engineering)
"Vo" = (
/obj/structure/chair/office{
	dir = 8
	},
/turf/open/floor/wood,
/area/ship/cargo/office)
"VJ" = (
/obj/structure/chair/sofa,
/turf/open/floor/wood,
/area/ship/crew)
"Xc" = (
/turf/open/floor/plasteel/stairs{
	dir = 4
	},
/area/ship/bridge)
"YE" = (
/obj/structure/chair/comfy/brown{
	dir = 4
	},
/turf/open/floor/wood,
/area/ship/crew)
"YG" = (
/turf/open/floor/plating,
/area/ship/engineering)
"YQ" = (
/turf/template_noop,
/area/template_noop)
"Zs" = (
/obj/machinery/atmospherics/pipe/simple/scrubbers/hidden/layer4{
	dir = 10
	},
/obj/structure/reagent_dispensers/fueltank,
/obj/effect/turf_decal/box,
/turf/open/floor/plating,
/area/ship/engineering)
"Zv" = (
/obj/effect/decal/cleanable/oil,
/obj/structure/closet/secure_closet/engineering_personal,
/obj/item/clothing/gloves/color/yellow,
/obj/item/clothing/gloves/color/yellow,
/obj/item/storage/belt/utility/full,
/obj/item/storage/belt/utility/full,
/obj/item/clothing/glasses/welding,
/obj/item/clothing/glasses/welding,
/turf/open/floor/plating,
/area/ship/engineering)
"ZI" = (
/obj/machinery/computer/helm{
	dir = 8
	},
/turf/open/floor/plasteel/dark,
/area/ship/bridge)
"ZQ" = (
/obj/machinery/atmospherics/pipe/manifold/supply/hidden/layer2{
	dir = 1
	},
/obj/machinery/atmospherics/pipe/manifold/scrubbers/hidden/layer4{
	dir = 1
	},
/obj/structure/cable{
	icon_state = "4-8"
	},
/obj/structure/cable{
	icon_state = "1-8"
	},
/turf/open/floor/plasteel/tech/techmaint,
/area/ship/hallway/central)

(1,1,1) = {"
YQ
YQ
YQ
YQ
YQ
YQ
YQ
YQ
YQ
YQ
YQ
YQ
YQ
YQ
YQ
YQ
YQ
YQ
YQ
YQ
"}
(2,1,1) = {"
YQ
YQ
YQ
YQ
YQ
YQ
YQ
YQ
YQ
YQ
YQ
YQ
YQ
YQ
YQ
YQ
YQ
YQ
YQ
YQ
"}
(3,1,1) = {"
YQ
YQ
ru
ru
ru
ru
ni
ni
ni
ru
ru
ru
ni
ni
ni
ru
ru
YQ
YQ
YQ
"}
(4,1,1) = {"
YQ
YQ
Ee
UZ
YG
ru
dN
dN
dN
qz
vL
iY
CU
CU
CU
Zv
cY
YQ
YQ
YQ
"}
(5,1,1) = {"
YQ
YQ
As
iN
YG
ru
hr
Sx
gj
rh
zY
Pk
tD
cL
SL
so
ru
YQ
YQ
YQ
"}
(6,1,1) = {"
YQ
YQ
aQ
dj
OD
ru
YG
Ew
Gb
ru
Jt
ru
QO
Ql
zH
ru
ru
YQ
YQ
YQ
"}
(7,1,1) = {"
YQ
YQ
aQ
ru
YG
ru
qR
Ig
ii
ru
iL
ru
FT
jW
Zs
Od
nO
YQ
YQ
YQ
"}
(8,1,1) = {"
YQ
YQ
cw
kM
kM
kM
kM
kM
kM
Ri
QB
Ri
Ri
Ri
FY
ru
cw
YQ
YQ
YQ
"}
(9,1,1) = {"
YQ
YQ
cw
cw
kM
lJ
RX
lJ
kM
ah
ZQ
OW
IJ
yl
Fw
cw
cw
YQ
YQ
YQ
"}
(10,1,1) = {"
YQ
YQ
cw
cw
kM
KP
YE
hT
kM
kb
ej
jj
jj
jj
jj
cw
cw
YQ
YQ
YQ
"}
(11,1,1) = {"
YQ
YQ
cw
cw
kM
VJ
bA
BS
kM
EX
Or
MS
rj
Rr
gP
cw
cw
YQ
YQ
YQ
"}
(12,1,1) = {"
YQ
YQ
cw
cw
kM
VJ
nA
dx
kM
ue
NR
dr
nF
qS
gP
cw
cw
YQ
YQ
YQ
"}
(13,1,1) = {"
YQ
YQ
cw
cw
kM
in
yw
DU
Lr
Jp
QN
kL
nF
qS
gP
cw
cw
YQ
YQ
YQ
"}
(14,1,1) = {"
YQ
YQ
cw
cw
GV
kM
kM
kM
kM
co
Hd
Rj
nF
qS
jj
cw
cw
YQ
YQ
YQ
"}
(15,1,1) = {"
YQ
YQ
cw
cw
cw
kM
yF
Rv
Ld
Ul
OP
ev
Hz
jj
GV
cw
cw
YQ
YQ
YQ
"}
(16,1,1) = {"
YQ
YQ
cw
cw
cw
kM
bI
dZ
kM
co
pM
pM
pM
pM
cw
cw
cw
YQ
YQ
YQ
"}
(17,1,1) = {"
YQ
YQ
cw
cw
cw
kM
kM
kM
kM
co
pM
AM
yG
mD
cw
cw
cw
YQ
YQ
YQ
"}
(18,1,1) = {"
YQ
YQ
cw
cw
cw
cw
kM
lP
kM
co
pM
jH
dA
mD
cw
cw
cw
YQ
YQ
YQ
"}
(19,1,1) = {"
YQ
YQ
cw
cw
cw
cw
kM
RY
fk
oN
sR
qo
Vo
pM
cw
cw
cw
YQ
YQ
YQ
"}
(20,1,1) = {"
YQ
YQ
cw
cw
cw
cw
bO
bO
bO
dq
bO
bO
bO
bO
cw
cw
cw
YQ
YQ
YQ
"}
(21,1,1) = {"
YQ
YQ
cw
cw
cw
cw
cw
bO
vN
aa
NW
bO
cw
cw
cw
cw
cw
YQ
YQ
YQ
"}
(22,1,1) = {"
YQ
YQ
cw
cw
cw
cw
cw
bO
Mb
Qa
zO
bO
cw
cw
cw
cw
cw
YQ
YQ
YQ
"}
(23,1,1) = {"
YQ
YQ
cw
cw
cw
cw
cw
bO
ZI
aT
im
bO
cw
cw
cw
cw
cw
YQ
YQ
YQ
"}
(24,1,1) = {"
YQ
YQ
cw
cw
cw
cw
cw
bO
bO
Xc
bO
bO
cw
cw
cw
cw
cw
YQ
YQ
YQ
"}
(25,1,1) = {"
YQ
YQ
cw
cw
cw
cw
cw
cw
Rz
uq
Rz
cw
cw
cw
cw
cw
cw
YQ
YQ
YQ
"}
(26,1,1) = {"
YQ
YQ
cw
cw
cw
cw
cw
cw
Rz
fy
Rz
cw
cw
cw
cw
cw
cw
YQ
YQ
YQ
"}
(27,1,1) = {"
YQ
YQ
cw
cw
cw
cw
cw
cw
Rz
Rz
Rz
cw
cw
cw
cw
cw
cw
YQ
YQ
YQ
"}
(28,1,1) = {"
YQ
YQ
YQ
YQ
YQ
YQ
YQ
YQ
YQ
YQ
YQ
YQ
YQ
YQ
YQ
YQ
YQ
YQ
YQ
YQ
"}
(29,1,1) = {"
YQ
YQ
YQ
YQ
YQ
YQ
YQ
YQ
YQ
YQ
YQ
YQ
YQ
YQ
YQ
YQ
YQ
YQ
YQ
YQ
"}
(30,1,1) = {"
YQ
YQ
YQ
YQ
YQ
YQ
YQ
YQ
YQ
YQ
YQ
YQ
YQ
YQ
YQ
YQ
YQ
YQ
YQ
YQ
"}
