//MAP CONVERTED BY dmm2tgm.py THIS HEADER COMMENT PREVENTS RECONVERSION, DO NOT REMOVE
"aa" = (
/obj/machinery/atmospherics/pipe/simple/supply/hidden/layer2{
	dir = 9
	},
/obj/machinery/atmospherics/pipe/simple/scrubbers/hidden/layer4{
	dir = 10
	},
/obj/structure/cable{
	icon_state = "1-8"
	},
/turf/open/floor/plasteel/white,
/area/ship/bridge)
"ah" = (
/obj/machinery/power/apc/auto_name/west,
/obj/structure/cable{
	icon_state = "0-2"
	},
/turf/open/floor/plasteel/white,
/area/ship/hallway/central)
"aQ" = (
/obj/structure/toilet{
	pixel_y = 14
	},
/obj/structure/sink{
	dir = 8;
	pixel_x = 12
	},
/obj/machinery/light/small{
	dir = 4;
	pixel_y = 8
	},
/turf/open/floor/carpet/red_gold,
/area/ship/crew)
"aT" = (
/turf/open/floor/plasteel/white,
/area/ship/bridge)
"bA" = (
/obj/structure/table/wood,
/turf/open/floor/carpet/red_gold,
/area/ship/crew)
"bD" = (
/obj/machinery/atmospherics/pipe/simple/scrubbers/hidden/layer4,
/turf/open/floor/plasteel/white,
/area/ship/bridge)
"bI" = (
/obj/structure/window/reinforced/spawner/north,
/obj/structure/rack,
/obj/item/pickaxe,
/obj/item/pickaxe,
/obj/effect/spawner/lootdrop/maintenance/three,
/turf/open/floor/plasteel/dark,
/area/ship/cargo)
"bO" = (
/turf/closed/wall/mineral/plastitanium,
/area/ship/bridge)
"co" = (
/obj/machinery/atmospherics/pipe/simple/supply/hidden/layer2{
	dir = 4
	},
/obj/machinery/atmospherics/pipe/simple/scrubbers/hidden/layer4{
	dir = 8
	},
/obj/structure/cable{
	icon_state = "4-8"
	},
/turf/open/floor/plasteel/white,
/area/ship/hallway/central)
"ct" = (
/obj/structure/chair{
	dir = 4
	},
/turf/open/floor/plasteel/dark,
/area/ship/bridge)
"cw" = (
/obj/effect/turf_decal/industrial/stand_clear{
	dir = 1
	},
/obj/effect/turf_decal/industrial/warning,
/turf/open/floor/plasteel/tech/techmaint,
/area/ship/cargo)
"cL" = (
/obj/structure/cable{
	icon_state = "1-8"
	},
/obj/structure/cable{
	icon_state = "1-2"
	},
/obj/machinery/atmospherics/pipe/simple/scrubbers/hidden/layer4,
/obj/machinery/atmospherics/pipe/manifold/supply/hidden/layer2{
	dir = 8
	},
/turf/open/floor/plating,
/area/ship/engineering)
"cY" = (
/obj/machinery/porta_turret/centcom_shuttle/weak,
/turf/closed/wall/mineral/plastitanium,
/area/ship/bridge)
"dj" = (
/obj/structure/chair/comfy/brown{
	dir = 8
	},
/turf/open/floor/plating,
/area/ship/engineering)
"dq" = (
/obj/machinery/door/airlock/command{
	name = "Bridge"
	},
/obj/machinery/door/poddoor/shutters/preopen{
	id = "intelfucky"
	},
/obj/machinery/atmospherics/pipe/simple/supply/hidden/layer2{
	dir = 4
	},
/obj/machinery/atmospherics/pipe/simple/scrubbers/hidden/layer4{
	dir = 8
	},
/obj/structure/cable{
	icon_state = "4-8"
	},
/turf/open/floor/plasteel/white,
/area/ship/bridge)
"dx" = (
/obj/machinery/atmospherics/pipe/simple/scrubbers/hidden/layer4{
	dir = 5
	},
/turf/open/floor/wood,
/area/ship/crew)
"dN" = (
/obj/machinery/power/smes/shuttle/precharged{
	dir = 4
	},
/obj/structure/window/reinforced{
	dir = 8
	},
/turf/closed/wall/mineral/plastitanium,
/area/ship/engineering)
"dZ" = (
/obj/structure/table/wood,
/obj/item/toy/cards/deck,
/obj/machinery/light/small/broken{
	dir = 1
	},
/turf/open/floor/plating,
/area/ship/engineering)
"ej" = (
/obj/machinery/atmospherics/pipe/simple/scrubbers/hidden/layer4{
	dir = 10
	},
/obj/structure/cable{
	icon_state = "1-2"
	},
/obj/machinery/airalarm/all_access{
	dir = 8;
	pixel_x = 25
	},
/turf/open/floor/wood,
/area/ship/crew)
"ev" = (
/obj/structure/chair/office{
	dir = 8
	},
/turf/open/floor/wood,
/area/ship/cargo/office)
"fk" = (
/obj/effect/turf_decal/industrial/warning,
/turf/open/floor/plasteel/tech/techmaint,
/area/ship/cargo)
"gj" = (
/obj/structure/cable{
	icon_state = "2-8"
	},
/obj/structure/cable{
	icon_state = "1-2"
	},
/obj/machinery/atmospherics/pipe/simple/supply/hidden/layer2,
/obj/machinery/atmospherics/pipe/simple/supply/hidden/layer2,
/obj/machinery/atmospherics/pipe/simple/scrubbers/hidden/layer4{
	dir = 6
	},
/obj/machinery/power/terminal{
	dir = 8
	},
/obj/structure/cable{
	icon_state = "2-4"
	},
/turf/open/floor/plating,
/area/ship/engineering)
"gG" = (
/obj/effect/spawner/structure/window/plasma/reinforced/plastitanium,
/obj/structure/grille,
/obj/machinery/door/poddoor{
	id = "scbridge"
	},
/turf/open/floor/plating,
/area/template_noop)
"gP" = (
/obj/machinery/door/poddoor{
	id = "scbay"
	},
/obj/structure/fans/tiny,
/turf/open/floor/plating,
/area/ship/cargo)
"hr" = (
/obj/structure/cable{
	icon_state = "2-8"
	},
/obj/machinery/atmospherics/components/unary/vent_pump/on/layer2,
/obj/machinery/power/terminal{
	dir = 8
	},
/turf/open/floor/plating,
/area/ship/engineering)
"hT" = (
/obj/structure/sign/poster/contraband/syndicate_pistol,
/turf/closed/wall/mineral/plastitanium,
/area/ship/engineering)
"ia" = (
/obj/machinery/atmospherics/pipe/simple/scrubbers/hidden/layer4{
	dir = 6
	},
/obj/machinery/atmospherics/pipe/simple/supply/hidden/layer2,
/turf/open/floor/plasteel/white,
/area/ship/crew)
"id" = (
/obj/effect/decal/cleanable/oil,
/obj/effect/decal/cleanable/glass,
/obj/machinery/autolathe,
/turf/open/floor/plating,
/area/ship/engineering)
"ii" = (
/obj/machinery/power/apc/auto_name/east,
/obj/structure/cable{
	icon_state = "1-8"
	},
/obj/structure/cable{
	icon_state = "0-8"
	},
/obj/effect/decal/cleanable/oil,
/turf/open/floor/plating,
/area/ship/engineering)
"im" = (
/obj/machinery/advanced_airlock_controller{
	pixel_x = -28
	},
/obj/machinery/atmospherics/pipe/simple/supply/hidden/layer2,
/obj/machinery/atmospherics/components/unary/vent_scrubber/on/layer4{
	dir = 1
	},
/turf/open/floor/plating,
/area/ship/hallway/central)
"in" = (
/obj/machinery/power/apc/auto_name/north,
/obj/structure/cable{
	icon_state = "0-2"
	},
/obj/structure/chair/sofa/left,
/turf/open/floor/wood,
/area/ship/crew)
"iL" = (
/obj/machinery/atmospherics/pipe/simple/supply/hidden/layer2{
	dir = 4
	},
/obj/machinery/atmospherics/pipe/simple/supply/hidden/layer2{
	dir = 4
	},
/obj/machinery/atmospherics/pipe/simple/scrubbers/hidden/layer4{
	dir = 8
	},
/obj/structure/cable{
	icon_state = "4-8"
	},
/turf/open/floor/plasteel/white,
/area/ship/engineering)
"iN" = (
/obj/machinery/atmospherics/pipe/simple/scrubbers/hidden/layer4,
/obj/structure/cable{
	icon_state = "1-2"
	},
/obj/machinery/door/airlock/glass{
	name = "Crew Quarters"
	},
/turf/open/floor/plasteel/tech/techmaint,
/area/ship/crew)
"iY" = (
/obj/machinery/atmospherics/components/unary/vent_scrubber/on/layer4{
	dir = 8
	},
/obj/structure/cable{
	icon_state = "4-8"
	},
/obj/machinery/light/small,
/turf/open/floor/plating,
/area/ship/engineering)
"jj" = (
/turf/closed/wall/mineral/plastitanium,
/area/ship/cargo)
"jW" = (
/obj/machinery/cryopod{
	dir = 8
	},
/obj/machinery/atmospherics/components/unary/vent_scrubber/on/layer4{
	dir = 8
	},
/obj/effect/turf_decal/industrial/hatch/red,
/turf/open/floor/plasteel/tech/grid,
/area/ship/crew)
"kb" = (
/obj/machinery/atmospherics/components/unary/vent_pump/on/layer2,
/turf/open/floor/plasteel/white,
/area/ship/hallway/central)
"kL" = (
/obj/machinery/atmospherics/pipe/simple/scrubbers/hidden/layer4,
/obj/machinery/atmospherics/pipe/simple/supply/hidden/layer2,
/obj/machinery/door/airlock{
	name = "Cryopods"
	},
/turf/open/floor/plasteel/white,
/area/ship/crew)
"kM" = (
/turf/closed/wall/mineral/plastitanium,
/area/ship/crew)
"lJ" = (
/obj/structure/bed/pod,
/obj/structure/curtain,
/obj/item/bedsheet/blue,
/turf/open/floor/wood,
/area/ship/crew)
"lP" = (
/obj/machinery/atmospherics/pipe/simple/scrubbers/hidden/layer4{
	dir = 10
	},
/obj/structure/reagent_dispensers/fueltank,
/obj/effect/turf_decal/box,
/turf/open/floor/plating,
/area/ship/engineering)
"mD" = (
/turf/open/floor/wood,
/area/ship/cargo/office)
"ni" = (
/obj/machinery/power/shuttle/engine/electric{
	dir = 4
	},
/turf/open/floor/plating,
/area/ship/engineering)
"nA" = (
/obj/machinery/atmospherics/pipe/simple/scrubbers/hidden/layer4{
	dir = 6
	},
/obj/structure/table/wood,
/turf/open/floor/carpet/red_gold,
/area/ship/crew)
"nF" = (
/obj/machinery/atmospherics/pipe/simple/scrubbers/hidden/layer4{
	dir = 8
	},
/turf/open/floor/plasteel/tech/techmaint,
/area/ship/cargo)
"nO" = (
/obj/machinery/atmospherics/components/unary/passive_vent/layer4{
	dir = 1
	},
/turf/open/floor/plating,
/area/ship/external)
"oN" = (
/obj/machinery/atmospherics/pipe/manifold/supply/hidden/layer2{
	dir = 1
	},
/obj/machinery/atmospherics/pipe/manifold/scrubbers/hidden/layer4{
	dir = 1
	},
/obj/structure/cable{
	icon_state = "4-8"
	},
/obj/structure/cable{
	icon_state = "2-8"
	},
/turf/open/floor/plasteel/white,
/area/ship/hallway/central)
"pM" = (
/turf/closed/wall/mineral/plastitanium,
/area/ship/cargo/office)
"qo" = (
/obj/machinery/atmospherics/pipe/simple/supply/hidden/layer2,
/obj/structure/cable{
	icon_state = "1-8"
	},
/turf/open/floor/wood,
/area/ship/cargo/office)
"qz" = (
/obj/structure/table,
/obj/machinery/airalarm/all_access{
	dir = 4;
	pixel_x = -25
	},
/obj/item/storage/toolbox/mechanical{
	pixel_y = 8
	},
/obj/item/storage/toolbox/electrical,
/turf/open/floor/plating,
/area/ship/engineering)
"qD" = (
/obj/effect/decal/cleanable/oil,
/obj/structure/closet/secure_closet/engineering_personal,
/obj/item/clothing/gloves/color/yellow,
/obj/item/clothing/gloves/color/yellow,
/obj/item/storage/belt/utility/full,
/obj/item/storage/belt/utility/full,
/obj/item/clothing/glasses/welding,
/obj/item/clothing/glasses/welding,
/turf/open/floor/plating,
/area/ship/engineering)
"qR" = (
/obj/effect/turf_decal/industrial/warning/corner{
	dir = 8
	},
/obj/machinery/mineral/ore_redemption{
	dir = 8;
	output_dir = 1
	},
/obj/effect/turf_decal/box,
/turf/open/floor/plating,
/area/ship/cargo)
"qS" = (
/obj/machinery/cryopod{
	dir = 8
	},
/obj/machinery/atmospherics/components/unary/vent_pump/on/layer2{
	dir = 8
	},
/obj/effect/turf_decal/industrial/hatch/red,
/turf/open/floor/plasteel/tech/grid,
/area/ship/crew)
"rh" = (
/obj/structure/cable{
	icon_state = "1-2"
	},
/obj/machinery/atmospherics/pipe/simple/supply/hidden/layer2,
/obj/machinery/atmospherics/pipe/simple/scrubbers/hidden/layer4,
/turf/open/floor/plating,
/area/ship/engineering)
"rj" = (
/obj/machinery/atmospherics/components/unary/vent_scrubber/on/layer4{
	dir = 4
	},
/turf/open/floor/plasteel/tech/techmaint,
/area/ship/cargo)
"ru" = (
/turf/closed/wall/mineral/plastitanium,
/area/ship/engineering)
"so" = (
/obj/effect/decal/cleanable/oil/streak,
/obj/structure/reagent_dispensers/watertank,
/obj/effect/turf_decal/box,
/turf/open/floor/plating,
/area/ship/engineering)
"sR" = (
/obj/machinery/door/window{
	dir = 1
	},
/obj/machinery/atmospherics/pipe/simple/supply/hidden/layer2,
/obj/machinery/atmospherics/pipe/simple/scrubbers/hidden/layer4,
/obj/structure/cable{
	icon_state = "1-2"
	},
/turf/open/floor/plasteel/stairs,
/area/ship/cargo)
"tD" = (
/obj/structure/cable{
	icon_state = "1-8"
	},
/obj/structure/cable{
	icon_state = "1-2"
	},
/obj/machinery/atmospherics/pipe/simple/supply/hidden/layer2,
/obj/machinery/atmospherics/pipe/manifold/scrubbers/hidden/layer4{
	dir = 8
	},
/obj/machinery/power/terminal{
	dir = 8
	},
/turf/open/floor/plating,
/area/ship/engineering)
"ua" = (
/obj/structure/chair/office{
	dir = 4;
	name = "Intel Officer's Chair"
	},
/obj/item/radio/intercom/wideband{
	reach = 2;
	pixel_y = -28;
	dir = 1
	},
/obj/effect/turf_decal/trimline/opaque/solgovblue,
/turf/open/floor/plasteel/dark,
/area/ship/bridge)
"uq" = (
/turf/open/floor/plasteel/dark,
/area/ship/bridge)
"vL" = (
/obj/structure/table,
/obj/item/stack/sheet/mineral/uranium/five{
	pixel_y = 8
	},
/obj/item/stack/sheet/mineral/uranium/five{
	pixel_y = 8
	},
/obj/item/stack/sheet/mineral/uranium/five{
	pixel_x = -3
	},
/turf/open/floor/plating,
/area/ship/engineering)
"vN" = (
/obj/structure/table/reinforced,
/obj/item/binoculars,
/obj/machinery/button{
	id = "scbay";
	name = "Cargo Bay Doors";
	pixel_y = 9;
	pixel_x = -6
	},
/obj/machinery/button{
	pixel_y = 9;
	pixel_x = 6;
	name = "Bridge Blast Doors"
	},
/obj/machinery/power/apc/auto_name/west,
/obj/machinery/atmospherics/components/unary/vent_pump/on/layer2,
/obj/structure/cable{
	icon_state = "0-2"
	},
/turf/open/floor/plasteel/dark,
/area/ship/bridge)
"xk" = (
/obj/machinery/door/window{
	dir = 1
	},
/turf/open/floor/plasteel/stairs,
/area/ship/cargo)
"yl" = (
/obj/structure/cable{
	icon_state = "2-4"
	},
/obj/item/storage/secure/safe{
	pixel_x = -24
	},
/obj/machinery/airalarm/all_access{
	pixel_y = 25
	},
/turf/open/floor/wood,
/area/ship/cargo/office)
"yw" = (
/obj/machinery/atmospherics/pipe/simple/supply/hidden/layer2{
	dir = 6
	},
/obj/structure/closet/wall{
	pixel_y = 28
	},
/obj/machinery/computer/cryopod{
	pixel_x = -24;
	dir = 4
	},
/turf/open/floor/plasteel/white,
/area/ship/crew)
"yF" = (
/obj/machinery/atmospherics/pipe/manifold/supply/hidden/layer2,
/obj/machinery/atmospherics/pipe/simple/scrubbers/hidden/layer4{
	dir = 8
	},
/obj/structure/cable{
	icon_state = "4-8"
	},
/obj/machinery/airalarm/all_access{
	dir = 1;
	pixel_y = -25
	},
/turf/open/floor/plasteel/white,
/area/ship/hallway/central)
"yG" = (
/obj/structure/table/reinforced,
/obj/item/binoculars{
	pixel_x = 4
	},
/obj/item/clipboard,
/obj/item/pen,
/turf/open/floor/plasteel/dark,
/area/ship/bridge)
"yI" = (
/obj/machinery/light/small{
	dir = 8
	},
/obj/structure/table,
/turf/open/floor/plating,
/area/ship/engineering)
"zH" = (
/obj/machinery/atmospherics/components/binary/pump/on/layer4{
	dir = 4
	},
/turf/open/floor/plating,
/area/ship/engineering)
"zY" = (
/obj/structure/cable{
	icon_state = "1-4"
	},
/obj/structure/cable{
	icon_state = "1-2"
	},
/obj/machinery/atmospherics/pipe/manifold/supply/hidden/layer2{
	dir = 8
	},
/obj/machinery/atmospherics/pipe/manifold/scrubbers/hidden/layer4{
	dir = 8
	},
/obj/machinery/power/terminal{
	dir = 8
	},
/turf/open/floor/plating,
/area/ship/engineering)
"AM" = (
/obj/machinery/door/airlock/centcom{
	name = "Restroom"
	},
/turf/open/floor/plasteel/tech/techmaint,
/area/ship/crew)
"BS" = (
/turf/open/floor/wood,
/area/ship/crew)
"Cn" = (
/obj/item/radio/intercom{
	dir = 1;
	pixel_y = 8
	},
/turf/closed/wall/mineral/plastitanium,
/area/template_noop)
"CH" = (
/obj/structure/grille,
/obj/effect/spawner/structure/window/plasma/reinforced/plastitanium,
/turf/closed/wall/mineral/plastitanium,
/area/template_noop)
"CU" = (
/obj/machinery/power/smes/shuttle/precharged{
	dir = 4
	},
/obj/structure/window/reinforced{
	dir = 8
	},
/turf/open/floor/plating,
/area/ship/engineering)
"CW" = (
/obj/structure/table/reinforced,
/obj/machinery/atmospherics/components/unary/vent_scrubber/on/layer4{
	dir = 1
	},
/obj/machinery/airalarm/all_access{
	dir = 4;
	pixel_x = -25
	},
/obj/item/paper_bin{
	pixel_x = -4
	},
/obj/item/pen/fountain,
/obj/item/folder/syndicate{
	pixel_x = 8;
	pixel_y = -2
	},
/turf/open/floor/plasteel/dark,
/area/ship/bridge)
"DU" = (
/obj/structure/closet/wall{
	pixel_y = -28;
	dir = 1
	},
/obj/item/storage/firstaid,
/obj/item/storage/firstaid,
/turf/open/floor/wood,
/area/ship/crew)
"Ee" = (
/obj/machinery/porta_turret/centcom_shuttle/weak{
	dir = 1
	},
/turf/closed/wall/mineral/plastitanium,
/area/ship/bridge)
"Ep" = (
/obj/structure/window/reinforced/spawner/north,
/obj/structure/rack,
/obj/item/reagent_containers/food/snacks/canned/beans,
/obj/item/reagent_containers/food/snacks/canned/beans,
/obj/item/reagent_containers/food/snacks/canned/beans,
/obj/item/reagent_containers/food/snacks/canned/beans,
/obj/item/reagent_containers/food/snacks/canned/beans,
/obj/item/reagent_containers/food/snacks/canned/beans,
/obj/item/reagent_containers/food/snacks/canned/beans,
/obj/item/reagent_containers/food/snacks/canned/beans,
/obj/item/reagent_containers/food/snacks/canned/beans,
/obj/item/reagent_containers/food/snacks/canned/beans,
/obj/item/reagent_containers/food/snacks/canned/beans,
/obj/effect/spawner/lootdrop/maintenance/two,
/turf/open/floor/plasteel/dark,
/area/ship/cargo)
"EX" = (
/obj/machinery/atmospherics/components/unary/vent_scrubber/on/layer4{
	dir = 8
	},
/obj/structure/cable{
	icon_state = "1-2"
	},
/obj/machinery/light/dim{
	dir = 4
	},
/turf/open/floor/wood,
/area/ship/crew)
"Fw" = (
/obj/machinery/door/airlock/external,
/turf/open/floor/plating,
/area/ship/hallway/central)
"FT" = (
/obj/machinery/atmospherics/components/unary/tank/air,
/obj/effect/turf_decal/box,
/turf/open/floor/plating,
/area/ship/engineering)
"FY" = (
/obj/machinery/atmospherics/pipe/simple/scrubbers/hidden/layer4{
	dir = 10
	},
/turf/closed/wall/mineral/plastitanium,
/area/ship/hallway/central)
"Gb" = (
/obj/machinery/button{
	id = "scbay";
	pixel_x = -28;
	name = "Cargo Bay Doors";
	dir = 4
	},
/obj/effect/turf_decal/industrial/warning,
/turf/open/floor/plasteel/tech/techmaint,
/area/ship/cargo)
"Gn" = (
/obj/machinery/power/apc/auto_name/west,
/obj/structure/cable,
/obj/structure/chair/office{
	dir = 4
	},
/turf/open/floor/wood,
/area/ship/cargo/office)
"GC" = (
/obj/structure/table/wood,
/obj/machinery/photocopier/faxmachine/longrange,
/obj/item/paper_bin,
/obj/item/toy/figure/detective{
	name = "Intel Buddy";
	pixel_y = 10;
	pixel_x = 5;
	toysay = "Let's see what Command thinks of this..."
	},
/turf/open/floor/wood,
/area/ship/cargo/office)
"GV" = (
/obj/machinery/porta_turret/centcom_shuttle/weak{
	dir = 4
	},
/turf/closed/wall/mineral/plastitanium,
/area/ship/bridge)
"Hd" = (
/obj/effect/turf_decal/trimline/opaque/bar/filled/warning,
/obj/effect/turf_decal/trimline/opaque/bar/filled/warning,
/turf/open/floor/plasteel/white,
/area/ship/hallway/central)
"Hz" = (
/obj/machinery/atmospherics/components/unary/vent_pump/on/layer2{
	dir = 1
	},
/obj/machinery/atmospherics/pipe/simple/scrubbers/hidden/layer4{
	dir = 9
	},
/obj/structure/cable,
/obj/machinery/power/apc/auto_name/south,
/turf/open/floor/plasteel/tech/techmaint,
/area/ship/cargo)
"Ig" = (
/obj/machinery/power/smes,
/obj/structure/cable{
	icon_state = "0-2"
	},
/turf/open/floor/plating,
/area/ship/engineering)
"IJ" = (
/obj/machinery/atmospherics/pipe/simple/supply/hidden/layer2{
	dir = 6
	},
/obj/machinery/atmospherics/pipe/simple/scrubbers/hidden/layer4{
	dir = 6
	},
/obj/structure/cable{
	icon_state = "2-4"
	},
/obj/structure/window/reinforced{
	dir = 8
	},
/obj/machinery/door/window/brigdoor,
/obj/structure/window/reinforced{
	dir = 4
	},
/obj/machinery/suit_storage_unit,
/turf/open/floor/plasteel/tech/techmaint,
/area/ship/hallway/central)
"Jp" = (
/obj/machinery/atmospherics/pipe/manifold/supply/hidden/layer2,
/obj/machinery/atmospherics/pipe/manifold4w/scrubbers/hidden/layer4,
/obj/structure/cable{
	icon_state = "4-8"
	},
/obj/structure/cable{
	icon_state = "1-8"
	},
/turf/open/floor/plasteel/white,
/area/ship/hallway/central)
"Jt" = (
/obj/machinery/atmospherics/pipe/simple/supply/hidden/layer2{
	dir = 4
	},
/obj/machinery/atmospherics/pipe/simple/scrubbers/hidden/layer4{
	dir = 8
	},
/obj/structure/cable{
	icon_state = "4-8"
	},
/turf/open/floor/plasteel/white,
/area/ship/engineering)
"KP" = (
/obj/structure/closet/wall{
	pixel_y = 28
	},
/obj/structure/chair/sofa/right,
/turf/open/floor/wood,
/area/ship/crew)
"KS" = (
/obj/item/radio/intercom{
	pixel_y = -9
	},
/turf/closed/wall/mineral/plastitanium,
/area/ship/crew)
"Ld" = (
/obj/machinery/atmospherics/components/unary/vent_pump/on/layer2{
	dir = 1
	},
/turf/open/floor/plating,
/area/ship/hallway/central)
"Lr" = (
/obj/machinery/power/port_gen/pacman/super,
/obj/machinery/power/terminal,
/obj/effect/turf_decal/box,
/turf/open/floor/plating,
/area/ship/engineering)
"Mb" = (
/obj/structure/chair/office{
	dir = 4;
	name = "Captain's Chair"
	},
/obj/machinery/turretid{
	pixel_y = 28
	},
/obj/effect/turf_decal/trimline/opaque/solgovblue,
/turf/open/floor/plasteel/dark,
/area/ship/bridge)
"NR" = (
/turf/open/floor/plasteel/white,
/area/ship/hallway/central)
"NW" = (
/obj/machinery/atmospherics/components/unary/vent_pump/on/layer2{
	dir = 1
	},
/obj/machinery/light/small,
/turf/open/floor/plating,
/area/ship/engineering)
"Od" = (
/obj/machinery/atmospherics/pipe/simple/scrubbers/hidden/layer4,
/turf/closed/wall/mineral/plastitanium,
/area/ship/engineering)
"Or" = (
/obj/machinery/atmospherics/pipe/simple/supply/hidden/layer2{
	dir = 9
	},
/obj/machinery/atmospherics/pipe/simple/scrubbers/hidden/layer4{
	dir = 9
	},
/obj/structure/cable{
	icon_state = "1-8"
	},
/turf/open/floor/plasteel/white,
/area/ship/hallway/central)
"OD" = (
/obj/effect/decal/cleanable/glass,
/turf/open/floor/plating,
/area/ship/engineering)
"OP" = (
/obj/machinery/atmospherics/pipe/simple/supply/hidden/layer2,
/obj/machinery/atmospherics/pipe/simple/scrubbers/hidden/layer4,
/obj/structure/cable{
	icon_state = "1-2"
	},
/obj/effect/turf_decal/trimline/opaque/bar/filled/warning,
/turf/open/floor/plasteel/white,
/area/ship/hallway/central)
"OW" = (
/obj/machinery/door/airlock/external,
/obj/machinery/atmospherics/pipe/simple/supply/hidden/layer2,
/turf/open/floor/plasteel/tech/techmaint,
/area/ship/hallway/central)
"Pk" = (
/obj/structure/cable{
	icon_state = "1-2"
	},
/obj/machinery/atmospherics/pipe/simple/scrubbers/hidden/layer4,
/obj/machinery/power/terminal{
	dir = 8
	},
/turf/open/floor/plating,
/area/ship/engineering)
"Qa" = (
/obj/machinery/holopad/emergency/command,
/turf/open/floor/plasteel/white,
/area/ship/bridge)
"Ql" = (
/obj/machinery/atmospherics/components/binary/pump/layer2{
	dir = 8
	},
/turf/open/floor/plating,
/area/ship/engineering)
"QN" = (
/obj/machinery/atmospherics/components/unary/vent_scrubber/on/layer4{
	dir = 1
	},
/obj/effect/turf_decal/trimline/opaque/bar/filled/corner,
/turf/open/floor/plasteel/white,
/area/ship/hallway/central)
"QO" = (
/obj/structure/curtain/cloth,
/obj/machinery/shower{
	pixel_y = 15
	},
/obj/structure/mirror{
	pixel_x = -28
	},
/turf/open/floor/carpet/red_gold,
/area/ship/crew)
"Ri" = (
/turf/closed/wall/mineral/plastitanium,
/area/ship/hallway/central)
"Rj" = (
/obj/structure/cable{
	icon_state = "4-8"
	},
/obj/machinery/door/window{
	dir = 4
	},
/obj/machinery/light/small{
	dir = 1
	},
/turf/open/floor/wood,
/area/ship/cargo/office)
"Rr" = (
/obj/item/toy/plush/spider,
/turf/open/floor/plating,
/area/ship/engineering)
"Rv" = (
/obj/machinery/atmospherics/pipe/simple/supply/hidden/layer2,
/obj/machinery/atmospherics/pipe/simple/scrubbers/hidden/layer4,
/obj/structure/cable{
	icon_state = "1-2"
	},
/obj/machinery/door/airlock/centcom{
	name = "Officer's Office"
	},
/turf/open/floor/plasteel/tech/techmaint,
/area/ship/cargo/office)
"Rz" = (
/obj/effect/spawner/structure/window/plasma/reinforced/plastitanium,
/obj/structure/grille,
/obj/machinery/door/poddoor{
	id = "scbridge"
	},
/turf/open/floor/plating,
/area/ship/bridge)
"RX" = (
/obj/machinery/atmospherics/components/unary/vent_pump/on/layer2{
	dir = 4
	},
/obj/structure/bed/pod,
/obj/structure/curtain,
/obj/item/bedsheet/blue,
/turf/open/floor/wood,
/area/ship/crew)
"Sx" = (
/obj/structure/cable{
	icon_state = "2-8"
	},
/obj/structure/cable{
	icon_state = "1-2"
	},
/obj/machinery/atmospherics/pipe/simple/supply/hidden/layer2,
/obj/machinery/power/terminal{
	dir = 8
	},
/turf/open/floor/plating,
/area/ship/engineering)
"SL" = (
/obj/structure/cable{
	icon_state = "1-8"
	},
/obj/machinery/atmospherics/pipe/simple/supply/hidden/layer2,
/obj/machinery/atmospherics/pipe/simple/scrubbers/hidden/layer4{
	dir = 5
	},
/turf/open/floor/plating,
/area/ship/engineering)
"Ul" = (
/obj/machinery/atmospherics/pipe/manifold4w/scrubbers/hidden/layer4,
/obj/machinery/atmospherics/pipe/manifold4w/supply/hidden/layer2,
/obj/structure/cable{
	icon_state = "4-8"
	},
/obj/structure/cable{
	icon_state = "2-8"
	},
/turf/open/floor/plasteel/white,
/area/ship/hallway/central)
"UP" = (
/obj/machinery/atmospherics/pipe/simple/supply/hidden/layer2{
	dir = 4
	},
/obj/machinery/atmospherics/pipe/simple/scrubbers/hidden/layer4{
	dir = 8
	},
/obj/structure/cable{
	icon_state = "4-8"
	},
/obj/machinery/door/airlock/engineering{
	name = "Engineering"
	},
/turf/open/floor/plasteel/white,
/area/ship/hallway/central)
"UZ" = (
/obj/structure/chair/comfy/brown{
	dir = 4
	},
/obj/effect/decal/cleanable/glass,
/turf/open/floor/plating,
/area/ship/engineering)
"Vo" = (
/obj/structure/window/reinforced/spawner/north,
/obj/structure/rack,
/obj/structure/railing{
	dir = 4
	},
/obj/item/clothing/glasses/heat,
/obj/item/clothing/glasses/heat,
/obj/item/clothing/glasses/cold,
/obj/item/clothing/glasses/cold,
/obj/effect/spawner/lootdrop/maintenance/five,
/turf/open/floor/plasteel/dark,
/area/ship/cargo)
"VJ" = (
/obj/structure/chair/sofa,
/turf/open/floor/wood,
/area/ship/crew)
"Wb" = (
/turf/closed/wall/mineral/plastitanium,
/area/template_noop)
"WM" = (
/obj/machinery/computer/cargo/express{
	dir = 8
	},
/obj/machinery/button{
	id = "intelfucky";
	pixel_y = -24;
	pixel_x = -4;
	name = "Privacy Lock";
	dir = 1
	},
/turf/open/floor/plasteel/dark,
/area/ship/bridge)
"Xc" = (
/turf/open/floor/plasteel/stairs{
	dir = 4
	},
/area/ship/bridge)
"Xv" = (
/obj/structure/table/wood,
/turf/open/floor/wood,
/area/ship/cargo/office)
"YE" = (
/obj/structure/chair/comfy/brown{
	dir = 4
	},
/turf/open/floor/wood,
/area/ship/crew)
"YG" = (
/turf/open/floor/plating,
/area/ship/engineering)
"YQ" = (
/turf/template_noop,
/area/template_noop)
"Zs" = (
/obj/machinery/atmospherics/pipe/simple/supply/hidden/layer2{
	dir = 4
	},
/obj/machinery/atmospherics/pipe/simple/scrubbers/hidden/layer4{
	dir = 8
	},
/obj/structure/cable{
	icon_state = "4-8"
	},
/obj/structure/window/reinforced{
	dir = 4
	},
/obj/machinery/door/window/brigdoor,
/obj/structure/window/reinforced{
	dir = 8
	},
/obj/machinery/suit_storage_unit,
/turf/open/floor/plasteel/tech/techmaint,
/area/ship/hallway/central)
"Zv" = (
/obj/machinery/atmospherics/components/unary/vent_scrubber/on/layer4{
	dir = 8
	},
/obj/machinery/light/small{
	dir = 1
	},
/turf/open/floor/plating,
/area/ship/engineering)
"ZI" = (
/obj/machinery/computer/helm{
	dir = 8
	},
/turf/open/floor/plasteel/dark,
/area/ship/bridge)
"ZQ" = (
/obj/machinery/atmospherics/pipe/manifold/supply/hidden/layer2{
	dir = 1
	},
/obj/machinery/atmospherics/pipe/manifold/scrubbers/hidden/layer4{
	dir = 1
	},
/obj/structure/cable{
	icon_state = "4-8"
	},
/obj/structure/cable{
	icon_state = "1-8"
	},
/turf/open/floor/plasteel/white,
/area/ship/hallway/central)

(1,1,1) = {"
ru
ru
ru
ru
ni
ni
ni
ru
ni
ni
ni
ru
ru
ru
ru
"}
(2,1,1) = {"
Ee
UZ
YG
ru
dN
dN
dN
qz
CU
CU
CU
id
yI
qD
cY
"}
(3,1,1) = {"
hT
dZ
YG
ru
hr
Sx
gj
rh
zY
Pk
tD
cL
SL
NW
ru
"}
(4,1,1) = {"
ru
dj
OD
YG
YG
vL
iY
ru
Jt
ru
Zv
Ql
zH
ru
ru
"}
(5,1,1) = {"
ru
ru
Rr
ru
Lr
Ig
ii
ru
iL
ru
so
FT
lP
Od
nO
"}
(6,1,1) = {"
YQ
kM
kM
kM
kM
kM
kM
Ri
UP
Ri
Ri
Ri
FY
ru
YQ
"}
(7,1,1) = {"
YQ
YQ
kM
lJ
RX
lJ
kM
ah
ZQ
OW
im
Ld
Fw
YQ
YQ
"}
(8,1,1) = {"
YQ
YQ
kM
KP
YE
DU
kM
kb
yF
jj
jj
jj
jj
YQ
YQ
"}
(9,1,1) = {"
YQ
YQ
kM
VJ
bA
BS
kM
IJ
Or
Ep
rj
Gb
gP
YQ
YQ
"}
(10,1,1) = {"
YQ
YQ
kM
VJ
nA
dx
kM
Zs
NR
bI
nF
cw
gP
YQ
YQ
"}
(11,1,1) = {"
YQ
YQ
kM
in
EX
ej
iN
Jp
QN
Vo
nF
fk
gP
YQ
YQ
"}
(12,1,1) = {"
YQ
YQ
GV
kM
kM
kM
kM
co
Hd
xk
nF
qR
jj
YQ
YQ
"}
(13,1,1) = {"
YQ
YQ
YQ
kM
yw
ia
kL
Ul
OP
sR
Hz
jj
GV
YQ
YQ
"}
(14,1,1) = {"
YQ
YQ
YQ
KS
qS
jW
kM
co
pM
pM
pM
pM
Wb
YQ
YQ
"}
(15,1,1) = {"
YQ
YQ
YQ
kM
kM
kM
kM
co
pM
yl
Gn
mD
CH
YQ
YQ
"}
(16,1,1) = {"
YQ
YQ
YQ
YQ
kM
QO
kM
co
pM
Rj
Xv
GC
CH
YQ
YQ
"}
(17,1,1) = {"
YQ
YQ
YQ
YQ
kM
aQ
AM
oN
Rv
qo
ev
mD
Wb
YQ
YQ
"}
(18,1,1) = {"
YQ
YQ
YQ
YQ
bO
bO
bO
dq
bO
bO
bO
bO
Wb
YQ
YQ
"}
(19,1,1) = {"
YQ
YQ
YQ
YQ
YQ
bO
vN
aa
bD
CW
Cn
YQ
YQ
YQ
YQ
"}
(20,1,1) = {"
YQ
YQ
YQ
YQ
YQ
bO
Mb
Qa
aT
ua
Wb
YQ
YQ
YQ
YQ
"}
(21,1,1) = {"
YQ
YQ
YQ
YQ
YQ
bO
ZI
aT
aT
WM
Wb
YQ
YQ
YQ
YQ
"}
(22,1,1) = {"
YQ
YQ
YQ
YQ
YQ
bO
bO
Xc
Xc
bO
Wb
YQ
YQ
YQ
YQ
"}
(23,1,1) = {"
YQ
YQ
YQ
YQ
YQ
YQ
Rz
uq
uq
gG
YQ
YQ
YQ
YQ
YQ
"}
(24,1,1) = {"
YQ
YQ
YQ
YQ
YQ
YQ
Rz
yG
ct
gG
YQ
YQ
YQ
YQ
YQ
"}
(25,1,1) = {"
YQ
YQ
YQ
YQ
YQ
YQ
Rz
Rz
Rz
gG
YQ
YQ
YQ
YQ
YQ
"}
