//MAP CONVERTED BY dmm2tgm.py THIS HEADER COMMENT PREVENTS RECONVERSION, DO NOT REMOVE
"a" = (
/turf/open/space/basic,
/area/space)
"e" = (
/obj/structure/railing,
/turf/open/floor/plasteel/stairs{
	dir = 8
	},
/area/space)
"f" = (
/obj/structure/railing{
	dir = 4
	},
/turf/open/floor/plasteel/stairs{
	dir = 1
	},
/area/space)
"g" = (
/turf/closed/wall/mineral/titanium,
/area/space)
"h" = (
/obj/structure/railing/corner{
	dir = 4
	},
/turf/open/floor/plasteel,
/area/space)
"n" = (
/obj/structure/window/reinforced/fulltile/shuttle,
/turf/open/space/basic,
/area/space)
"p" = (
/turf/open/floor/plasteel/mono,
/area/space)
"s" = (
/turf/closed/wall/mineral/titanium/nodiagonal,
/area/space)
"t" = (
/obj/structure/grille,
/turf/open/space/basic,
/area/space)
"u" = (
/turf/open/floor/wood/birch,
/area/space)
"v" = (
/turf/open/floor/plasteel/patterned,
/area/space)
"x" = (
/obj/structure/railing,
/turf/open/floor/plasteel,
/area/space)
"A" = (
/turf/open/floor/plating,
/area/space)
"H" = (
/obj/structure/railing{
	dir = 1
	},
/turf/open/floor/plasteel/stairs{
	dir = 8
	},
/area/space)
"I" = (
/turf/open/floor/wood/maple,
/area/space)
"J" = (
/turf/open/floor/wood/walnut,
/area/space)
"O" = (
/obj/structure/railing{
	dir = 1
	},
/turf/open/floor/plasteel,
/area/space)
"P" = (
/turf/open/floor/plasteel,
/area/space)
"R" = (
/turf/open/floor/wood,
/area/space)
"W" = (
/obj/structure/railing{
	dir = 4
	},
/turf/open/floor/plasteel/stairs,
/area/space)
"X" = (
/obj/structure/railing/corner{
	dir = 2
	},
/turf/open/floor/plasteel,
/area/space)

(1,1,1) = {"
g
a
a
a
a
a
a
g
a
a
a
a
g
a
a
a
a
a
a
a
a
a
a
a
a
a
a
a
a
a
g
a
a
a
a
g
a
"}
(2,1,1) = {"
s
a
a
a
a
a
a
g
g
g
g
g
g
a
a
a
a
a
a
a
a
a
a
a
a
a
a
a
a
a
g
g
g
g
g
g
a
"}
(3,1,1) = {"
n
a
a
a
a
a
a
g
A
A
A
A
g
a
a
a
a
a
a
a
a
a
a
a
a
a
a
a
a
a
g
A
A
A
A
g
a
"}
(4,1,1) = {"
t
a
a
a
a
a
a
g
A
A
A
A
g
g
a
a
a
a
a
a
a
a
a
a
a
a
a
a
a
g
g
A
A
A
A
g
a
"}
(5,1,1) = {"
A
a
a
a
a
a
a
g
A
A
A
A
g
g
g
g
g
g
g
g
g
g
g
g
g
g
g
g
g
g
g
A
A
A
A
g
a
"}
(6,1,1) = {"
R
a
a
a
a
a
a
g
g
g
g
g
g
g
X
W
W
v
p
p
p
p
p
p
p
v
f
f
h
g
g
g
g
g
g
g
a
"}
(7,1,1) = {"
I
a
a
a
a
a
g
g
P
P
P
P
P
g
x
v
v
v
p
p
p
p
p
p
p
v
v
v
O
g
P
P
P
P
P
g
g
"}
(8,1,1) = {"
J
a
a
a
a
a
g
P
P
P
P
P
P
g
e
v
p
p
p
p
p
p
p
p
p
p
p
v
H
g
P
P
P
P
P
P
g
"}
(9,1,1) = {"
u
a
a
a
a
a
g
P
P
P
P
P
P
g
e
v
p
p
p
p
p
p
p
p
p
p
p
v
H
g
P
P
P
P
P
P
g
"}
(10,1,1) = {"
p
a
a
a
a
a
g
P
P
P
P
P
P
g
e
v
p
p
p
p
p
p
p
p
p
p
p
v
H
g
P
P
P
P
P
P
g
"}
(11,1,1) = {"
v
a
a
a
a
a
g
P
P
P
P
P
P
g
e
v
p
p
p
p
p
p
p
p
p
p
p
v
H
g
P
P
P
P
P
P
g
"}
(12,1,1) = {"
P
a
a
a
a
a
g
P
P
P
P
P
P
g
x
v
p
p
p
p
p
p
p
p
p
p
p
v
O
g
P
P
P
P
P
P
g
"}
(13,1,1) = {"
a
a
a
a
a
a
g
P
P
P
P
P
P
g
x
v
p
p
p
p
p
p
p
p
p
p
p
v
O
g
P
P
P
P
P
P
g
"}
(14,1,1) = {"
a
a
a
a
a
a
g
P
P
P
P
P
P
g
e
v
p
p
p
p
p
p
p
p
p
p
p
v
H
g
P
P
P
P
P
P
g
"}
(15,1,1) = {"
a
a
a
a
a
a
g
P
P
P
P
P
P
g
e
v
p
p
p
p
p
p
p
p
p
p
p
v
H
g
P
P
P
P
P
P
g
"}
(16,1,1) = {"
a
a
a
a
a
a
g
P
P
P
P
P
P
g
e
v
p
p
p
p
p
p
p
p
p
p
p
v
H
g
P
P
P
P
P
P
g
"}
(17,1,1) = {"
a
a
a
a
a
a
g
P
P
P
P
P
P
g
e
v
v
v
v
v
v
v
v
v
v
v
v
v
H
g
P
P
P
P
P
P
g
"}
(18,1,1) = {"
a
a
a
a
a
a
g
g
P
P
P
P
P
g
P
g
g
g
g
g
g
g
g
g
g
g
g
g
P
g
P
P
P
P
P
g
g
"}
(19,1,1) = {"
a
a
a
a
a
a
a
g
g
g
g
g
g
g
g
g
R
R
R
R
R
g
R
R
R
R
R
g
g
g
g
g
g
g
g
g
a
"}
(20,1,1) = {"
a
a
a
a
a
a
a
g
R
R
R
R
R
R
R
g
R
R
R
R
R
g
R
R
R
R
R
g
R
R
R
R
R
R
R
g
a
"}
(21,1,1) = {"
a
a
a
a
a
a
a
g
R
R
R
R
R
R
R
g
R
R
R
R
R
g
R
R
R
R
R
g
R
R
R
R
R
R
R
g
a
"}
(22,1,1) = {"
a
a
a
a
a
a
a
g
R
R
R
R
R
R
R
g
R
R
R
R
R
g
R
R
R
R
R
g
R
R
R
R
R
R
R
g
a
"}
(23,1,1) = {"
a
a
a
a
a
a
a
g
R
R
R
R
R
R
R
g
R
R
R
R
R
g
R
R
R
R
R
g
R
R
R
R
R
R
R
g
a
"}
(24,1,1) = {"
a
a
a
a
a
a
a
g
R
R
R
R
R
R
R
g
g
g
g
g
g
g
g
g
g
g
g
g
R
R
R
R
R
R
R
g
a
"}
(25,1,1) = {"
a
a
a
a
a
a
a
g
R
R
R
R
R
R
R
g
R
R
R
R
R
R
R
R
R
R
R
g
R
R
R
R
R
R
R
g
a
"}
(26,1,1) = {"
a
a
a
a
a
a
a
g
R
R
R
R
R
R
R
g
R
R
R
R
R
R
R
R
R
R
R
g
R
R
R
R
R
R
R
g
a
"}
(27,1,1) = {"
a
a
a
a
a
a
a
g
R
R
R
R
R
R
R
g
R
R
R
R
R
R
R
R
R
R
R
g
R
R
R
R
R
R
R
g
a
"}
(28,1,1) = {"
a
a
a
a
a
a
a
g
R
R
R
R
R
R
R
g
R
R
R
R
R
R
R
R
R
R
R
g
R
R
R
R
R
R
R
g
a
"}
(29,1,1) = {"
a
a
a
a
a
a
a
g
R
R
R
R
R
R
R
g
R
R
R
R
R
R
R
R
R
R
R
g
R
R
R
R
R
R
R
g
a
"}
(30,1,1) = {"
a
a
a
a
a
a
a
g
R
R
R
R
R
R
R
g
g
R
R
R
R
R
R
R
R
R
g
g
R
R
R
R
R
R
R
g
a
"}
(31,1,1) = {"
a
a
a
a
a
a
a
g
R
R
R
R
R
R
R
g
g
g
g
g
g
g
g
g
g
g
g
g
R
R
R
R
R
R
R
g
a
"}
(32,1,1) = {"
a
a
a
a
a
a
a
g
g
R
R
R
R
R
g
g
a
a
a
a
a
a
a
a
a
a
a
g
g
R
R
R
R
R
g
g
a
"}
(33,1,1) = {"
a
a
a
a
a
a
a
a
g
g
g
g
g
g
g
a
a
a
a
a
a
a
a
a
a
a
a
a
g
g
g
g
g
g
g
a
a
"}
(34,1,1) = {"
a
a
a
a
a
a
a
a
a
a
a
a
a
a
a
a
a
a
a
a
a
a
a
a
a
a
a
a
a
a
a
a
a
a
a
a
a
"}
