//MAP CONVERTED BY dmm2tgm.py THIS HEADER COMMENT PREVENTS RECONVERSION, DO NOT REMOVE
"a" = (
/turf/closed/mineral/random,
/area/template_noop)
"b" = (
/obj/effect/turf_decal/corner/opaque/black/half{
	dir = 1
	},
/obj/effect/decal/cleanable/dirt/dust,
/obj/machinery/light/broken/directional/north,
/turf/open/floor/plasteel/airless,
/area/template_noop)
"d" = (
/turf/closed/wall/r_wall/rust,
/area/template_noop)
"e" = (
/mob/living/simple_animal/hostile/carp,
/turf/open/floor/plating/asteroid/smoothed,
/area/template_noop)
"f" = (
/turf/closed/wall/r_wall,
/area/template_noop)
"g" = (
/obj/effect/turf_decal/corner/opaque/black/half{
	dir = 1
	},
/turf/open/floor/plasteel/airless,
/area/template_noop)
"m" = (
/obj/effect/turf_decal/corner/opaque/black/half{
	dir = 1
	},
/obj/effect/decal/cleanable/dirt/dust,
/turf/open/floor/plasteel/airless,
/area/template_noop)
"s" = (
/obj/item/stack/ore/salvage/scrapmetal/ten,
/turf/open/floor/plating/airless,
/area/template_noop)
"t" = (
/obj/structure/spawner/carp,
/turf/open/floor/plating/asteroid/smoothed,
/area/template_noop)
"A" = (
/mob/living/simple_animal/hostile/carp,
/turf/template_noop,
/area/template_noop)
"D" = (
/obj/structure/lattice,
/obj/item/stack/ore/salvage/scrapmetal/ten,
/turf/open/space/basic,
/area/template_noop)
"H" = (
/obj/structure/grille/broken,
/obj/structure/poddoor_assembly/shutters,
/obj/item/stack/ore/salvage/scrapmetal/ten,
/turf/open/floor/plating/airless,
/area/template_noop)
"K" = (
/obj/effect/decal/cleanable/dirt/dust,
/obj/item/stack/ore/salvage/scrapmetal/ten,
/turf/open/floor/plating/airless,
/area/template_noop)
"L" = (
/obj/structure/lattice,
/turf/open/space/basic,
/area/template_noop)
"M" = (
/turf/open/floor/plating/airless,
/area/template_noop)
"P" = (
/mob/living/simple_animal/hostile/carp,
/turf/open/space/basic,
/area/template_noop)
"S" = (
/obj/effect/turf_decal/corner/opaque/black/half{
	dir = 1
	},
/obj/effect/decal/cleanable/dirt/dust,
/obj/item/stack/ore/salvage/scrapmetal/ten,
/turf/open/floor/plasteel/airless,
/area/template_noop)
"T" = (
/turf/template_noop,
/area/template_noop)
"W" = (
/turf/open/floor/plasteel/airless,
/area/template_noop)
"X" = (
/obj/structure/grille/broken,
/obj/structure/poddoor_assembly/shutters,
/turf/open/floor/plating/airless,
/area/template_noop)
"Y" = (
/turf/open/floor/plating/asteroid/smoothed,
/area/template_noop)

(1,1,1) = {"
T
T
T
T
P
T
T
T
T
T
"}
(2,1,1) = {"
T
T
T
T
T
L
T
P
T
T
"}
(3,1,1) = {"
T
T
T
d
K
L
a
a
T
T
"}
(4,1,1) = {"
T
T
f
g
M
e
a
a
a
T
"}
(5,1,1) = {"
T
T
d
b
M
Y
Y
a
a
a
"}
(6,1,1) = {"
T
f
d
W
Y
t
e
a
a
a
"}
(7,1,1) = {"
T
H
m
s
e
Y
a
a
a
T
"}
(8,1,1) = {"
T
X
S
L
a
a
a
d
T
T
"}
(9,1,1) = {"
T
d
m
M
T
K
a
d
T
T
"}
(10,1,1) = {"
T
L
W
M
T
M
a
T
T
T
"}
(11,1,1) = {"
T
T
A
T
T
L
T
T
T
T
"}
(12,1,1) = {"
f
D
L
T
T
D
T
T
T
T
"}
(13,1,1) = {"
d
M
T
T
T
T
T
T
T
T
"}
