//MAP CONVERTED BY dmm2tgm.py THIS HEADER COMMENT PREVENTS RECONVERSION, DO NOT REMOVE
"a" = (
/obj/structure/lattice,
/turf/open/space/basic,
/area/template_noop)
"c" = (
/obj/machinery/atmospherics/pipe/simple/orange/hidden{
	dir = 9
	},
/obj/structure/catwalk/over/plated_catwalk/dark,
/turf/open/floor/plating/airless,
/area/template_noop)
"n" = (
/obj/machinery/atmospherics/pipe/simple/orange/hidden{
	dir = 5
	},
/obj/structure/catwalk/over/plated_catwalk/dark,
/turf/open/floor/plating/airless,
/area/template_noop)
"o" = (
/obj/item/stack/ore/salvage/scrapmetal/ten,
/turf/open/space/basic,
/area/template_noop)
"s" = (
/obj/structure/girder/reinforced,
/turf/open/floor/plating/airless,
/area/template_noop)
"u" = (
/obj/structure/salvageable/machine,
/obj/machinery/door/poddoor/shutters/preopen,
/turf/open/floor/plating/airless,
/area/template_noop)
"x" = (
/obj/item/stack/ore/salvage/scrapmetal/ten,
/turf/open/floor/plating/airless,
/area/template_noop)
"y" = (
/turf/template_noop,
/area/template_noop)
"A" = (
/obj/machinery/atmospherics/components/unary/tank/fuel{
	dir = 1
	},
/obj/machinery/light/broken/directional/west,
/turf/open/floor/plating/airless,
/area/template_noop)
"B" = (
/obj/machinery/light/broken/directional/east,
/obj/item/stack/ore/salvage/scrapmetal/ten,
/turf/open/floor/plating/airless,
/area/template_noop)
"C" = (
/obj/machinery/atmospherics/pipe/simple/orange/hidden{
	dir = 4
	},
/obj/structure/catwalk/over/plated_catwalk/dark,
/turf/open/floor/plating/airless,
/area/template_noop)
"G" = (
/turf/closed/wall/r_wall,
/area/template_noop)
"J" = (
/obj/machinery/atmospherics/components/unary/shuttle/fire_heater{
	dir = 2
	},
/obj/machinery/door/poddoor/shutters/preopen,
/turf/open/floor/plating/airless,
/area/template_noop)
"K" = (
/turf/closed/wall,
/area/template_noop)
"M" = (
/obj/machinery/atmospherics/pipe/manifold/orange/hidden,
/obj/structure/catwalk/over/plated_catwalk/dark,
/obj/item/stack/ore/salvage/scrapmetal/ten,
/turf/open/floor/plating/airless,
/area/template_noop)
"Q" = (
/obj/machinery/power/shuttle/engine/electric{
	dir = 2
	},
/turf/open/floor/plating/airless,
/area/template_noop)
"R" = (
/turf/open/floor/plating/airless,
/area/template_noop)
"T" = (
/obj/machinery/atmospherics/components/binary/pump{
	dir = 1
	},
/turf/open/floor/plating/airless,
/area/template_noop)
"U" = (
/obj/machinery/atmospherics/components/binary/valve/on{
	dir = 4
	},
/obj/structure/catwalk/over/plated_catwalk/dark,
/turf/open/floor/plating/airless,
/area/template_noop)
"V" = (
/obj/structure/frame,
/turf/open/floor/plating/airless,
/area/template_noop)
"W" = (
/obj/machinery/power/shuttle/engine/fire{
	dir = 2
	},
/turf/open/floor/plating/airless,
/area/template_noop)

(1,1,1) = {"
y
y
y
o
y
s
G
x
"}
(2,1,1) = {"
y
G
G
s
G
G
R
y
"}
(3,1,1) = {"
G
G
A
n
R
K
y
y
"}
(4,1,1) = {"
Q
u
R
U
a
a
x
y
"}
(5,1,1) = {"
W
J
T
M
a
K
y
y
"}
(6,1,1) = {"
G
K
K
C
y
y
y
y
"}
(7,1,1) = {"
W
J
T
c
R
y
o
y
"}
(8,1,1) = {"
V
u
R
R
a
o
y
y
"}
(9,1,1) = {"
G
G
B
a
a
a
y
y
"}
(10,1,1) = {"
y
G
s
R
a
y
y
y
"}
(11,1,1) = {"
y
y
y
o
y
y
y
y
"}
