//MAP CONVERTED BY dmm2tgm.py THIS HEADER COMMENT PREVENTS RECONVERSION, DO NOT REMOVE
"a" = (
/obj/structure/lattice,
/turf/open/space/basic,
/area/space)
"c" = (
/obj/structure/girder,
/turf/open/floor/plating/airless,
/area/space)
"d" = (
/turf/closed/wall/mineral/titanium/nodiagonal,
/area/space)
"e" = (
/obj/item/stack/ore/salvage/scraptitanium/five,
/turf/open/floor/plating/airless,
/area/space)
"f" = (
/obj/structure/girder,
/obj/item/stack/ore/salvage/scraptitanium/five,
/turf/open/floor/plating/airless,
/area/space)
"h" = (
/obj/effect/turf_decal/trimline/opaque/blue/filled/arrow_cw{
	dir = 4
	},
/obj/effect/decal/cleanable/blood/old,
/obj/machinery/light/small/broken/directional/east,
/turf/open/floor/plasteel/dark/airless,
/area/space)
"l" = (
/obj/machinery/light/small/broken/directional/west,
/turf/open/floor/plating/airless,
/area/space)
"o" = (
/obj/effect/turf_decal/trimline/opaque/blue/filled/arrow_cw{
	dir = 4
	},
/obj/effect/decal/cleanable/blood/gibs/old,
/turf/open/floor/plasteel/dark/airless,
/area/space)
"w" = (
/obj/item/stack/ore/salvage/scraptitanium/five,
/turf/open/space/basic,
/area/space)
"F" = (
/obj/effect/decal/cleanable/dirt/dust,
/obj/machinery/light/small/broken/directional/south,
/turf/open/floor/engine/hull,
/area/space)
"G" = (
/obj/structure/lattice,
/obj/item/stack/ore/salvage/scraptitanium/five,
/turf/open/space/basic,
/area/space)
"H" = (
/obj/structure/poddoor_assembly/shutters,
/obj/structure/grille/broken,
/turf/open/floor/plating/airless,
/area/space)
"L" = (
/obj/structure/bodycontainer/morgue,
/turf/open/floor/plasteel/dark/airless,
/area/space)
"M" = (
/turf/template_noop,
/area/space)
"P" = (
/obj/effect/turf_decal/siding/wood/walnut{
	dir = 4
	},
/obj/effect/decal/cleanable/dirt/dust,
/turf/open/floor/carpet/airless,
/area/space)
"R" = (
/obj/machinery/light/small/broken/directional/south,
/obj/item/stack/ore/salvage/scraptitanium/five,
/turf/open/floor/engine/hull,
/area/space)
"U" = (
/obj/structure/girder,
/turf/open/floor/plating,
/area/space)
"V" = (
/obj/effect/decal/cleanable/dirt/dust,
/turf/open/floor/engine/hull,
/area/space)

(1,1,1) = {"
M
M
M
M
M
f
M
M
"}
(2,1,1) = {"
M
M
M
M
G
c
M
M
"}
(3,1,1) = {"
M
M
M
M
a
d
M
M
"}
(4,1,1) = {"
M
M
a
a
d
d
w
M
"}
(5,1,1) = {"
M
M
w
a
L
d
M
M
"}
(6,1,1) = {"
M
M
M
h
o
d
R
d
"}
(7,1,1) = {"
M
e
U
d
d
d
M
d
"}
(8,1,1) = {"
M
M
M
l
P
d
V
f
"}
(9,1,1) = {"
M
M
w
M
M
H
M
M
"}
(10,1,1) = {"
M
M
M
M
M
M
a
M
"}
(11,1,1) = {"
M
M
H
M
w
M
G
M
"}
(12,1,1) = {"
M
M
H
M
M
F
d
M
"}
(13,1,1) = {"
G
a
d
M
M
M
d
M
"}
(14,1,1) = {"
M
M
M
M
a
G
d
M
"}
