//MAP CONVERTED BY dmm2tgm.py THIS HEADER COMMENT PREVENTS RECONVERSION, DO NOT REMOVE
"av" = (
/obj/structure/lattice,
/turf/closed/wall/r_wall,
/area/space)
"aI" = (
/obj/structure/window/plasma/reinforced/plastitanium,
/obj/structure/grille,
/obj/machinery/door/poddoor/shutters{
	dir = 4
	},
/obj/machinery/atmospherics/pipe/layer_manifold{
	dir = 4
	},
/turf/open/floor/plating/airless,
/area/space)
"aN" = (
/obj/structure/salvageable/computer{
	dir = 1
	},
/obj/effect/turf_decal/trimline/opaque/bottlegreen/filled/line{
	dir = 6
	},
/turf/open/floor/hangar/plasteel/dark,
/area/space)
"aZ" = (
/obj/structure/window/plasma/reinforced/plastitanium,
/obj/structure/grille,
/obj/machinery/door/poddoor/shutters/preopen{
	dir = 4
	},
/turf/open/floor/plating,
/area/space)
"bv" = (
/obj/structure/table/reinforced,
/obj/item/radio/intercom/wideband/table{
	pixel_x = -7;
	dir = 8;
	pixel_y = 5
	},
/obj/effect/turf_decal/trimline/opaque/bottlegreen/filled/line{
	dir = 8
	},
/obj/effect/decal/cleanable/dirt,
/turf/open/floor/hangar/plasteel/dark,
/area/space)
"bN" = (
/obj/structure/chair/comfy/shuttle,
/obj/effect/turf_decal/trimline/opaque/bottlegreen/filled/corner{
	dir = 8
	},
/obj/effect/decal/cleanable/dirt,
/turf/open/floor/hangar/plasteel/dark,
/area/space)
"cs" = (
/obj/structure/railing{
	dir = 4
	},
/obj/item/stack/ore/salvage/scrapmetal,
/turf/open/floor/plating/airless{
	icon_state = "platingdmg3"
	},
/area/space)
"cu" = (
/turf/open/floor/plasteel/airless{
	icon_state = "tile_full"
	},
/area/space)
"fH" = (
/obj/structure/chair/comfy/beige,
/obj/machinery/light/small/directional/north,
/turf/open/floor/plasteel/airless{
	icon_state = "tiled_dark"
	},
/area/space)
"fO" = (
/obj/machinery/door/airlock/command,
/obj/machinery/atmospherics/pipe/simple/supply/hidden/layer2,
/obj/machinery/atmospherics/pipe/simple/scrubbers/hidden/layer4,
/turf/open/floor/hangar/plasteel/dark,
/area/space)
"hu" = (
/obj/structure/table/reinforced,
/obj/item/wallframe/intercom/table{
	dir = 8;
	pixel_x = -7
	},
/obj/item/food/nachos{
	pixel_x = 8;
	pixel_y = 18
	},
/obj/item/reagent_containers/food/drinks/soda_cans/shoal_punch{
	pixel_x = 11
	},
/obj/effect/turf_decal/trimline/opaque/bottlegreen/filled/line{
	dir = 10
	},
/obj/machinery/light/small/directional/west,
/turf/open/floor/hangar/plasteel/dark,
/area/space)
"is" = (
/obj/structure/cable{
	icon_state = "1-4"
	},
/obj/effect/decal/cleanable/dirt,
/turf/open/floor/plating/airless{
	icon_state = "plating_rust"
	},
/area/space)
"iy" = (
/obj/machinery/atmospherics/components/unary/vent_pump/on/layer2{
	dir = 4
	},
/obj/machinery/light/broken/directional/south,
/obj/effect/decal/cleanable/dirt,
/turf/open/floor/plasteel/airless{
	icon_state = "tiled_dark"
	},
/area/space)
"jq" = (
/obj/effect/decal/cleanable/dirt,
/turf/open/floor/plasteel/airless{
	icon_state = "tiled_dark"
	},
/area/space)
"kg" = (
/obj/structure/chair/comfy/beige{
	dir = 4
	},
/obj/item/ammo_casing/spent{
	pixel_y = 10;
	pixel_x = 7
	},
/obj/machinery/atmospherics/pipe/simple/supply/hidden/layer2,
/obj/effect/decal/cleanable/dirt,
/turf/open/floor/plasteel/airless{
	icon_state = "tiled_dark"
	},
/area/space)
"kj" = (
/obj/machinery/atmospherics/components/unary/vent_scrubber/on/layer4{
	dir = 4
	},
/obj/effect/turf_decal/siding/wood{
	color = "#543C30";
	dir = 9
	},
/obj/machinery/light/small/directional/north,
/obj/effect/decal/cleanable/dirt,
/turf/open/floor/wood{
	icon_state = "wood-broken5"
	},
/area/space)
"lB" = (
/obj/structure/cable{
	icon_state = "6-8"
	},
/obj/structure/cable{
	icon_state = "1-4"
	},
/obj/machinery/atmospherics/components/unary/vent_scrubber/on/layer4{
	dir = 4
	},
/obj/effect/decal/cleanable/dirt,
/turf/open/floor/plating/airless{
	icon_state = "platingdmg1"
	},
/area/space)
"lS" = (
/obj/structure/windoor_assembly{
	dir = 2
	},
/obj/machinery/shower{
	pixel_y = 18
	},
/obj/structure/sink{
	dir = 8;
	pixel_x = 14;
	pixel_y = 5
	},
/turf/open/floor/plating/airless,
/area/space)
"lZ" = (
/obj/machinery/atmospherics/components/unary/tank/air,
/turf/open/floor/plating/airless{
	icon_state = "platingdmg3"
	},
/area/space)
"md" = (
/obj/machinery/atmospherics/components/unary/vent_pump/on/layer2{
	dir = 1
	},
/obj/machinery/atmospherics/pipe/simple/scrubbers/hidden/layer4{
	dir = 9
	},
/obj/effect/turf_decal/siding/wood{
	dir = 5;
	color = "#543C30"
	},
/obj/effect/decal/cleanable/dirt,
/turf/open/floor/wood,
/area/space)
"mg" = (
/obj/machinery/power/smes/shuttle{
	dir = 2
	},
/obj/structure/window/plasma{
	dir = 1
	},
/obj/machinery/door/poddoor/shutters,
/turf/open/floor/plating/airless,
/area/space)
"mk" = (
/obj/machinery/door/poddoor{
	dir = 4
	},
/turf/open/floor/plating/airless,
/area/space)
"mE" = (
/obj/structure/table/reinforced,
/obj/item/paper_bin{
	pixel_x = 6;
	pixel_y = 6
	},
/obj/item/pen{
	pixel_x = 5;
	pixel_y = 8
	},
/obj/effect/turf_decal/trimline/opaque/bottlegreen/filled/line{
	dir = 6
	},
/obj/item/reagent_containers/glass/mortar/metal{
	pixel_x = -8
	},
/obj/item/cigbutt{
	pixel_x = -5;
	pixel_y = 13
	},
/obj/item/cigbutt{
	pixel_x = -10;
	pixel_y = 6
	},
/obj/item/cigbutt/cigarbutt{
	pixel_x = -6;
	pixel_y = 4
	},
/obj/item/storage/fancy/cigarettes/cigpack_robust{
	pixel_x = -8;
	pixel_y = 11
	},
/obj/machinery/light/small/directional/east,
/turf/open/floor/hangar/plasteel/dark,
/area/space)
"mI" = (
/obj/structure/chair/comfy/shuttle,
/obj/effect/turf_decal/trimline/opaque/bottlegreen/filled/corner,
/turf/open/floor/hangar/plasteel/dark,
/area/space)
"mW" = (
/obj/machinery/power/terminal{
	dir = 4
	},
/obj/structure/cable{
	icon_state = "0-8"
	},
/obj/effect/decal/cleanable/dirt,
/obj/effect/decal/cleanable/oil,
/turf/open/floor/plating/airless,
/area/space)
"pj" = (
/obj/structure/dresser{
	dir = 8
	},
/obj/effect/decal/cleanable/dirt,
/turf/open/floor/wood,
/area/space)
"pC" = (
/obj/effect/decal/cleanable/dirt,
/turf/open/floor/plating/airless{
	icon_state = "platingdmg1"
	},
/area/space)
"qr" = (
/obj/structure/salvageable/autolathe,
/turf/open/floor/plating/airless{
	icon_state = "platingdmg1"
	},
/area/space)
"qQ" = (
/obj/item/stack/ore/salvage/scrapmetal{
	pixel_x = -10
	},
/turf/open/space/basic,
/area/space)
"tk" = (
/obj/machinery/power/terminal{
	dir = 1
	},
/obj/structure/cable{
	icon_state = "0-2"
	},
/turf/open/floor/plating/airless{
	icon_state = "platingdmg1"
	},
/area/space)
"uo" = (
/obj/effect/decal/cleanable/ash/large,
/obj/effect/decal/cleanable/plasma,
/turf/open/floor/plating/airless,
/area/space)
"uC" = (
/obj/item/chair/stool/bar,
/obj/effect/decal/cleanable/blood/hitsplatter{
	dir = 4
	},
/obj/machinery/atmospherics/pipe/simple/scrubbers/hidden/layer4,
/obj/effect/decal/cleanable/dirt,
/turf/open/floor/plasteel/airless{
	icon_state = "tiled_dark"
	},
/area/space)
"vQ" = (
/obj/effect/turf_decal/miskilamo_small/right{
	dir = 4
	},
/obj/machinery/atmospherics/pipe/simple/general/hidden{
	dir = 1
	},
/turf/open/floor/engine/hull,
/area/space)
"xj" = (
/obj/machinery/atmospherics/components/unary/vent_scrubber/on/layer4{
	dir = 8
	},
/obj/effect/turf_decal/trimline/opaque/bottlegreen/filled/line{
	dir = 5
	},
/turf/open/floor/hangar/plasteel/dark,
/area/space)
"xy" = (
/obj/structure/toilet{
	dir = 8;
	pixel_x = 7;
	pixel_y = 6
	},
/obj/machinery/light/small/directional/east,
/turf/open/floor/carpet/black/airless,
/area/space)
"xS" = (
/obj/structure/door_assembly/door_assembly_eng,
/obj/machinery/atmospherics/pipe/simple/supply/hidden/layer2,
/obj/machinery/atmospherics/pipe/simple/scrubbers/hidden/layer4,
/obj/effect/decal/cleanable/dirt,
/turf/open/floor/hangar/plasteel/dark,
/area/space)
"yi" = (
/obj/item/stack/ore/salvage/scrapmetal{
	pixel_y = 12
	},
/turf/open/floor/plating/airless{
	icon_state = "platingdmg2"
	},
/area/space)
"yl" = (
/obj/machinery/power/terminal{
	dir = 1
	},
/obj/structure/cable{
	icon_state = "0-2"
	},
/obj/structure/cable{
	icon_state = "4-10"
	},
/turf/open/floor/plating/airless{
	icon_state = "plating_rust"
	},
/area/space)
"yW" = (
/obj/structure/catwalk/over/plated_catwalk/dark,
/obj/machinery/atmospherics/pipe/manifold/supply/hidden/layer2{
	dir = 4
	},
/obj/machinery/atmospherics/pipe/manifold/scrubbers/hidden/layer4{
	dir = 4
	},
/obj/machinery/light/small/directional/east,
/obj/effect/decal/cleanable/dirt,
/turf/open/floor/plating/airless,
/area/space)
"yY" = (
/obj/machinery/power/port_gen/pacman,
/obj/structure/cable{
	icon_state = "0-4"
	},
/turf/open/floor/plating/airless,
/area/space)
"za" = (
/obj/structure/lattice,
/turf/open/space/basic,
/area/space)
"An" = (
/obj/machinery/atmospherics/pipe/simple/scrubbers/hidden/layer4{
	dir = 8
	},
/obj/structure/filingcabinet/double{
	pixel_y = 22
	},
/obj/item/folder/documents,
/obj/item/pen/fountain,
/obj/item/pen/fountain,
/obj/effect/turf_decal/trimline/opaque/bottlegreen/filled/line{
	dir = 1
	},
/turf/open/floor/hangar/plasteel/dark,
/area/space)
"AV" = (
/obj/effect/decal/cleanable/dirt,
/turf/open/floor/hangar/plasteel/dark,
/area/space)
"Ba" = (
/obj/structure/lattice,
/obj/structure/girder/reinforced,
/turf/open/space/basic,
/area/space)
"BY" = (
/obj/machinery/atmospherics/pipe/simple/supply/hidden/layer2{
	dir = 9
	},
/obj/machinery/button{
	dir = 8;
	pixel_x = 21
	},
/obj/effect/decal/cleanable/dirt,
/turf/open/floor/plasteel/airless{
	icon_state = "tiled_dark"
	},
/area/space)
"Cz" = (
/obj/machinery/power/smes/shuttle{
	dir = 2
	},
/obj/structure/window/plasma{
	dir = 1
	},
/obj/machinery/door/poddoor/shutters,
/turf/open/floor/plating/airless{
	icon_state = "plating_rust"
	},
/area/space)
"Dq" = (
/obj/effect/turf_decal/industrial/warning{
	dir = 4
	},
/obj/structure/railing{
	dir = 4
	},
/obj/machinery/suit_storage_unit/industrial,
/obj/item/clothing/suit/space/hardsuit/mining/independent,
/obj/machinery/light/directional/south,
/turf/open/floor/plasteel/dark/airless{
	icon_state = "grid_dark"
	},
/area/space)
"DL" = (
/obj/structure/catwalk/over/plated_catwalk/dark,
/obj/effect/decal/cleanable/blood/gibs/down,
/obj/machinery/atmospherics/pipe/simple/supply/hidden/layer2,
/obj/machinery/atmospherics/pipe/simple/scrubbers/hidden/layer4,
/turf/open/floor/plating/airless{
	icon_state = "plating_rust"
	},
/area/space)
"EE" = (
/obj/effect/decal/cleanable/dirt,
/turf/open/floor/plating/airless,
/area/space)
"EN" = (
/obj/machinery/porta_turret/ruin/burst,
/turf/closed/wall/r_wall,
/area/space)
"ET" = (
/obj/machinery/button{
	pixel_y = 22
	},
/turf/open/floor/plating/airless{
	icon_state = "platingdmg3"
	},
/area/space)
"Fq" = (
/obj/structure/girder/reinforced,
/turf/open/floor/plating/airless,
/area/space)
"FE" = (
/obj/structure/cable{
	icon_state = "4-8"
	},
/obj/structure/cable{
	icon_state = "1-4"
	},
/obj/effect/decal/cleanable/dirt,
/turf/open/floor/plating/airless,
/area/space)
"FY" = (
/obj/structure/catwalk/over/plated_catwalk/dark,
/obj/machinery/atmospherics/pipe/simple/supply/hidden/layer2{
	dir = 8
	},
/obj/machinery/atmospherics/pipe/manifold/scrubbers/hidden/layer4,
/turf/open/floor/plating/airless,
/area/space)
"Gh" = (
/obj/structure/door_assembly{
	dir = 4
	},
/turf/open/floor/plasteel/airless{
	icon_state = "tiled_dark"
	},
/area/space)
"Hy" = (
/obj/machinery/atmospherics/components/binary/pump/layer2,
/obj/machinery/atmospherics/components/binary/pump/layer4{
	dir = 4
	},
/turf/open/floor/plating/airless,
/area/space)
"Hz" = (
/obj/machinery/door/poddoor/preopen{
	dir = 4
	},
/obj/effect/decal/cleanable/dirt,
/turf/open/floor/plating/airless,
/area/space)
"Im" = (
/obj/structure/salvageable/machine,
/turf/open/floor/plating/airless{
	icon_state = "platingdmg3"
	},
/area/space)
"IC" = (
/obj/machinery/door/airlock{
	dir = 4
	},
/turf/open/floor/plasteel/airless{
	icon_state = "tiled_dark"
	},
/area/space)
"JL" = (
/obj/structure/table/wood/poker,
/obj/item/toy/cards/deck/kotahi{
	pixel_y = 4
	},
/obj/item/gun/ballistic/derringer/empty{
	pixel_y = 11;
	pixel_x = -3
	},
/obj/item/ammo_casing/spent{
	pixel_x = -6;
	pixel_y = -3
	},
/turf/open/floor/plasteel/airless{
	icon_state = "tiled_dark"
	},
/area/space)
"Kd" = (
/obj/effect/turf_decal/industrial/warning{
	dir = 4
	},
/obj/machinery/atmospherics/pipe/simple/supply/hidden/layer2{
	dir = 8
	},
/obj/machinery/atmospherics/pipe/simple/scrubbers/hidden/layer4{
	dir = 8
	},
/turf/open/floor/plasteel/airless{
	icon_state = "tile_full"
	},
/area/space)
"Ki" = (
/obj/structure/catwalk/over/plated_catwalk/dark,
/obj/structure/cable{
	icon_state = "2-9"
	},
/obj/structure/cable{
	icon_state = "1-2"
	},
/obj/machinery/atmospherics/pipe/manifold/supply/hidden/layer2{
	dir = 1
	},
/obj/machinery/atmospherics/pipe/simple/scrubbers/hidden/layer4,
/turf/open/floor/plasteel/airless{
	icon_state = "grid_dark"
	},
/area/space)
"Kn" = (
/obj/effect/turf_decal/industrial/warning{
	dir = 4
	},
/obj/structure/railing{
	dir = 4
	},
/turf/open/floor/plasteel/airless{
	icon_state = "tile_full"
	},
/area/space)
"Kp" = (
/obj/machinery/door/poddoor/preopen{
	dir = 4
	},
/turf/open/floor/plating/airless,
/area/space)
"LZ" = (
/turf/closed/wall,
/area/space)
"Mn" = (
/obj/machinery/atmospherics/pipe/simple/scrubbers/hidden/layer4{
	dir = 5
	},
/obj/effect/decal/cleanable/dirt,
/turf/open/floor/plating/airless,
/area/space)
"Ny" = (
/obj/structure/table/reinforced,
/obj/machinery/microwave{
	pixel_y = 6
	},
/turf/open/floor/plasteel/airless{
	icon_state = "tiled_dark"
	},
/area/space)
"NS" = (
/obj/machinery/atmospherics/components/unary/vent_pump/on/layer2,
/turf/open/floor/plasteel/airless{
	icon_state = "tiled_dark"
	},
/area/space)
"OT" = (
/obj/structure/catwalk/over/plated_catwalk,
/obj/structure/catwalk/over/plated_catwalk/dark,
/obj/machinery/atmospherics/pipe/manifold4w/supply/hidden/layer2,
/obj/machinery/atmospherics/pipe/manifold/scrubbers/hidden/layer4{
	dir = 1
	},
/turf/open/floor/plating/airless,
/area/space)
"Ph" = (
/obj/structure/salvageable/computer{
	dir = 1
	},
/obj/effect/turf_decal/trimline/opaque/bottlegreen/filled/line{
	dir = 10
	},
/turf/open/floor/hangar/plasteel/dark,
/area/space)
"Pk" = (
/turf/closed/wall/r_wall,
/area/space)
"Pv" = (
/obj/structure/cable{
	icon_state = "2-5"
	},
/obj/structure/cable{
	icon_state = "4-8"
	},
/turf/open/floor/plating/airless,
/area/space)
"PO" = (
/obj/structure/lattice,
/obj/item/stack/ore/salvage/scrapmetal,
/turf/open/space/basic,
/area/space)
"PP" = (
/obj/effect/turf_decal/miskilamo_small{
	dir = 4
	},
/obj/machinery/atmospherics/pipe/simple/general/hidden{
	dir = 9
	},
/turf/open/floor/engine/hull,
/area/space)
"PS" = (
/obj/structure/catwalk/over/plated_catwalk/dark,
/obj/machinery/atmospherics/pipe/simple/supply/hidden/layer2{
	dir = 8
	},
/obj/machinery/atmospherics/pipe/simple/scrubbers/hidden/layer4{
	dir = 8
	},
/obj/effect/decal/cleanable/dirt,
/turf/open/floor/plating/airless,
/area/space)
"Qq" = (
/turf/open/space/basic,
/area/space)
"QE" = (
/obj/structure/girder,
/turf/open/floor/plating/airless,
/area/space)
"QF" = (
/obj/structure/window/plasma/reinforced/plastitanium,
/obj/structure/grille,
/obj/machinery/door/poddoor/shutters/preopen,
/turf/open/floor/plating,
/area/space)
"QO" = (
/obj/machinery/power/terminal{
	dir = 1
	},
/obj/structure/cable{
	icon_state = "0-2"
	},
/obj/structure/cable{
	icon_state = "2-8"
	},
/turf/open/floor/plating/airless,
/area/space)
"QQ" = (
/obj/structure/closet/crate/trashcart,
/obj/machinery/light/small/directional/east,
/turf/open/floor/plating/airless,
/area/space)
"QV" = (
/obj/effect/spawner/bunk_bed,
/obj/effect/turf_decal/siding/wood{
	dir = 10;
	color = "#543C30"
	},
/obj/effect/decal/cleanable/dirt,
/turf/open/floor/wood,
/area/space)
"QZ" = (
/obj/structure/crate_shelf,
/obj/effect/turf_decal/box,
/obj/machinery/light/broken/directional/south,
/turf/open/floor/plasteel/dark/airless{
	icon_state = "grid_dark"
	},
/area/space)
"Rf" = (
/obj/item/radio/intercom/directional/north,
/obj/machinery/atmospherics/components/unary/vent_scrubber/on/layer4,
/turf/open/floor/plasteel/airless{
	icon_state = "tiled_dark"
	},
/area/space)
"Ry" = (
/obj/machinery/atmospherics/components/unary/outlet_injector/on,
/turf/open/floor/engine/hull,
/area/space)
"RL" = (
/obj/structure/crate_shelf,
/obj/structure/closet/crate{
	name = "ration crate"
	},
/obj/effect/turf_decal/box,
/obj/item/blackmarket_uplink,
/obj/item/inhaler/sting,
/obj/item/reagent_containers/hypospray/medipen/rabbit,
/turf/open/floor/plasteel/dark/airless{
	icon_state = "grid_dark"
	},
/area/space)
"RP" = (
/obj/effect/turf_decal/miskilamo_small/left{
	dir = 4
	},
/turf/open/floor/engine/hull,
/area/space)
"RY" = (
/obj/machinery/atmospherics/pipe/simple/supply/hidden/layer2{
	dir = 9
	},
/obj/machinery/atmospherics/pipe/simple/scrubbers/hidden/layer4{
	dir = 5
	},
/obj/effect/turf_decal/trimline/opaque/bottlegreen/filled/line{
	dir = 1
	},
/turf/open/floor/hangar/plasteel/dark,
/area/space)
"Sr" = (
/obj/machinery/light/small/broken/directional/south,
/obj/structure/closet/secure_closet/freezer/fridge,
/obj/item/food/canned/peaches{
	pixel_y = 10
	},
/obj/item/food/canned/peaches{
	pixel_x = -9;
	pixel_y = 10
	},
/obj/item/pizzabox/pineapple,
/obj/item/storage/cans/sixbeer{
	pixel_x = 3;
	pixel_y = 7
	},
/turf/open/floor/plasteel/airless{
	icon_state = "tiled_dark"
	},
/area/space)
"TU" = (
/obj/effect/turf_decal/siding/wood{
	dir = 5;
	color = "#543C30"
	},
/turf/closed/wall,
/area/space)
"Uc" = (
/obj/machinery/power/shuttle/engine/electric{
	dir = 2
	},
/turf/open/floor/plating/airless,
/area/space)
"Ul" = (
/obj/effect/spawner/bunk_bed,
/obj/effect/turf_decal/siding/wood{
	color = "#543C30";
	dir = 6
	},
/turf/open/floor/wood{
	icon_state = "wood-broken4"
	},
/area/space)
"UK" = (
/obj/effect/turf_decal/industrial/warning{
	dir = 4
	},
/obj/structure/railing{
	dir = 4
	},
/obj/effect/decal/cleanable/dirt,
/turf/open/floor/plasteel/airless{
	icon_state = "tile_full"
	},
/area/space)
"Vm" = (
/obj/structure/closet/wall/blue/directional/east,
/obj/item/gun/ballistic/automatic/pistol/ringneck/indie,
/obj/item/ammo_box/magazine/m10mm_ringneck,
/obj/item/ammo_box/magazine/m10mm_ringneck,
/obj/item/melee/knife/combat,
/obj/effect/turf_decal/trimline/opaque/bottlegreen/filled/line{
	dir = 4
	},
/turf/open/floor/hangar/plasteel/dark,
/area/space)
"Vu" = (
/obj/machinery/power/smes,
/obj/structure/cable{
	icon_state = "0-1"
	},
/turf/open/floor/plating/airless,
/area/space)
"VP" = (
/turf/open/floor/plating/airless{
	icon_state = "platingdmg2"
	},
/area/space)
"We" = (
/obj/effect/decal/cleanable/food/egg_smudge,
/obj/effect/decal/cleanable/dirt,
/turf/open/floor/plasteel/airless{
	icon_state = "tiled_dark"
	},
/area/space)
"Wn" = (
/obj/structure/catwalk/over/plated_catwalk/dark,
/obj/machinery/atmospherics/pipe/simple/supply/hidden/layer2,
/obj/machinery/atmospherics/pipe/simple/scrubbers/hidden/layer4,
/turf/open/floor/plating/airless,
/area/space)
"XD" = (
/obj/machinery/door/airlock,
/obj/machinery/atmospherics/pipe/simple/supply/hidden/layer2,
/obj/machinery/atmospherics/pipe/simple/scrubbers/hidden/layer4,
/turf/open/floor/hangar/plasteel/dark,
/area/space)
"YD" = (
/obj/machinery/atmospherics/components/unary/vent_pump/on/layer2{
	dir = 4
	},
/obj/effect/turf_decal/trimline/opaque/bottlegreen/filled/line{
	dir = 9
	},
/obj/effect/decal/cleanable/dirt,
/obj/effect/decal/cleanable/cobweb,
/turf/open/floor/hangar/plasteel/dark,
/area/space)
"YI" = (
/obj/structure/cable{
	icon_state = "1-2"
	},
/obj/structure/cable{
	icon_state = "2-8"
	},
/obj/machinery/atmospherics/pipe/manifold/scrubbers/hidden/layer4{
	dir = 1
	},
/obj/effect/decal/cleanable/oil,
/turf/open/floor/plating/airless,
/area/space)
"YU" = (
/obj/effect/decal/cleanable/dirt,
/turf/open/floor/plasteel/airless{
	icon_state = "tile_full"
	},
/area/space)
"YV" = (
/obj/machinery/power/terminal{
	dir = 1
	},
/obj/structure/cable{
	icon_state = "0-2"
	},
/turf/open/floor/plating/airless,
/area/space)
"YX" = (
/obj/structure/closet/wall/white/directional/east,
/obj/item/pushbroom,
/obj/item/mop,
/obj/item/reagent_containers/glass/bucket{
	pixel_x = 8;
	pixel_y = -6
	},
/obj/effect/decal/cleanable/garbage,
/turf/open/floor/plating/airless,
/area/space)
"ZC" = (
/obj/effect/decal/cleanable/ash,
/turf/open/floor/plating/airless,
/area/space)

(1,1,1) = {"
Qq
Qq
Qq
Qq
Qq
Qq
Qq
Qq
Qq
Qq
Qq
Qq
Qq
Qq
Qq
Qq
Qq
Qq
Qq
Qq
"}
(2,1,1) = {"
Qq
Qq
Qq
Qq
Qq
Qq
Qq
Qq
Qq
Qq
Qq
Qq
Qq
Qq
Qq
Qq
Qq
Qq
Qq
Qq
"}
(3,1,1) = {"
Qq
Qq
Qq
Qq
Qq
Qq
Qq
Qq
Qq
Qq
Qq
Qq
Qq
Qq
Qq
Qq
Qq
Qq
Qq
Qq
"}
(4,1,1) = {"
Qq
Qq
Qq
Qq
Qq
qQ
Qq
Qq
za
Qq
Qq
Qq
Qq
Qq
Qq
Qq
Qq
Qq
Qq
Qq
"}
(5,1,1) = {"
Qq
Qq
Qq
Qq
Qq
Qq
PO
av
Hz
Kp
mk
Pk
EN
Qq
Qq
Qq
Qq
Qq
Qq
Qq
"}
(6,1,1) = {"
Qq
Qq
EN
Pk
Fq
PO
Ba
Im
yi
EE
YU
QZ
Pk
Pk
Pk
Qq
Qq
Qq
Qq
Qq
"}
(7,1,1) = {"
Qq
Pk
Pk
ET
EE
pC
VP
uo
ZC
Mn
cu
RL
LZ
pj
Pk
Pk
Qq
Qq
Qq
Qq
"}
(8,1,1) = {"
Qq
Uc
mg
tk
is
yY
QE
cs
Kn
Kd
UK
Dq
LZ
kj
QV
Pk
Qq
Qq
Qq
Qq
"}
(9,1,1) = {"
Qq
Uc
mg
YV
FE
mW
QE
NS
kg
OT
Wn
Wn
XD
md
Ul
Pk
Qq
Qq
Qq
Qq
"}
(10,1,1) = {"
Qq
Pk
Pk
qr
Pv
Vu
LZ
fH
JL
PS
jq
Sr
LZ
TU
LZ
Pk
Pk
Qq
Qq
Qq
"}
(11,1,1) = {"
Qq
Uc
Cz
yl
lB
iy
LZ
Rf
uC
FY
We
Ny
LZ
YD
bv
hu
aZ
aZ
Qq
Qq
"}
(12,1,1) = {"
Qq
Uc
Cz
QO
YI
Ki
xS
Wn
DL
yW
Wn
Wn
fO
RY
AV
bN
Ph
QF
Qq
Qq
"}
(13,1,1) = {"
Qq
Pk
Pk
lZ
Hy
BY
LZ
LZ
Gh
LZ
IC
LZ
LZ
An
AV
mI
aN
QF
Qq
Qq
"}
(14,1,1) = {"
Qq
Qq
EN
Pk
aI
Pk
Pk
lS
xy
LZ
YX
QQ
LZ
xj
Vm
mE
aZ
aZ
Qq
Qq
"}
(15,1,1) = {"
Qq
Qq
Ry
vQ
PP
RP
EN
Pk
Pk
Pk
Pk
Pk
Pk
Pk
Pk
Pk
EN
Qq
Qq
Qq
"}
(16,1,1) = {"
Qq
Qq
Qq
Qq
Qq
Qq
Qq
Qq
Qq
Qq
Qq
Qq
Qq
Qq
Qq
Qq
Qq
Qq
Qq
Qq
"}
(17,1,1) = {"
Qq
Qq
Qq
Qq
Qq
Qq
Qq
Qq
Qq
Qq
Qq
Qq
Qq
Qq
Qq
Qq
Qq
Qq
Qq
Qq
"}
(18,1,1) = {"
Qq
Qq
Qq
Qq
Qq
Qq
Qq
Qq
Qq
Qq
Qq
Qq
Qq
Qq
Qq
Qq
Qq
Qq
Qq
Qq
"}
(19,1,1) = {"
Qq
Qq
Qq
Qq
Qq
Qq
Qq
Qq
Qq
Qq
Qq
Qq
Qq
Qq
Qq
Qq
Qq
Qq
Qq
Qq
"}
(20,1,1) = {"
Qq
Qq
Qq
Qq
Qq
Qq
Qq
Qq
Qq
Qq
Qq
Qq
Qq
Qq
Qq
Qq
Qq
Qq
Qq
Qq
"}
