//MAP CONVERTED BY dmm2tgm.py THIS HEADER COMMENT PREVENTS RECONVERSION, DO NOT REMOVE
"a" = (
/turf/open/space/basic,
/area/space)
"b" = (
/obj/effect/decal/cleanable/glass/plastitanium,
/turf/open/floor/plating/airless{
	icon_state = "platingdmg1"
	},
/area/space)
"c" = (
/obj/structure/girder,
/turf/open/floor/plating/airless{
	icon_state = "platingdmg1"
	},
/area/space)
"e" = (
/obj/item/stack/ore/salvage/scrapmetal/ten,
/turf/open/space/basic,
/area/space)
"h" = (
/turf/closed/wall/mineral/plastitanium/nodiagonal,
/area/space)
"k" = (
/obj/machinery/door/firedoor/heavy/closed,
/obj/machinery/door/airlock/hatch,
/turf/open/floor/plasteel/tech,
/area/space)
"l" = (
/obj/structure/girder,
/turf/open/space/basic,
/area/space)
"m" = (
/obj/item/stack/ore/salvage/scraptitanium/five,
/turf/open/space/basic,
/area/space)
"p" = (
/obj/machinery/door/firedoor/heavy/closed,
/obj/structure/door_assembly/door_assembly_hatch,
/turf/open/floor/plasteel/tech,
/area/space)
"r" = (
/obj/machinery/power/terminal{
	dir = 8
	},
/obj/structure/catwalk/over/plated_catwalk/dark,
/turf/open/floor/plating/airless,
/area/space)
"s" = (
/turf/open/floor/plating/airless{
	icon_state = "platingdmg1"
	},
/area/space)
"t" = (
/obj/effect/turf_decal/borderfloor,
/obj/effect/turf_decal/trimline/opaque/red/line{
	dir = 1
	},
/obj/effect/decal/cleanable/blood{
	icon_state = "floor1-old"
	},
/turf/open/floor/plasteel/tech/airless,
/area/space)
"u" = (
/obj/structure/poddoor_assembly/shutters{
	dir = 8
	},
/obj/structure/lattice,
/turf/open/space/basic,
/area/space)
"w" = (
/obj/effect/decal/cleanable/glass/plastitanium,
/turf/open/floor/plating/airless{
	icon_state = "platingdmg2"
	},
/area/space)
"x" = (
/obj/effect/turf_decal/borderfloor,
/obj/effect/turf_decal/trimline/opaque/red/line{
	dir = 1
	},
/turf/open/floor/plasteel/tech/airless,
/area/space)
"y" = (
/obj/machinery/portable_atmospherics/canister/oxygen,
/obj/structure/catwalk/over/plated_catwalk/dark,
/turf/open/floor/plating/airless,
/area/space)
"z" = (
/obj/structure/window/reinforced{
	dir = 8
	},
/obj/machinery/power/smes/shuttle/micro/precharged{
	dir = 4
	},
/obj/structure/cable/yellow{
	icon_state = "0-8"
	},
/obj/machinery/door/poddoor/shutters{
	dir = 4
	},
/turf/open/floor/engine/hull/reinforced,
/area/space)
"A" = (
/obj/structure/lattice,
/turf/open/space/basic,
/area/space)
"B" = (
/obj/structure/poddoor_assembly/shutters{
	dir = 8
	},
/turf/open/space/basic,
/area/space)
"C" = (
/obj/effect/decal/cleanable/blood{
	icon_state = "floor4-old"
	},
/turf/open/floor/plating/airless{
	icon_state = "platingdmg1"
	},
/area/space)
"D" = (
/obj/structure/frame/computer/retro{
	dir = 8
	},
/turf/open/floor/plating/airless{
	icon_state = "platingdmg1"
	},
/area/space)
"E" = (
/obj/effect/turf_decal/borderfloor,
/obj/effect/turf_decal/trimline/opaque/red/line{
	dir = 1
	},
/obj/machinery/light/broken/directional/north,
/turf/open/floor/plasteel/tech/airless,
/area/space)
"H" = (
/obj/item/stack/rods/ten,
/turf/open/space/basic,
/area/space)
"I" = (
/obj/effect/turf_decal/borderfloor{
	dir = 1
	},
/obj/effect/turf_decal/trimline/opaque/red/line,
/turf/open/floor/plasteel/tech/airless,
/area/space)
"K" = (
/obj/structure/lattice,
/turf/open/floor/plating/airless{
	icon_state = "platingdmg1"
	},
/area/space)
"L" = (
/obj/effect/mob_spawn/human/corpse/ramzi/space/soft/surplus,
/obj/structure/lattice,
/turf/open/space/basic,
/area/space)
"N" = (
/obj/machinery/power/terminal{
	dir = 8
	},
/turf/open/floor/plating/airless{
	icon_state = "platingdmg1"
	},
/area/space)
"O" = (
/obj/effect/decal/cleanable/blood{
	icon_state = "floor7-old"
	},
/obj/effect/decal/cleanable/glass/plastitanium,
/turf/open/floor/plating/airless{
	icon_state = "platingdmg2"
	},
/area/space)
"Q" = (
/obj/structure/grille,
/obj/structure/window/plasma/reinforced/plastitanium,
/turf/open/floor/plating,
/area/space)
"W" = (
/obj/effect/mob_spawn/human/corpse/ramzi/space/soft/surplus,
/turf/open/space/basic,
/area/space)
"X" = (
/obj/structure/grille,
/obj/item/shard/plastitanium{
	pixel_x = -6;
	pixel_y = 0
	},
/obj/item/shard/plastitanium{
	pixel_x = 3;
	pixel_y = -6
	},
/obj/effect/decal/cleanable/glass/plastitanium,
/turf/open/floor/plating,
/area/space)
"Y" = (
/obj/structure/cable/yellow{
	icon_state = "0-4"
	},
/obj/structure/frame,
/turf/open/floor/engine/hull/reinforced,
/area/space)
"Z" = (
/obj/machinery/power/shuttle/engine/electric{
	dir = 4
	},
/obj/structure/cable/yellow{
	icon_state = "0-4"
	},
/turf/open/floor/engine/hull/reinforced,
/area/space)

(1,1,1) = {"
a
c
Y
h
a
a
a
a
a
a
"}
(2,1,1) = {"
a
c
z
h
B
a
u
l
a
a
"}
(3,1,1) = {"
a
h
N
p
b
s
A
a
a
a
"}
(4,1,1) = {"
m
a
A
h
x
s
h
Z
h
a
"}
(5,1,1) = {"
e
a
a
h
t
I
h
z
h
a
"}
(6,1,1) = {"
a
a
a
h
E
I
k
r
h
a
"}
(7,1,1) = {"
a
A
a
K
s
I
h
y
h
a
"}
(8,1,1) = {"
m
a
a
L
C
w
h
h
h
a
"}
(9,1,1) = {"
a
e
a
a
H
O
X
a
h
H
"}
(10,1,1) = {"
a
A
l
a
A
a
A
a
a
a
"}
(11,1,1) = {"
a
a
a
A
D
h
W
a
a
a
"}
(12,1,1) = {"
a
a
a
A
Q
l
a
a
e
a
"}
