//MAP CONVERTED BY dmm2tgm.py THIS HEADER COMMENT PREVENTS RECONVERSION, DO NOT REMOVE
"aa" = (
/obj/effect/decal/cleanable/dirt,
/turf/open/floor/plating/airless{
	icon_state = "platingdmg3"
	},
/area/space)
"ah" = (
/obj/structure/catwalk/over/plated_catwalk,
/obj/structure/cable{
	icon_state = "4-8"
	},
/obj/machinery/atmospherics/pipe/simple/supply/hidden/layer2{
	dir = 8
	},
/obj/machinery/atmospherics/pipe/manifold/scrubbers/hidden/layer4,
/turf/open/floor/plating/airless,
/area/space)
"aG" = (
/obj/effect/turf_decal/box,
/obj/structure/crate_shelf,
/obj/structure/closet/crate,
/obj/item/toy/plush/blahaj,
/obj/item/toy/plush/beeplushie,
/obj/item/toy/plush/moth,
/turf/open/floor/plasteel/dark/airless{
	icon_state = "grid_dark"
	},
/area/space)
"aJ" = (
/obj/effect/decal/cleanable/dirt,
/turf/open/floor/plating/airless{
	icon_state = "platingdmg1"
	},
/area/space)
"bR" = (
/obj/effect/decal/cleanable/dirt,
/turf/open/floor/plasteel/airless{
	icon_state = "tiled_dark"
	},
/area/space)
"ft" = (
/obj/effect/turf_decal/industrial/warning{
	dir = 1
	},
/obj/effect/decal/cleanable/dirt,
/turf/open/floor/plasteel/dark/airless{
	icon_state = "grid_dark"
	},
/area/space)
"fQ" = (
/obj/effect/turf_decal/techfloor,
/obj/effect/decal/cleanable/dirt,
/obj/machinery/light/broken/directional/east,
/turf/open/floor/plasteel/dark/airless{
	icon_state = "grid_dark"
	},
/area/space)
"gz" = (
/obj/effect/turf_decal/industrial/warning{
	dir = 1
	},
/obj/machinery/light/broken/directional/west,
/turf/open/floor/plasteel/dark/airless{
	icon_state = "grid_dark"
	},
/area/space)
"hg" = (
/turf/open/floor/plasteel/dark/airless{
	icon_state = "grid_dark"
	},
/area/space)
"iM" = (
/obj/structure/lattice,
/obj/item/stack/ore/salvage/scrapmetal{
	pixel_x = -9
	},
/turf/open/space/basic,
/area/space)
"iX" = (
/obj/structure/catwalk/over/plated_catwalk,
/obj/structure/cable{
	icon_state = "4-8"
	},
/obj/machinery/atmospherics/pipe/simple/supply/hidden/layer2{
	dir = 8
	},
/obj/machinery/atmospherics/pipe/simple/scrubbers/hidden/layer4{
	dir = 8
	},
/turf/open/floor/plating/airless,
/area/space)
"jw" = (
/obj/structure/catwalk/over/plated_catwalk,
/obj/structure/cable{
	icon_state = "4-8"
	},
/obj/machinery/atmospherics/pipe/simple/supply/hidden/layer2{
	dir = 8
	},
/obj/machinery/atmospherics/pipe/simple/scrubbers/hidden/layer4{
	dir = 8
	},
/turf/open/floor/plating/airless{
	icon_state = "plating_rust"
	},
/area/space)
"jz" = (
/obj/structure/table/reinforced,
/obj/effect/turf_decal/techfloor{
	dir = 8
	},
/obj/item/attachment/laser_sight{
	pixel_x = 7;
	pixel_y = 9
	},
/obj/item/attachment/rail_light{
	pixel_x = 6
	},
/obj/item/attachment/rail_light{
	pixel_x = -3
	},
/turf/open/floor/plasteel/airless{
	icon_state = "tiled_dark"
	},
/area/space)
"kk" = (
/obj/structure/marker_beacon,
/turf/open/floor/plating/airless,
/area/space)
"lZ" = (
/obj/effect/turf_decal/techfloor,
/obj/effect/decal/cleanable/dirt,
/obj/effect/decal/cleanable/oil,
/turf/open/floor/plasteel/dark/airless{
	icon_state = "grid_dark"
	},
/area/space)
"mb" = (
/turf/open/floor/plating/airless,
/area/space)
"ns" = (
/obj/effect/decal/cleanable/dirt,
/obj/effect/decal/cleanable/oil,
/turf/open/floor/plasteel/dark/airless{
	icon_state = "grid_dark"
	},
/area/space)
"oA" = (
/obj/item/stack/rods,
/turf/open/space/basic,
/area/space)
"pR" = (
/obj/item/stack/ore/salvage/scrapmetal,
/turf/open/floor/plating/airless,
/area/space)
"qS" = (
/obj/structure/rack,
/obj/item/weldingtool/largetank{
	pixel_x = -3
	},
/turf/open/floor/plasteel/airless{
	icon_state = "tile_full"
	},
/area/space)
"qU" = (
/obj/machinery/door/poddoor,
/turf/open/floor/plating/airless,
/area/space)
"rC" = (
/obj/effect/decal/cleanable/dirt,
/obj/machinery/light/small/broken/directional/north,
/obj/item/kirbyplants/dead{
	pixel_x = 12;
	pixel_y = 20
	},
/turf/open/floor/plasteel/airless{
	icon_state = "tile_full"
	},
/area/space)
"rL" = (
/obj/machinery/cryopod{
	dir = 8
	},
/turf/open/floor/plasteel/airless{
	icon_state = "tiled_dark"
	},
/area/space)
"rZ" = (
/obj/structure/railing{
	dir = 1;
	pixel_y = 7
	},
/obj/machinery/atmospherics/components/unary/vent_pump/on/layer2,
/obj/effect/decal/cleanable/dirt,
/obj/structure/chair/handrail{
	dir = 8
	},
/turf/open/floor/plasteel/airless{
	icon_state = "tile_full"
	},
/area/space)
"sL" = (
/obj/structure/salvageable/circuit_imprinter,
/obj/machinery/light/dim/directional/south,
/turf/open/floor/plasteel/airless{
	icon_state = "tile_full"
	},
/area/space)
"tf" = (
/obj/item/stack/ore/salvage/scrapmetal,
/turf/open/space/basic,
/area/space)
"tU" = (
/obj/structure/closet/secure_closet/armorycage,
/obj/item/stock_parts/cell/gun/empty{
	pixel_x = -6
	},
/obj/item/stock_parts/cell/gun/upgraded/empty{
	pixel_x = 2
	},
/obj/effect/turf_decal/techfloor{
	dir = 9
	},
/obj/machinery/light/small/broken/directional/north,
/turf/open/floor/plasteel/airless{
	icon_state = "tiled_dark"
	},
/area/space)
"vW" = (
/obj/structure/grille,
/turf/open/floor/plating/airless,
/area/space)
"wF" = (
/obj/item/stack/ore/salvage/scrapmetal,
/obj/item/stack/ore/salvage/scrapmetal,
/turf/open/space/basic,
/area/space)
"wN" = (
/obj/effect/turf_decal/box,
/obj/structure/crate_shelf,
/turf/open/floor/plasteel/dark/airless{
	icon_state = "grid_dark"
	},
/area/space)
"xg" = (
/obj/effect/turf_decal/box,
/obj/structure/crate_shelf,
/obj/structure/closet/crate/medical,
/obj/item/storage/firstaid,
/obj/item/stack/medical/splint,
/obj/item/stack/medical/splint,
/turf/open/floor/plasteel/dark/airless{
	icon_state = "grid_dark"
	},
/area/space)
"xN" = (
/turf/open/floor/plating/airless{
	icon_state = "plating_rust"
	},
/area/space)
"yd" = (
/obj/machinery/door/poddoor,
/turf/open/floor/plating/airless{
	icon_state = "plating_rust"
	},
/area/space)
"yh" = (
/obj/effect/turf_decal/industrial/warning{
	dir = 1
	},
/obj/machinery/light/dim/directional/east,
/turf/open/floor/plasteel/dark/airless{
	icon_state = "grid_dark"
	},
/area/space)
"yn" = (
/obj/structure/lattice,
/obj/item/stack/ore/salvage/scrapmetal,
/turf/open/space/basic,
/area/space)
"zX" = (
/obj/structure/girder/reinforced,
/turf/open/floor/plating/airless,
/area/space)
"Ab" = (
/turf/closed/wall/rust,
/area/space)
"Af" = (
/obj/effect/turf_decal/box,
/obj/structure/crate_shelf,
/obj/structure/closet/crate/engineering,
/obj/item/stock_parts/micro_laser/high{
	pixel_x = -4;
	pixel_y = 5
	},
/obj/item/stock_parts/micro_laser/high{
	pixel_x = -9;
	pixel_y = 8
	},
/obj/item/stock_parts/capacitor/adv{
	pixel_x = 7;
	pixel_y = -5
	},
/obj/item/stock_parts/capacitor,
/obj/item/stock_parts/capacitor{
	pixel_x = -7;
	pixel_y = -6
	},
/obj/item/stock_parts/cell/high{
	pixel_x = 7;
	pixel_y = 3
	},
/turf/open/floor/plasteel/dark/airless{
	icon_state = "grid_dark"
	},
/area/space)
"An" = (
/obj/effect/turf_decal/techfloor,
/obj/effect/decal/cleanable/dirt,
/turf/open/floor/plasteel/dark/airless{
	icon_state = "grid_dark"
	},
/area/space)
"AP" = (
/obj/structure/cable{
	icon_state = "4-8"
	},
/turf/open/floor/plating/airless,
/area/space)
"BB" = (
/turf/open/floor/plating/airless{
	icon_state = "platingdmg1"
	},
/area/space)
"BD" = (
/obj/structure/salvageable/autolathe,
/turf/open/floor/plasteel/airless{
	icon_state = "tile_full"
	},
/area/space)
"Dp" = (
/obj/effect/decal/cleanable/dirt,
/obj/effect/decal/cleanable/oil/slippery,
/turf/open/floor/plasteel/airless{
	icon_state = "tile_full"
	},
/area/space)
"DJ" = (
/obj/structure/lattice,
/turf/open/space/basic,
/area/space)
"EG" = (
/obj/effect/turf_decal/techfloor,
/obj/effect/turf_decal/stairs{
	color = "#a3a2a0";
	dir = 1
	},
/turf/open/floor/plasteel/dark/airless{
	icon_state = "grid_dark"
	},
/area/space)
"ER" = (
/obj/item/stack/rods,
/turf/open/floor/plating/airless,
/area/space)
"Gg" = (
/obj/structure/table/reinforced,
/obj/effect/turf_decal/techfloor{
	dir = 8
	},
/obj/item/melee/sword/mass,
/obj/item/melee/sword/mass{
	pixel_x = 6
	},
/turf/open/floor/plasteel/airless{
	icon_state = "tiled_dark"
	},
/area/space)
"GQ" = (
/obj/structure/rack,
/obj/item/storage/toolbox/electrical{
	pixel_y = 9
	},
/obj/item/storage/toolbox/mechanical,
/obj/item/radio/intercom/directional/south,
/turf/open/floor/plasteel/airless{
	icon_state = "tile_full"
	},
/area/space)
"Ij" = (
/obj/item/stack/cable_coil/cut/red,
/obj/machinery/atmospherics/pipe/simple/supply/hidden/layer2{
	dir = 8
	},
/turf/open/floor/plating/airless,
/area/space)
"Iy" = (
/turf/open/space/basic,
/area/space)
"Lj" = (
/obj/effect/turf_decal/techfloor,
/obj/machinery/light/broken/directional/west,
/turf/open/floor/plasteel/dark/airless{
	icon_state = "grid_dark"
	},
/area/space)
"Mk" = (
/obj/machinery/door/airlock/security{
	name = "Armory"
	},
/turf/open/floor/plasteel/airless{
	icon_state = "tiled_dark"
	},
/area/space)
"Ms" = (
/obj/structure/table,
/obj/item/implant/radio{
	pixel_y = 10
	},
/obj/item/implant/radio{
	pixel_y = 10;
	pixel_x = 10
	},
/turf/open/floor/plasteel/airless{
	icon_state = "tiled_dark"
	},
/area/space)
"Ne" = (
/obj/item/stack/cable_coil/cut/red,
/turf/open/floor/plating/airless{
	icon_state = "platingdmg1"
	},
/area/space)
"OD" = (
/turf/closed/wall,
/area/space)
"OK" = (
/turf/closed/wall/r_wall/rust,
/area/space)
"ON" = (
/obj/structure/window/reinforced/fulltile,
/obj/structure/grille,
/turf/open/floor/plating/airless,
/area/space)
"Qf" = (
/obj/effect/decal/cleanable/dirt,
/turf/open/floor/plating/airless,
/area/space)
"QC" = (
/obj/effect/turf_decal/techfloor{
	dir = 1
	},
/turf/open/floor/plasteel/airless{
	icon_state = "tiled_dark"
	},
/area/space)
"QV" = (
/obj/item/stack/ore/salvage/scrapmetal{
	pixel_x = -10
	},
/turf/open/space/basic,
/area/space)
"RB" = (
/obj/structure/railing{
	dir = 1;
	pixel_y = 7
	},
/obj/machinery/atmospherics/components/unary/vent_scrubber/on/layer4,
/obj/structure/chair/handrail{
	dir = 4
	},
/turf/open/floor/plasteel/airless{
	icon_state = "tile_full"
	},
/area/space)
"RC" = (
/obj/structure/railing{
	dir = 1;
	pixel_y = 7
	},
/obj/effect/decal/cleanable/dirt,
/turf/open/floor/plasteel/airless{
	icon_state = "tile_full"
	},
/area/space)
"TF" = (
/obj/structure/catwalk/over/plated_catwalk,
/obj/structure/cable{
	icon_state = "4-8"
	},
/obj/machinery/atmospherics/pipe/simple/supply/hidden/layer2{
	dir = 8
	},
/obj/machinery/atmospherics/pipe/simple/scrubbers/hidden/layer4{
	dir = 8
	},
/obj/effect/decal/cleanable/dirt,
/turf/open/floor/plating/airless,
/area/space)
"TJ" = (
/obj/structure/catwalk/over/plated_catwalk,
/obj/structure/cable{
	icon_state = "4-8"
	},
/obj/machinery/atmospherics/pipe/simple/supply/hidden/layer2{
	dir = 8
	},
/turf/open/floor/plating/airless,
/area/space)
"TT" = (
/obj/effect/decal/cleanable/dirt,
/turf/open/floor/plasteel/airless{
	icon_state = "tile_full"
	},
/area/space)
"Ur" = (
/obj/machinery/portable_atmospherics/canister/oxygen,
/obj/effect/decal/cleanable/dirt,
/obj/machinery/light/dim/directional/south,
/turf/open/floor/plasteel/airless{
	icon_state = "tile_full"
	},
/area/space)
"VH" = (
/obj/machinery/door/airlock/grunge{
	dir = 4;
	name = "Cargo Bay"
	},
/obj/structure/cable{
	icon_state = "4-8"
	},
/obj/machinery/atmospherics/pipe/simple/supply/hidden/layer2{
	dir = 8
	},
/obj/machinery/atmospherics/pipe/simple/scrubbers/hidden/layer4{
	dir = 8
	},
/turf/open/floor/plasteel/airless{
	icon_state = "tile_full"
	},
/area/space)
"Wh" = (
/turf/closed/wall/r_wall,
/area/space)
"Wl" = (
/obj/structure/catwalk/over/plated_catwalk,
/obj/structure/cable{
	icon_state = "4-8"
	},
/obj/machinery/atmospherics/pipe/manifold/supply/hidden/layer2,
/obj/machinery/atmospherics/pipe/simple/scrubbers/hidden/layer4{
	dir = 8
	},
/turf/open/floor/plating/airless,
/area/space)
"WT" = (
/obj/structure/grille,
/obj/structure/grille,
/turf/open/floor/plating/airless,
/area/space)
"WU" = (
/turf/open/floor/plating/airless{
	icon_state = "platingdmg3"
	},
/area/space)
"Xp" = (
/obj/effect/turf_decal/industrial/warning{
	dir = 1
	},
/turf/open/floor/plasteel/dark/airless{
	icon_state = "grid_dark"
	},
/area/space)
"YD" = (
/obj/structure/railing{
	dir = 1;
	pixel_y = 7
	},
/turf/open/floor/plasteel/airless{
	icon_state = "tile_full"
	},
/area/space)
"YH" = (
/obj/effect/decal/cleanable/dirt,
/turf/open/floor/plasteel/dark/airless{
	icon_state = "grid_dark"
	},
/area/space)
"YT" = (
/obj/effect/turf_decal/industrial/warning{
	dir = 1
	},
/obj/effect/turf_decal/industrial/warning{
	dir = 1
	},
/obj/effect/decal/cleanable/dirt,
/turf/open/floor/plasteel/dark/airless{
	icon_state = "grid_dark"
	},
/area/space)
"Zm" = (
/obj/structure/closet/crate/secure/loot,
/obj/item/pickaxe/drill,
/obj/item/stack/marker_beacon/thirty,
/obj/item/storage/box/flares,
/obj/effect/mapping_helpers/crate_shelve,
/turf/open/floor/plasteel/dark/airless{
	icon_state = "grid_dark"
	},
/area/space)
"ZR" = (
/obj/structure/door_assembly/door_assembly_grunge{
	dir = 4
	},
/obj/structure/cable{
	icon_state = "4-8"
	},
/obj/machinery/atmospherics/pipe/simple/supply/hidden/layer2{
	dir = 8
	},
/obj/machinery/atmospherics/pipe/simple/scrubbers/hidden/layer4{
	dir = 8
	},
/turf/open/floor/plasteel/airless{
	icon_state = "tile_full"
	},
/area/space)

(1,1,1) = {"
Iy
Iy
Iy
Iy
Iy
Iy
DJ
Iy
Iy
Iy
Iy
Iy
Iy
Iy
DJ
Iy
Iy
Iy
Iy
Iy
"}
(2,1,1) = {"
Iy
Iy
Iy
Iy
Iy
Iy
vW
Iy
Iy
Iy
Iy
Iy
Iy
DJ
OK
Iy
Iy
QV
Iy
Iy
"}
(3,1,1) = {"
Iy
Iy
Iy
Iy
Iy
Iy
WT
Iy
Iy
DJ
Iy
Iy
Iy
aJ
zX
DJ
Iy
Iy
Iy
Iy
"}
(4,1,1) = {"
Iy
Iy
Iy
Iy
Iy
Iy
Iy
QV
wF
WU
DJ
Iy
mb
Ij
DJ
Iy
ER
Iy
Iy
Iy
"}
(5,1,1) = {"
Iy
Iy
Iy
Iy
Iy
Iy
Iy
Iy
DJ
mb
iM
DJ
DJ
TF
OK
DJ
vW
Iy
Iy
Iy
"}
(6,1,1) = {"
Iy
Iy
Iy
Iy
Iy
Iy
Iy
Wh
Ms
rL
BB
yn
TT
TF
Wh
Iy
Iy
Iy
Iy
Iy
"}
(7,1,1) = {"
Iy
Iy
Iy
Iy
Iy
Iy
Iy
OK
OK
OD
Ab
Ab
OD
ZR
Wh
Wh
Iy
Iy
Iy
Iy
"}
(8,1,1) = {"
Iy
Iy
Iy
Iy
Iy
Iy
Iy
qU
gz
Af
xg
Lj
RB
ah
Ur
OK
kk
vW
Iy
Iy
"}
(9,1,1) = {"
Iy
Iy
Iy
Iy
Iy
Iy
Iy
qU
ft
Zm
hg
lZ
RC
TF
GQ
OK
Iy
vW
Iy
Iy
"}
(10,1,1) = {"
Iy
Iy
Iy
Iy
Iy
Iy
Iy
qU
YT
YH
hg
EG
Dp
TF
qS
OK
Iy
vW
Iy
Iy
"}
(11,1,1) = {"
Iy
Iy
Iy
Iy
Iy
Iy
Iy
qU
Xp
ns
hg
An
YD
jw
BD
Wh
Iy
vW
Iy
Iy
"}
(12,1,1) = {"
Iy
Iy
Iy
Iy
Iy
Iy
Iy
yd
yh
aG
wN
fQ
rZ
Wl
sL
Wh
kk
vW
Iy
Iy
"}
(13,1,1) = {"
Iy
Iy
Iy
Iy
Iy
Iy
Iy
Wh
Wh
ON
ON
Ab
OD
VH
OK
OK
Iy
Iy
Iy
Iy
"}
(14,1,1) = {"
Iy
Iy
Iy
Iy
Iy
Iy
Iy
OK
tU
Gg
jz
Ab
rC
iX
Wh
Iy
Iy
Iy
Iy
Iy
"}
(15,1,1) = {"
Iy
Iy
Iy
Iy
Iy
Iy
DJ
OK
QC
bR
bR
OD
TT
jw
Wh
kk
vW
Iy
Iy
Iy
"}
(16,1,1) = {"
Iy
Iy
Iy
Iy
Iy
Iy
Iy
DJ
aJ
pR
bR
Mk
Qf
TJ
zX
Iy
vW
Iy
Iy
Iy
"}
(17,1,1) = {"
Iy
Iy
Iy
Iy
Iy
Iy
Iy
Iy
DJ
xN
DJ
OD
Ne
AP
Wh
Iy
vW
Iy
Iy
Iy
"}
(18,1,1) = {"
Iy
Iy
Iy
Iy
Iy
Iy
Iy
tf
Iy
Iy
DJ
mb
DJ
aa
Iy
Iy
DJ
Iy
Iy
Iy
"}
(19,1,1) = {"
Iy
Iy
Iy
Iy
Iy
Iy
Iy
Iy
Iy
Iy
tf
Iy
Iy
DJ
Iy
Iy
Iy
oA
Iy
Iy
"}
(20,1,1) = {"
Iy
Iy
Iy
Iy
Iy
Iy
Iy
Iy
Iy
Iy
Iy
Iy
Iy
Iy
Iy
Iy
Iy
Iy
Iy
Iy
"}
