//MAP CONVERTED BY dmm2tgm.py THIS HEADER COMMENT PREVENTS RECONVERSION, DO NOT REMOVE
"a" = (
/turf/template_noop,
/area/template_noop)
"b" = (
/turf/closed/wall/mineral/titanium/nodiagonal,
/area/template_noop)
"c" = (
/obj/structure/lattice,
/obj/item/stack/ore/salvage/scraptitanium/five,
/turf/open/space/basic,
/area/template_noop)
"e" = (
/mob/living/simple_animal/hostile/asteroid/hivelord,
/turf/open/floor/plating/airless,
/area/template_noop)
"g" = (
/obj/structure/lattice,
/obj/structure/lattice,
/obj/item/stack/ore/salvage/scraptitanium/five,
/turf/open/space/basic,
/area/template_noop)
"i" = (
/obj/structure/cable,
/turf/open/floor/plating/airless,
/area/template_noop)
"m" = (
/obj/structure/cable{
	icon_state = "2-5"
	},
/obj/structure/cable{
	icon_state = "2-9"
	},
/turf/open/floor/plating/airless,
/area/template_noop)
"o" = (
/obj/item/shard,
/turf/open/space/basic,
/area/template_noop)
"p" = (
/obj/effect/turf_decal/corner/opaque/bottlegreen/half{
	dir = 1
	},
/mob/living/simple_animal/hostile/asteroid/hivelord,
/obj/machinery/light/broken/directional/north,
/turf/open/floor/plasteel/mono/white/airless,
/area/template_noop)
"q" = (
/obj/machinery/door/poddoor,
/obj/machinery/power/shieldwallgen/atmos/roundstart{
	dir = 8
	},
/obj/structure/cable{
	icon_state = "0-10"
	},
/turf/open/floor/plating/airless,
/area/template_noop)
"r" = (
/obj/item/stack/ore/salvage/scraptitanium/five,
/turf/open/space/basic,
/area/template_noop)
"t" = (
/obj/structure/girder,
/turf/open/floor/plating/airless,
/area/template_noop)
"v" = (
/mob/living/simple_animal/hostile/asteroid/hivelord,
/obj/item/stack/ore/salvage/scraptitanium/five,
/turf/open/floor/plating/airless,
/area/template_noop)
"z" = (
/turf/open/floor/plating/airless,
/area/template_noop)
"A" = (
/obj/structure/lattice,
/turf/open/space/basic,
/area/template_noop)
"B" = (
/obj/structure/poddoor_assembly,
/obj/machinery/power/shieldwallgen/atmos/roundstart{
	dir = 4
	},
/obj/structure/cable{
	icon_state = "0-6"
	},
/obj/item/stack/ore/salvage/scraptitanium/five,
/turf/open/floor/plating/airless,
/area/template_noop)
"D" = (
/obj/structure/poddoor_assembly,
/turf/open/floor/plating/airless,
/area/template_noop)
"E" = (
/obj/effect/turf_decal/corner/opaque/bottlegreen/half,
/obj/item/stack/ore/salvage/scraptitanium/five,
/turf/open/floor/plasteel/mono/white/airless,
/area/template_noop)
"J" = (
/obj/structure/grille,
/obj/structure/window/reinforced/fulltile/shuttle,
/obj/machinery/door/poddoor/shutters/preopen,
/turf/open/floor/plating/airless,
/area/template_noop)
"K" = (
/obj/effect/turf_decal/corner/opaque/bottlegreen/half{
	dir = 1
	},
/obj/item/stack/ore/salvage/scraptitanium/five,
/obj/effect/decal/cleanable/glass,
/turf/open/floor/plasteel/mono/white/airless,
/area/template_noop)
"N" = (
/obj/machinery/light/broken/directional/south,
/turf/open/floor/plating/airless,
/area/template_noop)
"T" = (
/obj/effect/turf_decal/corner/opaque/black/half{
	dir = 1
	},
/turf/open/floor/plasteel/mono/airless,
/area/template_noop)
"V" = (
/obj/effect/turf_decal/corner/opaque/black/half{
	dir = 1
	},
/obj/item/stack/ore/salvage/scraptitanium/five,
/obj/machinery/light/broken/directional/north,
/turf/open/floor/plasteel/mono/airless,
/area/template_noop)
"W" = (
/obj/effect/turf_decal/corner/opaque/black/half{
	dir = 1
	},
/obj/machinery/light/broken/directional/north,
/turf/open/floor/plasteel/mono/airless,
/area/template_noop)
"Y" = (
/obj/structure/grille/broken,
/obj/structure/poddoor_assembly/shutters,
/obj/effect/decal/cleanable/glass,
/obj/item/shard,
/turf/open/floor/plating/airless,
/area/template_noop)
"Z" = (
/turf/open/floor/plasteel/mono/white/airless,
/area/template_noop)

(1,1,1) = {"
a
a
a
a
a
r
a
a
a
a
a
"}
(2,1,1) = {"
a
a
a
a
a
a
a
b
a
a
a
"}
(3,1,1) = {"
a
a
r
a
a
a
b
t
a
a
a
"}
(4,1,1) = {"
a
t
a
a
a
A
c
b
b
b
a
"}
(5,1,1) = {"
a
b
p
a
a
a
a
b
c
a
a
"}
(6,1,1) = {"
o
J
A
A
r
a
a
g
a
a
a
"}
(7,1,1) = {"
a
Y
K
a
a
a
a
c
a
A
a
"}
(8,1,1) = {"
a
b
K
Z
a
a
a
a
a
A
b
"}
(9,1,1) = {"
a
b
b
b
z
A
a
a
a
e
t
"}
(10,1,1) = {"
a
a
b
W
a
a
a
a
A
E
t
"}
(11,1,1) = {"
a
a
B
T
A
r
a
r
t
b
b
"}
(12,1,1) = {"
a
a
D
m
i
a
a
a
z
b
a
"}
(13,1,1) = {"
a
a
q
z
a
a
a
a
N
b
a
"}
(14,1,1) = {"
a
a
b
V
A
a
a
A
c
b
a
"}
(15,1,1) = {"
a
a
b
b
z
a
r
a
a
b
a
"}
(16,1,1) = {"
a
a
a
b
v
A
c
a
a
c
a
"}
(17,1,1) = {"
a
a
a
b
a
a
a
a
a
a
a
"}
(18,1,1) = {"
a
a
a
z
a
a
a
a
a
a
r
"}
(19,1,1) = {"
a
a
a
a
a
a
a
a
a
a
a
"}
(20,1,1) = {"
a
a
a
r
a
a
a
a
a
a
a
"}
