//MAP CONVERTED BY dmm2tgm.py THIS HEADER COMMENT PREVENTS RECONVERSION, DO NOT REMOVE
"aj" = (
/obj/structure/rack,
/obj/effect/spawner/lootdrop/aimodule_harmless,
/obj/effect/decal/cleanable/oil,
/turf/open/floor/plating/rust,
/area/rockplanet/surface/outdoors)
"bY" = (
/obj/structure/closet/crate/engineering,
/obj/effect/decal/cleanable/cobweb,
/turf/open/floor/pod/light,
/area/rockplanet/surface/outdoors)
"ch" = (
/obj/effect/decal/cleanable/plasma,
/turf/open/floor/plating/rust,
/area/rockplanet/surface/outdoors)
"cL" = (
/obj/structure/cable{
	icon_state = "2-5"
	},
/turf/open/floor/plating,
/area/rockplanet/surface/outdoors)
"em" = (
/obj/structure/chair/plastic,
/turf/open/floor/plating/rust,
/area/rockplanet/surface/outdoors)
"en" = (
/obj/machinery/power/port_gen/pacman,
/obj/structure/cable,
/turf/open/floor/plating,
/area/rockplanet/surface/outdoors)
"fC" = (
/obj/structure/rack,
/obj/item/stack/wrapping_paper,
/obj/effect/spawner/lootdrop/gambling,
/obj/effect/decal/cleanable/cobweb,
/turf/open/floor/plating/rust,
/area/rockplanet/surface/outdoors)
"gy" = (
/obj/machinery/suit_storage_unit/mining/eva,
/obj/effect/decal/cleanable/cobweb,
/obj/effect/decal/cleanable/dirt/dust,
/turf/open/floor/plating/rust,
/area/rockplanet/surface/outdoors)
"gA" = (
/obj/effect/decal/cleanable/glass,
/turf/open/floor/plating/asteroid,
/area/rockplanet/surface/outdoors)
"im" = (
/obj/structure/rack,
/obj/effect/spawner/lootdrop/donkpockets,
/obj/effect/spawner/lootdrop/donkpockets,
/obj/effect/spawner/lootdrop/mafia_outfit,
/turf/open/floor/plating,
/area/rockplanet/surface/outdoors)
"iy" = (
/obj/structure/cable,
/obj/structure/statue/sandstone/assistant,
/turf/open/floor/plating/asteroid,
/area/rockplanet/surface/outdoors)
"kf" = (
/obj/structure/ore_box,
/obj/effect/decal/cleanable/dirt/dust,
/obj/effect/turf_decal/industrial/warning/full,
/turf/open/floor/plating/asteroid,
/area/rockplanet/surface/outdoors)
"kF" = (
/obj/structure/closet/crate/bin,
/turf/open/floor/plating,
/area/rockplanet/surface/outdoors)
"kU" = (
/obj/structure/table/reinforced,
/obj/item/gun/energy/laser/retro,
/turf/open/floor/pod/light,
/area/rockplanet/surface/outdoors)
"kW" = (
/obj/structure/shuttle/engine/propulsion{
	dir = 8
	},
/turf/open/floor/plating/rust,
/area/rockplanet/surface/outdoors)
"mj" = (
/obj/structure/fluff/oldturret,
/turf/open/floor/plating/asteroid,
/area/rockplanet/surface/outdoors)
"mK" = (
/obj/structure/marker_beacon,
/turf/open/floor/plating/rust,
/area/rockplanet/surface/outdoors)
"np" = (
/obj/structure/cable,
/obj/machinery/power/floodlight,
/turf/open/floor/plating/asteroid,
/area/rockplanet/surface/outdoors)
"nw" = (
/obj/effect/decal/cleanable/plasma,
/turf/open/floor/plating,
/area/rockplanet/surface/outdoors)
"nO" = (
/obj/structure/barricade/wooden/crude,
/obj/structure/window/fulltile,
/turf/open/floor/plating,
/area/rockplanet/surface/outdoors)
"nV" = (
/turf/closed/wall,
/area/rockplanet/surface/outdoors)
"pc" = (
/obj/structure/marker_beacon,
/turf/open/floor/plating,
/area/rockplanet/surface/outdoors)
"pl" = (
/obj/machinery/vending/snack,
/turf/open/floor/plating,
/area/rockplanet/surface/outdoors)
"rJ" = (
/obj/structure/shuttle/engine/heater{
	dir = 8
	},
/turf/closed/wall/mineral/titanium,
/area/rockplanet/surface/outdoors)
"sT" = (
/obj/structure/rack,
/obj/item/stack/wrapping_paper,
/turf/open/floor/plating/rust,
/area/rockplanet/surface/outdoors)
"sW" = (
/obj/structure/rack,
/obj/effect/spawner/lootdrop/gambling,
/obj/effect/decal/cleanable/garbage,
/turf/open/floor/plating,
/area/rockplanet/surface/outdoors)
"tl" = (
/obj/structure/barricade/wooden/crude,
/obj/structure/window/fulltile,
/obj/effect/decal/cleanable/glass,
/turf/open/floor/plating,
/area/rockplanet/surface/outdoors)
"tm" = (
/obj/structure/table/reinforced,
/obj/item/flashlight/lamp/green,
/obj/effect/decal/cleanable/cobweb/cobweb2,
/turf/open/floor/plating/rust,
/area/rockplanet/surface/outdoors)
"tp" = (
/turf/open/floor/pod/light,
/area/rockplanet/surface/outdoors)
"tU" = (
/obj/structure/closet/crate,
/obj/effect/decal/cleanable/dirt/dust,
/obj/effect/turf_decal/industrial/warning/full,
/turf/open/floor/plating/asteroid,
/area/rockplanet/surface/outdoors)
"uc" = (
/obj/machinery/door/airlock/shuttle,
/turf/open/floor/pod/light,
/area/rockplanet/surface/outdoors)
"un" = (
/obj/effect/decal/cleanable/dirt/dust,
/turf/closed/wall/mineral/titanium,
/area/rockplanet/surface/outdoors)
"wA" = (
/obj/effect/decal/cleanable/dirt/dust,
/turf/open/floor/pod/light,
/area/rockplanet/surface/outdoors)
"wB" = (
/obj/effect/decal/cleanable/garbage,
/obj/effect/decal/cleanable/dirt/dust,
/turf/open/floor/plating,
/area/rockplanet/surface/outdoors)
"wM" = (
/obj/item/bot_assembly/medbot,
/turf/open/floor/plating/asteroid,
/area/rockplanet/surface/outdoors)
"yd" = (
/obj/structure/statue/sandstone/assistant,
/obj/structure/cable{
	icon_state = "4-9"
	},
/turf/open/floor/plating/asteroid,
/area/rockplanet/surface/outdoors)
"ze" = (
/obj/structure/cable{
	icon_state = "1-2"
	},
/turf/open/floor/plating,
/area/rockplanet/surface/outdoors)
"zq" = (
/obj/machinery/modular_computer/console/preset/civilian,
/obj/effect/decal/cleanable/cobweb/cobweb2,
/obj/effect/decal/cleanable/dirt/dust,
/turf/open/floor/pod/light,
/area/rockplanet/surface/outdoors)
"zY" = (
/obj/structure/closet/crate,
/obj/effect/decal/cleanable/dirt/dust,
/turf/open/floor/pod/light,
/area/rockplanet/surface/outdoors)
"Ag" = (
/obj/effect/decal/cleanable/oil,
/turf/open/floor/plating/asteroid,
/area/rockplanet/surface/outdoors)
"AK" = (
/obj/structure/closet/crate,
/obj/effect/turf_decal/industrial/warning/full,
/turf/open/floor/plating/asteroid,
/area/rockplanet/surface/outdoors)
"Ba" = (
/obj/structure/door_assembly/door_assembly_highsecurity,
/obj/structure/cable{
	icon_state = "6-8"
	},
/turf/open/floor/plating/rust,
/area/rockplanet/surface/outdoors)
"BE" = (
/obj/structure/door_assembly/door_assembly_hatch,
/obj/structure/cable{
	icon_state = "1-6"
	},
/turf/open/floor/plating,
/area/rockplanet/surface/outdoors)
"Cf" = (
/obj/structure/rack,
/obj/item/stack/wrapping_paper,
/obj/effect/decal/cleanable/garbage,
/turf/open/floor/plating,
/area/rockplanet/surface/outdoors)
"Cl" = (
/obj/mecha/working/ripley/cargo,
/obj/effect/turf_decal/industrial/warning/full,
/turf/open/floor/plating/asteroid,
/area/rockplanet/surface/outdoors)
"CC" = (
/obj/effect/decal/cleanable/dirt/dust,
/turf/open/floor/plating/rust,
/area/rockplanet/surface/outdoors)
"De" = (
/turf/template_noop,
/area/template_noop)
"Ga" = (
/obj/effect/decal/cleanable/blood/old,
/turf/open/floor/plating,
/area/rockplanet/surface/outdoors)
"Gg" = (
/obj/structure/chair/plastic,
/turf/open/floor/plating,
/area/rockplanet/surface/outdoors)
"Ha" = (
/obj/structure/table/wood/poker,
/obj/item/storage/bag/money/vault,
/turf/open/floor/carpet/red,
/area/rockplanet/surface/outdoors)
"Hm" = (
/obj/effect/decal/fakelattice,
/turf/open/floor/plating/asteroid,
/area/rockplanet/surface/outdoors)
"IN" = (
/obj/structure/grille,
/obj/structure/window/shuttle,
/turf/open/floor/pod/light,
/area/rockplanet/surface/outdoors)
"IU" = (
/obj/machinery/power/floodlight,
/obj/structure/cable{
	icon_state = "0-8"
	},
/turf/open/floor/plating/asteroid,
/area/rockplanet/surface/outdoors)
"IZ" = (
/obj/effect/decal/cleanable/robot_debris,
/turf/open/floor/plating/asteroid,
/area/rockplanet/surface/outdoors)
"Lm" = (
/turf/closed/wall/mineral/titanium,
/area/rockplanet/surface/outdoors)
"Ln" = (
/turf/open/floor/carpet/red,
/area/rockplanet/surface/outdoors)
"LG" = (
/obj/effect/turf_decal/industrial/warning/full,
/turf/open/floor/plating/asteroid,
/area/rockplanet/surface/outdoors)
"Ma" = (
/obj/effect/decal/cleanable/dirt/dust,
/obj/effect/decal/cleanable/oil,
/turf/open/floor/plating,
/area/rockplanet/surface/outdoors)
"MR" = (
/obj/effect/decal/cleanable/dirt/dust,
/turf/open/floor/plating,
/area/rockplanet/surface/outdoors)
"Nl" = (
/obj/effect/decal/cleanable/greenglow,
/turf/open/floor/plating/asteroid,
/area/rockplanet/surface/outdoors)
"OC" = (
/obj/structure/chair/comfy/shuttle{
	dir = 1
	},
/turf/open/floor/pod/light,
/area/rockplanet/surface/outdoors)
"OY" = (
/obj/structure/chair/office{
	dir = 8
	},
/turf/open/floor/plating,
/area/rockplanet/surface/outdoors)
"OZ" = (
/obj/structure/cable{
	icon_state = "4-10"
	},
/turf/open/floor/plating/rust,
/area/rockplanet/surface/outdoors)
"PS" = (
/obj/structure/rack,
/obj/effect/decal/cleanable/garbage,
/obj/item/circuitboard/machine/thermomachine,
/turf/open/floor/plating,
/area/rockplanet/surface/outdoors)
"QD" = (
/obj/structure/rack,
/obj/effect/spawner/lootdrop/gambling,
/obj/effect/decal/cleanable/garbage,
/obj/effect/decal/cleanable/dirt/dust,
/obj/item/wrench,
/turf/open/floor/plating,
/area/rockplanet/surface/outdoors)
"RB" = (
/obj/structure/chair{
	dir = 4
	},
/obj/effect/decal/cleanable/blood/old,
/obj/effect/decal/cleanable/dirt/dust,
/turf/open/floor/carpet/red,
/area/rockplanet/surface/outdoors)
"RE" = (
/obj/effect/decal/cleanable/dirt/dust,
/obj/structure/cable{
	icon_state = "2-9"
	},
/turf/open/floor/plating,
/area/rockplanet/surface/outdoors)
"Sn" = (
/turf/open/floor/plating,
/area/rockplanet/surface/outdoors)
"SE" = (
/obj/effect/decal/cleanable/food/tomato_smudge,
/turf/open/floor/plating/rust,
/area/rockplanet/surface/outdoors)
"Tk" = (
/turf/open/floor/plating/rust,
/area/rockplanet/surface/outdoors)
"Tl" = (
/obj/effect/decal/cleanable/glass,
/turf/open/floor/plating,
/area/rockplanet/surface/outdoors)
"TB" = (
/obj/structure/closet/crate/miningcar,
/obj/effect/turf_decal/industrial/warning/full,
/turf/open/floor/plating/asteroid,
/area/rockplanet/surface/outdoors)
"Ue" = (
/turf/closed/wall/rust,
/area/rockplanet/surface/outdoors)
"VU" = (
/mob/living/simple_animal/pet/cat/kitten,
/turf/open/floor/plating,
/area/rockplanet/surface/outdoors)
"Xc" = (
/obj/structure/filingcabinet/chestdrawer,
/obj/effect/decal/cleanable/cobweb/cobweb2,
/turf/open/floor/plating,
/area/rockplanet/surface/outdoors)
"Ya" = (
/turf/open/floor/plating/asteroid,
/area/rockplanet/surface/outdoors)
"Zq" = (
/obj/structure/table/wood/poker,
/obj/item/stack/sheet/mineral/plasma,
/obj/item/storage/pill_bottle/zoom,
/turf/open/floor/carpet/red,
/area/rockplanet/surface/outdoors)

(1,1,1) = {"
Ue
Ue
Ue
nV
nV
nV
mj
Ya
Ya
Ya
Ya
Ya
De
De
De
"}
(2,1,1) = {"
Ue
fC
ch
im
Ga
nV
IZ
Ya
pc
MR
Tk
Tk
Tk
mK
De
"}
(3,1,1) = {"
Ue
sT
wB
QD
Sn
tl
wM
Ya
Lm
CC
kW
kW
MR
Lm
De
"}
(4,1,1) = {"
Ue
sW
Ga
Cf
CC
tl
Ya
Ya
un
Lm
rJ
rJ
Lm
Lm
De
"}
(5,1,1) = {"
nV
PS
Tl
aj
SE
Ue
Ya
Ya
Lm
Lm
bY
tp
Lm
Lm
De
"}
(6,1,1) = {"
nV
Ma
Sn
MR
Tk
Ue
np
Ya
Tk
Lm
zY
wA
un
CC
De
"}
(7,1,1) = {"
Ue
Gg
VU
MR
Sn
nV
iy
Ya
Tk
uc
tp
tp
uc
Tk
De
"}
(8,1,1) = {"
Ue
em
nw
cL
ze
BE
Hm
Hm
Tk
Lm
kU
wA
Lm
Tk
De
"}
(9,1,1) = {"
Ue
tm
OZ
MR
kF
nV
yd
Ya
Tk
Lm
zq
OC
Lm
Tk
De
"}
(10,1,1) = {"
Ue
Ue
Ba
nV
nV
nV
IU
Ya
CC
Lm
IN
IN
Lm
CC
De
"}
(11,1,1) = {"
Ue
gy
Sn
RE
en
nV
Ya
Ya
mK
Tk
Tk
CC
Sn
pc
De
"}
(12,1,1) = {"
Ue
MR
Ln
RB
Sn
nO
Ya
Ya
Ya
Hm
Ya
Ya
Hm
De
De
"}
(13,1,1) = {"
nV
pl
Ha
Zq
MR
nO
gA
Ya
Ya
tU
AK
AK
TB
Ya
De
"}
(14,1,1) = {"
nV
Xc
MR
OY
Tk
Ue
Ya
Nl
Ya
Cl
AK
kf
LG
Ag
De
"}
(15,1,1) = {"
nV
nV
nV
Ue
Ue
Ue
mj
Ya
Ya
Ya
Ya
De
De
De
De
"}
