//MAP CONVERTED BY dmm2tgm.py THIS HEADER COMMENT PREVENTS RECONVERSION, DO NOT REMOVE
"a" = (
/turf/template_noop,
/area/template_noop)
"b" = (
/obj/structure/table/wood/fancy/red,
/obj/item/clothing/suit/hooded/cultrobes,
/obj/effect/decal/cleanable/dirt/dust,
/turf/open/floor/plasteel/dark,
/area/overmap_encounter/planetoid/rockplanet/explored)
"c" = (
/obj/structure/table/wood/fancy/red,
/obj/item/restraints/legcuffs/bola/cult,
/turf/open/floor/plasteel/dark,
/area/overmap_encounter/planetoid/rockplanet/explored)
"d" = (
/obj/structure/window/reinforced/tinted/fulltile,
/obj/structure/grille,
/turf/open/floor/plating,
/area/overmap_encounter/planetoid/rockplanet/explored)
"e" = (
/obj/item/bedsheet/cult,
/obj/structure/bed,
/obj/structure/trap/cult,
/turf/open/floor/plasteel/dark,
/area/overmap_encounter/planetoid/rockplanet/explored)
"f" = (
/obj/structure/destructible/cult/forge,
/obj/effect/decal/cleanable/cobweb/cobweb2,
/obj/effect/decal/cleanable/dirt/dust,
/turf/open/floor/plasteel/dark,
/area/overmap_encounter/planetoid/rockplanet/explored)
"h" = (
/obj/item/stack/sheet/runed_metal/ten,
/obj/structure/table/wood/fancy/red,
/turf/open/floor/plating/rust,
/area/overmap_encounter/planetoid/rockplanet/explored)
"j" = (
/mob/living/simple_animal/hostile/construct/proteon/hostile,
/obj/effect/decal/cleanable/wrapping,
/turf/open/floor/plasteel/dark,
/area/overmap_encounter/planetoid/rockplanet/explored)
"k" = (
/obj/effect/decal/remains/human,
/turf/open/floor/plasteel/dark,
/area/overmap_encounter/planetoid/rockplanet/explored)
"l" = (
/turf/closed/wall/mineral/cult,
/area/overmap_encounter/planetoid/rockplanet/explored)
"m" = (
/obj/effect/decal/cleanable/oil/slippery,
/turf/open/floor/plasteel/dark,
/area/overmap_encounter/planetoid/rockplanet/explored)
"n" = (
/obj/structure/destructible/cult/talisman,
/obj/effect/decal/cleanable/blood/splatter,
/turf/open/floor/plasteel/dark,
/area/overmap_encounter/planetoid/rockplanet/explored)
"o" = (
/turf/open/floor/plasteel/dark,
/area/overmap_encounter/planetoid/rockplanet/explored)
"q" = (
/obj/structure/destructible/cult/pylon,
/obj/effect/decal/cleanable/cobweb/cobweb2,
/obj/effect/decal/cleanable/blood/splatter,
/turf/open/floor/plasteel/dark,
/area/overmap_encounter/planetoid/rockplanet/explored)
"t" = (
/obj/effect/decal/cleanable/ash,
/turf/open/floor/plasteel/dark,
/area/overmap_encounter/planetoid/rockplanet/explored)
"u" = (
/turf/closed/mineral/random/rockplanet,
/area/overmap_encounter/planetoid/rockplanet/explored)
"v" = (
/obj/structure/trap/cult,
/obj/effect/decal/cleanable/dirt/dust,
/turf/open/floor/plasteel/dark,
/area/overmap_encounter/planetoid/rockplanet/explored)
"w" = (
/obj/structure/headpike/bone,
/turf/open/floor/plating/asteroid/rockplanet/lit,
/area/overmap_encounter/planetoid/rockplanet/explored)
"y" = (
/obj/effect/decal/cleanable/plasma,
/turf/open/floor/plasteel/dark,
/area/overmap_encounter/planetoid/rockplanet/explored)
"z" = (
/obj/structure/table/wood/fancy/red,
/obj/item/toy/plush/narplush,
/turf/open/floor/plasteel/dark,
/area/overmap_encounter/planetoid/rockplanet/explored)
"A" = (
/obj/structure/bookcase/random/religion,
/obj/effect/decal/cleanable/cobweb/cobweb2,
/turf/open/floor/plasteel/dark,
/area/overmap_encounter/planetoid/rockplanet/explored)
"C" = (
/obj/effect/decal/cleanable/dirt/dust,
/obj/effect/decal/cleanable/ash,
/turf/open/floor/plasteel/dark,
/area/overmap_encounter/planetoid/rockplanet/explored)
"D" = (
/obj/structure/destructible/cult/tome,
/turf/open/floor/plasteel/dark,
/area/overmap_encounter/planetoid/rockplanet/explored)
"E" = (
/obj/effect/decal/cleanable/dirt/dust,
/turf/open/floor/plasteel/dark,
/area/overmap_encounter/planetoid/rockplanet/explored)
"F" = (
/obj/structure/destructible/cult/tome,
/obj/effect/decal/cleanable/cobweb,
/obj/effect/decal/cleanable/dirt/dust,
/obj/effect/decal/cleanable/blood/splatter,
/turf/open/floor/plasteel/dark,
/area/overmap_encounter/planetoid/rockplanet/explored)
"H" = (
/obj/machinery/door/airlock/cult,
/obj/structure/trap/cult,
/turf/open/floor/plasteel/dark,
/area/overmap_encounter/planetoid/rockplanet/explored)
"I" = (
/obj/effect/decal/cleanable/dirt/dust,
/obj/effect/decal/cleanable/garbage,
/turf/open/floor/plasteel/dark,
/area/overmap_encounter/planetoid/rockplanet/explored)
"J" = (
/obj/effect/decal/cleanable/crayon,
/turf/open/floor/plasteel/dark,
/area/overmap_encounter/planetoid/rockplanet/explored)
"K" = (
/obj/effect/mob_spawn/human/corpse/charredskeleton,
/turf/open/floor/plating/asteroid/rockplanet/lit,
/area/overmap_encounter/planetoid/rockplanet/explored)
"N" = (
/obj/structure/bookcase/random/religion,
/obj/effect/decal/cleanable/cobweb,
/obj/effect/decal/cleanable/dirt/dust,
/turf/open/floor/plasteel/dark,
/area/overmap_encounter/planetoid/rockplanet/explored)
"O" = (
/obj/structure/table/wood/fancy/red,
/obj/item/melee/cultblade/dagger,
/turf/open/floor/plasteel/dark,
/area/overmap_encounter/planetoid/rockplanet/explored)
"P" = (
/obj/item/storage/fancy/candle_box,
/obj/item/lighter/greyscale,
/obj/effect/decal/cleanable/dirt/dust,
/turf/open/floor/plasteel/dark,
/area/overmap_encounter/planetoid/rockplanet/explored)
"Q" = (
/obj/structure/table/wood/fancy/red,
/obj/effect/decal/cleanable/vomit/old,
/turf/open/floor/plasteel/dark,
/area/overmap_encounter/planetoid/rockplanet/explored)
"S" = (
/mob/living/simple_animal/hostile/construct/proteon/hostile,
/obj/effect/decal/cleanable/blood/old,
/turf/open/floor/plasteel/dark,
/area/overmap_encounter/planetoid/rockplanet/explored)
"T" = (
/obj/effect/decal/cleanable/dirt/dust,
/obj/effect/decal/cleanable/food/salt,
/turf/open/floor/plasteel/dark,
/area/overmap_encounter/planetoid/rockplanet/explored)
"U" = (
/obj/effect/decal/cleanable/blood/old,
/turf/open/floor/plasteel/dark,
/area/overmap_encounter/planetoid/rockplanet/explored)
"V" = (
/obj/structure/closet/crate/necropolis,
/obj/effect/decal/cleanable/dirt/dust,
/obj/effect/decal/cleanable/blood/splatter,
/obj/item/book/granter/spell/blind,
/turf/open/floor/plasteel/dark,
/area/overmap_encounter/planetoid/rockplanet/explored)
"Y" = (
/obj/effect/decal/cleanable/ash/large,
/turf/open/floor/plating/asteroid/rockplanet/lit,
/area/overmap_encounter/planetoid/rockplanet/explored)
"Z" = (
/mob/living/simple_animal/hostile/construct/proteon/hostile,
/obj/effect/decal/cleanable/blood/splatter,
/turf/open/floor/plasteel/dark,
/area/overmap_encounter/planetoid/rockplanet/explored)

(1,1,1) = {"
a
u
u
u
K
w
Y
w
a
a
"}
(2,1,1) = {"
u
u
l
l
l
l
H
l
l
a
"}
(3,1,1) = {"
u
l
l
F
c
m
o
z
l
l
"}
(4,1,1) = {"
l
l
h
o
E
C
Z
o
b
l
"}
(5,1,1) = {"
l
N
o
S
y
J
o
o
O
l
"}
(6,1,1) = {"
d
D
v
t
o
P
T
o
n
d
"}
(7,1,1) = {"
l
A
U
y
k
E
t
U
y
l
"}
(8,1,1) = {"
l
l
l
q
e
Q
I
j
v
l
"}
(9,1,1) = {"
u
u
l
l
l
l
l
f
V
l
"}
(10,1,1) = {"
a
u
u
u
u
u
l
l
l
l
"}
