//MAP CONVERTED BY dmm2tgm.py THIS HEADER COMMENT PREVENTS RECONVERSION, DO NOT REMOVE
"av" = (
/obj/structure/closet/firecloset,
/turf/open/floor/plating,
/area/space)
"bz" = (
/obj/structure/closet/cardboard,
/obj/item/weaponcrafting/gunkit/capgun_ugrade_kit,
/turf/open/floor/plasteel,
/area/space)
"bG" = (
/obj/structure/displaycase,
/obj/item/gun/energy/e_gun/mini,
/turf/open/floor/plating/rust,
/area/space)
"bM" = (
/obj/structure/table/wood/reinforced,
/obj/item/storage/firstaid/medical,
/turf/open/floor/plasteel,
/area/space)
"cz" = (
/obj/machinery/door/airlock/public/glass,
/turf/open/floor/plasteel,
/area/space)
"cH" = (
/obj/structure/table,
/turf/open/floor/plasteel/white,
/area/space)
"cQ" = (
/turf/open/floor/plasteel,
/area/space)
"dD" = (
/obj/machinery/door/airlock/security,
/turf/open/floor/plating/rust,
/area/space)
"eV" = (
/obj/structure/closet/cardboard,
/obj/structure/fluff/paper/stack{
	dir = 8
	},
/obj/item/paper,
/turf/open/floor/plasteel,
/area/space)
"fq" = (
/obj/structure/table/wood/reinforced,
/obj/structure/window/reinforced{
	dir = 1
	},
/obj/item/stack/cable_coil/cut,
/turf/open/floor/plasteel,
/area/space)
"gw" = (
/obj/structure/table/wood/reinforced,
/obj/item/modular_computer/laptop/preset,
/turf/open/floor/plasteel,
/area/space)
"gx" = (
/obj/structure/closet/cardboard,
/obj/item/paper,
/turf/open/floor/plasteel,
/area/space)
"gM" = (
/obj/machinery/door/window/westleft{
	dir = 2
	},
/turf/open/floor/plasteel,
/area/space)
"gX" = (
/obj/structure/door_assembly/door_assembly_research,
/turf/open/floor/plating/rust,
/area/space)
"iL" = (
/turf/closed/wall/rust,
/area/space)
"jn" = (
/obj/structure/table/wood/reinforced,
/obj/item/pen/blue,
/obj/item/pen{
	pixel_x = 7;
	pixel_y = 3
	},
/turf/open/floor/plasteel,
/area/space)
"jo" = (
/obj/structure/table/wood/reinforced,
/obj/item/weldingtool/hugetank,
/turf/open/floor/plasteel,
/area/space)
"kb" = (
/turf/open/floor/plating/rust,
/area/space)
"kj" = (
/obj/structure/closet/cardboard,
/obj/structure/fluff/paper/stack,
/turf/open/floor/plasteel,
/area/space)
"kR" = (
/obj/structure/closet/cardboard,
/obj/structure/fluff/paper/stack{
	dir = 8
	},
/turf/open/floor/plasteel,
/area/space)
"mo" = (
/obj/structure/fluff/paper/stack{
	dir = 9
	},
/turf/open/floor/plasteel,
/area/space)
"nn" = (
/obj/structure/fluff/paper/stack{
	dir = 9
	},
/obj/item/paper,
/obj/structure/reagent_dispensers/fueltank,
/turf/open/floor/plasteel,
/area/space)
"nL" = (
/obj/structure/sign/poster/official/nanotrasen_logo{
	pixel_y = 32
	},
/turf/open/floor/plating/asteroid,
/area/space)
"oa" = (
/obj/structure/chair{
	dir = 1
	},
/turf/open/floor/plating/rust,
/area/space)
"oe" = (
/obj/structure/table/wood/reinforced,
/obj/item/documents/syndicate/blue,
/turf/open/floor/plasteel,
/area/space)
"ot" = (
/obj/structure/chair{
	dir = 1
	},
/turf/open/floor/plasteel,
/area/space)
"ov" = (
/obj/structure/table,
/turf/open/floor/plating/rust,
/area/space)
"qg" = (
/obj/structure/closet/cardboard,
/obj/structure/fluff/paper/stack{
	dir = 9
	},
/obj/item/paper,
/turf/open/floor/plasteel,
/area/space)
"qn" = (
/obj/structure/fluff/paper/stack{
	dir = 5
	},
/turf/open/floor/plasteel,
/area/space)
"rV" = (
/obj/structure/window/reinforced,
/obj/machinery/door/window/westleft{
	dir = 4
	},
/turf/open/floor/plasteel,
/area/space)
"sQ" = (
/obj/structure/window/reinforced{
	dir = 1
	},
/obj/machinery/door/window/westleft{
	dir = 4
	},
/turf/open/floor/plasteel,
/area/space)
"to" = (
/obj/item/target,
/turf/open/floor/plasteel/white,
/area/space)
"tp" = (
/obj/structure/window/reinforced{
	dir = 1
	},
/obj/structure/table/wood/reinforced,
/obj/machinery/computer/security/wooden_tv,
/turf/open/floor/plasteel,
/area/space)
"tr" = (
/obj/structure/fluff/paper/stack{
	dir = 5
	},
/obj/item/paper,
/obj/item/paper,
/turf/open/floor/plasteel,
/area/space)
"tD" = (
/turf/open/floor/plating/asteroid,
/area/space)
"uB" = (
/obj/structure/chair/office{
	dir = 8
	},
/turf/open/floor/plasteel,
/area/space)
"uV" = (
/obj/structure/table/wood/reinforced,
/turf/open/floor/plasteel,
/area/space)
"vq" = (
/obj/item/target/alien,
/turf/open/floor/plasteel/white,
/area/space)
"vz" = (
/obj/structure/chair{
	dir = 1
	},
/turf/open/floor/plating,
/area/space)
"vY" = (
/obj/structure/table/wood/reinforced,
/obj/item/storage/firstaid/fire,
/turf/open/floor/plasteel,
/area/space)
"wp" = (
/obj/machinery/door/airlock/security,
/turf/open/floor/plasteel,
/area/space)
"wD" = (
/obj/structure/closet/cardboard,
/turf/open/floor/plasteel,
/area/space)
"wT" = (
/obj/machinery/porta_turret/syndicate/energy,
/turf/open/floor/plasteel,
/area/space)
"yY" = (
/obj/structure/rack,
/obj/item/stock_parts/cell/gun/empty,
/turf/open/floor/plasteel,
/area/space)
"Ae" = (
/obj/machinery/porta_turret/syndicate/energy,
/turf/open/floor/plating/rust,
/area/space)
"AG" = (
/obj/structure/table/wood/reinforced,
/obj/item/gun/energy/laser,
/turf/open/floor/plasteel,
/area/space)
"Bf" = (
/obj/structure/closet/cardboard,
/obj/structure/fluff/paper/stack,
/obj/item/paper,
/turf/open/floor/plasteel,
/area/space)
"Bv" = (
/obj/structure/closet/cardboard,
/obj/structure/fluff/paper/stack{
	dir = 9
	},
/obj/item/paper,
/obj/item/paper,
/obj/item/paper,
/turf/open/floor/plasteel,
/area/space)
"Cl" = (
/obj/structure/table/wood/reinforced,
/obj/item/paper/crumpled,
/turf/open/floor/plasteel,
/area/space)
"CK" = (
/obj/structure/closet/cardboard,
/obj/structure/fluff/paper/stack{
	dir = 9
	},
/obj/item/paper,
/obj/item/paper,
/turf/open/floor/plasteel,
/area/space)
"Ea" = (
/obj/structure/table,
/obj/item/ammo_box/c9mm/rubbershot,
/turf/open/floor/plasteel/white,
/area/space)
"EW" = (
/obj/structure/table/wood/reinforced,
/obj/item/stack/sheet/mineral/uranium/five,
/turf/open/floor/plasteel,
/area/space)
"Fb" = (
/obj/structure/table,
/obj/item/ammo_box/n762,
/turf/open/floor/plasteel/white,
/area/space)
"FC" = (
/obj/structure/barricade/sandbags,
/turf/open/floor/plasteel/white,
/area/space)
"Ge" = (
/obj/structure/window/reinforced{
	dir = 1
	},
/obj/structure/window/reinforced{
	dir = 4
	},
/turf/open/floor/plasteel,
/area/space)
"Gj" = (
/obj/structure/displaycase,
/obj/item/gun/energy/laser/captain/brazil,
/turf/open/floor/plasteel/white,
/area/space)
"GR" = (
/turf/open/floor/plating,
/area/space)
"HL" = (
/obj/structure/rack,
/obj/item/stock_parts/cell/gun/upgraded/empty,
/turf/open/floor/plating/rust,
/area/space)
"Ie" = (
/obj/structure/rack,
/obj/item/stock_parts/cell/gun/empty,
/turf/open/floor/plating/rust,
/area/space)
"KH" = (
/obj/structure/window/reinforced{
	dir = 4
	},
/turf/open/floor/plasteel,
/area/space)
"KW" = (
/turf/closed/wall/r_wall/rust,
/area/space)
"Ma" = (
/obj/structure/table,
/turf/open/floor/plastic,
/area/space)
"Mq" = (
/obj/effect/spawner/structure/window,
/turf/open/floor/plating/rust,
/area/space)
"Mt" = (
/obj/structure/window/reinforced{
	dir = 1
	},
/turf/open/floor/plasteel,
/area/space)
"MS" = (
/obj/structure/window/reinforced,
/turf/open/floor/plasteel,
/area/space)
"Oz" = (
/obj/machinery/door/airlock/public/glass,
/turf/open/floor/plating/rust,
/area/space)
"QL" = (
/turf/open/floor/plasteel/white,
/area/space)
"Ra" = (
/obj/effect/gibspawner,
/turf/open/floor/plasteel,
/area/space)
"Rw" = (
/obj/machinery/door/airlock/public/glass,
/turf/open/floor/plating,
/area/space)
"RT" = (
/obj/structure/table,
/turf/open/floor/plasteel,
/area/space)
"Sj" = (
/obj/structure/closet/cardboard,
/obj/structure/fluff/paper/stack{
	dir = 5
	},
/turf/open/floor/plasteel,
/area/space)
"Vw" = (
/obj/structure/displaycase,
/obj/item/gun/energy/e_gun/mini,
/turf/open/floor/plasteel,
/area/space)
"VP" = (
/obj/structure/closet/cardboard,
/obj/structure/fluff/paper/stack{
	dir = 9
	},
/turf/open/floor/plasteel,
/area/space)
"Wn" = (
/obj/structure/table,
/obj/item/ammo_box/c45,
/turf/open/floor/plasteel/white,
/area/space)
"WB" = (
/obj/item/target/clown,
/turf/open/floor/plasteel/white,
/area/space)
"WJ" = (
/obj/structure/table/wood/reinforced,
/obj/machinery/computer/crew{
	dir = 1
	},
/turf/open/floor/plasteel,
/area/space)
"WL" = (
/obj/structure/closet/cardboard,
/obj/structure/fluff/paper/stack{
	dir = 8
	},
/obj/item/paper,
/obj/item/paper,
/obj/item/paper,
/turf/open/floor/plasteel,
/area/space)
"YX" = (
/obj/machinery/door/window/westleft{
	dir = 1
	},
/turf/open/floor/plasteel,
/area/space)
"Zd" = (
/obj/structure/window/reinforced,
/obj/structure/table/wood/reinforced,
/obj/item/stack/sheet/animalhide/human,
/obj/item/stack/sheet/mineral/titanium/five,
/turf/open/floor/plasteel,
/area/space)
"Zu" = (
/obj/structure/fluff/paper/stack{
	dir = 5
	},
/obj/item/paper,
/turf/open/floor/plasteel,
/area/space)
"ZX" = (
/obj/structure/closet/firecloset,
/turf/open/floor/plasteel,
/area/space)

(1,1,1) = {"
tD
tD
tD
tD
tD
tD
tD
tD
tD
tD
tD
tD
tD
tD
tD
tD
tD
tD
tD
tD
tD
tD
tD
tD
tD
tD
tD
tD
tD
tD
tD
tD
tD
tD
tD
tD
tD
tD
tD
tD
tD
tD
tD
tD
tD
tD
tD
tD
tD
tD
"}
(2,1,1) = {"
tD
tD
tD
tD
tD
tD
tD
tD
tD
tD
tD
tD
tD
tD
tD
tD
tD
tD
tD
tD
tD
tD
tD
tD
tD
tD
tD
tD
tD
tD
tD
tD
tD
tD
tD
tD
tD
tD
tD
tD
tD
tD
tD
tD
tD
tD
tD
tD
tD
tD
"}
(3,1,1) = {"
tD
tD
tD
tD
tD
tD
tD
tD
tD
tD
tD
tD
tD
tD
tD
tD
tD
tD
tD
tD
tD
tD
tD
tD
tD
tD
tD
tD
tD
tD
tD
tD
tD
tD
tD
tD
tD
tD
tD
tD
tD
tD
tD
tD
tD
tD
tD
tD
tD
tD
"}
(4,1,1) = {"
tD
tD
tD
tD
tD
tD
tD
tD
tD
tD
tD
tD
tD
tD
tD
tD
tD
tD
tD
tD
tD
tD
tD
tD
tD
tD
tD
tD
tD
tD
tD
tD
tD
tD
tD
tD
tD
tD
tD
tD
tD
tD
tD
tD
tD
tD
tD
tD
tD
tD
"}
(5,1,1) = {"
tD
tD
tD
tD
tD
tD
tD
tD
tD
tD
tD
tD
tD
tD
tD
tD
tD
tD
tD
tD
tD
tD
tD
tD
tD
tD
tD
tD
tD
tD
tD
tD
tD
tD
tD
tD
tD
tD
tD
tD
tD
tD
tD
tD
tD
tD
tD
tD
tD
tD
"}
(6,1,1) = {"
tD
tD
tD
tD
tD
tD
tD
tD
tD
tD
tD
tD
tD
tD
tD
tD
tD
tD
tD
tD
tD
tD
tD
tD
tD
tD
tD
tD
tD
tD
tD
tD
tD
tD
tD
tD
tD
tD
tD
tD
tD
tD
tD
tD
tD
tD
tD
tD
tD
tD
"}
(7,1,1) = {"
tD
tD
tD
tD
tD
tD
tD
tD
tD
tD
tD
tD
tD
tD
tD
tD
tD
tD
tD
tD
tD
tD
tD
tD
tD
tD
tD
tD
tD
tD
tD
tD
tD
tD
tD
tD
tD
tD
tD
tD
tD
tD
tD
tD
tD
tD
tD
tD
tD
tD
"}
(8,1,1) = {"
tD
tD
tD
tD
tD
tD
tD
tD
tD
tD
tD
tD
tD
tD
tD
tD
tD
tD
tD
tD
tD
tD
tD
tD
tD
tD
tD
tD
tD
tD
tD
tD
tD
tD
tD
tD
tD
tD
tD
tD
tD
tD
tD
tD
tD
tD
tD
tD
tD
tD
"}
(9,1,1) = {"
tD
tD
tD
tD
tD
tD
tD
tD
tD
tD
tD
tD
tD
tD
tD
tD
tD
tD
tD
tD
tD
tD
tD
tD
tD
tD
tD
tD
tD
tD
tD
tD
tD
tD
tD
tD
tD
tD
tD
tD
tD
tD
tD
tD
tD
tD
tD
tD
tD
tD
"}
(10,1,1) = {"
tD
tD
tD
tD
tD
tD
tD
tD
tD
tD
tD
tD
tD
tD
tD
tD
tD
tD
tD
tD
tD
tD
tD
tD
tD
tD
tD
tD
tD
tD
tD
tD
tD
tD
tD
tD
tD
tD
tD
tD
tD
tD
tD
tD
tD
tD
tD
tD
tD
tD
"}
(11,1,1) = {"
tD
tD
tD
tD
tD
tD
KW
KW
KW
KW
KW
KW
KW
KW
KW
KW
KW
KW
tD
tD
tD
tD
tD
tD
tD
tD
tD
tD
tD
tD
tD
tD
tD
tD
tD
tD
tD
tD
tD
tD
tD
tD
tD
tD
tD
tD
tD
tD
tD
tD
"}
(12,1,1) = {"
tD
tD
tD
tD
tD
KW
KW
jn
oe
tp
uV
jo
fq
EW
Zd
vY
uV
KW
KW
tD
tD
tD
tD
tD
tD
tD
tD
tD
tD
tD
tD
tD
tD
tD
tD
tD
tD
tD
tD
tD
tD
tD
tD
tD
tD
tD
tD
tD
tD
tD
"}
(13,1,1) = {"
tD
tD
tD
tD
tD
KW
Cl
uB
cQ
Mt
uB
cQ
Mt
uB
MS
Ra
cQ
uV
KW
tD
tD
tD
tD
tD
tD
tD
tD
tD
tD
tD
tD
tD
tD
tD
tD
tD
tD
tD
tD
tD
tD
tD
tD
tD
tD
tD
tD
tD
tD
tD
"}
(14,1,1) = {"
tD
tD
tD
tD
tD
KW
AG
cQ
cQ
sQ
KH
KH
Ge
KH
rV
cQ
uB
bM
KW
tD
tD
tD
tD
tD
tD
tD
tD
tD
tD
tD
tD
tD
tD
tD
tD
tD
tD
tD
tD
tD
tD
tD
tD
tD
tD
tD
tD
tD
tD
tD
"}
(15,1,1) = {"
tD
tD
tD
tD
tD
KW
gw
cQ
cQ
YX
cQ
cQ
cQ
cQ
gM
cQ
cQ
WJ
iL
iL
iL
iL
iL
tD
tD
tD
tD
tD
tD
tD
tD
tD
tD
tD
tD
tD
tD
tD
tD
tD
tD
tD
tD
tD
tD
tD
tD
tD
tD
tD
"}
(16,1,1) = {"
tD
tD
tD
KW
KW
KW
KW
KW
KW
iL
cz
cz
iL
iL
iL
iL
iL
iL
iL
bG
Vw
Vw
iL
tD
tD
tD
tD
tD
tD
tD
tD
tD
tD
tD
tD
tD
tD
tD
tD
tD
tD
tD
tD
tD
tD
tD
tD
tD
tD
tD
"}
(17,1,1) = {"
tD
tD
tD
KW
Gj
QL
QL
Fb
QL
iL
cQ
cQ
iL
kb
kb
kb
kb
Ae
iL
kb
kb
cQ
iL
iL
iL
iL
iL
tD
tD
tD
tD
tD
tD
tD
tD
tD
tD
tD
tD
tD
tD
tD
tD
tD
tD
tD
tD
tD
tD
tD
"}
(18,1,1) = {"
tD
tD
tD
KW
QL
QL
QL
Wn
QL
iL
cQ
cQ
iL
Mq
Mq
Mq
Mq
Mq
iL
av
cQ
GR
RT
GR
cQ
cQ
iL
tD
tD
tD
tD
tD
tD
tD
tD
tD
tD
tD
tD
tD
tD
tD
tD
tD
tD
tD
tD
tD
tD
tD
"}
(19,1,1) = {"
tD
tD
tD
KW
QL
QL
QL
Ea
QL
iL
cQ
cQ
cQ
dD
kb
kb
cQ
cQ
wp
cQ
GR
kb
ov
RT
kb
ot
iL
tD
tD
tD
tD
tD
tD
tD
tD
tD
tD
tD
tD
tD
tD
tD
tD
tD
tD
tD
tD
tD
tD
tD
"}
(20,1,1) = {"
tD
tD
tD
KW
QL
QL
QL
QL
QL
iL
cQ
cQ
iL
Mq
Mq
Mq
Mq
Mq
iL
yY
kb
GR
kb
RT
cQ
ot
iL
tD
tD
tD
tD
tD
tD
tD
tD
tD
tD
tD
tD
tD
tD
tD
tD
tD
tD
tD
tD
tD
tD
tD
"}
(21,1,1) = {"
tD
tD
tD
KW
QL
QL
QL
QL
QL
iL
cQ
cQ
iL
Ae
kb
kb
kb
kb
iL
HL
cQ
kb
kb
RT
GR
vz
iL
nL
tD
tD
tD
tD
tD
tD
tD
tD
tD
tD
tD
tD
tD
tD
tD
tD
tD
tD
tD
tD
tD
tD
"}
(22,1,1) = {"
tD
tD
tD
KW
FC
FC
FC
FC
QL
gX
cQ
cQ
iL
iL
iL
iL
iL
iL
iL
yY
kb
GR
GR
RT
cQ
cQ
Oz
tD
tD
tD
tD
tD
tD
tD
tD
tD
tD
tD
tD
tD
tD
tD
tD
tD
tD
tD
tD
tD
tD
tD
"}
(23,1,1) = {"
tD
tD
tD
KW
QL
QL
QL
cH
QL
gX
cQ
cQ
iL
iL
iL
iL
iL
iL
iL
Ie
kb
kb
kb
Ma
GR
cQ
Rw
tD
tD
tD
tD
tD
tD
tD
tD
tD
tD
tD
tD
tD
tD
tD
tD
tD
tD
tD
tD
tD
tD
tD
"}
(24,1,1) = {"
tD
tD
tD
KW
QL
QL
QL
cH
QL
iL
cQ
cQ
iL
Ae
kb
kb
kb
kb
iL
yY
GR
cQ
GR
Ma
GR
ot
iL
nL
tD
tD
tD
tD
tD
tD
tD
tD
tD
tD
tD
tD
tD
tD
tD
tD
tD
tD
tD
tD
tD
tD
"}
(25,1,1) = {"
tD
tD
tD
KW
QL
QL
QL
cH
QL
iL
cQ
cQ
iL
Mq
Mq
Mq
Mq
Mq
iL
cQ
cQ
GR
ov
ov
GR
ot
iL
tD
tD
tD
tD
tD
tD
tD
tD
tD
tD
tD
tD
tD
tD
tD
tD
tD
tD
tD
tD
tD
tD
tD
"}
(26,1,1) = {"
tD
tD
tD
KW
QL
QL
QL
cH
QL
iL
cQ
cQ
cQ
wp
kb
cQ
cQ
cQ
dD
GR
kb
cQ
RT
cQ
kb
oa
iL
tD
tD
tD
tD
tD
tD
tD
tD
tD
tD
tD
tD
tD
tD
tD
tD
tD
tD
tD
tD
tD
tD
tD
"}
(27,1,1) = {"
tD
tD
tD
KW
QL
QL
QL
cH
QL
iL
cQ
cQ
iL
Mq
Mq
Mq
Mq
Mq
iL
ZX
GR
GR
YX
cQ
cQ
GR
iL
tD
tD
tD
tD
tD
tD
tD
tD
tD
tD
tD
tD
tD
tD
tD
tD
tD
tD
tD
tD
tD
tD
tD
"}
(28,1,1) = {"
tD
tD
tD
KW
QL
QL
QL
QL
QL
iL
cQ
cQ
iL
kb
kb
kb
kb
Ae
iL
kb
cQ
cQ
iL
iL
iL
iL
iL
tD
tD
tD
tD
tD
tD
tD
tD
tD
tD
tD
tD
tD
tD
tD
tD
tD
tD
tD
tD
tD
tD
tD
"}
(29,1,1) = {"
tD
tD
tD
KW
to
vq
WB
QL
QL
iL
cQ
cQ
iL
iL
iL
iL
iL
iL
iL
Vw
Vw
Vw
iL
tD
tD
tD
tD
tD
tD
tD
tD
tD
tD
tD
tD
tD
tD
tD
tD
tD
tD
tD
tD
tD
tD
tD
tD
tD
tD
tD
"}
(30,1,1) = {"
tD
tD
tD
KW
KW
KW
KW
KW
KW
iL
cz
cz
iL
wT
kj
kR
bz
wT
iL
iL
iL
iL
iL
tD
tD
tD
tD
tD
tD
tD
tD
tD
tD
tD
tD
tD
tD
tD
tD
tD
tD
tD
tD
tD
tD
tD
tD
tD
tD
tD
"}
(31,1,1) = {"
tD
tD
tD
KW
wT
qg
kR
Sj
Sj
Sj
qn
mo
eV
VP
Bf
CK
kj
wD
KW
tD
tD
tD
tD
tD
tD
tD
tD
tD
tD
tD
tD
tD
tD
tD
tD
tD
tD
tD
tD
tD
tD
tD
tD
tD
tD
tD
tD
tD
tD
tD
"}
(32,1,1) = {"
tD
tD
tD
KW
gx
VP
qg
qg
VP
eV
Zu
tr
WL
Bv
qg
qg
VP
wD
KW
tD
tD
tD
tD
tD
tD
tD
tD
tD
tD
tD
tD
tD
tD
tD
tD
tD
tD
tD
tD
tD
tD
tD
tD
tD
tD
tD
tD
tD
tD
tD
"}
(33,1,1) = {"
tD
tD
tD
KW
wT
kR
VP
eV
eV
qg
eV
nn
eV
gx
qg
kR
wD
wT
KW
tD
tD
tD
tD
tD
tD
tD
tD
tD
tD
tD
tD
tD
tD
tD
tD
tD
tD
tD
tD
tD
tD
tD
tD
tD
tD
tD
tD
tD
tD
tD
"}
(34,1,1) = {"
tD
tD
tD
KW
KW
KW
KW
KW
KW
KW
KW
KW
KW
KW
KW
KW
KW
KW
KW
tD
tD
tD
tD
tD
tD
tD
tD
tD
tD
tD
tD
tD
tD
tD
tD
tD
tD
tD
tD
tD
tD
tD
tD
tD
tD
tD
tD
tD
tD
tD
"}
(35,1,1) = {"
tD
tD
tD
tD
tD
tD
tD
tD
tD
tD
tD
tD
tD
tD
tD
tD
tD
tD
tD
tD
tD
tD
tD
tD
tD
tD
tD
tD
tD
tD
tD
tD
tD
tD
tD
tD
tD
tD
tD
tD
tD
tD
tD
tD
tD
tD
tD
tD
tD
tD
"}
(36,1,1) = {"
tD
tD
tD
tD
tD
tD
tD
tD
tD
tD
tD
tD
tD
tD
tD
tD
tD
tD
tD
tD
tD
tD
tD
tD
tD
tD
tD
tD
tD
tD
tD
tD
tD
tD
tD
tD
tD
tD
tD
tD
tD
tD
tD
tD
tD
tD
tD
tD
tD
tD
"}
(37,1,1) = {"
tD
tD
tD
tD
tD
tD
tD
tD
tD
tD
tD
tD
tD
tD
tD
tD
tD
tD
tD
tD
tD
tD
tD
tD
tD
tD
tD
tD
tD
tD
tD
tD
tD
tD
tD
tD
tD
tD
tD
tD
tD
tD
tD
tD
tD
tD
tD
tD
tD
tD
"}
(38,1,1) = {"
tD
tD
tD
tD
tD
tD
tD
tD
tD
tD
tD
tD
tD
tD
tD
tD
tD
tD
tD
tD
tD
tD
tD
tD
tD
tD
tD
tD
tD
tD
tD
tD
tD
tD
tD
tD
tD
tD
tD
tD
tD
tD
tD
tD
tD
tD
tD
tD
tD
tD
"}
(39,1,1) = {"
tD
tD
tD
tD
tD
tD
tD
tD
tD
tD
tD
tD
tD
tD
tD
tD
tD
tD
tD
tD
tD
tD
tD
tD
tD
tD
tD
tD
tD
tD
tD
tD
tD
tD
tD
tD
tD
tD
tD
tD
tD
tD
tD
tD
tD
tD
tD
tD
tD
tD
"}
(40,1,1) = {"
tD
tD
tD
tD
tD
tD
tD
tD
tD
tD
tD
tD
tD
tD
tD
tD
tD
tD
tD
tD
tD
tD
tD
tD
tD
tD
tD
tD
tD
tD
tD
tD
tD
tD
tD
tD
tD
tD
tD
tD
tD
tD
tD
tD
tD
tD
tD
tD
tD
tD
"}
(41,1,1) = {"
tD
tD
tD
tD
tD
tD
tD
tD
tD
tD
tD
tD
tD
tD
tD
tD
tD
tD
tD
tD
tD
tD
tD
tD
tD
tD
tD
tD
tD
tD
tD
tD
tD
tD
tD
tD
tD
tD
tD
tD
tD
tD
tD
tD
tD
tD
tD
tD
tD
tD
"}
(42,1,1) = {"
tD
tD
tD
tD
tD
tD
tD
tD
tD
tD
tD
tD
tD
tD
tD
tD
tD
tD
tD
tD
tD
tD
tD
tD
tD
tD
tD
tD
tD
tD
tD
tD
tD
tD
tD
tD
tD
tD
tD
tD
tD
tD
tD
tD
tD
tD
tD
tD
tD
tD
"}
(43,1,1) = {"
tD
tD
tD
tD
tD
tD
tD
tD
tD
tD
tD
tD
tD
tD
tD
tD
tD
tD
tD
tD
tD
tD
tD
tD
tD
tD
tD
tD
tD
tD
tD
tD
tD
tD
tD
tD
tD
tD
tD
tD
tD
tD
tD
tD
tD
tD
tD
tD
tD
tD
"}
(44,1,1) = {"
tD
tD
tD
tD
tD
tD
tD
tD
tD
tD
tD
tD
tD
tD
tD
tD
tD
tD
tD
tD
tD
tD
tD
tD
tD
tD
tD
tD
tD
tD
tD
tD
tD
tD
tD
tD
tD
tD
tD
tD
tD
tD
tD
tD
tD
tD
tD
tD
tD
tD
"}
(45,1,1) = {"
tD
tD
tD
tD
tD
tD
tD
tD
tD
tD
tD
tD
tD
tD
tD
tD
tD
tD
tD
tD
tD
tD
tD
tD
tD
tD
tD
tD
tD
tD
tD
tD
tD
tD
tD
tD
tD
tD
tD
tD
tD
tD
tD
tD
tD
tD
tD
tD
tD
tD
"}
(46,1,1) = {"
tD
tD
tD
tD
tD
tD
tD
tD
tD
tD
tD
tD
tD
tD
tD
tD
tD
tD
tD
tD
tD
tD
tD
tD
tD
tD
tD
tD
tD
tD
tD
tD
tD
tD
tD
tD
tD
tD
tD
tD
tD
tD
tD
tD
tD
tD
tD
tD
tD
tD
"}
(47,1,1) = {"
tD
tD
tD
tD
tD
tD
tD
tD
tD
tD
tD
tD
tD
tD
tD
tD
tD
tD
tD
tD
tD
tD
tD
tD
tD
tD
tD
tD
tD
tD
tD
tD
tD
tD
tD
tD
tD
tD
tD
tD
tD
tD
tD
tD
tD
tD
tD
tD
tD
tD
"}
(48,1,1) = {"
tD
tD
tD
tD
tD
tD
tD
tD
tD
tD
tD
tD
tD
tD
tD
tD
tD
tD
tD
tD
tD
tD
tD
tD
tD
tD
tD
tD
tD
tD
tD
tD
tD
tD
tD
tD
tD
tD
tD
tD
tD
tD
tD
tD
tD
tD
tD
tD
tD
tD
"}
(49,1,1) = {"
tD
tD
tD
tD
tD
tD
tD
tD
tD
tD
tD
tD
tD
tD
tD
tD
tD
tD
tD
tD
tD
tD
tD
tD
tD
tD
tD
tD
tD
tD
tD
tD
tD
tD
tD
tD
tD
tD
tD
tD
tD
tD
tD
tD
tD
tD
tD
tD
tD
tD
"}
(50,1,1) = {"
tD
tD
tD
tD
tD
tD
tD
tD
tD
tD
tD
tD
tD
tD
tD
tD
tD
tD
tD
tD
tD
tD
tD
tD
tD
tD
tD
tD
tD
tD
tD
tD
tD
tD
tD
tD
tD
tD
tD
tD
tD
tD
tD
tD
tD
tD
tD
tD
tD
tD
"}
