//MAP CONVERTED BY dmm2tgm.py THIS HEADER COMMENT PREVENTS RECONVERSION, DO NOT REMOVE
"a" = (
/turf/closed/indestructible/riveted/hierophant,
/area/ruin/unpowered/hierophant)
"b" = (
/turf/open/indestructible/hierophant,
/area/ruin/unpowered/hierophant)
"c" = (
/obj/effect/light_emitter{
	set_cap = 3;
	set_luminosity = 5
	},
/turf/open/indestructible/hierophant,
/area/ruin/unpowered/hierophant)
"d" = (
/mob/living/simple_animal/hostile/megafauna/hierophant,
/turf/open/indestructible/hierophant,
/area/ruin/unpowered/hierophant)
"e" = (
/turf/open/indestructible/hierophant/two,
/area/ruin/unpowered/hierophant)
"f" = (
/obj/effect/light_emitter{
	set_cap = 3;
	set_luminosity = 5
	},
/turf/open/indestructible/hierophant/two,
/area/ruin/unpowered/hierophant)
"m" = (
/turf/open/floor/plating/asteroid/rockplanet,
/area/overmap_encounter/planetoid/rockplanet)
"s" = (
/obj/effect/light_emitter{
	set_cap = 3;
	set_luminosity = 5
	},
/turf/open/floor/plating/asteroid/rockplanet/lit,
/area/ruin/unpowered/hierophant)
"K" = (
/obj/effect/light_emitter{
	set_cap = 3;
	set_luminosity = 5
	},
/turf/open/floor/plating/rust/wasteplanet,
/area/ruin/unpowered/hierophant)
"Z" = (
/turf/open/floor/plating/asteroid/rockplanet/lit,
/area/ruin/unpowered/hierophant)

(1,1,1) = {"
m
m
m
Z
Z
Z
b
a
a
Z
Z
a
a
a
a
a
Z
Z
Z
b
Z
Z
Z
"}
(2,1,1) = {"
m
m
Z
Z
Z
b
b
b
b
b
b
c
b
b
b
b
b
b
b
b
b
Z
Z
"}
(3,1,1) = {"
m
m
Z
Z
s
c
b
b
b
a
b
b
b
a
b
b
b
c
c
b
b
Z
Z
"}
(4,1,1) = {"
m
Z
Z
Z
Z
b
b
b
b
b
b
b
b
b
b
b
b
b
b
b
Z
Z
Z
"}
(5,1,1) = {"
m
Z
Z
Z
Z
a
b
b
Z
Z
b
c
b
b
b
c
b
a
a
b
s
Z
Z
"}
(6,1,1) = {"
m
Z
Z
Z
Z
a
b
K
b
b
b
c
b
b
b
c
b
a
a
b
s
Z
Z
"}
(7,1,1) = {"
m
Z
Z
Z
Z
Z
Z
Z
Z
e
e
e
e
e
e
e
e
b
b
b
Z
Z
Z
"}
(8,1,1) = {"
Z
Z
Z
Z
s
s
Z
Z
e
a
e
e
e
a
e
e
e
c
c
b
Z
Z
Z
"}
(9,1,1) = {"
Z
Z
Z
Z
Z
Z
Z
Z
e
e
e
f
e
e
e
e
e
b
b
Z
Z
Z
a
"}
(10,1,1) = {"
Z
Z
Z
Z
Z
Z
Z
Z
e
e
e
e
e
e
e
a
e
b
b
Z
a
Z
a
"}
(11,1,1) = {"
Z
Z
Z
Z
Z
Z
Z
Z
e
e
b
b
b
e
e
e
e
b
b
Z
Z
Z
m
"}
(12,1,1) = {"
Z
s
Z
Z
Z
s
Z
Z
f
e
b
d
b
e
f
e
e
c
c
Z
Z
Z
m
"}
(13,1,1) = {"
Z
Z
Z
Z
Z
Z
Z
Z
e
e
b
b
b
e
e
e
e
b
b
Z
Z
Z
m
"}
(14,1,1) = {"
Z
Z
Z
Z
Z
Z
e
a
e
e
e
e
e
e
e
a
e
b
b
Z
Z
Z
m
"}
(15,1,1) = {"
Z
Z
Z
Z
Z
Z
e
e
e
e
e
f
e
e
e
e
e
b
b
Z
Z
Z
m
"}
(16,1,1) = {"
a
Z
Z
Z
s
c
e
e
e
a
e
e
e
a
e
e
e
c
c
b
Z
Z
m
"}
(17,1,1) = {"
Z
Z
Z
Z
Z
b
e
e
e
e
e
e
e
e
e
e
e
b
b
b
Z
Z
m
"}
(18,1,1) = {"
Z
Z
s
Z
a
a
b
c
b
b
b
c
b
b
b
c
b
a
a
b
c
Z
m
"}
(19,1,1) = {"
Z
Z
s
Z
a
Z
b
c
b
b
b
c
b
b
b
c
b
a
a
b
c
Z
Z
"}
(20,1,1) = {"
Z
Z
Z
Z
Z
b
b
b
b
b
b
b
b
b
b
b
b
b
b
b
b
b
Z
"}
(21,1,1) = {"
Z
Z
Z
Z
s
c
b
b
b
a
b
b
b
a
b
b
b
c
c
b
b
b
a
"}
(22,1,1) = {"
Z
Z
Z
Z
Z
Z
b
b
b
b
b
c
b
b
b
b
b
b
b
b
b
b
a
"}
(23,1,1) = {"
a
a
Z
Z
Z
Z
Z
a
a
a
a
a
a
a
a
a
Z
Z
Z
b
a
a
a
"}
