//MAP CONVERTED BY dmm2tgm.py THIS HEADER COMMENT PREVENTS RECONVERSION, DO NOT REMOVE
"a" = (
/turf/template_noop,
/area/template_noop)
"f" = (
/obj/structure/closet/crate/grave,
/turf/open/floor/plating/asteroid,
/area/rockplanet/surface/outdoors)
"g" = (
/turf/open/floor/pod/dark,
/area/rockplanet/surface/outdoors)
"h" = (
/obj/effect/decal/cleanable/blood/old,
/turf/open/floor/plating/asteroid,
/area/rockplanet/surface/outdoors)
"j" = (
/obj/structure/table/reinforced,
/obj/item/gun/energy/plasmacutter/adv,
/turf/open/floor/pod/dark,
/area/rockplanet/surface/outdoors)
"l" = (
/obj/machinery/stasis/survival_pod,
/obj/effect/decal/cleanable/cobweb,
/turf/open/floor/pod/dark,
/area/rockplanet/surface/outdoors)
"m" = (
/obj/structure/ore_box,
/turf/open/floor/plating/asteroid,
/area/rockplanet/surface/outdoors)
"n" = (
/obj/structure/table/reinforced,
/obj/structure/closet/secure_closet/freezer/gulag_fridge,
/turf/open/floor/pod/dark,
/area/rockplanet/surface/outdoors)
"o" = (
/obj/machinery/smartfridge/survival_pod,
/turf/open/floor/pod/dark,
/area/rockplanet/surface/outdoors)
"r" = (
/obj/effect/decal/fakelattice,
/turf/open/floor/plating/asteroid,
/area/rockplanet/surface/outdoors)
"u" = (
/obj/structure/closet/secure_closet/miner/unlocked,
/turf/open/floor/pod/dark,
/area/rockplanet/surface/outdoors)
"v" = (
/obj/effect/decal/cleanable/blood/splatter,
/turf/open/floor/plating/asteroid,
/area/rockplanet/surface/outdoors)
"w" = (
/mob/living/simple_animal/hostile/asteroid/goliath/beast/ancient/crystal,
/turf/open/floor/pod/dark,
/area/rockplanet/surface/outdoors)
"x" = (
/obj/effect/decal/cleanable/blood/old,
/turf/open/floor/pod/dark,
/area/rockplanet/surface/outdoors)
"A" = (
/obj/effect/decal/remains/human,
/turf/open/floor/pod/dark,
/area/rockplanet/surface/outdoors)
"C" = (
/obj/effect/decal/fakelattice,
/obj/effect/decal/cleanable/dirt,
/obj/structure/closet/emcloset/anchored,
/turf/open/floor/plating/asteroid,
/area/rockplanet/surface/outdoors)
"I" = (
/obj/effect/decal/cleanable/dirt,
/obj/effect/decal/cleanable/blood/splatter,
/turf/open/floor/pod/dark,
/area/rockplanet/surface/outdoors)
"J" = (
/obj/effect/decal/cleanable/oil/slippery,
/turf/open/floor/plating/asteroid,
/area/rockplanet/surface/outdoors)
"M" = (
/obj/effect/decal/cleanable/dirt,
/turf/open/floor/pod/dark,
/area/rockplanet/surface/outdoors)
"Q" = (
/turf/closed/wall/mineral/titanium/survival/pod,
/area/rockplanet/surface/outdoors)
"T" = (
/obj/structure/closet/crate/miningcar,
/turf/open/floor/plating/asteroid,
/area/rockplanet/surface/outdoors)
"X" = (
/obj/structure/table/reinforced,
/obj/machinery/microwave,
/turf/open/floor/pod/dark,
/area/rockplanet/surface/outdoors)
"Z" = (
/obj/structure/table/reinforced,
/obj/item/t_scanner/adv_mining_scanner,
/obj/effect/decal/cleanable/dirt,
/obj/effect/decal/cleanable/cobweb/cobweb2,
/turf/open/floor/pod/dark,
/area/rockplanet/surface/outdoors)

(1,1,1) = {"
Q
Q
Q
Q
Q
Q
Q
a
"}
(2,1,1) = {"
Q
l
I
u
n
X
Q
f
"}
(3,1,1) = {"
Q
o
g
x
M
g
r
a
"}
(4,1,1) = {"
Q
Q
A
M
g
g
r
a
"}
(5,1,1) = {"
Q
j
g
M
w
r
Q
a
"}
(6,1,1) = {"
Q
Z
x
M
r
a
h
a
"}
(7,1,1) = {"
Q
Q
Q
Q
C
a
a
m
"}
(8,1,1) = {"
a
T
J
a
a
v
a
a
"}
