//MAP CONVERTED BY dmm2tgm.py THIS HEADER COMMENT PREVENTS RECONVERSION, DO NOT REMOVE
"aj" = (
/obj/structure/table,
/obj/item/mmi/syndie,
/obj/item/mmi/syndie,
/obj/item/mmi/syndie,
/turf/open/floor/plasteel/mono/dark,
/area/ruin/unpowered)
"aq" = (
/turf/open/floor/plasteel/white,
/area/ruin/unpowered)
"aH" = (
/obj/structure/table,
/obj/item/retractor,
/turf/open/floor/plasteel/mono/dark,
/area/ruin/unpowered)
"aI" = (
/obj/effect/spawner/structure/window/reinforced,
/obj/machinery/door/poddoor/shutters,
/turf/open/floor/plating,
/area/ruin/unpowered)
"aO" = (
/obj/machinery/door/airlock/maintenance_hatch,
/obj/structure/disposalpipe/segment{
	dir = 4
	},
/obj/structure/disposalpipe/broken{
	dir = 4
	},
/turf/open/floor/plating,
/area/ruin/unpowered)
"bN" = (
/obj/structure/table_frame,
/turf/open/floor/plasteel,
/area/ruin/unpowered)
"cp" = (
/obj/structure/disposalpipe/segment{
	dir = 10
	},
/turf/open/floor/plasteel/white,
/area/ruin/unpowered)
"cB" = (
/turf/open/floor/plasteel/mono/dark,
/area/ruin/unpowered)
"et" = (
/obj/effect/spawner/structure/window/reinforced,
/obj/machinery/door/poddoor,
/obj/structure/disposalpipe/broken{
	dir = 1
	},
/turf/open/floor/engine,
/area/ruin/unpowered)
"fp" = (
/obj/structure/table,
/obj/machinery/button/door{
	pixel_x = 6;
	pixel_y = 24
	},
/turf/open/floor/plasteel/white,
/area/ruin/unpowered)
"fB" = (
/obj/structure/frame/machine{
	anchored = 1
	},
/turf/open/floor/plating{
	icon_state = "platingdmg1"
	},
/area/ruin/unpowered)
"fV" = (
/obj/machinery/button/door{
	pixel_x = 6;
	pixel_y = 24
	},
/obj/structure/disposalpipe/segment{
	dir = 4
	},
/turf/open/floor/plasteel,
/area/ruin/unpowered)
"ha" = (
/obj/structure/table_frame,
/turf/open/floor/plating{
	icon_state = "platingdmg1"
	},
/area/ruin/unpowered)
"hK" = (
/obj/effect/spawner/structure/window/reinforced,
/obj/machinery/door/poddoor,
/turf/open/floor/engine,
/area/ruin/unpowered)
"hN" = (
/obj/machinery/door/airlock/security,
/turf/open/floor/plasteel/white,
/area/ruin/unpowered)
"hS" = (
/turf/open/floor/plating{
	icon_state = "platingdmg1"
	},
/area/ruin/unpowered)
"iE" = (
/obj/effect/turf_decal/industrial/outline/yellow,
/turf/open/floor/plasteel,
/area/ruin/unpowered)
"jk" = (
/obj/effect/turf_decal/industrial/warning,
/obj/machinery/aug_manipulator,
/obj/machinery/light{
	dir = 4
	},
/turf/open/floor/plasteel/white,
/area/ruin/unpowered)
"ks" = (
/obj/machinery/computer/rdconsole/core,
/turf/open/floor/plasteel/white,
/area/ruin/unpowered)
"kz" = (
/obj/effect/spawner/structure/window/reinforced,
/obj/machinery/door/poddoor/shutters,
/turf/open/space/basic,
/area/ruin/unpowered)
"lE" = (
/obj/machinery/atmospherics/components/unary/vent_pump/on{
	dir = 4
	},
/turf/open/floor/circuit/red/telecomms,
/area/ruin/unpowered)
"nm" = (
/obj/structure/flora/rock/pile,
/turf/open/floor/plating/asteroid,
/area/rockplanet/surface/outdoors)
"nS" = (
/obj/effect/turf_decal/industrial/warning,
/turf/open/floor/plating,
/area/ruin/unpowered)
"oh" = (
/obj/effect/turf_decal/industrial/warning{
	dir = 1
	},
/turf/open/floor/plasteel/white,
/area/ruin/unpowered)
"oo" = (
/turf/open/floor/plating{
	icon_state = "platingdmg3"
	},
/area/ruin/unpowered)
"oJ" = (
/obj/machinery/computer/operating{
	dir = 1
	},
/obj/effect/turf_decal/borderfloor,
/turf/open/floor/plasteel/mono/dark,
/area/ruin/unpowered)
"oM" = (
/obj/structure/table/optable,
/obj/effect/turf_decal/borderfloor,
/turf/open/floor/plasteel/mono/dark,
/area/ruin/unpowered)
"oY" = (
/obj/effect/spawner/structure/window,
/obj/machinery/door/poddoor/shutters,
/turf/open/floor/plating,
/area/ruin/unpowered)
"pz" = (
/obj/effect/turf_decal/trimline/red/filled/line{
	dir = 1
	},
/turf/open/floor/plasteel,
/area/ruin/unpowered)
"pO" = (
/obj/structure/filingcabinet/chestdrawer,
/turf/open/floor/plasteel/white,
/area/ruin/unpowered)
"ra" = (
/turf/open/floor/plating/asteroid,
/area/rockplanet/surface/outdoors)
"rm" = (
/obj/structure/table,
/obj/item/circular_saw,
/obj/item/scalpel{
	pixel_y = 12
	},
/turf/open/floor/plasteel/mono/dark,
/area/ruin/unpowered)
"rr" = (
/obj/machinery/door/airlock/research,
/turf/open/floor/plasteel/white,
/area/ruin/unpowered)
"rB" = (
/obj/structure/door_assembly/door_assembly_com,
/turf/open/floor/plasteel/dark,
/area/ruin/unpowered)
"rQ" = (
/obj/machinery/computer/mech_bay_power_console{
	dir = 4
	},
/turf/open/floor/plasteel,
/area/ruin/unpowered)
"rW" = (
/obj/item/organ/body_egg/alien_embryo,
/turf/open/floor/engine,
/area/ruin/unpowered)
"sp" = (
/obj/machinery/door/poddoor/shutters,
/obj/effect/spawner/structure/window/reinforced,
/turf/open/floor/plating,
/area/ruin/unpowered)
"sO" = (
/obj/effect/turf_decal/industrial/warning{
	dir = 1
	},
/obj/machinery/light/broken,
/turf/open/floor/plasteel/white,
/area/ruin/unpowered)
"sR" = (
/obj/machinery/light,
/obj/structure/table,
/obj/item/storage/toolbox/mechanical,
/obj/item/crowbar,
/turf/open/floor/plasteel,
/area/ruin/unpowered)
"tc" = (
/obj/item/circuitboard/machine/rdserver,
/turf/open/floor/plasteel/dark,
/area/ruin/unpowered)
"tF" = (
/obj/effect/turf_decal/industrial/warning/corner,
/turf/open/floor/plating{
	icon_state = "panelscorched"
	},
/area/ruin/unpowered)
"tW" = (
/turf/open/floor/plating{
	icon_state = "panelscorched"
	},
/area/ruin/unpowered)
"uD" = (
/obj/effect/turf_decal/industrial/warning/corner{
	dir = 4
	},
/turf/open/floor/plasteel/white,
/area/ruin/unpowered)
"uE" = (
/obj/effect/turf_decal/trimline/red/filled/line{
	dir = 1
	},
/obj/structure/table_frame,
/turf/open/floor/plasteel,
/area/ruin/unpowered)
"uQ" = (
/obj/effect/turf_decal/industrial/warning,
/turf/open/floor/plasteel/white,
/area/ruin/unpowered)
"vc" = (
/obj/structure/table,
/obj/item/clothing/gloves/color/latex,
/obj/item/razor,
/turf/open/floor/plasteel/mono/dark,
/area/ruin/unpowered)
"wF" = (
/obj/effect/turf_decal/rechargefloor,
/turf/open/floor/plasteel,
/area/ruin/unpowered)
"xq" = (
/obj/structure/window/reinforced/spawner/west,
/obj/machinery/disposal/bin,
/obj/structure/disposalpipe/trunk{
	dir = 4
	},
/turf/open/floor/plasteel/white,
/area/ruin/unpowered)
"yH" = (
/obj/machinery/atmospherics/components/unary/vent_pump/siphon/on{
	dir = 4
	},
/turf/open/floor/circuit/red/telecomms,
/area/ruin/unpowered)
"zv" = (
/obj/structure/table_frame,
/turf/open/floor/plating,
/area/ruin/unpowered)
"zz" = (
/obj/effect/turf_decal/trimline/red/filled/line{
	dir = 1
	},
/obj/machinery/button/door{
	pixel_x = 6;
	pixel_y = 24
	},
/obj/machinery/light_switch{
	pixel_x = -7;
	pixel_y = 25
	},
/turf/open/floor/plasteel,
/area/ruin/unpowered)
"Ap" = (
/obj/structure/disposalpipe/segment{
	dir = 4
	},
/turf/open/floor/plasteel,
/area/ruin/unpowered)
"AX" = (
/obj/machinery/door/poddoor/shutters,
/turf/open/space/basic,
/area/ruin/unpowered)
"Cq" = (
/turf/template_noop,
/area/template_noop)
"Cu" = (
/turf/open/floor/plating,
/area/ruin/unpowered)
"CR" = (
/obj/machinery/door/poddoor,
/turf/open/floor/engine,
/area/ruin/unpowered)
"DJ" = (
/obj/structure/girder/reinforced,
/turf/open/floor/plating,
/area/ruin/unpowered)
"DV" = (
/obj/item/kirbyplants/random,
/obj/effect/turf_decal/borderfloor,
/turf/open/floor/plasteel/mono/dark,
/area/ruin/unpowered)
"Fk" = (
/obj/effect/mine/shrapnel,
/turf/open/floor/plating/asteroid,
/area/rockplanet/surface/outdoors)
"FH" = (
/obj/effect/turf_decal/trimline/red/filled/line{
	dir = 9
	},
/obj/structure/reagent_dispensers/peppertank{
	pixel_x = -32
	},
/obj/structure/closet/secure_closet/security/science,
/turf/open/floor/plasteel,
/area/ruin/unpowered)
"Gb" = (
/obj/effect/turf_decal/borderfloor,
/turf/open/floor/plasteel/mono/dark,
/area/ruin/unpowered)
"Gk" = (
/obj/machinery/door/airlock/research,
/obj/machinery/door/poddoor/shutters,
/turf/open/floor/plasteel/white,
/area/ruin/unpowered)
"Hp" = (
/obj/effect/turf_decal/industrial/warning{
	dir = 1
	},
/obj/structure/frame/machine{
	anchored = 1
	},
/turf/open/floor/plasteel/white,
/area/ruin/unpowered)
"HD" = (
/obj/structure/table,
/obj/item/storage/box/bodybags,
/obj/item/pen,
/turf/open/floor/plasteel/mono/dark,
/area/ruin/unpowered)
"JY" = (
/obj/structure/table/reinforced,
/obj/machinery/door/poddoor/shutters,
/turf/open/floor/plating,
/area/ruin/unpowered)
"Kj" = (
/obj/effect/turf_decal/industrial/warning{
	dir = 4
	},
/turf/open/floor/plasteel/white,
/area/ruin/unpowered)
"KZ" = (
/obj/machinery/door/airlock/research,
/turf/open/floor/plasteel,
/area/ruin/unpowered)
"Lt" = (
/obj/structure/girder/reinforced,
/turf/open/floor/plating{
	icon_state = "panelscorched"
	},
/area/ruin/unpowered)
"LN" = (
/obj/machinery/light/small{
	brightness = 3;
	dir = 8
	},
/turf/open/floor/plasteel/dark,
/area/ruin/unpowered)
"LZ" = (
/obj/effect/turf_decal/industrial/warning{
	dir = 4
	},
/obj/machinery/conveyor_switch/oneway,
/turf/open/floor/plasteel/white,
/area/ruin/unpowered)
"My" = (
/obj/structure/table,
/turf/open/floor/plasteel,
/area/ruin/unpowered)
"MQ" = (
/turf/open/floor/engine,
/area/ruin/unpowered)
"Nf" = (
/turf/open/floor/circuit/red/telecomms,
/area/ruin/unpowered)
"NP" = (
/turf/open/floor/plating/asteroid,
/area/ruin/unpowered)
"Od" = (
/obj/structure/table,
/obj/item/hemostat,
/obj/item/cautery{
	pixel_x = 4
	},
/turf/open/floor/plasteel/mono/dark,
/area/ruin/unpowered)
"Ol" = (
/obj/machinery/mech_bay_recharge_port{
	dir = 2
	},
/turf/open/floor/plasteel,
/area/ruin/unpowered)
"Ox" = (
/obj/structure/disposalpipe/trunk,
/obj/structure/disposaloutlet{
	dir = 1
	},
/turf/open/floor/engine,
/area/ruin/unpowered)
"ON" = (
/obj/structure/frame/machine{
	anchored = 1
	},
/turf/open/floor/plasteel,
/area/ruin/unpowered)
"Pn" = (
/obj/structure/disposalpipe/segment,
/turf/open/floor/plasteel/white,
/area/ruin/unpowered)
"Qi" = (
/obj/machinery/door/airlock/research,
/obj/structure/disposalpipe/segment{
	dir = 4
	},
/turf/open/floor/plasteel,
/area/ruin/unpowered)
"QP" = (
/obj/machinery/computer/mech_bay_power_console{
	dir = 8
	},
/turf/open/floor/plasteel,
/area/ruin/unpowered)
"Rg" = (
/obj/structure/bodycontainer/morgue,
/obj/effect/turf_decal/borderfloor,
/turf/open/floor/plasteel/mono/dark,
/area/ruin/unpowered)
"RV" = (
/obj/machinery/conveyor{
	dir = 4
	},
/turf/open/floor/plasteel,
/area/ruin/unpowered)
"Tl" = (
/obj/structure/window/reinforced/spawner/west,
/turf/open/floor/plasteel/white,
/area/ruin/unpowered)
"Ts" = (
/turf/closed/wall/r_wall/syndicate,
/area/ruin/unpowered)
"TF" = (
/obj/structure/door_assembly/door_assembly_com,
/turf/open/floor/plating,
/area/ruin/unpowered)
"UH" = (
/obj/effect/spawner/structure/window/reinforced,
/obj/machinery/atmospherics/pipe/simple/general/hidden{
	dir = 8
	},
/turf/open/floor/plating,
/area/ruin/unpowered)
"Vx" = (
/obj/effect/turf_decal/trimline/red/filled/line{
	dir = 8
	},
/obj/machinery/light/built{
	dir = 8
	},
/turf/open/floor/plasteel,
/area/ruin/unpowered)
"VO" = (
/obj/machinery/rnd/production/circuit_imprinter,
/turf/open/floor/plasteel/white,
/area/ruin/unpowered)
"VR" = (
/obj/structure/disposalpipe/broken{
	dir = 1
	},
/turf/open/floor/plasteel/white,
/area/ruin/unpowered)
"WJ" = (
/obj/machinery/light/small/broken{
	dir = 4
	},
/turf/open/floor/plating,
/area/ruin/unpowered)
"WO" = (
/obj/machinery/recharge_station,
/turf/open/floor/plasteel,
/area/ruin/unpowered)
"XI" = (
/obj/structure/disposalpipe/segment{
	dir = 9
	},
/turf/open/floor/plasteel/white,
/area/ruin/unpowered)
"Yd" = (
/turf/open/floor/plasteel,
/area/ruin/unpowered)
"Yj" = (
/obj/machinery/door/window/eastright{
	dir = 8
	},
/turf/open/floor/plasteel/white,
/area/ruin/unpowered)
"YE" = (
/turf/open/floor/plasteel/mono,
/area/ruin/unpowered)
"YK" = (
/obj/structure/disposalpipe/broken,
/obj/machinery/light_switch{
	pixel_x = -24;
	pixel_y = 8
	},
/turf/open/floor/plating{
	icon_state = "platingdmg3"
	},
/area/ruin/unpowered)

(1,1,1) = {"
Ts
aO
Ts
Ts
Ts
Ts
Ts
Ts
Ts
Ts
Ts
Cq
Cq
Cq
Cq
Cq
Cq
Ts
Ts
Ts
Ts
Ts
Cq
"}
(2,1,1) = {"
Ts
fV
Ol
wF
rQ
WO
Ts
vc
HD
Rg
Ts
Ts
Gk
Ts
Ts
Ts
Ts
Ts
MQ
MQ
MQ
Ts
ra
"}
(3,1,1) = {"
AX
Ap
Nf
Nf
Nf
Yd
Ts
Od
cB
Gb
Ts
aq
aq
Ts
fB
LN
fB
Ts
MQ
MQ
MQ
Ts
hK
"}
(4,1,1) = {"
AX
Ap
Yd
Nf
Yd
sR
Ts
rm
cB
oM
Ts
aq
aq
Ts
lE
tc
yH
Ts
MQ
MQ
MQ
MQ
hK
"}
(5,1,1) = {"
AX
Ap
Nf
Nf
Nf
Yd
Ts
aH
cB
oJ
Ts
aq
aq
Ts
UH
rB
UH
Ts
MQ
MQ
MQ
MQ
CR
"}
(6,1,1) = {"
KZ
Ap
Ol
wF
QP
WO
Ts
aj
cB
DV
Ts
aq
aq
TF
hS
Cu
hS
Ts
MQ
MQ
MQ
Ox
et
"}
(7,1,1) = {"
Ts
Qi
kz
kz
kz
Ts
Ts
xq
Yj
Tl
Ts
aq
aq
Ts
hS
NP
Cu
Ts
MQ
MQ
MQ
Ts
hK
"}
(8,1,1) = {"
Ts
cp
Pn
Pn
VR
YK
Pn
XI
aq
aq
Ts
aq
aq
Ts
fB
WJ
ha
Ts
MQ
rW
MQ
Ts
ra
"}
(9,1,1) = {"
Ts
VO
aq
tF
Kj
Kj
Kj
LZ
Kj
uD
Ts
aq
aq
Ts
Ts
Ts
Ts
Ts
Ts
DJ
Lt
Ts
Cq
"}
(10,1,1) = {"
Ts
ks
aq
uQ
hS
tW
hS
ON
RV
sO
Ts
aq
aq
Ts
FH
Vx
Cu
ra
Cq
Cq
Cq
Cq
Cq
"}
(11,1,1) = {"
Ts
Ts
fp
uQ
Yd
NP
hS
bN
RV
oh
Ts
aq
aq
Ts
zz
YE
tW
Fk
ra
Cq
Cq
Cq
Cq
"}
(12,1,1) = {"
ra
sp
oo
uQ
tW
iE
Yd
bN
iE
oh
oY
aq
Cu
hN
pz
Cu
Cu
ra
ra
ra
ra
Cq
Cq
"}
(13,1,1) = {"
ra
JY
aq
nS
Yd
Cu
Yd
tW
Cu
oh
rr
aq
aq
aI
uE
YE
tW
ra
ra
ra
Fk
Cq
Cq
"}
(14,1,1) = {"
ra
sp
pO
jk
bN
bN
bN
My
Yd
Hp
oY
Cu
aq
aI
zv
tW
tW
nm
Cq
Cq
Cq
Cq
Cq
"}
(15,1,1) = {"
ra
Ts
Ts
Ts
Ts
Ts
Ts
oY
JY
Ts
Ts
aq
Cu
aI
aI
aI
aI
Cq
Cq
Cq
Cq
Cq
Cq
"}
