//MAP CONVERTED BY dmm2tgm.py THIS HEADER COMMENT PREVENTS RECONVERSION, DO NOT REMOVE
"an" = (
/obj/effect/turf_decal/corner/neutral/diagonal,
/obj/effect/turf_decal/corner/blue/diagonal{
	dir = 4
	},
/turf/open/floor/plasteel/dark,
/area/ruin/powered)
"av" = (
/obj/effect/turf_decal/corner/purple/border{
	dir = 9
	},
/turf/open/floor/plasteel/white,
/area/ruin/powered)
"bz" = (
/turf/open/floor/plating/rust,
/area/ruin/powered)
"bG" = (
/obj/effect/turf_decal/corner/purple/border{
	dir = 1
	},
/obj/structure/sign/poster/official/random{
	pixel_y = 32
	},
/turf/open/floor/plasteel/white,
/area/ruin/powered)
"bK" = (
/turf/open/floor/plating,
/area/ruin/powered)
"bM" = (
/obj/effect/turf_decal/corner/purple/border{
	dir = 1
	},
/turf/open/floor/plasteel/white,
/area/ruin/powered)
"bN" = (
/obj/structure/closet/cardboard,
/obj/structure/fluff/paper/stack{
	dir = 8
	},
/obj/item/paper,
/obj/item/paper,
/obj/item/paper,
/obj/effect/decal/cleanable/dirt,
/turf/open/floor/plasteel/dark,
/area/ruin/powered)
"cr" = (
/obj/effect/gibspawner,
/obj/effect/decal/cleanable/dirt,
/turf/open/floor/plating/rust,
/area/ruin/powered)
"cz" = (
/obj/effect/decal/cleanable/dirt,
/turf/open/floor/plating/rust,
/area/ruin/powered)
"cH" = (
/obj/effect/turf_decal/corner/purple/border{
	dir = 5
	},
/turf/open/floor/plasteel/white,
/area/ruin/powered)
"dz" = (
/obj/effect/decal/cleanable/dirt,
/turf/open/floor/plasteel,
/area/ruin/powered)
"dD" = (
/obj/machinery/porta_turret/syndicate/energy,
/turf/open/floor/plasteel/dark,
/area/ruin/powered)
"dU" = (
/obj/structure/displaycase,
/obj/item/ammo_box/magazine/smgm45,
/turf/open/floor/plasteel,
/area/ruin/powered)
"ei" = (
/obj/structure/displaycase,
/obj/item/ammo_box/magazine/ebr,
/turf/open/floor/plating/rust,
/area/ruin/powered)
"eV" = (
/obj/structure/closet/cardboard,
/obj/item/paper,
/turf/open/floor/plasteel/dark,
/area/ruin/powered)
"fh" = (
/obj/structure/rack,
/obj/item/stock_parts/cell/gun/empty,
/obj/effect/turf_decal/industrial/outline/yellow,
/obj/structure/sign/poster/official/random{
	pixel_y = 32
	},
/obj/effect/decal/cleanable/dirt,
/turf/open/floor/plasteel,
/area/ruin/powered)
"fo" = (
/obj/machinery/vending/mining_equipment,
/turf/open/floor/plasteel,
/area/ruin/powered)
"fq" = (
/obj/structure/table,
/obj/item/ammo_box/n762,
/turf/open/floor/plasteel/mono/white,
/area/ruin/powered)
"ft" = (
/obj/machinery/door/airlock/public/glass,
/turf/open/floor/plating,
/area/ruin/powered)
"fT" = (
/obj/machinery/porta_turret/syndicate/energy,
/obj/effect/decal/cleanable/dirt,
/turf/open/floor/plasteel/dark,
/area/ruin/powered)
"gw" = (
/obj/structure/table,
/obj/item/ammo_box/c45,
/obj/effect/decal/cleanable/dirt,
/turf/open/floor/plasteel/mono/white,
/area/ruin/powered)
"gx" = (
/obj/structure/table,
/obj/item/ammo_box/c9mm/rubbershot,
/turf/open/floor/plasteel/mono/white,
/area/ruin/powered)
"gM" = (
/obj/effect/decal/cleanable/dirt,
/turf/open/floor/plasteel/white,
/area/ruin/powered)
"gX" = (
/obj/structure/barricade/sandbags,
/obj/effect/turf_decal/industrial/warning{
	dir = 9
	},
/obj/structure/railing{
	dir = 1
	},
/turf/open/floor/plasteel/mono/white,
/area/ruin/powered)
"hv" = (
/obj/structure/table,
/obj/effect/decal/cleanable/dirt,
/turf/open/floor/plating/rust,
/area/ruin/powered)
"hM" = (
/obj/machinery/door/airlock/public/glass,
/turf/open/floor/plasteel/mono,
/area/ruin/powered)
"hQ" = (
/obj/structure/sign/poster/official/random{
	pixel_y = 32
	},
/obj/structure/rack,
/obj/item/stock_parts/cell/gun/empty,
/obj/effect/turf_decal/industrial/outline/yellow,
/obj/effect/decal/cleanable/dirt,
/turf/open/floor/plasteel,
/area/ruin/powered)
"iw" = (
/obj/machinery/porta_turret/syndicate/energy,
/turf/open/floor/plating/rust,
/area/ruin/powered)
"iY" = (
/obj/structure/table,
/obj/effect/turf_decal/corner/green,
/obj/effect/turf_decal/corner/green{
	dir = 8
	},
/obj/effect/decal/cleanable/dirt,
/turf/open/floor/plasteel,
/area/ruin/powered)
"jn" = (
/obj/effect/turf_decal/industrial/warning{
	dir = 1
	},
/obj/structure/railing{
	dir = 1
	},
/turf/open/floor/plasteel/mono/white,
/area/ruin/powered)
"jo" = (
/obj/structure/railing{
	dir = 1
	},
/turf/open/floor/plating/rust,
/area/ruin/powered)
"jE" = (
/obj/effect/turf_decal/corner/green,
/obj/effect/turf_decal/corner/green{
	dir = 8
	},
/turf/open/floor/plasteel,
/area/ruin/powered)
"jF" = (
/obj/structure/table/wood/reinforced,
/obj/item/storage/firstaid/medical,
/obj/item/storage/firstaid/fire{
	pixel_y = 8
	},
/obj/effect/turf_decal/corner/neutral/diagonal,
/obj/effect/turf_decal/corner/blue/diagonal{
	dir = 4
	},
/obj/structure/sign/poster/official/random{
	pixel_y = -32
	},
/obj/effect/decal/cleanable/dirt,
/turf/open/floor/plasteel/dark,
/area/ruin/powered)
"kb" = (
/obj/item/target,
/obj/effect/turf_decal/industrial/warning{
	dir = 5
	},
/obj/structure/railing{
	dir = 1
	},
/turf/open/floor/plasteel/mono/white,
/area/ruin/powered)
"kj" = (
/obj/effect/turf_decal/corner/purple/border{
	dir = 4
	},
/turf/open/floor/plasteel/white,
/area/ruin/powered)
"kR" = (
/obj/structure/closet/cardboard,
/obj/structure/fluff/paper/stack{
	dir = 9
	},
/obj/item/paper,
/turf/open/floor/plasteel/dark,
/area/ruin/powered)
"lC" = (
/obj/structure/closet/cardboard,
/obj/item/paper,
/obj/effect/decal/cleanable/dirt,
/turf/open/floor/plasteel/dark,
/area/ruin/powered)
"mo" = (
/obj/structure/closet/cardboard,
/obj/structure/fluff/paper/stack{
	dir = 9
	},
/obj/effect/decal/cleanable/dirt,
/turf/open/floor/plasteel/dark,
/area/ruin/powered)
"mU" = (
/obj/effect/turf_decal/corner/green{
	dir = 1
	},
/turf/open/floor/plasteel,
/area/ruin/powered)
"nn" = (
/obj/structure/closet/cardboard,
/obj/structure/fluff/paper/stack{
	dir = 8
	},
/turf/open/floor/plasteel/dark,
/area/ruin/powered)
"nS" = (
/obj/machinery/door/airlock/public/glass,
/turf/open/floor/plating/rust,
/area/ruin/powered)
"nT" = (
/obj/structure/chair{
	dir = 1
	},
/turf/open/floor/plating/rust,
/area/ruin/powered)
"oe" = (
/obj/structure/table/wood/reinforced,
/obj/effect/turf_decal/corner/neutral/diagonal,
/obj/item/modular_computer/laptop/preset,
/turf/open/floor/plasteel/dark,
/area/ruin/powered)
"ov" = (
/obj/effect/turf_decal/corner/neutral/diagonal,
/obj/machinery/autolathe/hacked,
/obj/structure/sign/poster/official/random{
	pixel_y = 32
	},
/turf/open/floor/plasteel/dark,
/area/ruin/powered)
"pl" = (
/obj/structure/closet/cardboard,
/obj/effect/decal/cleanable/dirt,
/turf/open/floor/plasteel/dark,
/area/ruin/powered)
"px" = (
/turf/open/floor/plasteel,
/area/ruin/powered)
"qg" = (
/obj/effect/turf_decal/corner/neutral/diagonal,
/obj/machinery/plate_press,
/turf/open/floor/plasteel/dark,
/area/ruin/powered)
"qn" = (
/obj/structure/barricade/sandbags,
/obj/effect/turf_decal/industrial/warning{
	dir = 10
	},
/obj/structure/railing,
/obj/effect/decal/cleanable/dirt,
/turf/open/floor/plasteel/mono/white,
/area/ruin/powered)
"qQ" = (
/obj/effect/turf_decal/corner/green{
	dir = 4
	},
/obj/effect/turf_decal/corner/green{
	dir = 1
	},
/obj/effect/decal/cleanable/dirt,
/turf/open/floor/plasteel,
/area/ruin/powered)
"qW" = (
/obj/structure/window/reinforced,
/obj/structure/table/wood/reinforced,
/obj/item/stack/sheet/animalhide/human,
/obj/item/stack/sheet/mineral/titanium/five,
/obj/effect/decal/cleanable/dirt,
/turf/open/floor/plating/rust,
/area/ruin/powered)
"ru" = (
/obj/structure/rack,
/obj/item/stock_parts/cell/gun/upgraded/empty,
/obj/effect/decal/cleanable/dirt,
/turf/open/floor/plating/rust,
/area/ruin/powered)
"rP" = (
/obj/structure/table/wood/reinforced,
/obj/item/stack/sheet/mineral/uranium/five,
/obj/effect/turf_decal/corner/neutral/diagonal,
/obj/structure/sign/poster/official/random{
	pixel_x = -32
	},
/turf/open/floor/plasteel/dark,
/area/ruin/powered)
"rT" = (
/obj/structure/table,
/obj/effect/turf_decal/corner/green{
	dir = 4
	},
/obj/effect/turf_decal/corner/green{
	dir = 1
	},
/turf/open/floor/plasteel,
/area/ruin/powered)
"rV" = (
/obj/effect/turf_decal/industrial/warning,
/obj/structure/railing,
/obj/effect/decal/cleanable/dirt,
/turf/open/floor/plasteel/mono/white,
/area/ruin/powered)
"sQ" = (
/obj/effect/turf_decal/industrial/warning,
/obj/structure/railing,
/turf/open/floor/plasteel/mono/white,
/area/ruin/powered)
"tm" = (
/obj/machinery/vending/cola/random,
/turf/open/floor/plating,
/area/ruin/powered)
"to" = (
/obj/item/target/clown,
/obj/structure/railing,
/turf/open/floor/plating/rust,
/area/ruin/powered)
"tp" = (
/obj/structure/closet/cardboard,
/obj/structure/fluff/paper/stack{
	dir = 8
	},
/obj/effect/decal/cleanable/dirt,
/turf/open/floor/plasteel/dark,
/area/ruin/powered)
"tr" = (
/obj/structure/closet/cardboard,
/obj/structure/fluff/paper/stack{
	dir = 9
	},
/obj/item/paper,
/obj/effect/decal/cleanable/dirt,
/turf/open/floor/plasteel/dark,
/area/ruin/powered)
"tD" = (
/turf/template_noop,
/area/template_noop)
"tW" = (
/obj/structure/closet/cardboard,
/obj/item/weaponcrafting/gunkit/capgun_ugrade_kit,
/obj/effect/decal/cleanable/dirt,
/turf/open/floor/plasteel/dark,
/area/ruin/powered)
"um" = (
/obj/structure/table,
/obj/effect/turf_decal/corner/green{
	dir = 4
	},
/obj/effect/turf_decal/corner/green{
	dir = 1
	},
/obj/item/desk_flag/solgov,
/turf/open/floor/plasteel,
/area/ruin/powered)
"uq" = (
/obj/structure/rack,
/obj/item/stock_parts/cell/gun/empty,
/obj/effect/decal/cleanable/dirt,
/turf/open/floor/plating/rust,
/area/ruin/powered)
"uB" = (
/obj/structure/table/wood/reinforced,
/obj/item/pen/blue,
/obj/item/pen{
	pixel_x = 7;
	pixel_y = 3
	},
/turf/open/floor/plating/rust,
/area/ruin/powered)
"uL" = (
/obj/machinery/stasis,
/turf/open/floor/plating/rust,
/area/ruin/powered)
"uV" = (
/obj/structure/chair/office{
	dir = 8
	},
/turf/open/floor/plating/rust,
/area/ruin/powered)
"uW" = (
/obj/structure/closet/cardboard,
/obj/item/desk_flag/trans,
/obj/effect/decal/cleanable/dirt,
/turf/open/floor/plasteel/dark,
/area/ruin/powered)
"vq" = (
/obj/effect/turf_decal/corner/neutral/diagonal,
/turf/open/floor/plasteel/dark,
/area/ruin/powered)
"vY" = (
/obj/effect/turf_decal/corner/purple/border{
	dir = 8
	},
/turf/open/floor/plasteel/white,
/area/ruin/powered)
"wn" = (
/obj/structure/displaycase,
/obj/item/ammo_box/magazine/co9mm,
/turf/open/floor/plasteel,
/area/ruin/powered)
"wp" = (
/obj/structure/displaycase,
/obj/item/gun/energy/laser/captain/brazil,
/turf/open/floor/plasteel/mono/white,
/area/ruin/powered)
"wD" = (
/turf/open/floor/plasteel/white,
/area/ruin/powered)
"wH" = (
/obj/structure/rack,
/obj/item/stock_parts/cell/gun/empty,
/obj/effect/turf_decal/industrial/outline/yellow,
/obj/effect/decal/cleanable/dirt,
/turf/open/floor/plasteel,
/area/ruin/powered)
"wT" = (
/obj/structure/closet/cardboard,
/obj/structure/fluff/paper/stack{
	dir = 5
	},
/obj/effect/decal/cleanable/dirt,
/turf/open/floor/plasteel/dark,
/area/ruin/powered)
"yh" = (
/obj/structure/closet/cardboard,
/obj/structure/fluff/paper/stack{
	dir = 9
	},
/obj/item/paper,
/obj/item/paper,
/obj/item/paper,
/obj/effect/decal/cleanable/dirt,
/turf/open/floor/plasteel/dark,
/area/ruin/powered)
"yz" = (
/obj/structure/chair{
	dir = 1
	},
/obj/effect/decal/cleanable/dirt,
/turf/open/floor/plating,
/area/ruin/powered)
"yP" = (
/obj/structure/fluff/paper/stack{
	dir = 9
	},
/turf/open/floor/plasteel/dark,
/area/ruin/powered)
"yY" = (
/obj/structure/closet/cardboard,
/obj/structure/fluff/paper/stack{
	dir = 9
	},
/obj/item/paper,
/obj/item/ammo_box/magazine/m45,
/turf/open/floor/plasteel/dark,
/area/ruin/powered)
"zt" = (
/obj/machinery/door/window/westleft{
	dir = 1
	},
/obj/effect/turf_decal/corner/green{
	dir = 8
	},
/turf/open/floor/plasteel,
/area/ruin/powered)
"Ae" = (
/obj/structure/closet/cardboard,
/obj/structure/fluff/paper/stack{
	dir = 8
	},
/obj/item/paper,
/obj/effect/decal/cleanable/dirt,
/turf/open/floor/plasteel/dark,
/area/ruin/powered)
"AG" = (
/obj/structure/table/wood/reinforced,
/obj/item/documents/syndicate/blue,
/obj/effect/turf_decal/corner/neutral/diagonal,
/turf/open/floor/plasteel/dark,
/area/ruin/powered)
"AX" = (
/obj/structure/fluff/paper/stack{
	dir = 9
	},
/obj/item/paper,
/obj/structure/reagent_dispensers/fueltank,
/obj/effect/decal/cleanable/dirt,
/turf/open/floor/plasteel/dark,
/area/ruin/powered)
"Bf" = (
/obj/effect/turf_decal/corner/purple/border{
	dir = 10
	},
/turf/open/floor/plasteel/white,
/area/ruin/powered)
"Bv" = (
/obj/effect/turf_decal/corner/purple/border,
/turf/open/floor/plasteel/white,
/area/ruin/powered)
"BH" = (
/obj/structure/table,
/obj/effect/turf_decal/corner/green{
	dir = 4
	},
/obj/effect/turf_decal/corner/green{
	dir = 1
	},
/obj/item/clipboard,
/turf/open/floor/plasteel,
/area/ruin/powered)
"BJ" = (
/obj/structure/table,
/obj/effect/turf_decal/corner/green,
/obj/effect/turf_decal/corner/green{
	dir = 8
	},
/turf/open/floor/plasteel,
/area/ruin/powered)
"BK" = (
/obj/structure/displaycase,
/obj/item/ammo_box/magazine/mm712x82,
/turf/open/floor/plasteel,
/area/ruin/powered)
"Cc" = (
/obj/structure/chair{
	dir = 1
	},
/obj/effect/decal/cleanable/dirt,
/turf/open/floor/plasteel,
/area/ruin/powered)
"Cl" = (
/obj/effect/turf_decal/corner/purple/border,
/obj/effect/decal/cleanable/dirt,
/turf/open/floor/plasteel/white,
/area/ruin/powered)
"CK" = (
/obj/effect/turf_decal/corner/purple/border{
	dir = 6
	},
/turf/open/floor/plasteel/white,
/area/ruin/powered)
"CL" = (
/obj/structure/closet/firecloset,
/obj/effect/turf_decal/industrial/outline/yellow,
/turf/open/floor/plasteel,
/area/ruin/powered)
"DQ" = (
/turf/open/floor/plasteel/mono/dark,
/area/ruin/powered)
"DT" = (
/obj/structure/table,
/obj/item/flashlight/lamp,
/turf/open/floor/plating/rust,
/area/ruin/powered)
"Ea" = (
/obj/structure/closet/cardboard,
/obj/structure/fluff/paper/stack{
	dir = 9
	},
/turf/open/floor/plasteel/dark,
/area/ruin/powered)
"Ej" = (
/obj/structure/window/reinforced{
	dir = 1
	},
/obj/structure/window/reinforced{
	dir = 4
	},
/obj/effect/turf_decal/corner/neutral/diagonal,
/obj/effect/decal/cleanable/dirt,
/turf/open/floor/plasteel/dark,
/area/ruin/powered)
"EW" = (
/obj/structure/closet/cardboard,
/obj/structure/fluff/paper/stack{
	dir = 8
	},
/obj/item/paper,
/turf/open/floor/plasteel/dark,
/area/ruin/powered)
"Fb" = (
/obj/structure/window/reinforced{
	dir = 1
	},
/obj/structure/table/wood/reinforced,
/obj/machinery/computer/security/wooden_tv,
/obj/effect/turf_decal/corner/neutral/diagonal,
/obj/effect/decal/cleanable/dirt,
/turf/open/floor/plasteel/dark,
/area/ruin/powered)
"Fl" = (
/obj/structure/chair/office{
	dir = 8
	},
/obj/effect/turf_decal/corner/neutral/diagonal,
/obj/effect/turf_decal/corner/blue/diagonal{
	dir = 4
	},
/obj/effect/decal/cleanable/dirt,
/turf/open/floor/plasteel/dark,
/area/ruin/powered)
"Fx" = (
/obj/structure/table,
/obj/effect/decal/cleanable/dirt,
/obj/item/paper_bin,
/obj/item/pen,
/turf/open/floor/plating/rust,
/area/ruin/powered)
"FC" = (
/obj/structure/window/reinforced{
	dir = 1
	},
/turf/open/floor/plating/rust,
/area/ruin/powered)
"FE" = (
/obj/structure/table/wood/reinforced,
/obj/machinery/computer/crew{
	dir = 1
	},
/obj/effect/turf_decal/corner/neutral/diagonal,
/obj/effect/turf_decal/corner/blue/diagonal{
	dir = 4
	},
/obj/effect/decal/cleanable/dirt,
/turf/open/floor/plasteel/dark,
/area/ruin/powered)
"Ge" = (
/obj/structure/window/reinforced{
	dir = 1
	},
/obj/machinery/door/window/westleft{
	dir = 4
	},
/obj/effect/turf_decal/corner/neutral/diagonal,
/turf/open/floor/plasteel/dark,
/area/ruin/powered)
"Gj" = (
/obj/machinery/door/window/westleft{
	dir = 1
	},
/turf/open/floor/plasteel/dark,
/area/ruin/powered)
"GR" = (
/turf/closed/wall/rust,
/area/ruin/powered)
"GT" = (
/obj/structure/displaycase,
/obj/item/ammo_box/magazine/sniper_rounds,
/turf/open/floor/plasteel,
/area/ruin/powered)
"Hk" = (
/obj/effect/turf_decal/corner/neutral/diagonal,
/obj/effect/turf_decal/corner/blue/diagonal{
	dir = 4
	},
/obj/effect/decal/cleanable/dirt,
/turf/open/floor/plasteel/dark,
/area/ruin/powered)
"HL" = (
/obj/effect/spawner/structure/window,
/turf/open/floor/plating/rust,
/area/ruin/powered)
"Ie" = (
/obj/structure/door_assembly/door_assembly_research,
/turf/open/floor/plating/rust,
/area/ruin/powered)
"Ir" = (
/obj/machinery/door/airlock/security,
/turf/open/floor/plasteel/mono,
/area/ruin/powered)
"It" = (
/obj/structure/chair{
	dir = 1
	},
/turf/open/floor/plasteel,
/area/ruin/powered)
"IM" = (
/obj/structure/table/wood/reinforced,
/obj/item/storage/backpack/duffelbag/med/surgery,
/obj/effect/turf_decal/corner/neutral/diagonal,
/obj/effect/turf_decal/corner/blue/diagonal{
	dir = 4
	},
/obj/effect/decal/cleanable/dirt,
/turf/open/floor/plasteel/dark,
/area/ruin/powered)
"JS" = (
/obj/structure/closet/firecloset,
/obj/effect/decal/cleanable/dirt,
/turf/open/floor/plating,
/area/ruin/powered)
"Kt" = (
/obj/effect/decal/cleanable/dirt,
/turf/open/floor/plasteel/mono/dark,
/area/ruin/powered)
"KC" = (
/obj/structure/closet/cardboard,
/obj/structure/fluff/paper/stack,
/obj/item/paper,
/obj/item/gun/ballistic/automatic/pistol/commander/no_mag,
/obj/effect/decal/cleanable/dirt,
/turf/open/floor/plasteel/dark,
/area/ruin/powered)
"KH" = (
/obj/structure/closet/cardboard,
/obj/structure/fluff/paper/stack{
	dir = 5
	},
/turf/open/floor/plasteel/dark,
/area/ruin/powered)
"KV" = (
/obj/structure/table,
/turf/open/floor/plating/rust,
/area/ruin/powered)
"KW" = (
/obj/structure/closet/cardboard,
/obj/structure/fluff/paper/stack{
	dir = 8
	},
/obj/item/paper,
/obj/item/ammo_box/magazine/m10mm,
/obj/effect/decal/cleanable/dirt,
/turf/open/floor/plasteel/dark,
/area/ruin/powered)
"Ll" = (
/obj/structure/window/reinforced,
/obj/machinery/door/window/westleft{
	dir = 4
	},
/turf/open/floor/plating/rust,
/area/ruin/powered)
"Ma" = (
/obj/structure/table/wood/reinforced,
/obj/effect/turf_decal/corner/neutral/diagonal,
/obj/structure/sign/poster/official/random{
	pixel_x = -32
	},
/obj/effect/decal/cleanable/dirt,
/turf/open/floor/plasteel/dark,
/area/ruin/powered)
"Mq" = (
/obj/structure/chair/office{
	dir = 8
	},
/obj/effect/turf_decal/corner/neutral/diagonal,
/turf/open/floor/plasteel/dark,
/area/ruin/powered)
"Mt" = (
/obj/structure/window/reinforced{
	dir = 4
	},
/obj/effect/turf_decal/corner/neutral/diagonal,
/obj/effect/decal/cleanable/dirt,
/turf/open/floor/plasteel/dark,
/area/ruin/powered)
"MS" = (
/obj/effect/decal/cleanable/dirt,
/turf/open/floor/plasteel/dark,
/area/ruin/powered)
"MZ" = (
/obj/effect/turf_decal/corner/green,
/obj/effect/turf_decal/corner/green{
	dir = 8
	},
/obj/effect/decal/cleanable/dirt,
/turf/open/floor/plasteel,
/area/ruin/powered)
"Nq" = (
/obj/effect/decal/cleanable/dirt,
/turf/open/floor/plating,
/area/ruin/powered)
"QL" = (
/obj/machinery/door/airlock/public/glass,
/obj/effect/decal/cleanable/dirt,
/turf/open/floor/plasteel/mono,
/area/ruin/powered)
"Ra" = (
/obj/effect/turf_decal/corner/red/half{
	dir = 8
	},
/obj/effect/turf_decal/corner/red{
	dir = 4
	},
/obj/effect/decal/cleanable/dirt,
/turf/open/floor/plasteel,
/area/ruin/powered)
"Rw" = (
/turf/closed/wall/r_wall/rust,
/area/ruin/powered)
"RT" = (
/obj/effect/turf_decal/corner/red/half{
	dir = 1
	},
/obj/effect/decal/cleanable/dirt,
/turf/open/floor/plasteel,
/area/ruin/powered)
"Sj" = (
/obj/effect/turf_decal/corner/red/half{
	dir = 1
	},
/turf/open/floor/plasteel,
/area/ruin/powered)
"TI" = (
/obj/structure/displaycase,
/obj/effect/decal/cleanable/dirt,
/obj/item/ammo_box/magazine/mm712x82,
/turf/open/floor/plasteel,
/area/ruin/powered)
"Ve" = (
/obj/structure/table,
/obj/effect/turf_decal/corner/green{
	dir = 4
	},
/obj/effect/turf_decal/corner/green{
	dir = 1
	},
/obj/effect/decal/cleanable/dirt,
/obj/item/folder,
/turf/open/floor/plasteel,
/area/ruin/powered)
"Vv" = (
/obj/structure/table/wood/reinforced,
/obj/structure/window/reinforced{
	dir = 1
	},
/obj/item/stack/cable_coil/cut,
/obj/effect/turf_decal/corner/neutral/diagonal,
/turf/open/floor/plasteel/dark,
/area/ruin/powered)
"Vw" = (
/obj/effect/turf_decal/corner/red/half{
	dir = 4
	},
/obj/effect/turf_decal/corner/red{
	dir = 1
	},
/obj/effect/decal/cleanable/dirt,
/turf/open/floor/plasteel,
/area/ruin/powered)
"VI" = (
/obj/structure/closet/cardboard,
/obj/structure/fluff/paper/stack,
/obj/effect/decal/cleanable/dirt,
/turf/open/floor/plasteel/dark,
/area/ruin/powered)
"VP" = (
/obj/structure/fluff/paper/stack{
	dir = 5
	},
/turf/open/floor/plasteel/dark,
/area/ruin/powered)
"VT" = (
/obj/structure/fluff/paper/stack{
	dir = 5
	},
/obj/item/paper,
/obj/item/paper,
/obj/effect/decal/cleanable/dirt,
/turf/open/floor/plasteel/dark,
/area/ruin/powered)
"Wi" = (
/obj/structure/closet/cardboard,
/obj/structure/fluff/paper/stack,
/turf/open/floor/plasteel/dark,
/area/ruin/powered)
"Wn" = (
/obj/structure/fluff/paper/stack{
	dir = 5
	},
/obj/item/paper,
/obj/effect/decal/cleanable/dirt,
/turf/open/floor/plasteel/dark,
/area/ruin/powered)
"Wz" = (
/obj/structure/closet/cardboard,
/obj/structure/fluff/paper/stack{
	dir = 9
	},
/obj/item/paper,
/obj/item/paper,
/obj/effect/decal/cleanable/dirt,
/turf/open/floor/plasteel/dark,
/area/ruin/powered)
"WB" = (
/obj/structure/table/wood/reinforced,
/obj/item/weldingtool/hugetank,
/obj/effect/decal/cleanable/dirt,
/turf/open/floor/plating/rust,
/area/ruin/powered)
"WI" = (
/obj/structure/window/reinforced,
/obj/effect/turf_decal/corner/neutral/diagonal,
/turf/open/floor/plasteel/dark,
/area/ruin/powered)
"WJ" = (
/obj/effect/turf_decal/corner/neutral/diagonal,
/obj/effect/decal/cleanable/dirt,
/turf/open/floor/plasteel/dark,
/area/ruin/powered)
"WL" = (
/turf/open/floor/plasteel/dark,
/area/ruin/powered)
"Xg" = (
/obj/machinery/door/window/westleft{
	dir = 2
	},
/obj/effect/decal/cleanable/dirt,
/turf/open/floor/plasteel/dark,
/area/ruin/powered)
"Yk" = (
/obj/structure/table/wood/reinforced,
/obj/item/desk_flag/solgov,
/obj/effect/turf_decal/corner/neutral/diagonal,
/obj/effect/turf_decal/corner/blue/diagonal{
	dir = 4
	},
/obj/effect/decal/cleanable/dirt,
/turf/open/floor/plasteel/dark,
/area/ruin/powered)
"YX" = (
/obj/effect/turf_decal/corner/red/half{
	dir = 8
	},
/obj/effect/turf_decal/corner/red,
/turf/open/floor/plasteel,
/area/ruin/powered)
"Zd" = (
/obj/effect/turf_decal/corner/red/half,
/obj/effect/decal/cleanable/dirt,
/turf/open/floor/plasteel,
/area/ruin/powered)
"Zu" = (
/obj/effect/turf_decal/corner/red/half,
/obj/structure/reagent_dispensers/water_cooler,
/obj/effect/decal/cleanable/dirt,
/turf/open/floor/plasteel,
/area/ruin/powered)
"ZX" = (
/obj/effect/turf_decal/corner/red/half{
	dir = 4
	},
/obj/effect/turf_decal/corner/red{
	dir = 8
	},
/obj/effect/decal/cleanable/dirt,
/turf/open/floor/plasteel,
/area/ruin/powered)

(1,1,1) = {"
tD
tD
tD
tD
Rw
Rw
Rw
Rw
Rw
Rw
Rw
Rw
Rw
Rw
Rw
Rw
tD
tD
tD
tD
tD
tD
tD
tD
tD
"}
(2,1,1) = {"
tD
tD
tD
Rw
Rw
Rw
Rw
Rw
Rw
Rw
Rw
Rw
Rw
Rw
Rw
Rw
Rw
tD
tD
tD
tD
tD
tD
tD
tD
"}
(3,1,1) = {"
tD
tD
Rw
Rw
Rw
uB
AG
Fb
Ma
WB
Vv
rP
qW
IM
uL
Rw
Rw
Rw
tD
tD
tD
tD
tD
tD
tD
"}
(4,1,1) = {"
tD
tD
Rw
Rw
oe
uV
vq
FC
Mq
WJ
FC
Mq
WI
cr
cz
Yk
Rw
Rw
tD
tD
tD
tD
tD
tD
tD
"}
(5,1,1) = {"
tD
tD
Rw
Rw
ov
vq
bz
Ge
Mt
Mt
Ej
Mt
Ll
bz
Fl
jF
Rw
Rw
tD
tD
tD
tD
tD
tD
tD
"}
(6,1,1) = {"
tD
Rw
Rw
Rw
qg
vq
vq
Gj
MS
WL
MS
cz
Xg
Hk
an
FE
Rw
GR
GR
GR
GR
tD
tD
tD
tD
"}
(7,1,1) = {"
Rw
Rw
Rw
Rw
Rw
Rw
Rw
GR
QL
QL
Rw
Rw
Rw
Rw
Rw
Rw
Rw
ei
BK
wn
GR
tD
tD
tD
tD
"}
(8,1,1) = {"
Rw
Rw
av
bz
bz
vY
Bf
GR
Ra
YX
GR
bz
bz
bz
bz
iw
GR
cz
bz
bz
GR
GR
GR
GR
GR
"}
(9,1,1) = {"
Rw
Rw
bz
fq
cz
cz
bz
GR
cz
Zd
GR
HL
HL
HL
HL
HL
GR
JS
px
Nq
BJ
bK
px
fo
GR
"}
(10,1,1) = {"
Rw
Rw
bG
gw
bz
wp
Bv
GR
bz
Zd
Ir
cz
bz
bz
Kt
Kt
Ir
dz
bK
cz
KV
Ve
cz
Cc
GR
"}
(11,1,1) = {"
Rw
Rw
bM
gx
bz
wD
Bv
GR
bz
cz
GR
HL
HL
HL
HL
HL
GR
fh
bz
Nq
cz
Fx
dz
Cc
GR
"}
(12,1,1) = {"
Rw
Rw
cz
gM
cz
wD
bz
HL
cz
Zd
GR
iw
bz
bz
bz
bz
GR
ru
px
cz
jE
rT
Nq
yz
GR
"}
(13,1,1) = {"
Rw
Rw
bz
gX
qn
wD
Bv
Ie
RT
Zu
GR
GR
GR
GR
GR
GR
GR
wH
bz
Nq
bK
BH
cz
dz
nS
"}
(14,1,1) = {"
Rw
Rw
bM
jn
rV
bz
Cl
HL
RT
Zd
GR
GR
GR
GR
GR
GR
GR
uq
cz
cz
bz
rT
bK
Nq
ft
"}
(15,1,1) = {"
Rw
Rw
bM
jo
rV
bz
Cl
HL
cz
Zd
GR
iw
bz
bz
bz
bz
GR
wH
Nq
px
MZ
um
bK
Cc
GR
"}
(16,1,1) = {"
Rw
Rw
bM
jn
rV
wD
Cl
HL
RT
Zd
GR
HL
HL
HL
HL
HL
GR
hQ
dz
Nq
hv
DT
bK
It
GR
"}
(17,1,1) = {"
Rw
Rw
bG
jn
sQ
wD
Cl
GR
RT
Zd
Ir
DQ
cz
DQ
DQ
Kt
Ir
bK
bz
dz
iY
qQ
bz
nT
GR
"}
(18,1,1) = {"
Rw
Rw
bz
jn
sQ
wD
Cl
GR
Sj
cz
GR
HL
HL
HL
HL
HL
GR
CL
Nq
Nq
zt
mU
px
tm
GR
"}
(19,1,1) = {"
Rw
Rw
bz
kb
to
wD
bz
GR
Sj
Zd
GR
bz
bz
bz
bz
iw
GR
cz
dz
px
GR
GR
GR
GR
GR
"}
(20,1,1) = {"
Rw
Rw
cH
kj
bz
bz
CK
GR
Vw
ZX
Rw
Rw
Rw
Rw
Rw
Rw
Rw
dU
TI
GT
GR
tD
tD
tD
tD
"}
(21,1,1) = {"
Rw
Rw
Rw
Rw
Rw
Rw
Rw
GR
QL
hM
GR
dD
Wi
nn
tW
fT
Rw
GR
GR
GR
GR
tD
tD
tD
tD
"}
(22,1,1) = {"
Rw
Rw
dD
kR
tp
wT
wT
KH
VP
yP
EW
Ea
KC
Wz
VI
pl
Rw
Rw
tD
tD
tD
tD
tD
tD
tD
"}
(23,1,1) = {"
Rw
Rw
eV
mo
tr
yY
Ea
KW
Wn
VT
bN
yh
tr
tr
mo
uW
Rw
Rw
tD
tD
tD
tD
tD
tD
tD
"}
(24,1,1) = {"
Rw
Rw
dD
nn
mo
Ae
EW
kR
Ae
AX
Ae
lC
tr
tp
pl
fT
Rw
Rw
tD
tD
tD
tD
tD
tD
tD
"}
(25,1,1) = {"
Rw
Rw
Rw
Rw
Rw
Rw
Rw
Rw
Rw
Rw
Rw
Rw
Rw
Rw
Rw
Rw
Rw
Rw
tD
tD
tD
tD
tD
tD
tD
"}
(26,1,1) = {"
tD
Rw
Rw
Rw
Rw
Rw
Rw
Rw
Rw
Rw
Rw
Rw
Rw
Rw
Rw
Rw
Rw
tD
tD
tD
tD
tD
tD
tD
tD
"}
