//MAP CONVERTED BY dmm2tgm.py THIS HEADER COMMENT PREVENTS RECONVERSION, DO NOT REMOVE
"a" = (
/obj/structure/fence/corner{
	dir = 9
	},
/turf/open/floor/plating/asteroid,
/area/rockplanet/surface/outdoors)
"b" = (
/obj/machinery/modular_computer/console/preset/civilian,
/obj/effect/decal/cleanable/cobweb,
/turf/open/floor/noslip,
/area/rockplanet/surface/outdoors)
"c" = (
/obj/machinery/power/floodlight,
/obj/structure/cable{
	icon_state = "0-4"
	},
/turf/open/floor/plating/asteroid,
/area/rockplanet/surface/outdoors)
"d" = (
/obj/item/grown/bananapeel,
/obj/structure/cable{
	icon_state = "4-8"
	},
/obj/structure/cable{
	icon_state = "1-8"
	},
/turf/open/floor/plating/asteroid,
/area/rockplanet/surface/outdoors)
"e" = (
/obj/structure/table/reinforced,
/obj/item/flashlight/lamp/bananalamp,
/turf/open/floor/noslip,
/area/rockplanet/surface/outdoors)
"f" = (
/obj/effect/decal/cleanable/oil/slippery,
/obj/item/grown/bananapeel,
/obj/structure/cable{
	icon_state = "2-4"
	},
/turf/open/floor/plating/asteroid,
/area/rockplanet/surface/outdoors)
"g" = (
/obj/structure/fence/door,
/obj/item/toy/snappop/phoenix,
/turf/open/floor/plating/asteroid,
/area/rockplanet/surface/outdoors)
"h" = (
/obj/machinery/door/airlock/titanium,
/obj/item/toy/snappop/phoenix,
/turf/open/floor/noslip,
/area/rockplanet/surface/outdoors)
"i" = (
/obj/structure/shuttle/engine/propulsion,
/turf/open/floor/plating/asteroid,
/area/rockplanet/surface/outdoors)
"j" = (
/mob/living/simple_animal/bot/honkbot,
/turf/open/floor/plating/asteroid,
/area/rockplanet/surface/outdoors)
"k" = (
/turf/closed/mineral/random,
/area/rockplanet/surface/outdoors)
"l" = (
/obj/item/grown/bananapeel,
/turf/open/floor/plating/asteroid,
/area/rockplanet/surface/outdoors)
"m" = (
/obj/structure/fence/corner{
	dir = 6
	},
/turf/open/floor/plating/asteroid,
/area/rockplanet/surface/outdoors)
"o" = (
/obj/structure/table/reinforced,
/obj/item/bikehorn/airhorn,
/obj/item/nullrod/clown,
/turf/open/floor/plating/asteroid,
/area/rockplanet/surface/outdoors)
"r" = (
/obj/structure/table/reinforced,
/obj/item/stack/ore/bananium,
/turf/open/floor/plating/asteroid,
/area/rockplanet/surface/outdoors)
"s" = (
/obj/structure/sign/poster/official/foam_force_ad,
/turf/closed/wall/mineral/titanium,
/area/rockplanet/surface/outdoors)
"t" = (
/obj/item/bedsheet/clown,
/obj/structure/bed,
/turf/open/floor/noslip,
/area/rockplanet/surface/outdoors)
"u" = (
/obj/structure/mecha_wreckage/honker,
/obj/effect/decal/cleanable/greenglow,
/turf/open/floor/plating/asteroid,
/area/rockplanet/surface/outdoors)
"w" = (
/obj/structure/sign/poster/contraband/clown,
/turf/closed/wall/mineral/titanium,
/area/rockplanet/surface/outdoors)
"x" = (
/obj/structure/chair/comfy/shuttle{
	dir = 1
	},
/mob/living/simple_animal/hostile/retaliate/clown,
/turf/open/floor/noslip,
/area/rockplanet/surface/outdoors)
"y" = (
/obj/structure/sign/poster/official/high_class_martini,
/turf/closed/wall/mineral/titanium,
/area/rockplanet/surface/outdoors)
"z" = (
/obj/structure/window/shuttle,
/obj/structure/grille,
/turf/open/floor/noslip,
/area/rockplanet/surface/outdoors)
"B" = (
/turf/closed/wall/mineral/titanium,
/area/rockplanet/surface/outdoors)
"D" = (
/obj/item/wrench,
/obj/item/stack/sheet/mineral/plasma,
/obj/item/stack/sheet/mineral/plasma,
/obj/item/stack/sheet/mineral/plasma,
/obj/item/stack/sheet/mineral/plasma,
/obj/item/stack/sheet/mineral/plasma,
/obj/item/stack/sheet/mineral/plasma,
/obj/item/stack/sheet/mineral/plasma,
/obj/item/stack/sheet/mineral/plasma,
/obj/item/stack/sheet/mineral/plasma,
/obj/item/stack/sheet/mineral/plasma,
/obj/structure/rack,
/turf/open/floor/plating/asteroid,
/area/rockplanet/surface/outdoors)
"E" = (
/obj/structure/shuttle/engine/heater,
/turf/closed/wall/mineral/titanium,
/area/rockplanet/surface/outdoors)
"F" = (
/obj/structure/fence{
	dir = 8
	},
/turf/open/floor/plating/asteroid,
/area/rockplanet/surface/outdoors)
"G" = (
/obj/structure/cable{
	icon_state = "1-8"
	},
/turf/open/floor/plating/asteroid,
/area/rockplanet/surface/outdoors)
"H" = (
/turf/open/floor/plating/asteroid,
/area/rockplanet/surface/outdoors)
"J" = (
/obj/machinery/power/floodlight,
/obj/structure/cable{
	icon_state = "0-8"
	},
/turf/open/floor/plating/asteroid,
/area/rockplanet/surface/outdoors)
"K" = (
/obj/structure/closet/crate/trashcart,
/obj/effect/spawner/lootdrop/maintenance/seven,
/turf/open/floor/plating/asteroid,
/area/rockplanet/surface/outdoors)
"L" = (
/obj/structure/fence/corner,
/turf/open/floor/plating/asteroid,
/area/rockplanet/surface/outdoors)
"M" = (
/obj/structure/fence,
/turf/open/floor/plating/asteroid,
/area/rockplanet/surface/outdoors)
"N" = (
/obj/effect/decal/cleanable/oil/slippery,
/turf/open/floor/plating/asteroid,
/area/rockplanet/surface/outdoors)
"O" = (
/obj/structure/table/reinforced,
/obj/item/pickaxe/drill,
/turf/open/floor/plating/asteroid,
/area/rockplanet/surface/outdoors)
"P" = (
/turf/open/floor/noslip,
/area/rockplanet/surface/outdoors)
"Q" = (
/turf/template_noop,
/area/template_noop)
"R" = (
/obj/machinery/power/port_gen/pacman,
/obj/structure/cable{
	icon_state = "0-2"
	},
/turf/open/floor/plating/asteroid,
/area/rockplanet/surface/outdoors)
"S" = (
/obj/structure/cable{
	icon_state = "4-8"
	},
/turf/open/floor/plating/asteroid,
/area/rockplanet/surface/outdoors)
"T" = (
/obj/structure/fence/corner{
	dir = 8
	},
/turf/open/floor/plating/asteroid,
/area/rockplanet/surface/outdoors)
"U" = (
/obj/structure/fence{
	dir = 4
	},
/turf/open/floor/plating/asteroid,
/area/rockplanet/surface/outdoors)
"V" = (
/obj/item/clothing/suit/space/hardsuit/clown,
/obj/item/clothing/head/helmet/space/hardsuit/clown,
/obj/structure/rack,
/turf/open/floor/noslip,
/area/rockplanet/surface/outdoors)
"W" = (
/obj/structure/table/reinforced,
/obj/item/seeds/banana/bluespace,
/obj/item/circuitboard/computer/arcade/orion_trail,
/turf/open/floor/plating/asteroid,
/area/rockplanet/surface/outdoors)
"X" = (
/obj/effect/decal/cleanable/oil/slippery,
/obj/structure/cable{
	icon_state = "4-8"
	},
/turf/open/floor/plating/asteroid,
/area/rockplanet/surface/outdoors)
"Y" = (
/obj/structure/statue/bananium/clown,
/obj/effect/decal/cleanable/cobweb/cobweb2,
/obj/structure/window/reinforced/survival_pod{
	dir = 8
	},
/obj/structure/window/reinforced/survival_pod,
/turf/open/floor/noslip,
/area/rockplanet/surface/outdoors)
"Z" = (
/obj/structure/table/reinforced,
/obj/item/reagent_containers/food/snacks/honkdae,
/turf/open/floor/plating/asteroid,
/area/rockplanet/surface/outdoors)

(1,1,1) = {"
Q
Q
Q
Q
k
k
k
k
M
M
a
"}
(2,1,1) = {"
Q
Q
k
k
k
k
u
D
H
c
U
"}
(3,1,1) = {"
Q
k
k
k
Z
r
H
l
H
X
U
"}
(4,1,1) = {"
k
k
W
l
H
N
H
H
H
S
g
"}
(5,1,1) = {"
k
k
B
z
y
h
B
B
R
d
U
"}
(6,1,1) = {"
k
B
b
x
P
P
e
E
i
S
F
"}
(7,1,1) = {"
k
w
Y
t
P
P
V
E
i
S
F
"}
(8,1,1) = {"
k
k
B
z
s
h
B
B
K
S
F
"}
(9,1,1) = {"
Q
k
k
o
l
H
H
H
f
G
U
"}
(10,1,1) = {"
Q
Q
k
k
O
j
H
H
J
T
m
"}
(11,1,1) = {"
Q
Q
Q
k
k
k
M
M
M
L
Q
"}
