//MAP CONVERTED BY dmm2tgm.py THIS HEADER COMMENT PREVENTS RECONVERSION, DO NOT REMOVE
"aa" = (
/obj/structure/closet/secure_closet/medical3,
/turf/open/floor/carpet/nanoweave/blue,
/area/space)
"aq" = (
/obj/effect/turf_decal/stripes{
	dir = 9
	},
/obj/structure/table/reinforced,
/obj/item/reagent_containers/glass/beaker/large,
/obj/item/reagent_containers/glass/beaker/large{
	pixel_x = 4
	},
/obj/item/reagent_containers/dropper{
	pixel_y = -3
	},
/obj/item/reagent_containers/dropper{
	pixel_y = 3
	},
/turf/open/floor/engine,
/area/space)
"aK" = (
/obj/structure/table/reinforced,
/obj/structure/window/reinforced/spawner{
	dir = 4
	},
/obj/machinery/door/window{
	dir = 1
	},
/obj/item/storage/box/syringes/variety,
/turf/open/floor/carpet/nanoweave/red,
/area/space)
"dn" = (
/obj/effect/turf_decal/stripes,
/obj/machinery/chem_master,
/turf/open/floor/engine,
/area/space)
"dX" = (
/obj/effect/spawner/structure/window/reinforced/tinted/shutters,
/turf/open/floor/plating/airless,
/area/space)
"ei" = (
/obj/item/kirbyplants/random,
/turf/open/floor/plasteel/airless/white,
/area/space)
"eY" = (
/obj/machinery/stasis,
/turf/open/floor/carpet/nanoweave,
/area/space)
"fe" = (
/obj/item/clothing/suit/toggle/labcoat/brig_phys,
/turf/open/floor/mineral/plastitanium/red,
/area/space)
"fM" = (
/obj/structure/closet/secure_closet/CMO,
/turf/open/floor/carpet/blue,
/area/space)
"gj" = (
/obj/effect/turf_decal/stripes,
/turf/open/floor/engine,
/area/space)
"gk" = (
/turf/open/floor/plasteel/dark,
/area/space)
"gq" = (
/obj/effect/decal/cleanable/dirt,
/obj/structure/falsewall/titanium,
/turf/open/floor/plating,
/area/space)
"gN" = (
/obj/structure/filingcabinet/chestdrawer,
/turf/open/floor/plasteel/airless/white,
/area/space)
"jx" = (
/obj/structure/table/glass,
/obj/item/stock_parts/cell/gun/mini{
	pixel_x = -8
	},
/obj/item/stock_parts/cell/gun/mini,
/obj/item/stock_parts/cell/gun/mini{
	pixel_x = 8
	},
/turf/open/floor/carpet/blue,
/area/space)
"jG" = (
/obj/effect/turf_decal/stripes{
	dir = 8
	},
/turf/open/floor/engine,
/area/space)
"kn" = (
/turf/open/floor/carpet/blue,
/area/space)
"kR" = (
/obj/machinery/computer/operating{
	dir = 8
	},
/turf/open/floor/carpet/nanoweave,
/area/space)
"la" = (
/obj/effect/turf_decal/stripes{
	dir = 5
	},
/obj/structure/closet/secure_closet/medical1,
/turf/open/floor/engine,
/area/space)
"lk" = (
/obj/structure/table/glass,
/obj/item/gun/energy/e_gun/mini,
/obj/item/screwdriver,
/turf/open/floor/carpet/blue,
/area/space)
"lA" = (
/turf/open/floor/engine,
/area/space)
"lB" = (
/obj/structure/closet/crate/freezer/blood,
/turf/open/floor/carpet/nanoweave/blue,
/area/space)
"lE" = (
/obj/structure/bed,
/obj/item/bedsheet/medical,
/turf/open/floor/carpet/nanoweave/beige,
/area/space)
"lI" = (
/turf/open/floor/carpet/nanoweave/beige,
/area/space)
"lL" = (
/obj/structure/window/reinforced/spawner,
/obj/machinery/door/window{
	dir = 8
	},
/obj/machinery/suit_storage_unit/cmo,
/turf/open/floor/carpet/nanoweave/blue,
/area/space)
"lY" = (
/obj/machinery/computer/camera_advanced/shuttle_docker/nav{
	dir = 8
	},
/turf/open/floor/plasteel/dark,
/area/space)
"ml" = (
/obj/item/bedsheet/medical,
/obj/structure/bed,
/turf/open/floor/carpet/nanoweave/beige,
/area/space)
"mp" = (
/obj/item/kirbyplants/random,
/turf/open/floor/mineral/titanium/white,
/area/space)
"mV" = (
/obj/structure/window/reinforced/spawner{
	dir = 4
	},
/obj/machinery/door/window{
	dir = 1
	},
/obj/structure/table/reinforced,
/obj/item/melee/baton,
/turf/open/floor/carpet/nanoweave/red,
/area/space)
"nU" = (
/obj/structure/table/reinforced,
/obj/item/reagent_containers/glass/bottle/charcoal{
	pixel_x = -3
	},
/obj/item/reagent_containers/glass/bottle/epinephrine{
	pixel_x = 3
	},
/obj/item/reagent_containers/glass/bottle/formaldehyde{
	pixel_x = -4;
	pixel_y = 5
	},
/obj/item/reagent_containers/glass/bottle/dexalin{
	pixel_x = 3;
	pixel_y = 5
	},
/turf/open/floor/engine,
/area/space)
"oT" = (
/obj/structure/bed,
/obj/item/bedsheet/medical,
/obj/machinery/vending/wallmed{
	pixel_x = -24
	},
/turf/open/floor/carpet/nanoweave,
/area/space)
"ps" = (
/obj/structure/table/glass,
/obj/structure/window/reinforced/spawner{
	dir = 1
	},
/obj/machinery/door/window{
	dir = 4
	},
/obj/item/defibrillator/compact/loaded,
/obj/machinery/defibrillator_mount/charging,
/obj/item/defibrillator/compact/loaded,
/obj/machinery/defibrillator_mount/charging,
/turf/open/floor/carpet/nanoweave/blue,
/area/space)
"py" = (
/obj/machinery/vending/wardrobe/medi_wardrobe,
/turf/open/floor/carpet/nanoweave/blue,
/area/space)
"pN" = (
/turf/open/floor/mineral/plastitanium/red,
/area/space)
"pU" = (
/obj/structure/closet/crate/freezer/surplus_limbs,
/turf/open/floor/carpet/nanoweave/blue,
/area/space)
"qj" = (
/turf/closed/wall/mineral/titanium/nodiagonal,
/area/space)
"qB" = (
/obj/effect/decal/cleanable/dirt,
/turf/open/floor/plasteel,
/area/space)
"rH" = (
/obj/machinery/chem_heater,
/turf/open/floor/engine,
/area/space)
"sQ" = (
/obj/structure/table/reinforced,
/obj/machinery/door/window{
	dir = 4
	},
/obj/item/storage/box/syndie_kit/chemical,
/turf/open/floor/carpet/nanoweave/red,
/area/space)
"tb" = (
/obj/machinery/door/airlock/freezer,
/turf/open/floor/carpet,
/area/space)
"tO" = (
/obj/machinery/smartfridge/chemistry/preloaded,
/turf/open/floor/engine,
/area/space)
"tT" = (
/obj/effect/spawner/structure/window/shuttle,
/turf/open/floor/plating/airless,
/area/space)
"tV" = (
/obj/machinery/vending/medical,
/turf/open/floor/carpet/nanoweave/blue,
/area/space)
"ua" = (
/obj/machinery/door/airlock/medical,
/turf/open/floor/mineral/titanium/white,
/area/space)
"uf" = (
/obj/structure/falsewall/titanium,
/obj/effect/decal/cleanable/dirt,
/turf/open/floor/plating,
/area/space)
"uj" = (
/obj/effect/turf_decal/stripes{
	dir = 10
	},
/turf/open/floor/engine,
/area/space)
"un" = (
/obj/structure/table/reinforced,
/turf/open/floor/plasteel/dark,
/area/space)
"uL" = (
/obj/effect/decal/cleanable/dirt,
/obj/structure/falsewall/titanium,
/turf/open/floor/plasteel,
/area/space)
"vB" = (
/obj/effect/turf_decal/loading_area{
	dir = 8
	},
/obj/effect/turf_decal/stripes/corner{
	dir = 8
	},
/obj/effect/turf_decal/stripes/corner{
	dir = 1
	},
/obj/effect/decal/cleanable/dirt,
/turf/open/floor/engine,
/area/space)
"wg" = (
/turf/open/space/basic,
/area/space)
"xR" = (
/obj/machinery/door/firedoor,
/obj/structure/table/reinforced,
/obj/machinery/door/window/brigdoor{
	dir = 4
	},
/obj/machinery/door/window{
	dir = 8
	},
/obj/item/paper_bin{
	pixel_x = -3;
	pixel_y = -3
	},
/obj/item/pen{
	pixel_x = -3;
	pixel_y = -3
	},
/obj/item/folder/blue{
	pixel_x = 4;
	pixel_y = 4
	},
/turf/open/floor/plasteel/checker,
/area/space)
"zg" = (
/obj/structure/table/glass,
/obj/structure/window/reinforced/spawner{
	dir = 1
	},
/obj/machinery/door/window{
	dir = 4
	},
/obj/item/storage/firstaid/brute{
	pixel_x = 3;
	pixel_y = 3
	},
/obj/item/storage/firstaid/brute,
/obj/item/storage/firstaid{
	pixel_x = -3;
	pixel_y = -3
	},
/turf/open/floor/carpet/nanoweave/blue,
/area/space)
"zp" = (
/obj/machinery/modular_computer/console/preset/id{
	dir = 1
	},
/obj/item/card/id/captains_spare,
/turf/open/floor/carpet/blue,
/area/space)
"zP" = (
/obj/machinery/cryopod/latejoin{
	dir = 1
	},
/turf/open/floor/carpet/nanoweave/beige,
/area/space)
"An" = (
/obj/effect/spawner/structure/window/shuttle,
/turf/open/floor/engine,
/area/space)
"BU" = (
/obj/machinery/computer/autopilot{
	dir = 8
	},
/turf/open/floor/plasteel/dark,
/area/space)
"Cd" = (
/obj/structure/window/reinforced/spawner{
	dir = 1
	},
/obj/machinery/door/window/eastright{
	dir = 8
	},
/obj/machinery/suit_storage_unit/cmo,
/turf/open/floor/carpet/nanoweave/blue,
/area/space)
"DC" = (
/obj/machinery/door/window{
	dir = 1
	},
/obj/structure/table/reinforced,
/turf/open/floor/engine,
/area/space)
"DD" = (
/turf/open/floor/plasteel/checker,
/area/space)
"EX" = (
/turf/open/floor/mineral/titanium/blue,
/area/space)
"EY" = (
/obj/structure/filingcabinet,
/turf/open/floor/carpet/blue,
/area/space)
"FN" = (
/obj/structure/bed,
/obj/item/bedsheet/cmo,
/obj/structure/curtain/cloth/grey,
/turf/open/floor/carpet/blue,
/area/space)
"FY" = (
/obj/structure/table/glass,
/obj/item/paper_bin/carbon,
/obj/item/pen/fountain/captain,
/turf/open/floor/carpet/blue,
/area/space)
"Gb" = (
/obj/structure/table/reinforced,
/obj/structure/window/reinforced/spawner{
	dir = 4
	},
/obj/machinery/door/window{
	dir = 1
	},
/obj/item/mmi,
/obj/item/mmi,
/obj/item/mmi,
/turf/open/floor/carpet/nanoweave/red,
/area/space)
"Gf" = (
/obj/item/kirbyplants/random,
/turf/open/floor/plasteel/checker,
/area/space)
"Gq" = (
/obj/machinery/iv_drip,
/turf/open/floor/carpet/nanoweave,
/area/space)
"GJ" = (
/obj/structure/bed/dogbed/runtime,
/mob/living/simple_animal/pet/cat/Runtime,
/obj/item/reagent_containers/food/condiment/milk,
/obj/item/reagent_containers/food/snacks/deadmouse,
/turf/open/floor/carpet/blue,
/area/space)
"Hw" = (
/obj/machinery/door/airlock/public/glass,
/turf/open/floor/mineral/titanium/blue,
/area/space)
"HV" = (
/obj/structure/table/reinforced,
/obj/structure/window/reinforced/spawner{
	dir = 1
	},
/obj/machinery/door/window{
	dir = 4
	},
/obj/item/storage/box/syndie_kit/throwing_weapons,
/turf/open/floor/carpet/nanoweave/red,
/area/space)
"ID" = (
/turf/open/floor/plasteel/airless/white,
/area/space)
"IJ" = (
/obj/structure/chair{
	dir = 4
	},
/turf/open/floor/plasteel/checker,
/area/space)
"IS" = (
/turf/open/floor/carpet/royalblue,
/area/space)
"JA" = (
/obj/effect/decal/cleanable/dirt,
/turf/open/floor/engine,
/area/space)
"JH" = (
/obj/structure/closet/secure_closet/medical3,
/turf/open/floor/plasteel/checker,
/area/space)
"JO" = (
/obj/machinery/vending/wardrobe/chem_wardrobe,
/obj/effect/turf_decal/stripes{
	dir = 4
	},
/turf/open/floor/engine,
/area/space)
"Km" = (
/obj/structure/chair,
/turf/open/floor/carpet/nanoweave,
/area/space)
"KF" = (
/obj/structure/table/glass,
/obj/structure/window/reinforced/spawner,
/obj/machinery/door/window{
	dir = 8
	},
/obj/item/storage/firstaid/o2{
	pixel_x = 3;
	pixel_y = 3
	},
/obj/item/storage/firstaid/o2,
/obj/item/storage/firstaid{
	pixel_x = -3;
	pixel_y = -3
	},
/turf/open/floor/carpet/nanoweave/blue,
/area/space)
"KN" = (
/obj/structure/falsewall/titanium,
/turf/open/floor/plasteel/checker,
/area/space)
"KY" = (
/obj/structure/chair{
	dir = 1
	},
/turf/open/floor/carpet/nanoweave,
/area/space)
"Lf" = (
/obj/structure/table/glass,
/obj/item/paper_bin,
/obj/item/pen/sleepy,
/turf/open/floor/carpet/blue,
/area/space)
"LT" = (
/obj/structure/table/reinforced,
/obj/item/storage/firstaid/advanced,
/turf/open/floor/plasteel/dark,
/area/space)
"LY" = (
/obj/effect/turf_decal/stripes{
	dir = 6
	},
/obj/machinery/chem_dispenser,
/turf/open/floor/engine,
/area/space)
"Mq" = (
/obj/machinery/door/airlock/medical,
/turf/open/floor/engine,
/area/space)
"Mr" = (
/obj/structure/table/glass,
/obj/item/storage/backpack/duffelbag/med/surgery,
/turf/open/floor/carpet/nanoweave,
/area/space)
"MF" = (
/obj/machinery/vending/wardrobe/medi_wardrobe,
/turf/open/floor/carpet/nanoweave/beige,
/area/space)
"MO" = (
/obj/machinery/computer/helm{
	dir = 8
	},
/turf/open/floor/plasteel/dark,
/area/space)
"Nv" = (
/turf/open/floor/carpet/nanoweave,
/area/space)
"NY" = (
/obj/machinery/door/airlock/external,
/turf/open/floor/mineral/titanium/blue,
/area/space)
"OD" = (
/obj/item/kirbyplants/random,
/turf/open/floor/carpet/nanoweave,
/area/space)
"Pl" = (
/turf/open/floor/carpet/nanoweave/blue,
/area/space)
"PS" = (
/obj/structure/fluff/empty_sleeper{
	dir = 4
	},
/turf/open/floor/carpet/nanoweave,
/area/space)
"Qd" = (
/obj/effect/turf_decal/stripes{
	dir = 4
	},
/turf/open/floor/engine,
/area/space)
"Qv" = (
/obj/structure/closet/secure_closet/personal,
/turf/open/floor/plasteel/airless/white,
/area/space)
"QS" = (
/obj/structure/dresser,
/turf/open/floor/carpet/blue,
/area/space)
"Rt" = (
/obj/effect/spawner/structure/window/shuttle,
/turf/open/space/basic,
/area/space)
"RP" = (
/obj/effect/decal/cleanable/dirt,
/turf/open/floor/plating,
/area/space)
"Sx" = (
/obj/effect/turf_decal/stripes{
	dir = 1
	},
/obj/structure/closet/secure_closet/chemical/heisenberg,
/turf/open/floor/engine,
/area/space)
"SA" = (
/obj/effect/turf_decal/stripes{
	dir = 4
	},
/obj/structure/table/reinforced,
/obj/item/reagent_containers/glass/beaker/large,
/obj/item/reagent_containers/glass/beaker/large{
	pixel_y = 6
	},
/obj/item/reagent_containers/dropper{
	pixel_y = 3
	},
/obj/item/reagent_containers/dropper{
	pixel_y = -3
	},
/turf/open/floor/engine,
/area/space)
"TS" = (
/obj/machinery/smartfridge/bloodbank/preloaded,
/turf/closed/wall/mineral/titanium/nodiagonal,
/area/space)
"Ue" = (
/obj/machinery/suit_storage_unit/cmo,
/turf/open/floor/carpet/blue,
/area/space)
"UI" = (
/obj/machinery/door/airlock/command,
/turf/open/floor/carpet,
/area/space)
"Vr" = (
/obj/effect/turf_decal/stripes{
	dir = 1
	},
/obj/structure/table/reinforced,
/obj/item/wrench/medical,
/obj/item/stack/ducts/fifty,
/obj/item/plunger,
/obj/item/construction/plumbing,
/turf/open/floor/engine,
/area/space)
"VB" = (
/obj/structure/table/glass,
/obj/structure/window/reinforced/spawner,
/obj/machinery/door/window/eastright,
/obj/item/storage/box/bodybags,
/obj/item/storage/box/hypospray,
/turf/open/floor/carpet/nanoweave/blue,
/area/space)
"Wo" = (
/obj/structure/table/glass,
/obj/structure/window/reinforced/spawner{
	dir = 1
	},
/obj/machinery/door/window/eastright{
	dir = 8
	},
/obj/item/storage/firstaid/fire{
	pixel_x = 3;
	pixel_y = 3
	},
/obj/item/storage/firstaid/fire,
/obj/item/storage/firstaid{
	pixel_x = -3;
	pixel_y = -3
	},
/turf/open/floor/carpet/nanoweave/blue,
/area/space)
"WI" = (
/turf/open/floor/carpet,
/area/space)
"Xv" = (
/obj/structure/table/glass,
/obj/structure/window/reinforced/spawner,
/obj/machinery/door/window/eastright,
/obj/item/storage/firstaid/toxin{
	pixel_x = 3;
	pixel_y = 2
	},
/obj/item/storage/firstaid/toxin,
/obj/item/storage/firstaid{
	pixel_x = -3;
	pixel_y = -3
	},
/turf/open/floor/carpet/nanoweave/blue,
/area/space)
"XJ" = (
/turf/open/floor/mineral/titanium/white,
/area/space)
"Yv" = (
/obj/structure/table/reinforced,
/obj/structure/window/reinforced/spawner{
	dir = 4
	},
/obj/machinery/door/window{
	dir = 1
	},
/obj/item/gun/syringe/syndicate{
	pixel_x = 3;
	pixel_y = -3
	},
/obj/item/gun/syringe{
	pixel_x = -3;
	pixel_y = 3
	},
/turf/open/floor/carpet/nanoweave/red,
/area/space)
"YM" = (
/obj/effect/turf_decal/stripes{
	dir = 4
	},
/obj/structure/table/reinforced,
/obj/machinery/reagentgrinder,
/obj/item/stack/sheet/mineral/plasma,
/obj/item/stack/sheet/mineral/plasma,
/turf/open/floor/engine,
/area/space)
"YZ" = (
/obj/structure/bed,
/obj/item/bedsheet/medical,
/turf/open/floor/carpet/nanoweave,
/area/space)
"ZH" = (
/obj/structure/chair/comfy/teal{
	dir = 8
	},
/turf/open/floor/carpet/royalblue,
/area/space)

(1,1,1) = {"
wg
wg
wg
wg
wg
wg
wg
wg
wg
wg
wg
wg
wg
wg
wg
wg
wg
wg
wg
wg
wg
wg
wg
wg
wg
wg
wg
wg
wg
wg
wg
wg
wg
wg
wg
wg
wg
wg
wg
wg
wg
wg
wg
wg
wg
wg
wg
wg
wg
wg
"}
(2,1,1) = {"
wg
wg
wg
wg
wg
wg
wg
wg
wg
wg
wg
wg
wg
wg
wg
wg
wg
wg
wg
wg
wg
wg
wg
wg
wg
wg
wg
wg
wg
wg
wg
wg
wg
wg
wg
wg
wg
wg
wg
wg
wg
wg
wg
wg
wg
wg
wg
wg
wg
wg
"}
(3,1,1) = {"
wg
wg
wg
wg
wg
wg
wg
wg
wg
wg
wg
wg
wg
wg
wg
wg
wg
wg
wg
wg
wg
wg
wg
wg
wg
wg
wg
wg
wg
wg
wg
wg
wg
wg
wg
wg
wg
wg
wg
wg
wg
wg
wg
wg
wg
wg
wg
wg
wg
wg
"}
(4,1,1) = {"
wg
wg
wg
wg
wg
wg
wg
wg
wg
wg
wg
wg
wg
wg
wg
wg
wg
wg
wg
wg
wg
wg
wg
wg
wg
wg
wg
wg
wg
wg
wg
wg
wg
wg
wg
wg
wg
wg
wg
wg
wg
wg
wg
wg
wg
wg
wg
wg
wg
wg
"}
(5,1,1) = {"
wg
wg
wg
wg
wg
wg
wg
wg
wg
wg
wg
wg
wg
wg
wg
wg
wg
wg
wg
wg
wg
wg
wg
wg
wg
wg
wg
wg
wg
wg
wg
wg
wg
wg
wg
wg
wg
wg
wg
wg
wg
wg
wg
wg
wg
wg
wg
wg
wg
wg
"}
(6,1,1) = {"
wg
wg
wg
wg
wg
wg
wg
wg
wg
wg
wg
wg
wg
wg
wg
wg
wg
wg
wg
wg
wg
wg
wg
wg
wg
wg
wg
wg
wg
wg
wg
wg
wg
wg
wg
wg
wg
wg
wg
wg
wg
wg
wg
wg
wg
wg
wg
wg
wg
wg
"}
(7,1,1) = {"
wg
wg
wg
wg
wg
wg
wg
wg
wg
wg
wg
wg
wg
wg
wg
wg
wg
wg
wg
wg
wg
wg
wg
wg
wg
wg
wg
wg
wg
wg
wg
wg
wg
wg
wg
wg
wg
wg
wg
wg
wg
wg
wg
wg
wg
wg
wg
wg
wg
wg
"}
(8,1,1) = {"
wg
wg
wg
wg
wg
wg
wg
wg
wg
wg
wg
wg
wg
wg
wg
wg
wg
wg
wg
wg
wg
wg
wg
wg
wg
wg
wg
wg
wg
wg
wg
wg
wg
wg
wg
wg
wg
wg
wg
wg
wg
wg
wg
wg
wg
wg
wg
wg
wg
wg
"}
(9,1,1) = {"
wg
wg
wg
wg
wg
wg
wg
wg
wg
wg
wg
wg
wg
wg
wg
wg
qj
qj
qj
qj
qj
qj
qj
qj
NY
NY
qj
qj
qj
qj
qj
qj
qj
NY
NY
qj
qj
qj
qj
qj
qj
qj
qj
wg
wg
wg
wg
wg
wg
wg
"}
(10,1,1) = {"
wg
wg
wg
wg
wg
wg
wg
wg
wg
wg
wg
wg
wg
wg
wg
wg
qj
qB
RP
RP
qj
OD
Nv
Nv
EX
EX
Gf
IJ
IJ
Gf
IJ
IJ
Gf
EX
EX
Nv
Nv
OD
qj
sQ
HV
qj
qj
wg
wg
wg
wg
wg
wg
wg
"}
(11,1,1) = {"
wg
wg
wg
wg
wg
wg
wg
wg
wg
wg
wg
wg
wg
wg
wg
wg
qj
RP
RP
qB
qj
Km
Nv
Nv
EX
EX
DD
DD
DD
DD
DD
DD
DD
EX
EX
Nv
Nv
KY
qj
pN
pN
Gb
qj
wg
wg
wg
wg
wg
wg
wg
"}
(12,1,1) = {"
wg
wg
wg
wg
wg
wg
wg
wg
wg
wg
wg
wg
wg
wg
wg
wg
qj
qB
RP
RP
qj
Km
Nv
Nv
EX
EX
DD
DD
DD
DD
DD
DD
DD
EX
EX
Nv
Nv
KY
qj
pN
pN
Yv
qj
wg
wg
wg
wg
wg
wg
wg
"}
(13,1,1) = {"
wg
wg
wg
wg
wg
wg
wg
wg
wg
wg
wg
wg
wg
wg
wg
wg
qj
RP
qB
RP
qj
Km
Nv
Nv
EX
EX
DD
DD
DD
DD
DD
DD
DD
EX
EX
Nv
Nv
KY
qj
pN
pN
Yv
qj
wg
wg
wg
wg
wg
wg
wg
"}
(14,1,1) = {"
wg
wg
wg
wg
wg
wg
wg
wg
wg
wg
wg
wg
wg
wg
wg
wg
qj
RP
RP
RP
qj
Km
Nv
Nv
EX
EX
DD
DD
DD
DD
DD
DD
DD
EX
EX
Nv
Nv
KY
qj
fe
pN
aK
qj
wg
wg
wg
wg
wg
wg
wg
"}
(15,1,1) = {"
wg
wg
wg
wg
wg
wg
wg
wg
wg
wg
wg
wg
wg
wg
wg
wg
qj
RP
RP
qB
qj
OD
Nv
Nv
EX
EX
DD
DD
DD
DD
DD
DD
DD
EX
EX
Nv
Nv
OD
qj
pN
pN
mV
qj
wg
wg
wg
wg
wg
wg
wg
"}
(16,1,1) = {"
wg
wg
wg
wg
wg
wg
wg
wg
wg
wg
wg
wg
wg
wg
wg
wg
qj
uL
uf
gq
qj
qj
qj
qj
Hw
Hw
qj
qj
qj
xR
qj
qj
qj
Hw
Hw
qj
qj
qj
qj
KN
qj
qj
qj
wg
wg
wg
wg
wg
wg
wg
"}
(17,1,1) = {"
wg
wg
wg
wg
wg
wg
wg
wg
wg
wg
wg
wg
wg
wg
wg
wg
qj
aq
vB
jG
jG
jG
uj
Mq
XJ
XJ
qj
FY
Lf
ZH
jx
lk
qj
XJ
XJ
qj
zg
Xv
aa
JH
ps
VB
qj
qj
wg
wg
wg
wg
wg
wg
"}
(18,1,1) = {"
wg
wg
wg
wg
wg
wg
wg
wg
wg
wg
wg
wg
wg
wg
wg
wg
qj
Vr
lA
JA
nU
rH
dn
An
XJ
XJ
qj
EY
kn
IS
kn
zp
qj
XJ
XJ
ua
Pl
DD
DD
DD
DD
DD
lB
tT
wg
wg
wg
wg
wg
wg
"}
(19,1,1) = {"
wg
wg
wg
wg
wg
wg
wg
wg
wg
wg
wg
wg
wg
wg
wg
wg
qj
Sx
lA
lA
lA
lA
gj
DC
XJ
XJ
qj
Ue
kn
IS
kn
QS
qj
XJ
XJ
ua
Pl
DD
DD
DD
DD
DD
pU
tT
wg
wg
wg
wg
wg
wg
"}
(20,1,1) = {"
wg
wg
wg
wg
wg
wg
wg
wg
wg
wg
wg
wg
wg
wg
wg
wg
qj
la
Qd
JO
SA
YM
LY
tO
XJ
XJ
qj
fM
kn
IS
GJ
FN
qj
XJ
XJ
qj
Wo
KF
py
tV
Cd
lL
qj
qj
wg
wg
wg
wg
wg
wg
"}
(21,1,1) = {"
wg
wg
wg
wg
wg
wg
wg
wg
wg
wg
wg
wg
wg
wg
wg
wg
qj
qj
qj
qj
qj
qj
qj
qj
XJ
XJ
qj
qj
qj
UI
qj
qj
qj
XJ
XJ
qj
qj
qj
qj
qj
qj
qj
qj
wg
wg
wg
wg
wg
wg
wg
"}
(22,1,1) = {"
wg
wg
wg
wg
wg
wg
wg
wg
wg
wg
wg
wg
wg
wg
wg
wg
wg
qj
qj
Qv
PS
YZ
Gq
qj
XJ
XJ
qj
ml
zP
WI
lI
lE
qj
XJ
XJ
qj
Gq
oT
PS
Qv
qj
qj
wg
wg
wg
wg
wg
wg
wg
wg
"}
(23,1,1) = {"
wg
wg
wg
wg
wg
wg
wg
wg
wg
wg
wg
wg
wg
wg
wg
wg
wg
qj
TS
ID
Nv
Nv
Nv
dX
XJ
XJ
qj
ml
WI
WI
WI
lE
qj
XJ
XJ
dX
Nv
Nv
Nv
ID
TS
qj
wg
wg
wg
wg
wg
wg
wg
wg
"}
(24,1,1) = {"
wg
wg
wg
wg
wg
wg
wg
wg
wg
wg
wg
wg
wg
wg
wg
wg
wg
wg
qj
ei
Nv
Nv
Nv
ua
XJ
XJ
qj
ml
MF
WI
lI
lE
qj
XJ
XJ
ua
Nv
Nv
Nv
ei
qj
wg
wg
wg
wg
wg
wg
wg
wg
wg
"}
(25,1,1) = {"
wg
wg
wg
wg
wg
wg
wg
wg
wg
wg
wg
wg
wg
wg
wg
wg
wg
wg
qj
gN
Nv
Nv
Nv
dX
XJ
XJ
qj
qj
qj
tb
qj
qj
qj
XJ
XJ
dX
Nv
Nv
Nv
gN
qj
wg
wg
wg
wg
wg
wg
wg
wg
wg
"}
(26,1,1) = {"
wg
wg
wg
wg
wg
wg
wg
wg
wg
wg
wg
wg
wg
wg
wg
wg
wg
wg
qj
qj
kR
eY
Mr
qj
mp
XJ
XJ
XJ
XJ
XJ
XJ
XJ
XJ
XJ
mp
qj
Mr
eY
kR
qj
qj
wg
wg
wg
wg
wg
wg
wg
wg
wg
"}
(27,1,1) = {"
wg
wg
wg
wg
wg
wg
wg
wg
wg
wg
wg
wg
wg
wg
wg
wg
wg
wg
wg
qj
qj
qj
qj
qj
qj
qj
qj
qj
qj
gk
qj
qj
qj
qj
qj
qj
qj
qj
qj
qj
wg
wg
wg
wg
wg
wg
wg
wg
wg
wg
"}
(28,1,1) = {"
wg
wg
wg
wg
wg
wg
wg
wg
wg
wg
wg
wg
wg
wg
wg
wg
wg
wg
wg
wg
wg
wg
wg
wg
qj
qj
gk
gk
gk
gk
gk
gk
gk
qj
qj
wg
wg
wg
wg
wg
wg
wg
Rt
wg
wg
wg
wg
wg
wg
wg
"}
(29,1,1) = {"
wg
wg
wg
wg
wg
wg
wg
wg
wg
wg
wg
wg
wg
wg
wg
wg
wg
wg
wg
wg
wg
wg
wg
wg
wg
qj
gk
gk
gk
gk
gk
gk
gk
qj
wg
wg
wg
wg
wg
wg
wg
wg
wg
wg
wg
wg
wg
wg
wg
wg
"}
(30,1,1) = {"
wg
wg
wg
wg
wg
wg
wg
wg
wg
wg
wg
wg
wg
wg
wg
wg
wg
wg
wg
wg
wg
wg
wg
wg
wg
tT
tT
LT
lY
MO
BU
un
tT
tT
wg
wg
wg
wg
wg
wg
wg
wg
wg
wg
wg
wg
wg
wg
wg
wg
"}
(31,1,1) = {"
wg
wg
wg
wg
wg
wg
wg
wg
wg
wg
wg
wg
wg
wg
wg
wg
wg
wg
wg
wg
wg
wg
wg
wg
wg
wg
tT
Rt
tT
tT
tT
tT
tT
wg
wg
wg
wg
wg
wg
wg
wg
wg
wg
wg
wg
wg
wg
wg
wg
wg
"}
(32,1,1) = {"
wg
wg
wg
wg
wg
wg
wg
wg
wg
wg
wg
wg
wg
wg
wg
wg
wg
wg
wg
wg
wg
wg
wg
wg
wg
wg
wg
wg
wg
wg
wg
wg
wg
wg
wg
wg
wg
wg
wg
wg
wg
wg
wg
wg
wg
wg
wg
wg
wg
wg
"}
(33,1,1) = {"
wg
wg
wg
wg
wg
wg
wg
wg
wg
wg
wg
wg
wg
wg
wg
wg
wg
wg
wg
wg
wg
wg
wg
wg
wg
wg
wg
wg
wg
wg
wg
wg
wg
wg
wg
wg
wg
wg
wg
wg
wg
wg
wg
wg
wg
wg
wg
wg
wg
wg
"}
(34,1,1) = {"
wg
wg
wg
wg
wg
wg
wg
wg
wg
wg
wg
wg
wg
wg
wg
wg
wg
wg
wg
wg
wg
wg
wg
wg
wg
wg
wg
wg
wg
wg
wg
wg
wg
wg
wg
wg
wg
wg
wg
wg
wg
wg
wg
wg
wg
wg
wg
wg
wg
wg
"}
(35,1,1) = {"
wg
wg
wg
wg
wg
wg
wg
wg
wg
wg
wg
wg
wg
wg
wg
wg
wg
wg
wg
wg
wg
wg
wg
wg
wg
wg
wg
wg
wg
wg
wg
wg
wg
wg
wg
wg
wg
wg
wg
wg
wg
wg
wg
wg
wg
wg
wg
wg
wg
wg
"}
(36,1,1) = {"
wg
wg
wg
wg
wg
wg
wg
wg
wg
wg
wg
wg
wg
wg
wg
wg
wg
wg
wg
wg
wg
wg
wg
wg
wg
wg
wg
wg
wg
wg
wg
wg
wg
wg
wg
wg
wg
wg
wg
wg
wg
wg
wg
wg
wg
wg
wg
wg
wg
wg
"}
(37,1,1) = {"
wg
wg
wg
wg
wg
wg
wg
wg
wg
wg
wg
wg
wg
wg
wg
wg
wg
wg
wg
wg
wg
wg
wg
wg
wg
wg
wg
wg
wg
wg
wg
wg
wg
wg
wg
wg
wg
wg
wg
wg
wg
wg
wg
wg
wg
wg
wg
wg
wg
wg
"}
(38,1,1) = {"
wg
wg
wg
wg
wg
wg
wg
wg
wg
wg
wg
wg
wg
wg
wg
wg
wg
wg
wg
wg
wg
wg
wg
wg
wg
wg
wg
wg
wg
wg
wg
wg
wg
wg
wg
wg
wg
wg
wg
wg
wg
wg
wg
wg
wg
wg
wg
wg
wg
wg
"}
(39,1,1) = {"
wg
wg
wg
wg
wg
wg
wg
wg
wg
wg
wg
wg
wg
wg
wg
wg
wg
wg
wg
wg
wg
wg
wg
wg
wg
wg
wg
wg
wg
wg
wg
wg
wg
wg
wg
wg
wg
wg
wg
wg
wg
wg
wg
wg
wg
wg
wg
wg
wg
wg
"}
(40,1,1) = {"
wg
wg
wg
wg
wg
wg
wg
wg
wg
wg
wg
wg
wg
wg
wg
wg
wg
wg
wg
wg
wg
wg
wg
wg
wg
wg
wg
wg
wg
wg
wg
wg
wg
wg
wg
wg
wg
wg
wg
wg
wg
wg
wg
wg
wg
wg
wg
wg
wg
wg
"}
(41,1,1) = {"
wg
wg
wg
wg
wg
wg
wg
wg
wg
wg
wg
wg
wg
wg
wg
wg
wg
wg
wg
wg
wg
wg
wg
wg
wg
wg
wg
wg
wg
wg
wg
wg
wg
wg
wg
wg
wg
wg
wg
wg
wg
wg
wg
wg
wg
wg
wg
wg
wg
wg
"}
(42,1,1) = {"
wg
wg
wg
wg
wg
wg
wg
wg
wg
wg
wg
wg
wg
wg
wg
wg
wg
wg
wg
wg
wg
wg
wg
wg
wg
wg
wg
wg
wg
wg
wg
wg
wg
wg
wg
wg
wg
wg
wg
wg
wg
wg
wg
wg
wg
wg
wg
wg
wg
wg
"}
(43,1,1) = {"
wg
wg
wg
wg
wg
wg
wg
wg
wg
wg
wg
wg
wg
wg
wg
wg
wg
wg
wg
wg
wg
wg
wg
wg
wg
wg
wg
wg
wg
wg
wg
wg
wg
wg
wg
wg
wg
wg
wg
wg
wg
wg
wg
wg
wg
wg
wg
wg
wg
wg
"}
(44,1,1) = {"
wg
wg
wg
wg
wg
wg
wg
wg
wg
wg
wg
wg
wg
wg
wg
wg
wg
wg
wg
wg
wg
wg
wg
wg
wg
wg
wg
wg
wg
wg
wg
wg
wg
wg
wg
wg
wg
wg
wg
wg
wg
wg
wg
wg
wg
wg
wg
wg
wg
wg
"}
(45,1,1) = {"
wg
wg
wg
wg
wg
wg
wg
wg
wg
wg
wg
wg
wg
wg
wg
wg
wg
wg
wg
wg
wg
wg
wg
wg
wg
wg
wg
wg
wg
wg
wg
wg
wg
wg
wg
wg
wg
wg
wg
wg
wg
wg
wg
wg
wg
wg
wg
wg
wg
wg
"}
(46,1,1) = {"
wg
wg
wg
wg
wg
wg
wg
wg
wg
wg
wg
wg
wg
wg
wg
wg
wg
wg
wg
wg
wg
wg
wg
wg
wg
wg
wg
wg
wg
wg
wg
wg
wg
wg
wg
wg
wg
wg
wg
wg
wg
wg
wg
wg
wg
wg
wg
wg
wg
wg
"}
(47,1,1) = {"
wg
wg
wg
wg
wg
wg
wg
wg
wg
wg
wg
wg
wg
wg
wg
wg
wg
wg
wg
wg
wg
wg
wg
wg
wg
wg
wg
wg
wg
wg
wg
wg
wg
wg
wg
wg
wg
wg
wg
wg
wg
wg
wg
wg
wg
wg
wg
wg
wg
wg
"}
(48,1,1) = {"
wg
wg
wg
wg
wg
wg
wg
wg
wg
wg
wg
wg
wg
wg
wg
wg
wg
wg
wg
wg
wg
wg
wg
wg
wg
wg
wg
wg
wg
wg
wg
wg
wg
wg
wg
wg
wg
wg
wg
wg
wg
wg
wg
wg
wg
wg
wg
wg
wg
wg
"}
(49,1,1) = {"
wg
wg
wg
wg
wg
wg
wg
wg
wg
wg
wg
wg
wg
wg
wg
wg
wg
wg
wg
wg
wg
wg
wg
wg
wg
wg
wg
wg
wg
wg
wg
wg
wg
wg
wg
wg
wg
wg
wg
wg
wg
wg
wg
wg
wg
wg
wg
wg
wg
wg
"}
(50,1,1) = {"
wg
wg
wg
wg
wg
wg
wg
wg
wg
wg
wg
wg
wg
wg
wg
wg
wg
wg
wg
wg
wg
wg
wg
wg
wg
wg
wg
wg
wg
wg
wg
wg
wg
wg
wg
wg
wg
wg
wg
wg
wg
wg
wg
wg
wg
wg
wg
wg
wg
wg
"}
