//MAP CONVERTED BY dmm2tgm.py THIS HEADER COMMENT PREVENTS RECONVERSION, DO NOT REMOVE
"a" = (
/turf/template_noop,
/area/template_noop)
"b" = (
/obj/effect/spawner/structure/window/shuttle,
/obj/machinery/door/firedoor/window,
/turf/open/floor/plating,
/area/shuttle/mining/large)
"c" = (
/obj/effect/turf_decal/tile/brown,
/obj/effect/turf_decal/tile/brown{
	dir = 1
	},
/obj/effect/turf_decal/tile/brown{
	dir = 8
	},
/obj/effect/decal/cleanable/dirt,
/obj/machinery/computer/camera_advanced/shuttle_docker/nav,
/obj/effect/turf_decal/bot_white,
/turf/open/floor/plasteel/dark,
/area/shuttle/mining/large)
"d" = (
/obj/effect/turf_decal/tile/brown,
/obj/effect/turf_decal/tile/brown{
	dir = 8
	},
/obj/effect/turf_decal/bot_white,
/obj/machinery/computer/helm,
/turf/open/floor/plasteel/dark,
/area/shuttle/mining/large)
"e" = (
/obj/structure/table/reinforced,
/obj/item/clothing/mask/gas,
/obj/effect/turf_decal/tile/brown,
/obj/effect/turf_decal/tile/brown{
	dir = 4
	},
/obj/effect/turf_decal/tile/brown{
	dir = 8
	},
/obj/item/tank/internals/emergency_oxygen,
/turf/open/floor/plasteel/dark,
/area/shuttle/mining/large)
"f" = (
/obj/structure/table/reinforced,
/obj/effect/turf_decal/tile/brown,
/obj/effect/turf_decal/tile/brown{
	dir = 1
	},
/obj/effect/turf_decal/tile/brown{
	dir = 4
	},
/obj/item/storage/firstaid/regular,
/turf/open/floor/plasteel/dark,
/area/shuttle/mining/large)
"g" = (
/obj/effect/turf_decal/tile/neutral,
/obj/effect/turf_decal/tile/neutral{
	dir = 8
	},
/obj/effect/turf_decal/tile/neutral{
	dir = 4
	},
/obj/structure/chair/comfy/shuttle{
	dir = 1
	},
/obj/effect/turf_decal/tile/brown{
	dir = 1
	},
/obj/effect/turf_decal/bot_white,
/turf/open/floor/plasteel/dark,
/area/shuttle/mining)
"h" = (
/obj/effect/turf_decal/tile/neutral,
/obj/effect/turf_decal/tile/neutral{
	dir = 8
	},
/obj/effect/turf_decal/tile/neutral{
	dir = 4
	},
/obj/effect/turf_decal/tile/neutral{
	dir = 1
	},
/obj/structure/chair/comfy/shuttle{
	dir = 1
	},
/obj/effect/turf_decal/bot_white,
/turf/open/floor/plasteel/dark,
/area/shuttle/mining/large)
"i" = (
/obj/effect/turf_decal/tile/neutral,
/obj/effect/turf_decal/tile/neutral{
	dir = 8
	},
/obj/effect/turf_decal/tile/neutral{
	dir = 1
	},
/obj/structure/chair/comfy/shuttle{
	dir = 1
	},
/obj/effect/turf_decal/tile/brown{
	dir = 4
	},
/obj/effect/turf_decal/bot_white,
/turf/open/floor/plasteel/dark,
/area/shuttle/mining/large)
"j" = (
/obj/structure/table/reinforced,
/obj/effect/turf_decal/tile/brown{
	dir = 8
	},
/obj/effect/turf_decal/tile/brown{
	dir = 1
	},
/obj/effect/turf_decal/tile/brown{
	dir = 4
	},
/obj/item/stack/ore/iron{
	pixel_x = 6;
	pixel_y = 4
	},
/obj/item/stack/ore/iron{
	pixel_x = -2;
	pixel_y = -8
	},
/turf/open/floor/plasteel/dark,
/area/shuttle/mining/large)
"k" = (
/turf/closed/wall/mineral/titanium/nodiagonal,
/area/shuttle/mining/large)
"l" = (
/obj/structure/table/reinforced,
/obj/effect/turf_decal/tile/brown{
	dir = 8
	},
/obj/effect/turf_decal/tile/brown,
/obj/effect/turf_decal/tile/brown{
	dir = 4
	},
/obj/item/folder/yellow,
/obj/item/pen,
/obj/effect/decal/cleanable/dirt,
/turf/open/floor/plasteel/dark,
/area/shuttle/mining/large)
"m" = (
/obj/effect/turf_decal/tile/neutral,
/obj/effect/turf_decal/tile/neutral{
	dir = 4
	},
/obj/effect/turf_decal/tile/neutral{
	dir = 1
	},
/obj/effect/turf_decal/stripes/white/corner,
/obj/machinery/light/small,
/obj/effect/turf_decal/tile/brown{
	dir = 8
	},
/turf/open/floor/plasteel/dark,
/area/shuttle/mining/large)
"n" = (
/obj/effect/turf_decal/tile/neutral,
/obj/effect/turf_decal/tile/neutral{
	dir = 8
	},
/obj/effect/turf_decal/tile/neutral{
	dir = 4
	},
/obj/effect/turf_decal/tile/neutral{
	dir = 1
	},
/obj/effect/turf_decal/stripes/white/line,
/obj/machinery/atmospherics/components/unary/vent_pump/on/layer1,
/turf/open/floor/plasteel/dark,
/area/shuttle/mining/large)
"o" = (
/obj/effect/turf_decal/tile/neutral{
	dir = 8
	},
/obj/effect/turf_decal/tile/neutral{
	dir = 4
	},
/obj/effect/turf_decal/tile/neutral{
	dir = 1
	},
/obj/effect/turf_decal/stripes/white/corner{
	dir = 8
	},
/obj/machinery/light/small,
/obj/effect/turf_decal/tile/brown,
/obj/effect/decal/cleanable/dirt,
/obj/item/radio/intercom/wideband{
	pixel_y = -29
	},
/turf/open/floor/plasteel/dark,
/area/shuttle/mining/large)
"p" = (
/obj/structure/table/reinforced,
/obj/effect/turf_decal/tile/brown{
	dir = 8
	},
/obj/effect/turf_decal/tile/brown,
/obj/effect/turf_decal/tile/brown{
	dir = 1
	},
/obj/effect/decal/cleanable/dirt,
/obj/item/stock_parts/cell/high,
/obj/item/screwdriver{
	pixel_y = 18
	},
/obj/machinery/airalarm{
	dir = 8;
	pixel_x = 24
	},
/turf/open/floor/plasteel/dark,
/area/shuttle/mining/large)
"q" = (
/obj/machinery/status_display/shuttle{
	shuttle_id = "mining"
	},
/turf/closed/wall/mineral/titanium/nodiagonal,
/area/shuttle/mining/large)
"r" = (
/obj/effect/turf_decal/tile/neutral,
/obj/effect/turf_decal/tile/neutral{
	dir = 8
	},
/obj/effect/turf_decal/tile/neutral{
	dir = 4
	},
/obj/effect/turf_decal/tile/neutral{
	dir = 1
	},
/obj/machinery/door/airlock/mining{
	name = "Mining Shuttle Cockpit"
	},
/obj/machinery/atmospherics/pipe/simple/general/hidden/layer1,
/turf/open/floor/plasteel/dark,
/area/shuttle/mining/large)
"s" = (
/obj/item/clothing/suit/hazardvest{
	desc = "A high-visibility lifejacket complete with whistle and slot for oxygen tanks.";
	name = "emergency lifejacket"
	},
/obj/item/clothing/suit/hazardvest{
	desc = "A high-visibility lifejacket complete with whistle and slot for oxygen tanks.";
	name = "emergency lifejacket"
	},
/obj/item/tank/internals/emergency_oxygen{
	pixel_x = 3
	},
/obj/item/tank/internals/emergency_oxygen{
	pixel_x = 3
	},
/obj/item/clothing/mask/breath{
	pixel_x = -3;
	pixel_y = -3
	},
/obj/item/clothing/mask/breath{
	pixel_x = -3;
	pixel_y = -3
	},
/obj/structure/closet/crate/internals,
/obj/item/pickaxe/emergency,
/obj/effect/turf_decal/box/white/corners{
	dir = 1
	},
/obj/item/clothing/head/hardhat/mining,
/obj/item/clothing/head/hardhat/mining,
/obj/item/storage/overmap_ship/electric{
	pixel_x = -22
	},
/turf/open/floor/plasteel/dark,
/area/shuttle/mining/large)
"t" = (
/obj/effect/turf_decal/box/white/corners{
	dir = 4
	},
/obj/machinery/light/small{
	dir = 1
	},
/obj/machinery/atmospherics/components/unary/portables_connector/layer1{
	dir = 4
	},
/obj/machinery/portable_atmospherics/canister/air,
/turf/open/floor/plasteel/dark,
/area/shuttle/mining/large)
"u" = (
/obj/effect/turf_decal/tile/neutral,
/obj/effect/turf_decal/tile/neutral{
	dir = 8
	},
/obj/effect/turf_decal/tile/neutral{
	dir = 4
	},
/obj/effect/turf_decal/tile/neutral{
	dir = 1
	},
/obj/effect/turf_decal/stripes/white/line{
	dir = 1
	},
/obj/machinery/atmospherics/pipe/manifold4w/general/hidden/layer1,
/turf/open/floor/plasteel/dark,
/area/shuttle/mining/large)
"v" = (
/obj/effect/turf_decal/box/white/corners{
	dir = 1
	},
/obj/machinery/light/small{
	dir = 1
	},
/obj/machinery/atmospherics/components/unary/vent_pump/on/layer1{
	dir = 8
	},
/turf/open/floor/plasteel/dark,
/area/shuttle/mining/large)
"w" = (
/obj/effect/turf_decal/box/white/corners{
	dir = 4
	},
/obj/effect/decal/cleanable/dirt,
/obj/structure/ore_box,
/obj/structure/extinguisher_cabinet{
	pixel_x = 24
	},
/turf/open/floor/plasteel/dark,
/area/shuttle/mining/large)
"x" = (
/obj/effect/turf_decal/box/white/corners{
	dir = 8
	},
/obj/effect/decal/cleanable/dirt,
/obj/structure/cable{
	icon_state = "2-4"
	},
/turf/open/floor/plasteel/dark,
/area/shuttle/mining/large)
"y" = (
/obj/effect/turf_decal/box/white/corners,
/obj/structure/cable{
	icon_state = "4-8"
	},
/obj/structure/sign/warning/electricshock{
	pixel_y = -32
	},
/turf/open/floor/plasteel/dark,
/area/shuttle/mining/large)
"A" = (
/obj/effect/turf_decal/box/white/corners{
	dir = 8
	},
/obj/structure/cable{
	icon_state = "4-8"
	},
/obj/structure/sign/warning/electricshock{
	pixel_y = -32
	},
/turf/open/floor/plasteel/dark,
/area/shuttle/mining/large)
"B" = (
/obj/effect/turf_decal/box/white/corners,
/obj/structure/cable{
	icon_state = "2-8"
	},
/turf/open/floor/plasteel/dark,
/area/shuttle/mining/large)
"C" = (
/obj/effect/turf_decal/stripes/white/line{
	dir = 1
	},
/obj/machinery/power/terminal,
/obj/structure/cable,
/obj/structure/table,
/obj/item/screwdriver,
/obj/item/wrench,
/obj/item/storage/toolbox/emergency,
/turf/open/floor/plating,
/area/shuttle/mining/large)
"D" = (
/obj/machinery/door/airlock/external{
	name = "Mining Shuttle External Airlock"
	},
/obj/effect/mapping_helpers/airlock/cyclelink_helper,
/obj/structure/cable{
	icon_state = "1-2"
	},
/obj/machinery/atmospherics/pipe/simple/general/hidden/layer1,
/obj/machinery/atmospherics/components/binary/pump{
	dir = 1
	},
/turf/open/floor/plating,
/area/shuttle/mining/large)
"E" = (
/obj/effect/turf_decal/stripes/white/line{
	dir = 1
	},
/obj/effect/decal/cleanable/dirt,
/obj/machinery/power/terminal,
/obj/structure/cable,
/turf/open/floor/plating,
/area/shuttle/mining/large)
"F" = (
/turf/closed/wall/mineral/titanium,
/area/shuttle/mining/large)
"G" = (
/obj/structure/window/reinforced,
/obj/machinery/door/window/northleft{
	name = "Engine Access"
	},
/obj/machinery/power/smes/shuttle/precharged{
	dir = 1
	},
/obj/structure/cable{
	icon_state = "0-2"
	},
/turf/open/floor/plating,
/area/shuttle/mining/large)
"H" = (
/obj/structure/sign/warning/vacuum/external{
	pixel_x = 32
	},
/obj/structure/cable{
	icon_state = "1-2"
	},
/obj/machinery/light/small{
	dir = 8
	},
/obj/machinery/advanced_airlock_controller/lavaland{
	pixel_x = -27
	},
/obj/machinery/atmospherics/components/unary/vent_pump/layer1{
	dir = 1
	},
/obj/machinery/atmospherics/pipe/simple/supply/hidden,
/turf/open/floor/plating,
/area/shuttle/mining/large)
"I" = (
/obj/machinery/power/shuttle/engine/electric{
	dir = 1
	},
/obj/structure/cable,
/turf/open/floor/plating/airless,
/area/shuttle/mining/large)
"J" = (
/obj/machinery/door/airlock/external{
	name = "Mining Shuttle External Airlock"
	},
/obj/effect/mapping_helpers/airlock/cyclelink_helper{
	dir = 1
	},
/obj/docking_port/mobile{
	dwidth = 3;
	height = 10;
	id = "mining";
	name = "mining shuttle";
	port_direction = 2;
	width = 7
	},
/obj/structure/cable{
	icon_state = "1-2"
	},
/obj/machinery/atmospherics/pipe/simple/supply/hidden,
/turf/open/floor/plating,
/area/shuttle/mining/large)
"O" = (
/obj/effect/turf_decal/tile/neutral,
/obj/effect/turf_decal/tile/neutral{
	dir = 8
	},
/obj/effect/turf_decal/tile/neutral{
	dir = 4
	},
/obj/effect/turf_decal/tile/neutral{
	dir = 1
	},
/obj/effect/turf_decal/stripes/white/line,
/obj/structure/cable{
	icon_state = "2-4"
	},
/obj/structure/cable{
	icon_state = "2-8"
	},
/obj/machinery/atmospherics/pipe/layer_manifold,
/turf/open/floor/plasteel/dark,
/area/shuttle/mining/large)
"R" = (
/obj/structure/sign/departments/cargo,
/turf/closed/wall/mineral/titanium/nodiagonal,
/area/shuttle/mining/large)
"T" = (
/obj/structure/window/reinforced,
/obj/machinery/door/window/northright{
	name = "Engine Access"
	},
/obj/machinery/power/smes/shuttle/precharged{
	dir = 1
	},
/obj/structure/cable{
	icon_state = "0-2"
	},
/turf/open/floor/plating,
/area/shuttle/mining/large)

(1,1,1) = {"
a
b
b
k
k
k
b
k
F
a
"}
(2,1,1) = {"
b
b
f
l
R
s
x
C
G
I
"}
(3,1,1) = {"
b
c
g
m
q
t
y
k
k
k
"}
(4,1,1) = {"
b
d
h
n
r
u
O
D
H
J
"}
(5,1,1) = {"
b
e
i
o
k
v
A
k
k
k
"}
(6,1,1) = {"
b
b
j
p
k
w
B
E
T
I
"}
(7,1,1) = {"
a
b
b
k
k
k
b
k
F
a
"}
