//MAP CONVERTED BY dmm2tgm.py THIS HEADER COMMENT PREVENTS RECONVERSION, DO NOT REMOVE
"a" = (
/turf/template_noop,
/area/template_noop)
"c" = (
/obj/machinery/power/smes/shuttle/precharged{
	dir = 4
	},
/obj/structure/cable{
	icon_state = "0-8"
	},
/turf/open/floor/plating,
/area/ship/engineering/engine)
"d" = (
/obj/structure/window/bronze/fulltile,
/turf/open/floor/plating,
/area/ship/crew)
"e" = (
/obj/structure/closet/crate/coffin,
/obj/effect/spawner/lootdrop/maintenance/six,
/turf/open/floor/wood,
/area/ship/crew)
"f" = (
/obj/structure/closet/crate/coffin,
/obj/effect/spawner/lootdrop/maintenance/three,
/obj/machinery/atmospherics/components/unary/vent_scrubber/on/layer2{
	dir = 1
	},
/turf/open/floor/wood,
/area/ship/crew)
"g" = (
/turf/closed/wall/mineral/wood,
/area/ship/crew)
"h" = (
/obj/machinery/computer/helm{
	dir = 8
	},
/turf/open/floor/wood,
/area/ship/crew)
"i" = (
/obj/machinery/atmospherics/components/unary/outlet_injector/on/layer2{
	dir = 1
	},
/turf/open/floor/plating,
/area/ship/engineering/engine)
"j" = (
/obj/structure/cable{
	icon_state = "1-8"
	},
/obj/machinery/atmospherics/pipe/simple/supply/hidden/layer4{
	dir = 9
	},
/obj/machinery/atmospherics/pipe/simple/scrubbers/hidden/layer2{
	dir = 9
	},
/turf/open/floor/wood,
/area/ship/crew)
"k" = (
/obj/structure/cable{
	icon_state = "4-8"
	},
/obj/machinery/atmospherics/pipe/simple/supply/hidden/layer4{
	dir = 8
	},
/obj/machinery/atmospherics/pipe/simple/scrubbers/hidden/layer2{
	dir = 4
	},
/turf/open/floor/wood,
/area/ship/crew)
"l" = (
/obj/structure/bed/pod,
/obj/structure/curtain/cloth/black,
/turf/open/floor/wood,
/area/ship/crew)
"m" = (
/obj/structure/window/reinforced/survival_pod{
	dir = 8;
	opacity = 1
	},
/obj/machinery/computer/piratepad_control{
	dir = 1
	},
/turf/open/floor/wood,
/area/ship/crew)
"o" = (
/obj/machinery/power/shuttle/engine/electric{
	dir = 4
	},
/obj/structure/window/reinforced/survival_pod{
	dir = 4;
	opacity = 1
	},
/obj/structure/cable{
	icon_state = "0-4"
	},
/turf/open/floor/plating,
/area/ship/engineering/engine)
"p" = (
/obj/machinery/atmospherics/components/unary/tank/air{
	piping_layer = 4
	},
/turf/open/floor/wood,
/area/ship/engineering/engine)
"q" = (
/obj/machinery/atmospherics/pipe/simple/supply/hidden/layer4{
	dir = 8
	},
/obj/machinery/atmospherics/pipe/simple/scrubbers/hidden/layer2{
	dir = 8
	},
/turf/open/floor/wood,
/area/ship/crew)
"r" = (
/turf/closed/wall/mineral/wood,
/area/ship/engineering/engine)
"s" = (
/obj/structure/cable{
	icon_state = "1-8"
	},
/obj/structure/cable{
	icon_state = "4-8"
	},
/obj/machinery/atmospherics/pipe/simple/supply/hidden/layer4{
	dir = 8
	},
/obj/machinery/atmospherics/pipe/simple/scrubbers/hidden/layer2{
	dir = 4
	},
/turf/open/floor/wood,
/area/ship/engineering/engine)
"t" = (
/obj/machinery/power/port_gen/pacman,
/obj/machinery/power/terminal{
	dir = 8
	},
/obj/structure/cable{
	icon_state = "0-8"
	},
/obj/machinery/light,
/turf/open/floor/wood,
/area/ship/engineering/engine)
"u" = (
/obj/structure/cable{
	icon_state = "0-2"
	},
/obj/machinery/atmospherics/components/unary/vent_pump/on/layer4{
	dir = 8
	},
/obj/machinery/power/apc/auto_name/east,
/turf/open/floor/wood,
/area/ship/engineering/engine)
"v" = (
/obj/structure/window/bronze/fulltile,
/obj/machinery/atmospherics/pipe/simple/scrubbers/hidden/layer2,
/turf/open/floor/plating,
/area/ship/engineering/engine)
"w" = (
/obj/structure/table/wood,
/obj/machinery/microwave,
/turf/open/floor/wood,
/area/ship/crew)
"x" = (
/obj/structure/window/reinforced/survival_pod{
	dir = 1
	},
/obj/structure/bed/pod,
/obj/structure/curtain/cloth/black,
/turf/open/floor/wood,
/area/ship/crew)
"y" = (
/obj/structure/table/wood,
/obj/item/clothing/suit/space/pirate,
/obj/item/clothing/head/helmet/space/pirate/bandana,
/obj/item/melee/transforming/energy/sword/pirate,
/obj/machinery/light{
	dir = 8
	},
/turf/open/floor/wood,
/area/ship/crew)
"z" = (
/obj/machinery/autolathe,
/turf/open/floor/wood,
/area/ship/crew)
"A" = (
/obj/machinery/atmospherics/pipe/simple/supply/hidden/layer4{
	dir = 9
	},
/obj/machinery/atmospherics/pipe/simple/scrubbers/hidden/layer2{
	dir = 10
	},
/turf/open/floor/wood,
/area/ship/crew)
"B" = (
/obj/structure/ore_box,
/turf/open/floor/wood,
/area/ship/crew)
"D" = (
/obj/structure/table/wood,
/obj/item/storage/belt/utility,
/obj/item/storage/belt/utility,
/obj/item/storage/toolbox/mechanical{
	pixel_y = 6
	},
/obj/item/storage/toolbox/electrical{
	pixel_y = 10
	},
/obj/item/storage/toolbox/syndicate{
	pixel_y = -4
	},
/obj/item/storage/toolbox/emergency/shuttle/electric,
/obj/item/clothing/gloves/color/red/insulated,
/obj/item/clothing/gloves/color/red/insulated,
/obj/machinery/airalarm/directional/north,
/turf/open/floor/wood,
/area/ship/engineering/engine)
"E" = (
/obj/structure/closet/crate/coffin,
/obj/effect/spawner/lootdrop/maintenance/four,
/turf/open/floor/wood,
/area/ship/crew)
"F" = (
/obj/structure/cable{
	icon_state = "2-8"
	},
/obj/structure/cable{
	icon_state = "1-2"
	},
/obj/structure/cable{
	icon_state = "2-4"
	},
/obj/machinery/atmospherics/pipe/simple/supply/hidden/layer4{
	dir = 5
	},
/obj/machinery/atmospherics/pipe/manifold/scrubbers/hidden/layer2{
	dir = 8
	},
/turf/open/floor/wood,
/area/ship/engineering/engine)
"G" = (
/obj/structure/chair/wood{
	dir = 4
	},
/turf/open/floor/wood,
/area/ship/crew)
"H" = (
/obj/machinery/computer/autopilot{
	dir = 8
	},
/turf/open/floor/wood,
/area/ship/crew)
"I" = (
/obj/structure/window/bronze/fulltile,
/obj/docking_port/mobile{
	can_move_docking_ports = 1;
	dir = 8;
	id = "pirate2";
	launch_status = 0;
	undock_roundstart = 1
	},
/turf/open/floor/plating,
/area/ship/crew)
"J" = (
/obj/machinery/power/smes/engineering,
/obj/structure/cable,
/obj/machinery/atmospherics/pipe/simple/scrubbers/hidden/layer2,
/turf/open/floor/wood,
/area/ship/engineering/engine)
"K" = (
/obj/machinery/door/window/survival_pod{
	dir = 1
	},
/turf/open/floor/wood,
/area/ship/crew)
"L" = (
/obj/structure/closet/crate,
/obj/effect/spawner/lootdrop/maintenance/eight,
/obj/item/stack/sheet/metal/fifty,
/obj/item/stack/sheet/glass/fifty,
/turf/open/floor/wood,
/area/ship/crew)
"M" = (
/obj/structure/window/reinforced/survival_pod{
	dir = 1
	},
/turf/open/floor/wood,
/area/ship/crew)
"N" = (
/obj/structure/table/wood,
/obj/item/areaeditor/shuttle,
/obj/machinery/light{
	dir = 4
	},
/obj/machinery/airalarm/directional/north,
/obj/item/storage/firstaid/advanced,
/obj/item/storage/firstaid/advanced,
/obj/item/circuitboard/computer/operating,
/turf/open/floor/wood,
/area/ship/crew)
"O" = (
/turf/open/floor/wood,
/area/ship/crew)
"P" = (
/obj/structure/fans/tiny,
/obj/machinery/door/poddoor{
	id = "piratedoors";
	name = "Plundering Accessibility Device"
	},
/turf/open/floor/wood,
/area/ship/crew)
"Q" = (
/obj/machinery/piratepad,
/turf/open/floor/wood,
/area/ship/crew)
"R" = (
/obj/structure/cable{
	icon_state = "0-2"
	},
/obj/machinery/atmospherics/pipe/simple/supply/hidden/layer4{
	dir = 6
	},
/obj/machinery/power/apc/auto_name/west,
/obj/machinery/ore_silo,
/obj/machinery/atmospherics/pipe/simple/scrubbers/hidden/layer2{
	dir = 6
	},
/turf/open/floor/wood,
/area/ship/crew)
"S" = (
/obj/item/clothing/suit/pirate/captain,
/obj/item/clothing/head/helmet/space/pirate,
/obj/item/melee/transforming/energy/sword/pirate,
/obj/item/clothing/head/pirate/captain,
/obj/machinery/light,
/obj/structure/closet/cabinet,
/turf/open/floor/wood,
/area/ship/crew)
"T" = (
/obj/structure/cable{
	icon_state = "2-8"
	},
/obj/machinery/atmospherics/pipe/manifold/supply/hidden/layer4{
	dir = 8
	},
/obj/machinery/atmospherics/components/unary/vent_scrubber/on/layer2,
/turf/open/floor/wood,
/area/ship/engineering/engine)
"U" = (
/obj/structure/window/bronze/fulltile,
/turf/open/floor/plating,
/area/ship/engineering/engine)
"V" = (
/obj/structure/tank_dispenser/oxygen,
/turf/open/floor/wood,
/area/ship/crew)
"W" = (
/obj/structure/fans/tiny,
/obj/machinery/door/poddoor{
	id = "piratedoors";
	name = "Plundering Accessibility Device"
	},
/obj/machinery/button/door{
	id = "piratedoors";
	pixel_x = 25
	},
/turf/open/floor/wood,
/area/ship/crew)
"X" = (
/obj/structure/window/reinforced/survival_pod{
	dir = 1
	},
/obj/machinery/cryopod/latejoin{
	dir = 1
	},
/turf/open/floor/wood,
/area/ship/crew)
"Y" = (
/obj/machinery/atmospherics/components/unary/vent_pump/on/layer4,
/obj/structure/closet/crate/miningcar,
/obj/item/pickaxe/silver,
/obj/item/pickaxe/silver,
/obj/item/mining_scanner,
/obj/item/mining_scanner,
/obj/item/storage/bag/ore,
/obj/item/storage/bag/ore,
/obj/item/clothing/glasses/meson,
/obj/item/clothing/glasses/meson,
/turf/open/floor/wood,
/area/ship/crew)
"Z" = (
/obj/structure/table/wood,
/obj/effect/spawner/lootdrop/donkpockets,
/obj/effect/spawner/lootdrop/donkpockets,
/obj/effect/spawner/lootdrop/donkpockets,
/turf/open/floor/wood,
/area/ship/crew)

(1,1,1) = {"
a
a
r
o
o
r
a
a
"}
(2,1,1) = {"
a
r
r
c
c
r
r
a
"}
(3,1,1) = {"
a
U
p
T
F
J
v
i
"}
(4,1,1) = {"
a
r
D
u
s
t
U
a
"}
(5,1,1) = {"
g
g
g
g
k
g
g
g
"}
(6,1,1) = {"
g
z
y
R
j
X
w
d
"}
(7,1,1) = {"
P
O
O
q
O
M
Z
d
"}
(8,1,1) = {"
P
E
Y
A
f
K
S
g
"}
(9,1,1) = {"
W
B
O
L
O
M
O
d
"}
(10,1,1) = {"
g
V
e
O
Q
x
l
d
"}
(11,1,1) = {"
g
g
N
G
G
m
g
g
"}
(12,1,1) = {"
a
g
g
h
H
g
g
a
"}
(13,1,1) = {"
a
a
g
d
I
g
a
a
"}
