//MAP CONVERTED BY dmm2tgm.py THIS HEADER COMMENT PREVENTS RECONVERSION, DO NOT REMOVE
"a" = (
/turf/open/space/basic,
/area/space)
"d" = (
/obj/structure/tank_dispenser,
/turf/open/floor/plating,
/area/space)
"e" = (
/obj/effect/spawner/structure/window/plasma/reinforced,
/turf/open/floor/plating,
/area/space)
"f" = (
/obj/effect/turf_decal/trimline/red/filled/line{
	dir = 9
	},
/turf/open/floor/plasteel/dark,
/area/space)
"g" = (
/obj/effect/turf_decal/trimline/red/filled/line{
	dir = 1
	},
/turf/open/floor/plasteel/dark,
/area/space)
"h" = (
/obj/effect/turf_decal/trimline/red/filled/line{
	dir = 5
	},
/turf/open/floor/plasteel/dark,
/area/space)
"j" = (
/obj/effect/turf_decal/trimline/red/filled/line{
	dir = 10
	},
/turf/open/floor/plasteel/dark,
/area/space)
"m" = (
/obj/effect/turf_decal/trimline/red/filled/line,
/turf/open/floor/plasteel/dark,
/area/space)
"o" = (
/turf/open/floor/plating,
/area/space)
"q" = (
/obj/machinery/door/airlock/glass,
/turf/open/floor/plasteel,
/area/space)
"s" = (
/turf/open/floor/engine/air,
/area/space)
"t" = (
/obj/effect/turf_decal/trimline/red/filled/line{
	dir = 4
	},
/turf/open/floor/plasteel/dark,
/area/space)
"u" = (
/turf/closed/wall/mineral/titanium,
/area/space)
"w" = (
/obj/effect/turf_decal/trimline/red/filled/line{
	dir = 6
	},
/turf/open/floor/plasteel/dark,
/area/space)
"x" = (
/obj/machinery/power/shuttle/engine/electric{
	dir = 1
	},
/turf/open/floor/plating,
/area/space)
"y" = (
/turf/open/floor/plasteel/dark,
/area/space)
"z" = (
/obj/effect/turf_decal/trimline/red/filled/line,
/turf/open/floor/plasteel/dark,
/area/space)
"A" = (
/turf/open/floor/plasteel,
/area/space)
"D" = (
/obj/effect/turf_decal/trimline/red/filled/line{
	dir = 8
	},
/turf/open/floor/plasteel/dark,
/area/space)
"G" = (
/obj/machinery/mass_driver{
	dir = 1
	},
/turf/open/floor/plating,
/area/space)
"H" = (
/obj/machinery/door/airlock/external/glass,
/turf/open/floor/plasteel,
/area/space)
"I" = (
/obj/effect/spawner/structure/window/shuttle,
/turf/open/floor/plating,
/area/space)
"N" = (
/obj/machinery/suit_storage_unit,
/turf/open/floor/plasteel,
/area/space)
"O" = (
/obj/machinery/power/smes/shuttle/precharged{
	dir = 1
	},
/obj/structure/window/reinforced/survival_pod,
/turf/open/floor/plating,
/area/space)
"P" = (
/obj/structure/window/plasma/reinforced/spawner,
/turf/open/floor/engine/air,
/area/space)
"T" = (
/obj/effect/spawner/structure/window/shuttle,
/turf/open/floor/plasteel/dark,
/area/space)
"V" = (
/obj/machinery/door/airlock/maintenance_hatch,
/turf/open/floor/plating,
/area/space)
"Y" = (
/obj/structure/fans/tiny,
/obj/machinery/door/poddoor,
/turf/open/floor/plating,
/area/space)

(1,1,1) = {"
a
a
a
a
a
a
a
a
a
a
a
a
a
a
a
a
a
a
a
a
a
a
a
a
a
a
a
a
a
a
"}
(2,1,1) = {"
a
a
a
a
a
a
a
a
a
a
a
a
a
a
a
u
u
u
u
u
u
u
u
u
u
a
a
a
a
a
"}
(3,1,1) = {"
a
a
a
a
a
a
a
a
a
a
a
u
u
u
u
u
o
o
o
o
u
o
o
o
O
x
a
a
a
a
"}
(4,1,1) = {"
a
a
a
a
a
a
a
a
a
u
u
u
A
A
u
o
o
o
o
o
V
o
o
o
O
x
a
a
a
a
"}
(5,1,1) = {"
a
a
a
a
a
a
a
a
u
u
A
A
A
A
V
o
o
o
o
o
u
o
o
o
O
x
a
a
a
a
"}
(6,1,1) = {"
a
a
a
a
a
a
a
a
u
u
A
A
A
A
u
u
u
u
u
u
u
u
u
u
u
u
a
a
a
a
"}
(7,1,1) = {"
a
a
a
a
a
a
a
a
a
u
A
A
A
A
u
s
P
s
P
s
P
s
s
u
u
a
a
a
a
a
"}
(8,1,1) = {"
a
a
a
a
a
a
a
a
u
u
A
A
A
A
u
s
P
s
P
s
P
s
s
u
a
a
a
a
a
a
"}
(9,1,1) = {"
a
a
a
a
a
a
u
u
u
u
u
u
u
q
u
e
e
e
e
e
e
e
e
u
a
a
a
a
a
a
"}
(10,1,1) = {"
a
a
a
a
a
u
u
o
o
o
u
A
A
A
u
A
A
A
A
A
A
A
A
u
a
a
a
a
a
a
"}
(11,1,1) = {"
a
a
a
a
u
u
o
o
o
o
V
A
A
A
u
A
A
A
A
A
A
A
A
u
a
a
a
a
a
a
"}
(12,1,1) = {"
a
a
a
a
Y
G
o
o
o
o
u
A
A
A
A
A
A
A
A
A
A
A
A
u
u
a
a
a
a
a
"}
(13,1,1) = {"
a
a
a
u
u
u
u
u
o
u
u
A
A
A
u
u
u
u
u
A
u
u
u
u
u
u
a
a
a
a
"}
(14,1,1) = {"
a
a
a
u
y
y
y
u
u
u
f
D
D
D
j
A
I
A
A
A
A
A
u
N
N
u
a
a
a
a
"}
(15,1,1) = {"
a
a
a
T
y
y
y
y
A
A
g
w
y
h
z
A
I
A
A
A
A
A
H
A
A
H
a
a
a
a
"}
(16,1,1) = {"
a
a
a
T
y
y
y
u
A
A
g
y
y
y
z
A
u
A
A
A
A
A
u
A
A
u
a
a
a
a
"}
(17,1,1) = {"
a
a
a
T
y
y
y
y
A
A
g
j
y
f
z
A
I
A
A
A
A
A
H
A
A
H
a
a
a
a
"}
(18,1,1) = {"
a
a
a
u
y
y
y
u
u
u
h
t
t
t
w
A
I
A
A
A
A
A
u
N
N
u
a
a
a
a
"}
(19,1,1) = {"
a
a
a
u
u
u
u
u
o
u
u
A
A
A
u
u
u
u
u
A
u
u
u
u
u
u
a
a
a
a
"}
(20,1,1) = {"
a
a
a
a
Y
G
o
o
o
o
u
A
A
A
A
A
A
A
A
A
A
A
A
u
u
a
a
a
a
a
"}
(21,1,1) = {"
a
a
a
a
u
u
o
o
d
o
V
A
A
A
A
A
u
A
A
A
A
A
A
u
a
a
a
a
a
a
"}
(22,1,1) = {"
a
a
a
a
a
u
u
o
o
o
u
A
A
A
A
A
u
A
A
A
A
A
A
u
a
a
a
a
a
a
"}
(23,1,1) = {"
a
a
a
a
a
a
u
u
u
u
u
u
u
A
u
u
u
u
A
A
A
A
u
u
a
a
a
a
a
a
"}
(24,1,1) = {"
a
a
a
a
a
a
a
a
u
u
A
A
A
A
u
A
A
u
u
A
A
u
u
u
a
a
a
a
a
a
"}
(25,1,1) = {"
a
a
a
a
a
a
a
a
a
u
A
A
A
A
u
A
A
A
u
I
V
u
u
u
u
a
a
a
a
a
"}
(26,1,1) = {"
a
a
a
a
a
a
a
a
u
u
A
A
A
A
u
A
A
A
u
o
o
o
o
u
u
u
a
a
a
a
"}
(27,1,1) = {"
a
a
a
a
a
a
a
a
u
u
A
A
A
A
u
A
A
A
u
o
o
o
o
o
O
x
a
a
a
a
"}
(28,1,1) = {"
a
a
a
a
a
a
a
a
a
u
u
u
A
A
u
A
A
A
u
o
o
o
o
o
O
x
a
a
a
a
"}
(29,1,1) = {"
a
a
a
a
a
a
a
a
a
a
a
u
u
u
u
u
A
A
u
o
o
o
o
o
O
x
a
a
a
a
"}
(30,1,1) = {"
a
a
a
a
a
a
a
a
a
a
a
a
a
a
a
u
u
u
u
u
u
u
u
u
u
a
a
a
a
a
"}
