//MAP CONVERTED BY dmm2tgm.py THIS HEADER COMMENT PREVENTS RECONVERSION, DO NOT REMOVE
"ab" = (
/turf/open/floor/engine/hull,
/area/template_noop)
"bj" = (
/obj/effect/turf_decal/syndicateemblem/middle/middle,
/turf/open/floor/mineral/plastitanium/red,
/area/template_noop)
"bO" = (
/obj/machinery/mineral/ore_redemption,
/turf/open/floor/plasteel/dark,
/area/template_noop)
"bR" = (
/turf/open/floor/engine/plasma,
/area/template_noop)
"cl" = (
/turf/open/floor/engine/o2,
/area/template_noop)
"ct" = (
/obj/structure/closet,
/obj/item/clothing/under/syndicate/skirt,
/obj/item/clothing/under/syndicate/skirt,
/obj/item/clothing/under/syndicate/bloodred/sleepytime,
/obj/item/clothing/under/syndicate/bloodred/sleepytime,
/obj/item/clothing/under/syndicate/bloodred/sleepytime,
/obj/item/clothing/under/syndicate/bloodred/sleepytime,
/obj/item/clothing/under/syndicate/bloodred/sleepytime,
/obj/item/clothing/under/syndicate,
/obj/item/clothing/under/syndicate,
/obj/item/clothing/under/syndicate,
/obj/item/clothing/under/syndicate/skirt,
/obj/item/clothing/under/syndicate/intern,
/obj/item/clothing/under/syndicate/intern,
/obj/item/clothing/under/syndicate/intern,
/obj/item/clothing/under/syndicate/intern,
/obj/item/clothing/under/syndicate/intern,
/obj/item/clothing/under/syndicate/intern,
/turf/open/floor/mineral/plastitanium,
/area/template_noop)
"dh" = (
/obj/structure/table/reinforced,
/turf/open/floor/plasteel/dark,
/area/template_noop)
"dB" = (
/turf/open/floor/mineral/plastitanium{
	color = "#68b9ff"
	},
/area/template_noop)
"dQ" = (
/obj/machinery/power/shuttle/engine/fueled/plasma{
	dir = 1
	},
/turf/open/floor/plating,
/area/template_noop)
"ee" = (
/obj/structure/window/reinforced/survival_pod{
	dir = 10
	},
/turf/open/floor/mineral/plastitanium{
	color = "#f3b3fe"
	},
/area/template_noop)
"es" = (
/obj/structure/frame/machine,
/turf/open/floor/mineral/plastitanium{
	color = "#68b9ff"
	},
/area/template_noop)
"ey" = (
/obj/machinery/power/shuttle/engine/electric,
/obj/structure/cable{
	icon_state = "0-2"
	},
/turf/open/floor/plating,
/area/template_noop)
"eL" = (
/obj/structure/table/glass,
/obj/item/nanite_remote,
/obj/item/nanite_remote/comm,
/obj/item/nanite_scanner,
/obj/item/storage/box/disks_nanite,
/turf/open/floor/mineral/plastitanium{
	color = "#f3b3fe"
	},
/area/template_noop)
"fg" = (
/obj/machinery/power/smes/shuttle/precharged,
/obj/structure/cable,
/turf/open/floor/plating,
/area/template_noop)
"fA" = (
/turf/open/floor/mineral/plastitanium{
	color = "#ff8649"
	},
/area/template_noop)
"gi" = (
/turf/open/floor/plasteel/dark,
/area/template_noop)
"gI" = (
/obj/machinery/suit_storage_unit/syndicate,
/turf/open/floor/plasteel/dark,
/area/template_noop)
"hh" = (
/obj/structure/cable{
	icon_state = "1-4"
	},
/turf/open/floor/plating,
/area/template_noop)
"hm" = (
/obj/machinery/cryopod/latejoin{
	dir = 1
	},
/turf/open/floor/mineral/plastitanium/red,
/area/template_noop)
"hs" = (
/obj/structure/cable{
	icon_state = "2-8"
	},
/obj/structure/cable{
	icon_state = "1-2"
	},
/turf/open/floor/plasteel/dark,
/area/template_noop)
"ht" = (
/turf/open/floor/mineral/plastitanium{
	color = "#f3b3fe"
	},
/area/template_noop)
"hR" = (
/obj/structure/cable{
	icon_state = "2-4"
	},
/obj/structure/cable{
	icon_state = "1-2"
	},
/turf/open/floor/plasteel/dark,
/area/template_noop)
"io" = (
/obj/structure/cable{
	icon_state = "2-4"
	},
/turf/open/floor/mineral/plastitanium{
	color = "#f3b3fe"
	},
/area/template_noop)
"ix" = (
/obj/structure/cable{
	icon_state = "1-2"
	},
/obj/structure/cable{
	icon_state = "2-8"
	},
/turf/open/floor/plasteel/dark,
/area/template_noop)
"iy" = (
/obj/structure/cable{
	icon_state = "1-8"
	},
/turf/open/floor/mineral/plastitanium{
	color = "#f3b3fe"
	},
/area/template_noop)
"iL" = (
/obj/structure/closet/emcloset,
/turf/open/floor/plasteel/dark,
/area/template_noop)
"iU" = (
/obj/structure/cable{
	icon_state = "2-4"
	},
/obj/structure/cable{
	icon_state = "1-2"
	},
/turf/open/floor/plasteel/dark,
/area/template_noop)
"je" = (
/obj/structure/cable{
	icon_state = "1-8"
	},
/turf/closed/wall/mineral/plastitanium/nodiagonal,
/area/template_noop)
"jf" = (
/obj/structure/cable{
	icon_state = "1-8"
	},
/turf/open/floor/plasteel/dark,
/area/template_noop)
"jg" = (
/obj/structure/cable{
	icon_state = "2-8"
	},
/turf/closed/wall/mineral/plastitanium/nodiagonal,
/area/template_noop)
"js" = (
/obj/structure/cable{
	icon_state = "2-8"
	},
/turf/open/floor/plasteel/dark,
/area/template_noop)
"jB" = (
/obj/structure/closet/firecloset,
/turf/open/floor/plasteel/dark,
/area/template_noop)
"jF" = (
/obj/structure/cable{
	icon_state = "1-4"
	},
/obj/structure/frame/machine,
/turf/open/floor/mineral/plastitanium{
	color = "#68b9ff"
	},
/area/template_noop)
"jN" = (
/obj/structure/cable{
	icon_state = "2-8"
	},
/turf/open/floor/mineral/plastitanium{
	color = "#68b9ff"
	},
/area/template_noop)
"jZ" = (
/obj/effect/turf_decal/syndicateemblem/middle/left,
/turf/open/floor/mineral/plastitanium/red,
/area/template_noop)
"kl" = (
/obj/machinery/chem_master,
/turf/open/floor/mineral/plastitanium{
	color = "#68b9ff"
	},
/area/template_noop)
"lh" = (
/obj/structure/window/reinforced/survival_pod,
/turf/open/floor/mineral/plastitanium{
	color = "#f3b3fe"
	},
/area/template_noop)
"lr" = (
/obj/machinery/door/poddoor,
/turf/open/floor/plasteel/dark,
/area/template_noop)
"lA" = (
/obj/effect/turf_decal/syndicateemblem/bottom/right,
/turf/open/floor/mineral/plastitanium/red,
/area/template_noop)
"lN" = (
/obj/structure/window/reinforced/survival_pod,
/obj/structure/table/glass,
/obj/machinery/reagentgrinder,
/obj/item/storage/box/syringes,
/obj/item/storage/box/beakers,
/turf/open/floor/mineral/plastitanium{
	color = "#68b9ff"
	},
/area/template_noop)
"lV" = (
/obj/machinery/computer/turbine_computer{
	dir = 1;
	id = "incineratorturbine"
	},
/turf/open/floor/plating,
/area/template_noop)
"mH" = (
/obj/structure/cable{
	icon_state = "1-2"
	},
/obj/machinery/door/window/survival_pod,
/turf/open/floor/mineral/plastitanium{
	color = "#68b9ff"
	},
/area/template_noop)
"mM" = (
/obj/machinery/smartfridge/chemistry,
/obj/machinery/door/window/survival_pod,
/turf/open/floor/mineral/plastitanium{
	color = "#68b9ff"
	},
/area/template_noop)
"mX" = (
/turf/open/floor/mineral/plastitanium{
	color = "#68b9ff"
	},
/area/template_noop)
"na" = (
/turf/open/floor/mineral/plastitanium{
	color = "#68b9ff"
	},
/area/template_noop)
"nx" = (
/obj/structure/cable{
	icon_state = "1-8"
	},
/turf/open/floor/plating,
/area/template_noop)
"nJ" = (
/obj/machinery/power/terminal{
	dir = 1
	},
/obj/structure/cable{
	icon_state = "0-2"
	},
/turf/open/floor/plating,
/area/template_noop)
"ou" = (
/obj/structure/cable{
	icon_state = "2-4"
	},
/turf/open/floor/plasteel/dark,
/area/template_noop)
"oK" = (
/obj/machinery/door/poddoor,
/obj/structure/fans/tiny,
/turf/open/floor/plasteel/dark,
/area/template_noop)
"pE" = (
/obj/effect/turf_decal/syndicateemblem/middle/right,
/turf/open/floor/mineral/plastitanium/red,
/area/template_noop)
"pR" = (
/obj/machinery/smartfridge/bloodbank/preloaded,
/turf/open/floor/mineral/plastitanium/red,
/area/template_noop)
"qo" = (
/turf/open/floor/mineral/plastitanium{
	color = "#f3b3fe"
	},
/area/template_noop)
"qq" = (
/obj/machinery/nanite_programmer,
/turf/open/floor/mineral/plastitanium{
	color = "#f3b3fe"
	},
/area/template_noop)
"qR" = (
/obj/structure/table/glass,
/obj/item/storage/firstaid/toxin{
	pixel_x = 3;
	pixel_y = 2
	},
/obj/item/storage/firstaid/brute,
/obj/item/storage/firstaid/regular,
/obj/item/defibrillator/compact/loaded,
/obj/structure/window/reinforced/survival_pod{
	dir = 1
	},
/obj/machinery/door/window/survival_pod{
	dir = 8
	},
/turf/open/floor/mineral/plastitanium{
	color = "#68b9ff"
	},
/area/template_noop)
"rV" = (
/obj/structure/table/reinforced,
/turf/open/floor/plasteel/dark,
/area/template_noop)
"si" = (
/obj/structure/window/reinforced/survival_pod{
	dir = 8
	},
/turf/open/floor/mineral/plastitanium{
	color = "#68b9ff"
	},
/area/template_noop)
"sk" = (
/obj/structure/table/glass,
/obj/item/reagent_containers/glass/bottle/formaldehyde{
	pixel_x = -10;
	pixel_y = 8
	},
/obj/item/reagent_containers/glass/bottle/charcoal{
	pixel_x = 9;
	pixel_y = 8
	},
/obj/item/reagent_containers/glass/bottle/epinephrine{
	pixel_y = 8
	},
/obj/item/reagent_containers/syringe,
/obj/structure/window/reinforced/survival_pod,
/obj/structure/window/reinforced/survival_pod{
	dir = 1
	},
/obj/machinery/door/window/survival_pod{
	dir = 8
	},
/turf/open/floor/mineral/plastitanium{
	color = "#f3b3fe"
	},
/area/template_noop)
"sA" = (
/obj/machinery/door/window/survival_pod{
	dir = 8
	},
/turf/open/floor/mineral/plastitanium{
	color = "#68b9ff"
	},
/area/template_noop)
"sN" = (
/obj/machinery/power/turbine{
	luminosity = 2
	},
/turf/open/floor/engine/vacuum,
/area/template_noop)
"tY" = (
/turf/open/floor/mineral/plastitanium{
	color = "#f3b3fe"
	},
/area/template_noop)
"tZ" = (
/obj/machinery/ore_silo,
/turf/open/floor/plasteel/dark,
/area/template_noop)
"uH" = (
/obj/structure/window/reinforced/survival_pod{
	dir = 8
	},
/turf/open/floor/mineral/plastitanium{
	color = "#f3b3fe"
	},
/area/template_noop)
"vd" = (
/turf/open/floor/mineral/plastitanium{
	color = "#68b9ff"
	},
/area/template_noop)
"wa" = (
/obj/item/clothing/under/rank/rnd/scientist/nanite,
/turf/open/floor/mineral/plastitanium{
	color = "#f3b3fe"
	},
/area/template_noop)
"wn" = (
/obj/structure/sink{
	dir = 4;
	pixel_x = -12
	},
/obj/structure/mirror{
	pixel_x = -24
	},
/turf/open/floor/mineral/plastitanium{
	color = "#68b9ff"
	},
/area/template_noop)
"xj" = (
/obj/machinery/door/poddoor/incinerator_atmos_main,
/turf/open/floor/engine/vacuum,
/area/template_noop)
"xY" = (
/obj/machinery/nanite_program_hub,
/turf/open/floor/mineral/plastitanium{
	color = "#f3b3fe"
	},
/area/template_noop)
"zO" = (
/obj/structure/tank_dispenser/oxygen,
/turf/open/floor/mineral/plastitanium,
/area/template_noop)
"Ad" = (
/obj/effect/turf_decal/syndicateemblem/bottom/middle,
/turf/open/floor/mineral/plastitanium/red,
/area/template_noop)
"At" = (
/turf/open/floor/mineral/plastitanium{
	color = "#f3b3fe"
	},
/area/template_noop)
"AM" = (
/turf/open/floor/mineral/plastitanium{
	color = "#68b9ff"
	},
/area/template_noop)
"AW" = (
/obj/effect/turf_decal/syndicateemblem/bottom/left,
/turf/open/floor/mineral/plastitanium/red,
/area/template_noop)
"Be" = (
/obj/effect/turf_decal/syndicateemblem/top/left,
/turf/open/floor/mineral/plastitanium/red,
/area/template_noop)
"Cr" = (
/obj/machinery/door/window/survival_pod,
/turf/open/floor/mineral/plastitanium{
	color = "#f3b3fe"
	},
/area/template_noop)
"Ct" = (
/obj/machinery/power/compressor{
	comp_id = "incineratorturbine";
	dir = 1;
	luminosity = 2
	},
/turf/open/floor/engine/vacuum,
/area/template_noop)
"CH" = (
/obj/machinery/door/poddoor,
/obj/structure/fans/tiny,
/turf/open/floor/mineral/plastitanium,
/area/template_noop)
"Dn" = (
/obj/structure/window/plasma/reinforced/spawner/west,
/obj/machinery/door/poddoor/incinerator_atmos_aux,
/turf/open/floor/engine/vacuum,
/area/template_noop)
"DU" = (
/obj/machinery/atmospherics/components/binary/pump,
/turf/open/floor/plating,
/area/template_noop)
"Ee" = (
/obj/machinery/nanite_chamber,
/turf/open/floor/mineral/plastitanium{
	color = "#f3b3fe"
	},
/area/template_noop)
"En" = (
/obj/machinery/computer/nanite_chamber_control{
	dir = 8
	},
/turf/open/floor/mineral/plastitanium{
	color = "#f3b3fe"
	},
/area/template_noop)
"Ep" = (
/obj/structure/cable{
	icon_state = "1-8"
	},
/turf/open/floor/mineral/plastitanium/red,
/area/template_noop)
"FP" = (
/obj/structure/window/reinforced/survival_pod{
	dir = 8
	},
/obj/structure/window/reinforced/survival_pod,
/obj/structure/table/glass,
/turf/open/floor/mineral/plastitanium{
	color = "#68b9ff"
	},
/area/template_noop)
"Gf" = (
/turf/open/floor/mineral/plastitanium{
	color = "#68b9ff"
	},
/area/template_noop)
"GM" = (
/obj/item/clothing/under/rank/rnd/scientist/nanite/skirt,
/turf/open/floor/mineral/plastitanium{
	color = "#f3b3fe"
	},
/area/template_noop)
"HF" = (
/obj/structure/cable{
	icon_state = "1-2"
	},
/turf/closed/wall/mineral/plastitanium/nodiagonal,
/area/template_noop)
"HL" = (
/obj/structure/cable{
	icon_state = "2-4"
	},
/turf/closed/wall/mineral/plastitanium/nodiagonal,
/area/template_noop)
"HQ" = (
/obj/machinery/door/window/survival_pod,
/turf/open/floor/mineral/plastitanium{
	color = "#68b9ff"
	},
/area/template_noop)
"HS" = (
/obj/structure/fans/tiny,
/turf/open/floor/engine,
/area/template_noop)
"Ia" = (
/obj/docking_port/mobile{
	can_move_docking_ports = 1;
	dir = 2;
	id = "syndieship";
	launch_status = 0;
	name = "SSV Shenanigans";
	undock_roundstart = 1
	},
/turf/open/floor/engine/hull,
/area/template_noop)
"Io" = (
/obj/structure/cable{
	icon_state = "1-4"
	},
/turf/open/floor/plasteel/dark,
/area/template_noop)
"IK" = (
/obj/structure/cable{
	icon_state = "1-2"
	},
/turf/open/floor/mineral/plastitanium{
	color = "#f3b3fe"
	},
/area/template_noop)
"Ja" = (
/obj/structure/cable{
	icon_state = "4-8"
	},
/turf/open/floor/plasteel/dark,
/area/template_noop)
"Jw" = (
/turf/open/floor/mineral/plastitanium{
	color = "#68b9ff"
	},
/area/template_noop)
"JC" = (
/obj/machinery/door/poddoor,
/obj/structure/fans/tiny,
/turf/open/floor/mineral/plastitanium/red,
/area/template_noop)
"KB" = (
/obj/structure/cable{
	icon_state = "1-2"
	},
/turf/open/floor/mineral/plastitanium{
	color = "#68b9ff"
	},
/area/template_noop)
"KF" = (
/obj/machinery/mass_driver{
	dir = 1
	},
/turf/open/floor/plasteel/dark,
/area/template_noop)
"KK" = (
/obj/structure/chair/comfy/shuttle{
	dir = 1
	},
/obj/item/areaeditor/shuttle,
/turf/open/floor/mineral/plastitanium{
	color = "#f3b3fe"
	},
/area/template_noop)
"Ly" = (
/turf/open/floor/mineral/plastitanium{
	color = "#f3b3fe"
	},
/area/template_noop)
"LJ" = (
/obj/effect/turf_decal/syndicateemblem/top/right,
/turf/open/floor/mineral/plastitanium/red,
/area/template_noop)
"Mg" = (
/obj/structure/cable{
	icon_state = "1-2"
	},
/obj/machinery/vending/autodrobe/all_access{
	default_price = 0;
	extra_price = 0
	},
/turf/open/floor/mineral/plastitanium,
/area/template_noop)
"Mi" = (
/obj/structure/cable{
	icon_state = "1-4"
	},
/turf/open/floor/mineral/plastitanium/red,
/area/template_noop)
"Mm" = (
/obj/machinery/computer/nanite_cloud_controller,
/turf/open/floor/mineral/plastitanium{
	color = "#f3b3fe"
	},
/area/template_noop)
"Nc" = (
/obj/structure/cable{
	icon_state = "1-2"
	},
/turf/open/floor/mineral/plastitanium{
	color = "#68b9ff"
	},
/area/template_noop)
"Nr" = (
/turf/template_noop,
/area/template_noop)
"Nx" = (
/turf/open/floor/mineral/plastitanium{
	color = "#68b9ff"
	},
/area/template_noop)
"ND" = (
/turf/open/floor/mineral/plastitanium{
	color = "#68b9ff"
	},
/area/template_noop)
"Oj" = (
/obj/structure/closet/secure_closet/chemical/heisenberg{
	req_access = list(21)
	},
/obj/item/storage/box/bodybags,
/turf/open/floor/mineral/plastitanium{
	color = "#68b9ff"
	},
/area/template_noop)
"Pr" = (
/obj/structure/cable{
	icon_state = "1-4"
	},
/turf/closed/wall/mineral/plastitanium/nodiagonal,
/area/template_noop)
"Ql" = (
/obj/structure/cable{
	icon_state = "1-2"
	},
/turf/open/floor/plasteel/dark,
/area/template_noop)
"QT" = (
/obj/structure/cable{
	icon_state = "2-8"
	},
/turf/open/floor/mineral/plastitanium,
/area/template_noop)
"Rr" = (
/obj/structure/table/optable,
/turf/open/floor/mineral/plastitanium{
	color = "#68b9ff"
	},
/area/template_noop)
"RG" = (
/obj/structure/table/glass,
/obj/item/storage/backpack/duffelbag/syndie/surgery,
/obj/structure/window/reinforced/survival_pod{
	dir = 1
	},
/turf/open/floor/mineral/plastitanium{
	color = "#68b9ff"
	},
/area/template_noop)
"Sj" = (
/obj/structure/window/plasma/reinforced/spawner/west,
/turf/open/floor/engine/vacuum,
/area/template_noop)
"Ul" = (
/obj/machinery/door/window/survival_pod{
	dir = 1
	},
/turf/open/floor/mineral/plastitanium{
	color = "#68b9ff"
	},
/area/template_noop)
"VA" = (
/obj/structure/window/reinforced/survival_pod{
	dir = 1
	},
/obj/machinery/computer/operating{
	dir = 8
	},
/turf/open/floor/mineral/plastitanium{
	color = "#68b9ff"
	},
/area/template_noop)
"VC" = (
/turf/open/floor/mineral/plastitanium{
	color = "#f3b3fe"
	},
/area/template_noop)
"VN" = (
/obj/structure/cable{
	icon_state = "2-4"
	},
/turf/open/floor/mineral/plastitanium/red,
/area/template_noop)
"Wd" = (
/obj/machinery/computer/helm{
	id = null
	},
/turf/open/floor/mineral/plastitanium{
	color = "#f3b3fe"
	},
/area/template_noop)
"Wl" = (
/obj/structure/AIcore/latejoin_inactive,
/turf/open/floor/mineral/plastitanium{
	color = "#f3b3fe"
	},
/area/template_noop)
"Wn" = (
/obj/machinery/autolathe,
/turf/open/floor/mineral/plastitanium/red,
/area/template_noop)
"Wp" = (
/obj/structure/cable{
	icon_state = "1-4"
	},
/turf/open/floor/mineral/plastitanium,
/area/template_noop)
"Xx" = (
/turf/open/floor/engine/vacuum,
/area/template_noop)
"XP" = (
/turf/closed/wall/mineral/plastitanium/nodiagonal,
/area/template_noop)
"Yi" = (
/obj/machinery/atmospherics/components/unary/shuttle/heater{
	dir = 1
	},
/turf/open/floor/plating,
/area/template_noop)
"YL" = (
/turf/open/floor/mineral/plastitanium/red,
/area/template_noop)
"YW" = (
/obj/structure/fans/tiny,
/obj/machinery/door/poddoor,
/turf/open/floor/mineral/plastitanium,
/area/template_noop)
"YY" = (
/obj/effect/spawner/structure/window/plasma/reinforced/plastitanium,
/turf/open/floor/plating,
/area/template_noop)
"Zn" = (
/obj/structure/cable{
	icon_state = "1-2"
	},
/turf/open/floor/plasteel/dark,
/area/template_noop)
"Zo" = (
/turf/open/floor/mineral/plastitanium,
/area/template_noop)
"Zw" = (
/obj/effect/turf_decal/syndicateemblem/top/middle,
/turf/open/floor/mineral/plastitanium/red,
/area/template_noop)
"ZH" = (
/turf/open/floor/plating,
/area/template_noop)

(1,1,1) = {"
Nr
Nr
Nr
Nr
Nr
Nr
Nr
Nr
Nr
Nr
Nr
Nr
Nr
Nr
Nr
Nr
Nr
Nr
Nr
Nr
Nr
Nr
Nr
Nr
XP
XP
XP
XP
XP
XP
XP
Nr
Nr
Nr
Nr
Nr
Nr
Nr
Nr
Nr
Nr
Nr
Nr
Nr
Nr
"}
(2,1,1) = {"
Nr
Nr
Nr
Nr
XP
XP
XP
XP
XP
XP
XP
Nr
Nr
Nr
Nr
Nr
Nr
Nr
Nr
Nr
Nr
Nr
XP
YY
XP
VC
lh
xY
eL
qq
XP
YY
YY
XP
Nr
Nr
Nr
Nr
Nr
Nr
Nr
Nr
Nr
Nr
Nr
"}
(3,1,1) = {"
Nr
Nr
Nr
Nr
ey
fg
nJ
hh
gi
gi
XP
XP
Nr
Nr
Nr
Nr
Nr
Nr
Nr
Nr
Nr
XP
XP
VC
VC
VC
Cr
wa
GM
VC
XP
Zo
Zo
XP
YY
XP
Nr
Nr
Nr
Nr
Nr
Nr
Nr
Nr
Nr
"}
(4,1,1) = {"
Nr
Nr
Nr
Nr
ey
fg
nJ
hs
Zn
Zn
Io
XP
XP
Nr
Nr
Nr
Nr
Nr
Nr
Nr
XP
XP
VC
VC
VC
VC
lh
Ee
En
Mm
XP
Zo
YL
Zo
Zo
XP
YY
XP
Nr
Nr
Nr
Nr
Nr
Nr
Nr
"}
(5,1,1) = {"
Nr
Nr
Nr
XP
XP
XP
XP
XP
XP
gi
Ja
gi
XP
Nr
Nr
Nr
Nr
Nr
Nr
Nr
YY
VC
VC
VC
VC
VC
ee
uH
uH
XP
XP
Zo
YL
YL
Zo
XP
ZH
XP
XP
Nr
Nr
Nr
Nr
Nr
Nr
"}
(6,1,1) = {"
Nr
XP
YY
XP
gI
gI
gI
gI
XP
XP
Ja
gi
XP
YY
XP
Nr
Nr
Nr
Nr
XP
XP
VC
VC
VC
VC
VC
VC
VC
VC
XP
Zo
YL
YL
YL
Zo
XP
ZH
ZH
XP
YY
XP
Nr
Nr
Nr
Nr
"}
(7,1,1) = {"
XP
XP
gi
gi
gi
Zn
Zn
Zn
Zn
Zn
ix
Io
gi
gi
XP
XP
Nr
Nr
XP
XP
VC
VC
VC
VC
VC
VC
VC
VC
VC
XP
Zo
YL
YL
YL
Zo
XP
ZH
ZH
ZH
ZH
XP
XP
Nr
Nr
Nr
"}
(8,1,1) = {"
lr
KF
gi
gi
gi
gi
gi
gi
gi
gi
gi
js
Zn
Io
gi
XP
XP
XP
XP
VC
io
IK
IK
IK
IK
IK
IK
IK
HF
HF
Wp
YL
YL
YL
Zo
Zo
ZH
ZH
ZH
ZH
ZH
YY
Nr
Nr
Nr
"}
(9,1,1) = {"
XP
XP
rV
XP
XP
YW
YW
YW
XP
XP
iL
jB
gi
js
Io
tZ
gi
gi
XP
HL
iy
VC
VC
VC
VC
VC
VC
XP
XP
Zo
QT
Mi
YL
YL
Zo
XP
ZH
ZH
ZH
ZH
ZH
XP
XP
Nr
Nr
"}
(10,1,1) = {"
Nr
XP
YY
XP
ab
ab
ab
ab
ab
XP
YY
XP
gi
gi
js
Zn
Zn
Zn
IK
je
XP
XP
VC
XP
VC
XP
XP
XP
Zo
YL
YL
YL
YL
Zo
XP
XP
ZH
ZH
ZH
ZH
ZH
DU
Yi
dQ
Nr
"}
(11,1,1) = {"
Nr
Nr
ab
ab
ab
ab
ab
ab
ab
ab
ab
XP
XP
bO
gi
gi
gi
VC
VC
XP
Wn
YL
YL
YL
YL
YL
YL
XP
Zo
YL
YL
YL
Zo
XP
XP
bR
ZH
ZH
ZH
ZH
ZH
DU
Yi
dQ
Nr
"}
(12,1,1) = {"
Nr
Nr
Nr
ab
ab
ab
ab
ab
ab
ab
ab
ab
oK
gi
gi
gi
gi
VC
VC
VC
VC
YL
YL
YL
YL
YL
VC
VC
Zo
YL
YL
YL
Zo
XP
bR
bR
ZH
ZH
ZH
ZH
XP
Dn
Sj
Nr
Nr
"}
(13,1,1) = {"
Nr
Nr
Nr
Nr
ab
ab
ab
ab
ab
ab
ab
ab
CH
Zo
Zo
Zo
Zo
Zo
Zo
XP
VC
VC
Be
jZ
AW
VC
VC
XP
Zo
YL
YL
YL
Zo
XP
bR
bR
ZH
ZH
ZH
lV
XP
Xx
XP
XP
XP
"}
(14,1,1) = {"
Nr
Nr
Nr
Nr
Ia
ab
ab
ab
ab
ab
ab
ab
JC
YL
YL
YL
YL
YL
YL
YY
Wd
KK
Zw
bj
Ad
VC
Wl
XP
Zo
YL
YL
YL
fA
XP
XP
XP
ZH
ZH
ZH
ZH
HS
Xx
Ct
sN
xj
"}
(15,1,1) = {"
Nr
Nr
Nr
Nr
ab
ab
ab
ab
ab
ab
ab
ab
CH
Zo
Zo
Zo
Zo
Zo
VC
XP
VC
VC
LJ
pE
lA
VC
VC
XP
Zo
YL
YL
YL
Zo
XP
cl
cl
ZH
ZH
ZH
ZH
XP
Xx
XP
XP
XP
"}
(16,1,1) = {"
Nr
Nr
Nr
ab
ab
ab
ab
ab
ab
ab
ab
ab
oK
gi
gi
gi
gi
VC
VC
VC
VC
YL
YL
YL
YL
YL
VC
VC
Zo
YL
YL
YL
Zo
XP
cl
cl
ZH
ZH
ZH
ZH
XP
XP
XP
Nr
Nr
"}
(17,1,1) = {"
Nr
Nr
ab
ab
ab
ab
ab
ab
ab
ab
ab
XP
XP
gi
gi
gi
gi
VC
VC
XP
YL
YL
YL
YL
YL
YL
YL
XP
Zo
YL
YL
YL
Zo
XP
XP
cl
ZH
ZH
ZH
ZH
ZH
DU
Yi
dQ
Nr
"}
(18,1,1) = {"
Nr
XP
YY
XP
ab
ab
ab
ab
ab
XP
YY
XP
gi
gi
ou
Zn
Zn
Zn
IK
Pr
XP
XP
ND
XP
ND
XP
XP
XP
Zo
YL
YL
YL
YL
Zo
XP
XP
ZH
ZH
ZH
ZH
ZH
DU
Yi
dQ
Nr
"}
(19,1,1) = {"
XP
XP
rV
XP
XP
YW
YW
YW
XP
XP
iL
jB
gi
ou
jf
gi
gi
gi
XP
jg
jF
lN
ND
wn
ND
ND
ND
XP
XP
Zo
VN
Ep
YL
YL
Zo
XP
ZH
ZH
ZH
ZH
ZH
XP
XP
Nr
Nr
"}
(20,1,1) = {"
lr
KF
gi
gi
gi
gi
gi
gi
gi
gi
gi
ou
Zn
jf
gi
XP
XP
XP
XP
es
jN
mH
Nc
Nc
Nc
Nc
Nc
Nc
HF
Mg
Ep
YL
YL
YL
Zo
Zo
ZH
ZH
ZH
ZH
ZH
YY
Nr
Nr
Nr
"}
(21,1,1) = {"
XP
XP
gi
gi
gi
Zn
Zn
Zn
Zn
Zn
iU
jf
gi
gi
XP
XP
Nr
Nr
XP
XP
kl
mM
ND
ND
ND
YL
ND
ND
XP
Zo
YL
YL
YL
YL
Zo
XP
ZH
ZH
ZH
ZH
XP
XP
Nr
Nr
Nr
"}
(22,1,1) = {"
Nr
XP
YY
XP
zO
gI
gI
gI
XP
XP
Ja
gi
XP
YY
XP
Nr
Nr
Nr
Nr
XP
XP
XP
ND
ND
ND
Zo
ND
ND
XP
Zo
YL
YL
YL
hm
ct
XP
ZH
ZH
XP
YY
XP
Nr
Nr
Nr
Nr
"}
(23,1,1) = {"
Nr
Nr
Nr
XP
XP
XP
XP
XP
XP
gi
Ja
gi
XP
Nr
Nr
Nr
Nr
Nr
Nr
Nr
XP
pR
si
sA
FP
ND
ND
ND
XP
XP
Zo
YL
YL
YL
Zo
XP
ZH
XP
XP
Nr
Nr
Nr
Nr
Nr
Nr
"}
(24,1,1) = {"
Nr
Nr
Nr
Nr
ey
fg
nJ
iU
Zn
Zn
jf
XP
XP
Nr
Nr
Nr
Nr
Nr
Nr
Nr
XP
XP
Oj
ND
HQ
ND
ND
ND
RG
XP
XP
Zo
YL
Zo
Zo
XP
YY
XP
Nr
Nr
Nr
Nr
Nr
Nr
Nr
"}
(25,1,1) = {"
Nr
Nr
Nr
Nr
ey
fg
nJ
nx
gi
gi
XP
XP
Nr
Nr
Nr
Nr
Nr
Nr
Nr
Nr
Nr
XP
XP
qR
sk
ND
ND
ND
Ul
ND
XP
Zo
Zo
XP
YY
XP
Nr
Nr
Nr
Nr
Nr
Nr
Nr
Nr
Nr
"}
(26,1,1) = {"
Nr
Nr
Nr
Nr
XP
XP
XP
XP
XP
XP
XP
Nr
Nr
Nr
Nr
Nr
Nr
Nr
Nr
Nr
Nr
Nr
XP
YY
XP
ND
ND
ND
VA
Rr
XP
YY
YY
XP
Nr
Nr
Nr
Nr
Nr
Nr
Nr
Nr
Nr
Nr
Nr
"}
(27,1,1) = {"
Nr
Nr
Nr
Nr
Nr
Nr
Nr
Nr
Nr
Nr
Nr
Nr
Nr
Nr
Nr
Nr
Nr
Nr
Nr
Nr
Nr
Nr
Nr
Nr
XP
XP
YY
XP
XP
XP
XP
Nr
Nr
Nr
Nr
Nr
Nr
Nr
Nr
Nr
Nr
Nr
Nr
Nr
Nr
"}
