//MAP CONVERTED BY dmm2tgm.py THIS HEADER COMMENT PREVENTS RECONVERSION, DO NOT REMOVE
"a" = (
/turf/closed/wall/mineral/snow,
/area/ruin/powered)
"i" = (
/obj/effect/mob_spawn/human/corpse/frontier,
/turf/open/floor/plating/asteroid/snow/icemoon,
/area/ruin/powered)
"t" = (
/obj/item/shovel,
/turf/open/floor/plating/asteroid/snow/icemoon,
/area/ruin/powered)
"v" = (
/mob/living/basic/bear/polar,
/turf/open/floor/plating/asteroid/snow/icemoon,
/area/ruin/powered)
"y" = (
/turf/open/floor/plating/asteroid/snow/icemoon,
/area/ruin/powered)
"C" = (
/obj/structure/flora/rock/pile/icy,
/turf/open/floor/plating/asteroid/snow/icemoon,
/area/overmap_encounter/planetoid/cave/explored)
"D" = (
/obj/machinery/space_heater,
/turf/open/floor/plating/asteroid/snow/icemoon,
/area/ruin/powered)
"I" = (
/obj/structure/flora/grass/both,
/turf/open/floor/plating/asteroid/snow/icemoon,
/area/overmap_encounter/planetoid/cave/explored)
"N" = (
/turf/template_noop,
/area/template_noop)
"R" = (
/turf/open/floor/plating/asteroid/snow/icemoon,
/area/overmap_encounter/planetoid/cave/explored)
"Y" = (
/obj/item/stack/sheet/mineral/snow,
/turf/open/floor/plating/asteroid/snow/icemoon,
/area/ruin/powered)

(1,1,1) = {"
N
N
N
N
N
I
R
"}
(2,1,1) = {"
N
a
a
a
a
a
C
"}
(3,1,1) = {"
N
a
D
y
Y
a
R
"}
(4,1,1) = {"
N
a
t
i
y
y
R
"}
(5,1,1) = {"
C
a
v
y
y
a
I
"}
(6,1,1) = {"
I
a
a
a
a
a
N
"}
(7,1,1) = {"
R
I
R
N
N
N
N
"}
