//MAP CONVERTED BY dmm2tgm.py THIS HEADER COMMENT PREVENTS RECONVERSION, DO NOT REMOVE
"a" = (
/obj/structure/geyser/random,
/turf/open/water,
/area/overmap_encounter/planetoid/cave/explored)
"c" = (
/obj/structure/table/wood,
/obj/item/gun/ballistic/rifle/illestren{
	pixel_x = -4;
	pixel_y = -7
	},
/obj/item/radio/old{
	pixel_y = 12;
	pixel_x = -7
	},
/obj/item/reagent_containers/food/snacks/chips{
	pixel_y = 8;
	pixel_x = 8
	},
/turf/open/floor/plating/ice/icemoon,
/area/overmap_encounter/planetoid/cave/explored)
"d" = (
/obj/structure/bonfire/prelit,
/turf/open/floor/plating/ice/icemoon,
/area/overmap_encounter/planetoid/cave/explored)
"k" = (
/turf/open/water,
/area/overmap_encounter/planetoid/cave/explored)
"y" = (
/obj/effect/spawner/random/trash,
/turf/open/water,
/area/overmap_encounter/planetoid/cave/explored)
"B" = (
/obj/structure/chair/wood,
/mob/living/simple_animal/hostile/human/frontier/internals,
/turf/open/floor/plating/ice/icemoon,
/area/overmap_encounter/planetoid/cave/explored)
"D" = (
/turf/template_noop,
/area/template_noop)
"G" = (
/turf/open/floor/plating/ice/icemoon,
/area/overmap_encounter/planetoid/cave/explored)
"Q" = (
/obj/structure/table/wood,
/obj/item/storage/cans/sixbeer{
	pixel_y = 6
	},
/obj/effect/spawner/random/trash/cigbutt{
	spawn_random_offset = 1;
	spawn_loot_count = 3
	},
/turf/open/floor/plating/ice/icemoon,
/area/overmap_encounter/planetoid/cave/explored)

(1,1,1) = {"
D
D
d
D
D
D
"}
(2,1,1) = {"
D
B
G
G
G
D
"}
(3,1,1) = {"
G
c
Q
k
k
a
"}
(4,1,1) = {"
G
a
y
k
k
G
"}
(5,1,1) = {"
G
G
k
k
k
G
"}
(6,1,1) = {"
D
G
G
d
k
G
"}
