//MAP CONVERTED BY dmm2tgm.py THIS HEADER COMMENT PREVENTS RECONVERSION, DO NOT REMOVE
"a" = (
/obj/structure/flora/ausbushes/fullgrass,
/turf/open/floor/plating/asteroid/snow/icemoon,
/area/overmap_encounter/planetoid/cave/explored)
"g" = (
/obj/structure/flora/rock/pile/icy,
/turf/open/floor/plating/asteroid/snow/icemoon,
/area/overmap_encounter/planetoid/cave/explored)
"h" = (
/obj/structure/flora/bush,
/turf/open/floor/plating/asteroid/snow/icemoon,
/area/overmap_encounter/planetoid/cave/explored)
"q" = (
/obj/structure/closet/crate/grave/stone,
/obj/effect/mob_spawn/human/corpse/frontier,
/turf/open/floor/plating/asteroid/snow/icemoon,
/area/overmap_encounter/planetoid/cave/explored)
"r" = (
/turf/open/floor/plating/asteroid/snow/icemoon,
/area/overmap_encounter/planetoid/cave/explored)
"G" = (
/obj/structure/flora/grass/brown,
/turf/open/floor/plating/asteroid/snow/icemoon,
/area/overmap_encounter/planetoid/cave/explored)
"L" = (
/obj/item/shovel,
/turf/open/floor/plating/asteroid/snow/icemoon,
/area/overmap_encounter/planetoid/cave/explored)
"V" = (
/turf/template_noop,
/area/template_noop)
"Y" = (
/mob/living/simple_animal/hostile/human/frontier/ranged/internals,
/turf/open/floor/plating/asteroid/snow/icemoon,
/area/overmap_encounter/planetoid/cave/explored)

(1,1,1) = {"
V
a
h
r
a
"}
(2,1,1) = {"
a
q
L
G
r
"}
(3,1,1) = {"
r
q
Y
r
r
"}
(4,1,1) = {"
g
q
a
r
g
"}
(5,1,1) = {"
a
r
r
G
V
"}
