//MAP CONVERTED BY dmm2tgm.py THIS HEADER COMMENT PREVENTS RECONVERSION, DO NOT REMOVE
"a" = (
/turf/template_noop,
/area/template_noop)
"g" = (
/obj/structure/flora/ausbushes/fullgrass,
/turf/open/floor/plating/asteroid/snow/safe,
/area/overmap_encounter/planetoid/ice/explored)
"h" = (
/obj/effect/spawner/random/snow_monkey_pack,
/turf/open/water,
/area/overmap_encounter/planetoid/ice/explored)
"i" = (
/obj/effect/spawner/random/sauna_capy{
	spawn_loot_chance = 5
	},
/turf/open/water,
/area/overmap_encounter/planetoid/ice/explored)
"s" = (
/obj/structure/flora/ash/garden/frigid,
/turf/open/floor/plating/asteroid/snow/safe,
/area/overmap_encounter/planetoid/ice/explored)
"v" = (
/turf/open/floor/plating/asteroid/snow/safe,
/area/overmap_encounter/planetoid/ice/explored)
"x" = (
/obj/structure/geyser/random,
/turf/open/water,
/area/overmap_encounter/planetoid/ice/explored)
"C" = (
/turf/open/water,
/area/overmap_encounter/planetoid/ice/explored)
"D" = (
/turf/closed/mineral/random/snow,
/area/overmap_encounter/planetoid/ice/explored)
"Q" = (
/turf/open/floor/plating/ice/icemoon,
/area/overmap_encounter/planetoid/ice/explored)
"X" = (
/obj/structure/flora/bush,
/turf/open/floor/plating/asteroid/snow/safe,
/area/overmap_encounter/planetoid/ice/explored)

(1,1,1) = {"
a
a
a
a
g
g
s
a
a
a
a
"}
(2,1,1) = {"
a
a
s
X
s
X
a
a
a
a
a
"}
(3,1,1) = {"
a
a
v
g
v
D
D
D
a
a
a
"}
(4,1,1) = {"
a
v
s
v
Q
Q
Q
Q
D
D
a
"}
(5,1,1) = {"
a
v
v
Q
C
C
C
C
C
D
a
"}
(6,1,1) = {"
s
X
D
Q
C
C
C
h
C
D
D
"}
(7,1,1) = {"
a
g
D
C
h
C
C
i
C
D
D
"}
(8,1,1) = {"
a
v
X
D
C
i
C
x
C
D
D
"}
(9,1,1) = {"
a
a
g
D
D
C
C
C
D
D
a
"}
(10,1,1) = {"
a
a
a
a
D
D
D
D
D
D
a
"}
(11,1,1) = {"
a
a
a
a
a
D
D
D
a
a
a
"}
