//MAP CONVERTED BY dmm2tgm.py THIS HEADER COMMENT PREVENTS RECONVERSION, DO NOT REMOVE
"as" = (
/obj/effect/turf_decal/corner_steel_grid{
	dir = 5
	},
/obj/effect/turf_decal/trimline/transparent/blue/filled/line,
/turf/open/floor/hangar/plasteel/dark/clipoutpost,
/area/hangar/weather)
"bJ" = (
/obj/effect/turf_decal/trimline/transparent/blue/filled/corner,
/obj/structure/railing/thin{
	dir = 9
	},
/turf/open/floor/hangar/plasteel/dark/clipoutpost,
/area/hangar/weather)
"bZ" = (
/obj/structure/railing/thin{
	dir = 8
	},
/obj/effect/turf_decal/corner_steel_grid{
	dir = 6
	},
/turf/open/floor/hangar/plasteel/dark/clipoutpost,
/area/hangar/weather)
"cC" = (
/obj/effect/turf_decal/trimline/transparent/blue/filled/line{
	dir = 8
	},
/obj/structure/railing/thin{
	dir = 4
	},
/turf/open/floor/hangar/plasteel/dark/clipoutpost,
/area/hangar/weather)
"dh" = (
/obj/machinery/conveyor/auto/outpost{
	dir = 10
	},
/turf/open/floor/pod/dark,
/area/hangar/weather)
"dH" = (
/obj/effect/turf_decal/trimline/transparent/blue/filled/line{
	dir = 6
	},
/obj/machinery/light/floor,
/turf/open/floor/hangar/plasteel/dark/clipoutpost,
/area/hangar/weather)
"eb" = (
/turf/closed/indestructible/plastitanium/nodiagnonal,
/area/hangar)
"ep" = (
/obj/machinery/conveyor/auto/outpost,
/obj/structure/plasticflaps/outpost,
/turf/open/floor/pod/dark,
/area/hangar/weather)
"fx" = (
/obj/structure/platform/industrial_alt/indestructible{
	color = "#999999";
	layer = 2
	},
/turf/open/water/beach/deep/outpost,
/area/hangar/weather)
"fL" = (
/obj/structure/platform/industrial_alt/indestructible{
	color = "#999999";
	layer = 2;
	dir = 1
	},
/turf/open/water/beach/deep/outpost,
/area/hangar/weather)
"gM" = (
/obj/structure/platform/industrial_alt/indestructible{
	dir = 9
	},
/turf/open/floor/hangar/clipoutpost{
	color = "#999999";
	light_power = 0.7
	},
/area/hangar/weather)
"hd" = (
/obj/structure/catwalk/over,
/turf/open/water/beach/deep/outpost,
/area/hangar/weather)
"hp" = (
/obj/effect/turf_decal/trimline/transparent/blue/filled/line,
/obj/structure/railing/thin{
	dir = 1
	},
/turf/open/floor/hangar/plasteel/dark/clipoutpost,
/area/hangar/weather)
"hy" = (
/obj/structure/railing/thin{
	dir = 1
	},
/obj/structure/chair/bench/blue/directional/north{
	dir = 2
	},
/turf/open/floor/hangar/plasteel/dark/clipoutpost,
/area/hangar/weather)
"jC" = (
/obj/structure/railing/thin{
	dir = 4
	},
/turf/open/floor/hangar/plasteel/dark/clipoutpost,
/area/hangar/weather)
"jE" = (
/obj/structure/platform/industrial_alt/corner/indestructible{
	color = "#999999";
	layer = 2;
	dir = 8
	},
/turf/open/water/beach/deep/outpost,
/area/hangar/weather)
"kt" = (
/turf/open/floor/hangar/clipoutpost{
	color = "#999999";
	light_power = 0.7
	},
/area/hangar/weather)
"kC" = (
/obj/effect/landmark/outpost/shaft_number,
/turf/open/floor/hangar/plasteel/dark/clipoutpost,
/area/hangar/weather)
"ll" = (
/obj/effect/turf_decal/trimline/transparent/blue/filled/line{
	dir = 8
	},
/obj/structure/railing/thin/corner,
/turf/open/floor/hangar/plasteel/dark/clipoutpost,
/area/hangar/weather)
"lw" = (
/obj/structure/plasticflaps/outpost,
/obj/machinery/conveyor/auto/outpost{
	dir = 8
	},
/turf/open/floor/pod/dark,
/area/hangar/weather)
"lO" = (
/obj/structure/plasticflaps/outpost,
/obj/machinery/conveyor/auto/outpost{
	dir = 5;
	verted = -1
	},
/turf/open/floor/pod/dark,
/area/hangar/weather)
"mf" = (
/obj/structure/disposalpipe/segment,
/obj/structure/catwalk/over,
/turf/open/water/beach/deep/outpost,
/area/hangar/weather)
"mz" = (
/obj/effect/turf_decal/trimline/transparent/blue/filled/line,
/obj/machinery/light/floor,
/turf/open/floor/hangar/plasteel/dark/clipoutpost,
/area/hangar/weather)
"nK" = (
/obj/machinery/conveyor/auto/outpost{
	dir = 6;
	verted = -1
	},
/turf/open/floor/pod/dark,
/area/hangar/weather)
"oF" = (
/obj/effect/turf_decal/industrial/warning{
	dir = 1
	},
/obj/effect/turf_decal/industrial/warning,
/obj/machinery/door/poddoor/ert,
/turf/open/floor/plasteel/tech,
/area/hangar)
"oM" = (
/obj/effect/turf_decal/industrial/warning{
	dir = 8
	},
/obj/effect/decal/fakelattice,
/turf/open/floor/hangar/clipoutpost,
/area/hangar/weather)
"oS" = (
/obj/effect/turf_decal/trimline/transparent/blue/filled/line{
	dir = 1
	},
/obj/machinery/light/floor,
/turf/open/floor/hangar/plasteel/dark/clipoutpost,
/area/hangar/weather)
"pH" = (
/obj/structure/platform/industrial_alt/indestructible{
	dir = 5
	},
/turf/open/floor/hangar/clipoutpost{
	color = "#999999";
	light_power = 0.7
	},
/area/hangar/weather)
"qA" = (
/obj/structure/railing/thin{
	dir = 1
	},
/obj/effect/turf_decal/trimline/transparent/blue/filled/line,
/turf/open/floor/hangar/plasteel/dark/clipoutpost,
/area/hangar/weather)
"qD" = (
/obj/structure/platform/industrial_alt/indestructible{
	color = "#999999";
	layer = 2
	},
/obj/structure/disposalpipe/segment,
/obj/structure/catwalk/over,
/turf/open/water/beach/deep/outpost,
/area/hangar/weather)
"rb" = (
/turf/open/floor/hangar/clipoutpost,
/area/hangar/weather)
"rh" = (
/obj/effect/turf_decal/trimline/transparent/blue/filled/line,
/obj/structure/railing/thin/corner{
	dir = 1
	},
/obj/effect/turf_decal/corner_steel_grid{
	dir = 4
	},
/turf/open/floor/hangar/plasteel/dark/clipoutpost,
/area/hangar/weather)
"ri" = (
/obj/effect/turf_decal/trimline/transparent/blue/filled/line{
	dir = 1
	},
/turf/open/floor/hangar/plasteel/dark/clipoutpost,
/area/hangar/weather)
"rN" = (
/obj/structure/platform/industrial_alt/indestructible{
	dir = 6
	},
/turf/open/floor/hangar/clipoutpost{
	color = "#999999";
	light_power = 0.7
	},
/area/hangar/weather)
"tr" = (
/obj/structure/platform/industrial_alt/corner/indestructible{
	dir = 4
	},
/turf/open/floor/hangar/clipoutpost{
	color = "#999999";
	light_power = 0.7
	},
/area/hangar/weather)
"tt" = (
/obj/structure/platform/industrial_alt/indestructible{
	color = "#999999";
	layer = 2;
	dir = 9
	},
/turf/open/water/beach/deep/outpost,
/area/hangar/weather)
"tL" = (
/obj/effect/turf_decal/industrial/warning{
	dir = 8
	},
/obj/effect/turf_decal/industrial/warning{
	dir = 4
	},
/obj/machinery/door/airlock{
	dir = 8
	},
/obj/effect/landmark/outpost/elevator_machine,
/turf/open/floor/plasteel/mono/dark,
/area/hangar)
"tP" = (
/obj/structure/platform/industrial_alt/indestructible{
	dir = 10
	},
/turf/open/water/beach/deep/outpost,
/area/hangar/weather)
"tX" = (
/obj/structure/platform/industrial_alt/corner/indestructible{
	color = "#999999";
	layer = 2
	},
/turf/open/water/beach/deep/outpost,
/area/hangar/weather)
"ug" = (
/obj/structure/platform/industrial_alt/corner/indestructible{
	color = "#999999";
	layer = 2;
	dir = 4
	},
/turf/open/water/beach/deep/outpost,
/area/hangar/weather)
"vd" = (
/obj/structure/platform/industrial_alt/corner/indestructible{
	dir = 8
	},
/turf/open/floor/hangar/clipoutpost{
	color = "#999999";
	light_power = 0.7
	},
/area/hangar/weather)
"vD" = (
/obj/structure/platform/industrial_alt/indestructible,
/turf/open/floor/hangar/clipoutpost{
	color = "#999999";
	light_power = 0.7
	},
/area/hangar/weather)
"vI" = (
/obj/structure/rack,
/obj/item/weldingtool/mini{
	pixel_x = -3;
	pixel_y = 4
	},
/obj/item/clothing/head/welding{
	pixel_x = 9;
	pixel_y = 0
	},
/turf/open/floor/hangar/plasteel/dark/clipoutpost,
/area/hangar/weather)
"vO" = (
/obj/structure/platform/industrial_alt/corner/indestructible{
	dir = 1
	},
/turf/open/floor/hangar/clipoutpost{
	color = "#999999";
	light_power = 0.7
	},
/area/hangar/weather)
"vR" = (
/obj/structure/platform/industrial_alt/indestructible{
	dir = 4
	},
/turf/open/water/beach/deep/outpost,
/area/hangar/weather)
"wr" = (
/obj/effect/turf_decal/box,
/obj/machinery/light/directional/north,
/turf/open/floor/pod/dark,
/area/hangar/weather)
"xJ" = (
/obj/structure/railing/thin,
/obj/structure/rack,
/obj/item/clothing/neck/poncho/darkblue{
	pixel_x = -8;
	pixel_y = 0
	},
/obj/item/clothing/neck/poncho/darkblue,
/obj/item/clothing/neck/poncho/darkblue{
	pixel_x = 9;
	pixel_y = 0
	},
/obj/machinery/light/directional/east,
/turf/open/floor/hangar/plasteel/dark/clipoutpost,
/area/hangar/weather)
"zs" = (
/obj/structure/platform/industrial_alt/indestructible{
	color = "#999999";
	layer = 2;
	dir = 8
	},
/turf/open/water/beach/deep/outpost,
/area/hangar/weather)
"zF" = (
/turf/open/floor/hangar/plasteel/dark/clipoutpost,
/area/hangar/weather)
"Aq" = (
/obj/machinery/conveyor/auto/outpost{
	dir = 8
	},
/turf/open/floor/pod/dark,
/area/hangar/weather)
"AD" = (
/obj/structure/disposalpipe/segment{
	dir = 4
	},
/turf/closed/indestructible/plastitanium/nodiagnonal,
/area/hangar/weather)
"AY" = (
/obj/effect/turf_decal/trimline/transparent/blue/filled/line{
	dir = 8
	},
/obj/structure/railing/thin/corner{
	dir = 4
	},
/turf/open/floor/hangar/plasteel/dark/clipoutpost,
/area/hangar/weather)
"CI" = (
/obj/structure/railing/thin{
	dir = 1
	},
/obj/structure/chair/bench/blue/directional/south,
/turf/open/floor/hangar/plasteel/dark/clipoutpost,
/area/hangar/weather)
"CM" = (
/obj/structure/platform/industrial_alt/indestructible{
	color = "#999999";
	layer = 2;
	dir = 4
	},
/turf/open/water/beach/deep/outpost,
/area/hangar/weather)
"Dz" = (
/obj/structure/platform/industrial_alt/indestructible{
	dir = 8
	},
/turf/open/water/beach/deep/outpost,
/area/hangar/weather)
"DR" = (
/obj/effect/turf_decal/industrial/warning{
	dir = 4
	},
/obj/effect/decal/fakelattice,
/turf/open/floor/hangar/clipoutpost,
/area/hangar/weather)
"ED" = (
/obj/structure/platform/industrial_alt/indestructible{
	color = "#999999";
	layer = 2;
	dir = 6
	},
/turf/open/water/beach/deep/outpost,
/area/hangar/weather)
"EL" = (
/obj/effect/turf_decal/corner_steel_grid{
	dir = 1
	},
/obj/effect/turf_decal/trimline/transparent/blue/filled/line,
/turf/open/floor/hangar/plasteel/dark/clipoutpost,
/area/hangar/weather)
"Fu" = (
/obj/effect/landmark/outpost/elevator_machine{
	shaft = "1"
	},
/obj/machinery/elevator_call_button{
	dir = 8;
	pixel_x = 25;
	pixel_y = 6
	},
/turf/open/floor/hangar/plasteel/dark/clipoutpost,
/area/hangar/weather)
"FP" = (
/turf/open/floor/plasteel/elevatorshaft,
/area/hangar)
"Gz" = (
/obj/structure/platform/industrial_alt/corner/indestructible{
	dir = 4
	},
/turf/open/water/beach/deep/outpost,
/area/hangar/weather)
"HN" = (
/obj/effect/landmark/outpost/hangar_dock,
/turf/open/floor/hangar/clipoutpost,
/area/hangar/weather)
"HY" = (
/obj/effect/turf_decal/trimline/transparent/blue/filled/corner{
	dir = 8
	},
/obj/structure/railing/thin{
	dir = 4
	},
/turf/open/floor/hangar/plasteel/dark/clipoutpost,
/area/hangar/weather)
"HZ" = (
/obj/structure/platform/industrial_alt/indestructible{
	color = "#999999";
	layer = 2;
	dir = 1
	},
/obj/structure/disposalpipe/segment,
/obj/structure/catwalk/over,
/turf/open/water/beach/deep/outpost,
/area/hangar/weather)
"IT" = (
/obj/structure/platform/industrial_alt/indestructible{
	dir = 4
	},
/turf/open/floor/hangar/clipoutpost{
	color = "#999999";
	light_power = 0.7
	},
/area/hangar/weather)
"Jn" = (
/obj/effect/turf_decal/trimline/transparent/blue/filled/line{
	dir = 4
	},
/obj/structure/railing/thin{
	dir = 8
	},
/turf/open/floor/hangar/plasteel/dark/clipoutpost,
/area/hangar/weather)
"Kj" = (
/turf/closed/indestructible/plastitanium/nodiagnonal,
/area/hangar/weather)
"Kr" = (
/obj/structure/railing{
	dir = 8
	},
/obj/effect/turf_decal/corner_steel_grid{
	dir = 9
	},
/turf/open/floor/hangar/plasteel/dark/clipoutpost,
/area/hangar/weather)
"Kt" = (
/obj/effect/landmark/outpost/elevator{
	shaft = "1"
	},
/turf/open/floor/plasteel/elevatorshaft,
/area/hangar)
"Ku" = (
/obj/effect/turf_decal/trimline/transparent/blue/filled/line{
	dir = 1
	},
/obj/structure/railing/thin,
/turf/open/floor/hangar/plasteel/dark/clipoutpost,
/area/hangar/weather)
"KM" = (
/obj/structure/platform/industrial_alt/indestructible{
	dir = 10
	},
/turf/open/floor/hangar/clipoutpost{
	color = "#999999";
	light_power = 0.7
	},
/area/hangar/weather)
"LI" = (
/obj/effect/turf_decal/trimline/transparent/blue/filled/line{
	dir = 8
	},
/turf/open/floor/hangar/plasteel/dark/clipoutpost,
/area/hangar/weather)
"Mz" = (
/obj/structure/railing/thin{
	dir = 1
	},
/obj/structure/rack,
/obj/item/clothing/neck/poncho/darkblue,
/obj/item/clothing/neck/poncho/darkblue{
	pixel_x = -9;
	pixel_y = 0
	},
/obj/item/clothing/neck/poncho/darkblue{
	pixel_x = 9;
	pixel_y = 0
	},
/obj/machinery/light/directional/east,
/turf/open/floor/hangar/plasteel/dark/clipoutpost,
/area/hangar/weather)
"Ny" = (
/obj/machinery/disposal/deliveryChute{
	dir = 1
	},
/obj/structure/disposalpipe/trunk{
	dir = 8
	},
/turf/open/floor/pod/dark,
/area/hangar/weather)
"Ob" = (
/turf/open/water/beach/deep/outpost,
/area/hangar/weather)
"Op" = (
/obj/effect/turf_decal/trimline/transparent/blue/filled/line,
/turf/open/floor/hangar/plasteel/dark/clipoutpost,
/area/hangar/weather)
"OC" = (
/obj/structure/platform/industrial_alt/indestructible{
	dir = 4
	},
/obj/structure/platform/industrial_alt/indestructible{
	color = "#999999";
	layer = 2;
	dir = 1
	},
/turf/open/water/beach/deep/outpost,
/area/hangar/weather)
"Pf" = (
/obj/structure/platform/industrial_alt/corner/indestructible,
/turf/open/floor/hangar/clipoutpost{
	color = "#999999";
	light_power = 0.7
	},
/area/hangar/weather)
"Pj" = (
/obj/structure/platform/industrial_alt/indestructible{
	color = "#999999";
	layer = 2;
	dir = 10
	},
/turf/open/water/beach/deep/outpost,
/area/hangar/weather)
"PS" = (
/obj/structure/marker_beacon{
	picked_color = "Teal"
	},
/turf/open/floor/hangar/clipoutpost,
/area/hangar/weather)
"Qm" = (
/obj/structure/platform/industrial_alt/indestructible{
	color = "#999999";
	layer = 2
	},
/obj/structure/platform/industrial_alt/indestructible{
	dir = 4
	},
/turf/open/water/beach/deep/outpost,
/area/hangar/weather)
"Qu" = (
/obj/structure/catwalk/over/plated_catwalk/dark,
/turf/open/floor/hangar/clipoutpost,
/area/hangar/weather)
"Qw" = (
/obj/structure/chair/bench/blue/directional/south,
/turf/open/floor/hangar/plasteel/dark/clipoutpost,
/area/hangar/weather)
"RM" = (
/obj/machinery/conveyor/auto/outpost,
/obj/effect/landmark/outpost/hangar_crate_spawner,
/turf/open/floor/pod/dark,
/area/hangar/weather)
"RY" = (
/obj/effect/turf_decal/trimline/transparent/blue/filled/corner{
	dir = 1
	},
/obj/structure/railing/thin{
	dir = 6
	},
/turf/open/floor/hangar/plasteel/dark/clipoutpost,
/area/hangar/weather)
"So" = (
/obj/structure/railing/thin,
/obj/structure/chair/bench/blue/directional/north,
/turf/open/floor/hangar/plasteel/dark/clipoutpost,
/area/hangar/weather)
"Sp" = (
/obj/structure/disposalpipe/trunk{
	dir = 4
	},
/obj/machinery/conveyor/auto/outpost{
	dir = 1
	},
/obj/structure/disposaloutlet{
	dir = 1
	},
/turf/open/floor/pod/dark,
/area/hangar/weather)
"Tb" = (
/obj/effect/turf_decal/trimline/transparent/blue/filled/corner{
	dir = 4
	},
/obj/structure/railing/thin{
	dir = 10
	},
/turf/open/floor/hangar/plasteel/dark/clipoutpost,
/area/hangar/weather)
"Ua" = (
/obj/effect/landmark/outpost/hangar_numbers,
/turf/open/floor/hangar/plasteel/dark/clipoutpost,
/area/hangar/weather)
"UQ" = (
/obj/structure/platform/industrial_alt/corner/indestructible{
	color = "#999999";
	layer = 2;
	dir = 1
	},
/turf/open/water/beach/deep/outpost,
/area/hangar/weather)
"UU" = (
/obj/structure/platform/industrial_alt/indestructible{
	dir = 1
	},
/turf/open/floor/hangar/clipoutpost{
	color = "#999999";
	light_power = 0.7
	},
/area/hangar/weather)
"UX" = (
/obj/structure/platform/industrial_alt/indestructible{
	dir = 8
	},
/turf/open/floor/hangar/clipoutpost{
	color = "#999999";
	light_power = 0.7
	},
/area/hangar/weather)
"WQ" = (
/obj/structure/sign/departments/cargo,
/turf/closed/indestructible/plastitanium/nodiagnonal,
/area/hangar/weather)
"XE" = (
/obj/structure/catwalk/over,
/turf/open/floor/hangar/clipoutpost,
/area/hangar/weather)
"YJ" = (
/obj/effect/turf_decal/trimline/transparent/blue/filled/line{
	dir = 9
	},
/obj/machinery/light/floor,
/turf/open/floor/hangar/plasteel/dark/clipoutpost,
/area/hangar/weather)
"Zd" = (
/obj/effect/turf_decal/trimline/transparent/blue/filled/line{
	dir = 4
	},
/turf/open/floor/hangar/plasteel/dark/clipoutpost,
/area/hangar/weather)
"Zf" = (
/obj/effect/turf_decal/trimline/transparent/blue/filled/line{
	dir = 10
	},
/obj/machinery/light/floor,
/turf/open/floor/hangar/plasteel/dark/clipoutpost,
/area/hangar/weather)
"ZP" = (
/obj/structure/platform/industrial_alt/corner/indestructible{
	dir = 1
	},
/turf/open/water/beach/deep/outpost,
/area/hangar/weather)
"ZS" = (
/obj/structure/platform/industrial_alt/indestructible{
	dir = 9
	},
/turf/open/water/beach/deep/outpost,
/area/hangar/weather)
"ZV" = (
/obj/effect/turf_decal/trimline/transparent/blue/filled/line{
	dir = 5
	},
/obj/machinery/light/floor,
/turf/open/floor/hangar/plasteel/dark/clipoutpost,
/area/hangar/weather)

(1,1,1) = {"
Ob
Ob
Ob
Ob
Ob
Ob
Ob
Ob
Ob
Ob
Ob
Ob
Ob
Ob
Ob
Ob
Ob
Ob
Ob
Ob
Ob
Ob
Ob
Ob
Ob
Ob
Ob
Ob
Ob
Ob
Ob
Ob
Ob
Ob
Ob
Ob
Ob
Ob
Ob
Ob
Ob
Ob
Ob
Ob
Ob
"}
(2,1,1) = {"
Ob
Ob
Ob
Ob
Ob
Ob
Ob
Ob
Ob
Ob
Ob
Ob
Ob
Ob
Ob
Ob
Ob
Ob
Ob
Ob
Ob
Ob
Ob
Ob
Ob
Ob
Ob
Ob
Ob
Ob
Ob
Ob
Ob
Ob
Ob
Ob
Ob
Ob
Ob
Ob
Ob
Ob
Ob
Ob
Ob
"}
(3,1,1) = {"
Ob
Ob
Ob
Ob
Ob
Ob
Ob
Ob
Ob
Ob
Ob
Ob
Ob
Ob
Ob
Ob
Ob
Ob
Ob
Ob
Ob
Ob
Ob
Ob
Ob
Ob
Ob
Ob
Ob
Ob
Ob
Ob
Ob
Ob
Ob
Ob
Ob
Ob
Ob
Ob
Ob
Ob
Ob
Ob
Ob
"}
(4,1,1) = {"
Ob
Ob
Ob
Ob
Ob
Ob
Ob
Ob
Ob
Ob
Ob
Ob
Ob
Ob
Ob
Ob
Ob
Ob
Ob
Ob
Ob
Ob
Ob
Ob
Ob
Ob
Ob
Ob
Ob
Ob
Ob
Ob
Ob
Ob
Ob
Ob
Ob
Ob
Ob
Ob
Ob
Ob
Ob
Ob
Ob
"}
(5,1,1) = {"
Ob
Ob
Ob
Ob
Ob
Ob
Ob
Ob
Ob
Ob
Ob
Ob
Ob
Ob
Ob
Ob
Ob
Ob
Ob
Ob
Ob
Ob
Ob
Ob
Ob
Ob
Ob
Ob
Ob
Ob
Ob
Ob
Ob
Ob
Ob
Ob
Ob
Ob
Ob
Ob
Ob
Ob
Ob
Ob
Ob
"}
(6,1,1) = {"
Ob
Ob
Ob
Ob
Ob
Ob
Ob
Ob
Ob
Ob
Ob
Ob
Ob
Ob
Ob
Ob
Ob
Ob
Ob
Ob
Ob
Ob
Ob
Ob
Ob
Ob
Ob
Ob
Ob
Ob
Ob
Ob
Ob
Ob
Ob
Ob
Ob
Ob
Ob
Ob
Ob
Ob
Ob
Ob
Ob
"}
(7,1,1) = {"
Ob
Ob
Ob
Ob
Ob
Ob
Ob
Ob
Ob
Ob
Ob
Ob
Ob
Ob
Ob
Ob
Ob
Ob
Ob
Ob
Ob
Ob
Ob
Ob
Ob
Ob
Ob
Ob
Ob
Ob
Ob
Ob
Ob
Ob
Ob
Ob
Ob
Ob
Ob
Ob
Ob
Ob
Ob
Ob
Ob
"}
(8,1,1) = {"
Ob
Ob
Ob
Ob
Ob
Ob
Ob
Ob
Ob
tX
CM
CM
CM
CM
CM
CM
CM
CM
CM
CM
CM
CM
CM
CM
CM
CM
CM
CM
CM
CM
CM
CM
CM
CM
CM
CM
CM
CM
CM
jE
Ob
Ob
Ob
Ob
Ob
"}
(9,1,1) = {"
Ob
Ob
Ob
Ob
Ob
Ob
Ob
Ob
Ob
fx
Pf
IT
IT
IT
IT
IT
IT
IT
IT
IT
IT
IT
IT
IT
IT
IT
IT
IT
IT
IT
IT
IT
IT
IT
IT
IT
IT
vd
kt
fL
Ob
Ob
Ob
Ob
Ob
"}
(10,1,1) = {"
Ob
Ob
Ob
Ob
Ob
Ob
Ob
Ob
Ob
fx
vD
bJ
Jn
Jn
Jn
Jn
Jn
Jn
Jn
Jn
Jn
Jn
Jn
Jn
Jn
Jn
Jn
Jn
Jn
Jn
Jn
Jn
Jn
Jn
Jn
Jn
Tb
UU
kt
fL
Ob
Ob
Ob
Ob
Ob
"}
(11,1,1) = {"
Ob
Ob
Ob
Ob
Ob
Ob
Ob
Ob
Ob
fx
vD
hp
Qu
Qu
Qu
Qu
Qu
Qu
Qu
Qu
Qu
Qu
Qu
Qu
Qu
Qu
Qu
Qu
Qu
Qu
Qu
Qu
Qu
Qu
Qu
Qu
Ku
UU
kt
fL
Ob
Ob
Ob
Ob
Ob
"}
(12,1,1) = {"
Ob
Ob
Ob
Ob
Ob
Ob
Ob
Ob
Ob
fx
vD
hp
Qu
YJ
LI
LI
LI
LI
LI
LI
LI
LI
LI
LI
LI
LI
LI
LI
LI
LI
LI
LI
LI
LI
Zf
Qu
Ku
UU
kt
fL
Ob
Ob
Ob
Ob
Ob
"}
(13,1,1) = {"
Ob
Ob
Ob
Ob
Ob
Ob
Ob
Ob
Ob
fx
vD
hp
Qu
ri
rb
rb
rb
rb
rb
rb
rb
rb
rb
rb
rb
rb
rb
rb
rb
rb
rb
rb
rb
HN
Op
Qu
Ku
UU
kt
fL
Ob
Ob
Ob
Ob
Ob
"}
(14,1,1) = {"
Ob
Ob
Ob
Ob
Ob
Ob
Ob
Ob
Ob
fx
vD
qA
Qu
ri
rb
rb
rb
rb
rb
rb
rb
rb
rb
rb
rb
rb
rb
rb
rb
rb
rb
rb
rb
rb
Op
Qu
Ku
UU
kt
fL
Ob
Ob
Ob
Ob
Ob
"}
(15,1,1) = {"
Ob
Ob
Ob
Ob
Ob
Ob
Ob
Ob
Ob
fx
vD
hp
Qu
ri
rb
rb
rb
rb
rb
rb
rb
rb
rb
rb
rb
rb
rb
rb
rb
rb
rb
rb
rb
rb
Op
Qu
Ku
UU
kt
fL
Ob
Ob
Ob
Ob
Ob
"}
(16,1,1) = {"
Ob
Ob
Ob
Ob
Ob
Ob
Ob
Ob
Ob
fx
vD
hp
Qu
oS
rb
rb
rb
rb
rb
rb
rb
rb
rb
rb
rb
rb
rb
rb
rb
rb
rb
rb
rb
rb
mz
Qu
Ku
UU
kt
fL
Ob
Ob
Ob
Ob
Ob
"}
(17,1,1) = {"
Ob
Ob
Ob
Ob
Ob
Ob
Ob
Ob
Ob
fx
vD
hp
Qu
ri
rb
rb
rb
rb
rb
rb
rb
rb
rb
rb
rb
rb
rb
rb
rb
rb
rb
rb
rb
rb
Op
Qu
Ku
UU
kt
fL
Ob
Ob
Ob
Ob
Ob
"}
(18,1,1) = {"
Ob
Ob
Ob
Ob
Ob
Ob
Ob
Ob
Ob
fx
vD
hp
Qu
ri
rb
rb
rb
rb
rb
rb
rb
rb
rb
rb
rb
rb
rb
rb
rb
rb
rb
rb
rb
rb
Op
Qu
Ku
UU
kt
fL
Ob
Ob
Ob
Ob
Ob
"}
(19,1,1) = {"
Ob
Ob
Ob
Ob
Ob
Ob
Ob
Ob
Ob
fx
vD
hp
Qu
ri
rb
rb
rb
rb
rb
rb
rb
rb
rb
rb
rb
rb
rb
rb
rb
rb
rb
rb
rb
rb
Op
Qu
Ku
UU
kt
fL
Ob
Ob
Ob
Ob
Ob
"}
(20,1,1) = {"
Ob
Ob
Ob
Ob
Ob
Ob
Ob
Ob
Ob
fx
vD
qA
Qu
ri
rb
rb
rb
rb
rb
rb
rb
rb
rb
rb
rb
rb
rb
rb
rb
rb
rb
rb
rb
rb
Op
Qu
Ku
UU
kt
fL
Ob
Ob
Ob
Ob
Ob
"}
(21,1,1) = {"
Ob
Ob
Ob
Ob
Ob
Ob
Ob
Ob
Ob
fx
vD
hp
Qu
ri
rb
rb
rb
rb
rb
rb
rb
rb
rb
rb
rb
rb
rb
rb
rb
rb
rb
rb
rb
rb
Op
Qu
Ku
UU
kt
fL
Ob
Ob
Ob
Ob
Ob
"}
(22,1,1) = {"
Ob
Ob
Ob
Ob
Ob
Ob
Ob
Ob
Ob
fx
vD
hp
Qu
oS
rb
rb
rb
rb
rb
rb
rb
rb
rb
rb
rb
rb
rb
rb
rb
rb
rb
rb
rb
rb
mz
Qu
Ku
UU
kt
fL
Ob
Ob
Ob
Ob
Ob
"}
(23,1,1) = {"
Ob
Ob
Ob
Ob
Ob
Ob
Ob
Ob
Ob
fx
vD
hp
Qu
ri
rb
rb
rb
rb
rb
rb
rb
rb
rb
rb
rb
rb
rb
rb
rb
rb
rb
rb
rb
rb
Op
Qu
Ku
UU
kt
fL
Ob
Ob
Ob
Ob
Ob
"}
(24,1,1) = {"
Ob
Ob
Ob
Ob
Ob
Ob
Ob
Ob
Ob
fx
vD
hp
Qu
ri
rb
rb
rb
rb
rb
rb
rb
rb
rb
rb
rb
rb
rb
rb
rb
rb
rb
rb
rb
rb
Op
Qu
Ku
UU
kt
fL
Ob
Ob
Ob
Ob
Ob
"}
(25,1,1) = {"
Ob
Ob
Ob
Ob
Ob
Ob
Ob
Ob
Ob
fx
vD
hp
Qu
ri
rb
rb
rb
rb
rb
rb
rb
rb
rb
rb
rb
rb
rb
rb
rb
rb
rb
rb
rb
rb
Op
Qu
Ku
UU
kt
fL
Ob
Ob
Ob
Ob
Ob
"}
(26,1,1) = {"
Ob
Ob
Ob
Ob
Ob
Ob
Ob
Ob
Ob
fx
vD
hp
Qu
ri
rb
rb
rb
rb
rb
rb
rb
rb
rb
rb
rb
rb
rb
rb
rb
rb
rb
rb
rb
rb
Op
Qu
Ku
UU
kt
fL
Ob
Ob
Ob
Ob
Ob
"}
(27,1,1) = {"
Ob
Ob
Ob
Ob
Ob
Ob
Ob
Ob
Ob
fx
vD
qA
Qu
ri
rb
rb
rb
rb
rb
rb
rb
rb
rb
rb
rb
rb
rb
rb
rb
rb
rb
rb
rb
rb
Op
Qu
Ku
UU
kt
fL
Ob
Ob
Ob
Ob
Ob
"}
(28,1,1) = {"
Ob
Ob
Ob
Ob
Ob
Ob
Ob
Ob
Ob
fx
vD
hp
Qu
ri
rb
rb
rb
rb
rb
rb
rb
rb
rb
rb
rb
rb
rb
rb
rb
rb
rb
rb
rb
rb
Op
Qu
Ku
UU
kt
fL
Ob
Ob
Ob
Ob
Ob
"}
(29,1,1) = {"
Ob
Ob
Ob
Ob
Ob
Ob
Ob
Ob
Ob
fx
vD
hp
Qu
oS
rb
rb
rb
rb
rb
rb
rb
rb
rb
rb
rb
rb
rb
rb
rb
rb
rb
rb
rb
rb
mz
Qu
Ku
UU
kt
fL
Ob
Ob
Ob
Ob
Ob
"}
(30,1,1) = {"
Ob
Ob
Ob
Ob
Ob
Ob
Ob
Ob
Ob
fx
vD
hp
Qu
ri
rb
rb
rb
rb
rb
rb
rb
rb
rb
rb
rb
rb
rb
rb
rb
rb
rb
rb
rb
rb
Op
Qu
Ku
UU
kt
fL
Ob
Ob
Ob
Ob
Ob
"}
(31,1,1) = {"
Ob
Ob
Ob
Ob
Ob
Ob
Ob
Ob
Ob
fx
vD
hp
Qu
ri
rb
rb
rb
rb
rb
rb
rb
rb
rb
rb
rb
rb
rb
rb
rb
rb
rb
rb
rb
rb
Op
Qu
Ku
UU
kt
fL
Ob
Ob
Ob
Ob
Ob
"}
(32,1,1) = {"
Ob
Ob
Ob
Ob
Ob
Ob
Ob
Ob
Ob
fx
vD
hp
Qu
ri
rb
rb
rb
rb
rb
rb
rb
rb
rb
rb
rb
rb
rb
rb
rb
rb
rb
rb
rb
rb
Op
Qu
Ku
UU
kt
fL
Ob
Ob
Ob
Ob
Ob
"}
(33,1,1) = {"
Ob
Ob
Ob
Ob
Ob
Ob
Ob
Ob
Ob
fx
vD
hp
Qu
ri
rb
rb
rb
rb
rb
rb
rb
rb
rb
rb
rb
rb
rb
rb
rb
rb
rb
rb
rb
rb
Op
Qu
Ku
UU
kt
fL
Ob
Ob
Ob
Ob
Ob
"}
(34,1,1) = {"
Ob
Ob
Ob
Ob
Ob
Ob
Ob
Ob
Ob
fx
vD
qA
Qu
ri
rb
rb
rb
rb
rb
rb
rb
rb
rb
rb
rb
rb
rb
rb
rb
rb
rb
rb
rb
rb
Op
Qu
Ku
UU
kt
fL
Ob
Ob
Ob
Ob
Ob
"}
(35,1,1) = {"
Ob
Ob
Ob
Ob
Ob
Ob
Ob
Ob
Ob
fx
vD
hp
Qu
ri
rb
rb
rb
rb
rb
rb
rb
rb
rb
rb
rb
rb
rb
rb
rb
rb
rb
rb
rb
rb
Op
Qu
Ku
UU
kt
fL
Ob
Ob
Ob
Ob
Ob
"}
(36,1,1) = {"
Ob
Ob
Ob
Ob
Ob
Ob
Ob
Ob
Ob
fx
vD
hp
Qu
ri
rb
rb
rb
rb
rb
rb
rb
rb
rb
rb
rb
rb
rb
rb
rb
rb
rb
rb
rb
rb
Op
Qu
Ku
UU
kt
fL
Ob
Ob
Ob
Ob
Ob
"}
(37,1,1) = {"
Ob
Ob
Ob
Ob
Ob
Ob
Ob
Ob
Ob
fx
vD
hp
Qu
oS
rb
rb
rb
rb
rb
rb
rb
rb
rb
rb
rb
rb
rb
rb
rb
rb
rb
rb
rb
rb
mz
Qu
Ku
UU
kt
fL
Ob
Ob
Ob
Ob
Ob
"}
(38,1,1) = {"
Ob
Ob
Ob
Ob
Ob
Ob
Ob
Ob
Ob
fx
vD
hp
Qu
ri
rb
rb
rb
rb
rb
rb
rb
rb
rb
rb
rb
rb
rb
rb
rb
rb
rb
rb
rb
rb
Op
Qu
Ku
UU
kt
fL
Ob
Ob
Ob
Ob
Ob
"}
(39,1,1) = {"
Ob
Ob
Ob
Ob
Ob
Ob
Ob
Ob
Ob
fx
vD
hp
Qu
ri
rb
rb
rb
rb
rb
rb
rb
rb
rb
rb
rb
rb
rb
rb
rb
rb
rb
rb
rb
rb
Op
Qu
Ku
UU
kt
fL
Ob
Ob
Ob
Ob
Ob
"}
(40,1,1) = {"
Ob
Ob
Ob
Ob
Ob
Ob
Ob
Ob
Ob
fx
vD
qA
Qu
ri
rb
rb
rb
rb
rb
rb
rb
rb
rb
rb
rb
rb
rb
rb
rb
rb
rb
rb
rb
rb
Op
Qu
Ku
UU
kt
fL
Ob
Ob
Ob
Ob
Ob
"}
(41,1,1) = {"
Ob
Ob
Ob
Ob
Ob
Ob
Ob
Ob
Ob
fx
vD
hp
Qu
ri
rb
rb
rb
rb
rb
rb
rb
rb
rb
rb
rb
rb
rb
rb
rb
rb
rb
rb
rb
rb
Op
Qu
Ku
UU
kt
fL
Ob
Ob
Ob
Ob
Ob
"}
(42,1,1) = {"
Ob
Ob
Ob
Ob
Ob
Ob
Ob
Ob
Ob
fx
vD
hp
Qu
ri
rb
rb
rb
rb
rb
rb
rb
rb
rb
rb
rb
rb
rb
rb
rb
rb
rb
rb
rb
rb
Op
Qu
Ku
UU
kt
fL
Ob
Ob
Ob
Ob
Ob
"}
(43,1,1) = {"
Ob
Ob
Ob
Ob
Ob
Ob
Ob
Ob
Ob
fx
vD
hp
Qu
ri
rb
rb
rb
rb
rb
rb
rb
rb
rb
rb
rb
rb
rb
rb
rb
rb
rb
rb
rb
rb
Op
Qu
Ku
UU
kt
fL
Ob
Ob
Ob
Ob
Ob
"}
(44,1,1) = {"
Ob
Ob
Ob
Ob
Ob
Ob
Ob
Ob
Ob
fx
vD
hp
Qu
ri
rb
rb
rb
rb
rb
rb
rb
rb
rb
rb
rb
rb
rb
rb
rb
rb
rb
rb
rb
rb
Op
Qu
Ku
UU
kt
fL
Ob
Ob
Ob
Ob
Ob
"}
(45,1,1) = {"
Ob
Ob
Ob
Ob
Ob
Ob
Ob
Ob
Ob
fx
vD
hp
Qu
oS
rb
rb
rb
rb
rb
rb
rb
rb
rb
rb
rb
rb
rb
rb
rb
rb
rb
rb
rb
rb
mz
Qu
Ku
UU
kt
fL
Ob
Ob
Ob
Ob
Ob
"}
(46,1,1) = {"
Ob
Ob
Ob
Ob
Ob
Ob
Ob
Ob
Ob
fx
vD
hp
Qu
ri
rb
rb
rb
rb
rb
rb
rb
rb
rb
rb
rb
rb
rb
rb
rb
rb
rb
rb
rb
rb
Op
Qu
Ku
UU
kt
fL
Ob
Ob
Ob
Ob
Ob
"}
(47,1,1) = {"
Ob
Ob
Ob
Ob
Ob
Ob
Ob
Ob
Ob
fx
vD
hp
Qu
ri
rb
rb
rb
rb
rb
rb
rb
rb
rb
rb
rb
rb
rb
rb
rb
rb
rb
rb
rb
rb
Op
Qu
Ku
UU
kt
fL
Ob
Ob
Ob
Ob
Ob
"}
(48,1,1) = {"
Ob
Ob
Ob
Ob
Ob
Ob
Ob
Ob
Ob
fx
vD
qA
Qu
ri
rb
rb
rb
rb
rb
rb
rb
rb
rb
rb
rb
rb
rb
rb
rb
rb
rb
rb
rb
rb
Op
Qu
Ku
UU
kt
fL
Ob
Ob
Ob
Ob
Ob
"}
(49,1,1) = {"
Ob
Ob
Ob
Ob
Ob
Ob
Ob
Ob
Ob
fx
vD
hp
Qu
ri
rb
rb
rb
rb
rb
rb
rb
rb
rb
rb
rb
rb
rb
rb
rb
rb
rb
rb
rb
rb
Op
Qu
Ku
UU
kt
fL
Ob
Ob
Ob
Ob
Ob
"}
(50,1,1) = {"
Ob
Ob
Ob
Ob
Ob
Ob
Ob
Ob
Ob
fx
vD
hp
Qu
ri
rb
rb
rb
rb
rb
rb
rb
rb
rb
rb
rb
rb
rb
rb
rb
rb
rb
rb
rb
rb
Op
Qu
Ku
UU
kt
fL
Ob
Ob
Ob
Ob
Ob
"}
(51,1,1) = {"
Ob
Ob
Ob
Ob
Ob
Ob
Ob
Ob
Ob
fx
vD
hp
Qu
ri
rb
rb
rb
rb
rb
rb
rb
rb
rb
rb
rb
rb
rb
rb
rb
rb
rb
rb
rb
rb
Op
Qu
Ku
UU
kt
fL
Ob
Ob
Ob
Ob
Ob
"}
(52,1,1) = {"
Ob
Ob
Ob
Ob
Ob
Ob
Ob
Ob
Ob
fx
vD
hp
Qu
ri
rb
rb
rb
rb
rb
rb
rb
rb
rb
rb
rb
rb
rb
rb
rb
rb
rb
rb
rb
rb
Op
Qu
Ku
UU
kt
fL
Ob
Ob
Ob
Ob
Ob
"}
(53,1,1) = {"
Ob
Ob
Ob
Ob
Ob
Ob
Ob
Ob
Ob
fx
vD
hp
Qu
oS
rb
rb
rb
rb
rb
rb
rb
rb
rb
rb
rb
rb
rb
rb
rb
rb
rb
rb
rb
rb
Op
Qu
Ku
UU
kt
fL
Ob
Ob
Ob
Ob
Ob
"}
(54,1,1) = {"
Ob
Ob
Ob
Ob
Ob
Ob
Ob
Ob
Ob
fx
vD
hp
Qu
ri
rb
rb
rb
rb
rb
rb
rb
rb
rb
rb
rb
rb
rb
rb
rb
rb
rb
rb
rb
rb
mz
Qu
Ku
UU
kt
fL
Ob
Ob
Ob
Ob
Ob
"}
(55,1,1) = {"
Ob
Ob
Ob
Ob
Ob
Ob
Ob
Ob
Ob
fx
vD
hp
Qu
ri
rb
rb
rb
rb
rb
rb
rb
rb
rb
rb
rb
rb
rb
rb
rb
rb
rb
rb
rb
rb
Op
Qu
Ku
UU
kt
fL
Ob
Ob
Ob
Ob
Ob
"}
(56,1,1) = {"
Ob
Ob
Ob
Ob
Ob
Ob
Ob
Ob
Ob
fx
vD
qA
Qu
ri
rb
rb
rb
rb
rb
rb
rb
rb
rb
rb
rb
rb
rb
rb
rb
rb
rb
rb
rb
rb
Op
Qu
Ku
UU
kt
fL
Ob
Ob
Ob
Ob
Ob
"}
(57,1,1) = {"
Ob
Ob
Ob
Ob
Ob
Ob
Ob
Ob
Ob
fx
vD
hp
Qu
ri
rb
rb
rb
rb
rb
rb
rb
rb
rb
rb
rb
rb
rb
rb
rb
rb
rb
rb
rb
rb
Op
Qu
Ku
UU
kt
fL
Ob
Ob
Ob
Ob
Ob
"}
(58,1,1) = {"
Ob
Ob
Ob
Ob
Ob
Ob
Ob
Ob
Ob
fx
vD
hp
Qu
ri
rb
rb
rb
rb
rb
rb
rb
rb
rb
rb
rb
rb
rb
rb
rb
rb
rb
rb
rb
rb
Op
Qu
Ku
UU
kt
fL
Ob
Ob
Ob
Ob
Ob
"}
(59,1,1) = {"
Ob
Ob
Ob
Ob
Ob
Ob
Ob
Ob
Ob
fx
vD
hp
Qu
ri
rb
rb
rb
rb
rb
rb
rb
rb
rb
rb
rb
rb
rb
rb
rb
rb
rb
rb
rb
rb
Op
Qu
Ku
UU
kt
fL
Ob
Ob
Ob
Ob
Ob
"}
(60,1,1) = {"
Ob
Ob
Ob
Ob
Ob
Ob
Ob
tX
CM
ED
vD
hp
Qu
ri
rb
rb
rb
rb
rb
rb
rb
rb
rb
rb
rb
rb
rb
rb
rb
rb
rb
rb
rb
rb
Op
Qu
Ku
UU
kt
fL
Ob
Ob
Ob
Ob
Ob
"}
(61,1,1) = {"
Ob
Ob
Ob
Ob
Ob
Ob
tX
ED
Pf
IT
rN
hp
Qu
oS
rb
rb
rb
rb
rb
rb
rb
rb
rb
rb
rb
rb
rb
rb
rb
rb
rb
rb
rb
rb
Op
Qu
Ku
UU
kt
fL
Ob
Ob
Ob
Ob
Ob
"}
(62,1,1) = {"
Ob
Ob
Ob
Ob
tX
CM
ED
kt
vD
Kj
bZ
rh
Qu
ri
rb
rb
rb
rb
rb
rb
rb
rb
rb
rb
rb
rb
rb
rb
rb
rb
rb
rb
rb
rb
Op
Qu
Ku
UU
kt
fL
Ob
Ob
Ob
Ob
Ob
"}
(63,1,1) = {"
Ob
Ob
Ob
Ob
fx
kt
kt
kt
vD
Kj
wr
as
Qu
ri
rb
rb
rb
rb
rb
rb
rb
rb
rb
rb
rb
rb
rb
rb
rb
rb
rb
rb
rb
rb
Op
Qu
Ku
UU
kt
fL
Ob
Ob
Ob
Ob
Ob
"}
(64,1,1) = {"
Ob
Ob
Ob
Ob
fx
Pf
IT
IT
rN
Kj
Aq
as
Qu
ri
rb
rb
rb
rb
rb
rb
rb
rb
rb
rb
rb
rb
rb
rb
rb
rb
rb
rb
rb
rb
Op
Qu
Ku
UU
kt
fL
Ob
Ob
Ob
Ob
Ob
"}
(65,1,1) = {"
Ob
Ob
Ob
Ob
fx
vD
Kj
Kj
Kj
Kj
Aq
as
Qu
ri
rb
rb
rb
rb
rb
rb
rb
rb
rb
rb
rb
rb
rb
rb
rb
rb
rb
rb
rb
rb
Op
Qu
Ku
UU
kt
fL
Ob
Ob
Ob
Ob
Ob
"}
(66,1,1) = {"
Ob
Ob
Ob
Ob
fx
vD
Kj
lO
ep
ep
dh
as
Qu
ri
PS
rb
rb
rb
rb
rb
rb
rb
rb
rb
rb
rb
rb
rb
rb
rb
rb
rb
rb
PS
Op
Qu
Ku
UU
kt
fL
Ob
Ob
Ob
Ob
Ob
"}
(67,1,1) = {"
Ob
Ob
Ob
Ob
fx
vD
Kj
lw
Kj
WQ
Kr
EL
Qu
ri
rb
rb
rb
rb
rb
rb
rb
rb
rb
rb
rb
rb
rb
rb
rb
rb
rb
rb
rb
rb
Op
Qu
Ku
UU
kt
fL
Ob
Ob
Ob
Ob
Ob
"}
(68,1,1) = {"
Ob
Ob
Ob
Ob
fx
vD
Kj
nK
Sp
Kj
Qw
mz
Qu
ri
rb
rb
rb
rb
rb
rb
rb
rb
rb
rb
rb
rb
rb
rb
rb
rb
rb
rb
rb
rb
Op
Qu
Ku
UU
kt
fL
Ob
Ob
Ob
Ob
Ob
"}
(69,1,1) = {"
Ob
Ob
Ob
Ob
fx
vD
Kj
Kj
AD
Kj
vI
Op
Qu
ZV
Zd
Zd
Zd
Zd
Zd
Zd
Zd
Zd
Zd
Zd
Zd
Zd
Zd
Zd
Zd
Zd
Zd
Zd
Zd
Zd
dH
Qu
Ku
UU
kt
fL
Ob
Ob
Ob
Ob
Ob
"}
(70,1,1) = {"
mf
mf
mf
mf
qD
vD
Kj
RM
Ny
Kj
Qw
Op
Qu
Qu
Qu
Qu
Qu
Qu
Qu
Qu
Qu
Qu
Qu
Qu
Qu
Qu
Qu
Qu
Qu
Qu
Qu
Qu
Qu
Qu
Qu
Qu
Ku
UU
kt
HZ
mf
mf
mf
mf
mf
"}
(71,1,1) = {"
Ob
Ob
Ob
Ob
fx
vD
Kj
Kj
Kj
Kj
jC
HY
cC
cC
cC
cC
cC
cC
cC
cC
AY
LI
Zf
Qu
YJ
LI
ll
cC
cC
cC
cC
cC
cC
cC
cC
cC
RY
UU
kt
fL
Ob
Ob
Ob
Ob
Ob
"}
(72,1,1) = {"
Ob
Ob
Ob
Ob
fx
vO
UX
UX
UX
UX
UX
UX
UX
UX
UX
UX
UX
UX
UX
KM
CI
kC
Op
Qu
ri
zF
So
gM
UX
UX
UX
UX
UX
UX
UX
UX
UX
tr
kt
fL
Ob
Ob
Ob
Ob
Ob
"}
(73,1,1) = {"
Ob
Ob
Ob
Ob
UQ
zs
zs
zs
zs
zs
zs
zs
zs
zs
zs
zs
zs
zs
Pj
vD
hy
Ua
Op
Qu
ri
zF
So
UU
tt
zs
zs
zs
zs
zs
zs
zs
zs
zs
zs
ug
Ob
Ob
Ob
Ob
Ob
"}
(74,1,1) = {"
Ob
Ob
Ob
Ob
Ob
Ob
Ob
Ob
Ob
Ob
Ob
Ob
Ob
Ob
Ob
Ob
Ob
Ob
fx
vD
Mz
zF
Op
Qu
ri
Fu
xJ
UU
fL
Ob
Ob
Ob
Ob
Ob
Ob
Ob
Ob
Ob
Ob
Ob
Ob
Ob
Ob
Ob
Ob
"}
(75,1,1) = {"
vR
vR
vR
vR
vR
vR
vR
vR
vR
vR
vR
vR
vR
vR
vR
vR
vR
vR
Qm
rN
eb
eb
tL
tL
tL
eb
eb
pH
OC
vR
vR
vR
vR
vR
vR
vR
vR
vR
vR
vR
vR
vR
vR
vR
vR
"}
(76,1,1) = {"
DR
DR
DR
DR
DR
DR
DR
DR
DR
DR
DR
DR
DR
DR
DR
DR
DR
DR
DR
DR
oF
FP
FP
FP
FP
Kt
oF
DR
DR
DR
DR
DR
DR
DR
DR
DR
DR
DR
DR
DR
DR
DR
DR
DR
DR
"}
(77,1,1) = {"
hd
XE
hd
hd
hd
hd
hd
hd
hd
hd
hd
hd
XE
hd
hd
hd
hd
hd
hd
hd
oF
FP
FP
FP
FP
FP
oF
hd
hd
hd
hd
hd
hd
hd
hd
hd
XE
hd
hd
hd
hd
hd
hd
hd
hd
"}
(78,1,1) = {"
Ob
rb
Ob
Ob
Ob
Ob
Ob
Ob
Ob
Ob
Ob
Ob
rb
Ob
Ob
Ob
Ob
Ob
Ob
Ob
oF
FP
FP
FP
FP
FP
oF
Ob
Ob
Ob
Ob
Ob
Ob
Ob
Ob
Ob
rb
Ob
Ob
Ob
Ob
Ob
Ob
Ob
Ob
"}
(79,1,1) = {"
hd
XE
hd
hd
hd
hd
hd
hd
hd
hd
hd
hd
XE
hd
hd
hd
hd
hd
hd
hd
oF
FP
FP
FP
FP
FP
oF
hd
hd
hd
hd
hd
hd
hd
hd
hd
XE
hd
hd
hd
hd
hd
hd
hd
hd
"}
(80,1,1) = {"
oM
oM
oM
oM
oM
oM
oM
oM
oM
oM
oM
oM
oM
oM
oM
oM
oM
oM
oM
oM
oF
FP
FP
FP
FP
FP
oF
oM
oM
oM
oM
oM
oM
oM
oM
oM
oM
oM
oM
oM
oM
oM
oM
oM
oM
"}
(81,1,1) = {"
Dz
Dz
Dz
Dz
Dz
Dz
Dz
Dz
Dz
Dz
Dz
Dz
Dz
Dz
Dz
Dz
Dz
Dz
Dz
tP
eb
eb
eb
eb
eb
eb
eb
ZS
Dz
Dz
Dz
Dz
Dz
Dz
Dz
Dz
Dz
Dz
Dz
Dz
Dz
Dz
Dz
Dz
Dz
"}
(82,1,1) = {"
Ob
Ob
Ob
Ob
Ob
Ob
Ob
Ob
Ob
Ob
Ob
Ob
Ob
Ob
Ob
Ob
Ob
Ob
Ob
ZP
Dz
Dz
Dz
Dz
Dz
Dz
Dz
Gz
Ob
Ob
Ob
Ob
Ob
Ob
Ob
Ob
Ob
Ob
Ob
Ob
Ob
Ob
Ob
Ob
Ob
"}
(83,1,1) = {"
Ob
Ob
Ob
Ob
Ob
Ob
Ob
Ob
Ob
Ob
Ob
Ob
Ob
Ob
Ob
Ob
Ob
Ob
Ob
Ob
Ob
Ob
Ob
Ob
Ob
Ob
Ob
Ob
Ob
Ob
Ob
Ob
Ob
Ob
Ob
Ob
Ob
Ob
Ob
Ob
Ob
Ob
Ob
Ob
Ob
"}
(84,1,1) = {"
Ob
Ob
Ob
Ob
Ob
Ob
Ob
Ob
Ob
Ob
Ob
Ob
Ob
Ob
Ob
Ob
Ob
Ob
Ob
Ob
Ob
Ob
Ob
Ob
Ob
Ob
Ob
Ob
Ob
Ob
Ob
Ob
Ob
Ob
Ob
Ob
Ob
Ob
Ob
Ob
Ob
Ob
Ob
Ob
Ob
"}
(85,1,1) = {"
Ob
Ob
Ob
Ob
Ob
Ob
Ob
Ob
Ob
Ob
Ob
Ob
Ob
Ob
Ob
Ob
Ob
Ob
Ob
Ob
Ob
Ob
Ob
Ob
Ob
Ob
Ob
Ob
Ob
Ob
Ob
Ob
Ob
Ob
Ob
Ob
Ob
Ob
Ob
Ob
Ob
Ob
Ob
Ob
Ob
"}
(86,1,1) = {"
Ob
Ob
Ob
Ob
Ob
Ob
Ob
Ob
Ob
Ob
Ob
Ob
Ob
Ob
Ob
Ob
Ob
Ob
Ob
Ob
Ob
Ob
Ob
Ob
Ob
Ob
Ob
Ob
Ob
Ob
Ob
Ob
Ob
Ob
Ob
Ob
Ob
Ob
Ob
Ob
Ob
Ob
Ob
Ob
Ob
"}
