//MAP CONVERTED BY dmm2tgm.py THIS HEADER COMMENT PREVENTS RECONVERSION, DO NOT REMOVE
"aj" = (
/obj/structure/platform/industrial_alt/indestructible{
	color = "#999999";
	layer = 2
	},
/turf/open/water/beach/deep/outpost,
/area/hangar/clip_ocean)
"ak" = (
/obj/effect/turf_decal/trimline/transparent/blue/filled/line{
	dir = 1
	},
/obj/machinery/light/floor,
/turf/open/floor/hangar/plasteel/dark/clipoutpost,
/area/hangar/clip_ocean)
"ap" = (
/obj/structure/catwalk/over/plated_catwalk/dark,
/turf/open/floor/hangar/clipoutpost,
/area/hangar)
"aG" = (
/obj/machinery/conveyor/auto/outpost,
/obj/structure/plasticflaps/outpost,
/turf/open/floor/pod/dark,
/area/hangar)
"aJ" = (
/obj/structure/catwalk/over,
/turf/open/water/beach/deep/outpost,
/area/hangar/clip_ocean)
"aY" = (
/turf/open/floor/hangar/clipoutpost,
/area/hangar/clip_ocean)
"bI" = (
/obj/effect/turf_decal/industrial/warning{
	dir = 4
	},
/obj/effect/decal/fakelattice,
/turf/open/floor/hangar/clipoutpost,
/area/hangar/clip_ocean)
"ch" = (
/obj/structure/railing/thin,
/obj/structure/rack,
/obj/item/clothing/neck/poncho/darkblue{
	pixel_x = -8;
	pixel_y = 0
	},
/obj/item/clothing/neck/poncho/darkblue,
/obj/item/clothing/neck/poncho/darkblue{
	pixel_x = 9;
	pixel_y = 0
	},
/obj/machinery/light/directional/east,
/turf/open/floor/hangar/plasteel/dark/clipoutpost,
/area/hangar)
"cu" = (
/obj/structure/platform/industrial_alt/indestructible{
	dir = 4
	},
/turf/open/floor/hangar/clipoutpost{
	color = "#999999";
	light_power = 0.7
	},
/area/hangar/clip_ocean)
"cJ" = (
/obj/effect/turf_decal/trimline/transparent/blue/filled/corner,
/obj/structure/railing/thin{
	dir = 9
	},
/turf/open/floor/hangar/plasteel/dark/clipoutpost,
/area/hangar/clip_ocean)
"dv" = (
/obj/structure/platform/industrial_alt/indestructible{
	dir = 4
	},
/obj/structure/platform/industrial_alt/indestructible{
	color = "#999999";
	layer = 2;
	dir = 1
	},
/turf/open/water/beach/deep/outpost,
/area/hangar/clip_ocean)
"dz" = (
/obj/effect/landmark/outpost/hangar_numbers,
/turf/open/floor/hangar/plasteel/dark/clipoutpost,
/area/hangar)
"dA" = (
/obj/effect/turf_decal/trimline/transparent/blue/filled/line{
	dir = 1
	},
/obj/structure/railing/thin,
/turf/open/floor/hangar/plasteel/dark/clipoutpost,
/area/hangar/clip_ocean)
"eI" = (
/obj/structure/platform/industrial_alt/indestructible{
	dir = 9
	},
/turf/open/floor/hangar/clipoutpost{
	color = "#999999";
	light_power = 0.7
	},
/area/hangar/clip_ocean)
"fb" = (
/obj/effect/turf_decal/industrial/warning{
	dir = 8
	},
/obj/effect/turf_decal/industrial/warning{
	dir = 4
	},
/obj/machinery/door/airlock{
	dir = 8
	},
/obj/effect/landmark/outpost/elevator_machine,
/turf/open/floor/plasteel/mono/dark,
/area/hangar)
"gt" = (
/obj/effect/landmark/outpost/elevator_machine{
	shaft = "1"
	},
/obj/machinery/elevator_call_button{
	dir = 8;
	pixel_x = 25;
	pixel_y = 6
	},
/turf/open/floor/hangar/plasteel/dark/clipoutpost,
/area/hangar)
"he" = (
/obj/structure/platform/industrial_alt/indestructible{
	color = "#999999";
	layer = 2;
	dir = 1
	},
/turf/open/water/beach/deep/outpost,
/area/hangar/clip_ocean)
"hq" = (
/obj/structure/platform/industrial_alt/indestructible{
	color = "#999999";
	layer = 2;
	dir = 10
	},
/turf/open/water/beach/deep/outpost,
/area/hangar/clip_ocean)
"hs" = (
/obj/structure/platform/industrial_alt/indestructible{
	dir = 4
	},
/turf/open/water/beach/deep/outpost,
/area/hangar/clip_ocean)
"ir" = (
/turf/closed/indestructible/plastitanium/nodiagnonal,
/area/hangar)
"iE" = (
/obj/effect/turf_decal/trimline/transparent/blue/filled/line{
	dir = 4
	},
/obj/structure/railing/thin{
	dir = 8
	},
/turf/open/floor/hangar/plasteel/dark/clipoutpost,
/area/hangar/clip_ocean)
"jo" = (
/obj/structure/plasticflaps/outpost,
/obj/machinery/conveyor/auto/outpost{
	dir = 5;
	verted = -1
	},
/turf/open/floor/pod/dark,
/area/hangar)
"kJ" = (
/obj/structure/railing/thin{
	dir = 1
	},
/obj/structure/chair/bench/blue/directional/north{
	dir = 2
	},
/turf/open/floor/hangar/plasteel/dark/clipoutpost,
/area/hangar)
"lz" = (
/obj/machinery/conveyor/auto/outpost{
	dir = 8
	},
/turf/open/floor/pod/dark,
/area/hangar)
"lC" = (
/obj/effect/turf_decal/trimline/transparent/blue/filled/line{
	dir = 10
	},
/obj/machinery/light/floor,
/turf/open/floor/hangar/plasteel/dark/clipoutpost,
/area/hangar/clip_ocean)
"lT" = (
/obj/machinery/conveyor/auto/outpost,
/obj/effect/landmark/outpost/hangar_crate_spawner,
/turf/open/floor/pod/dark,
/area/hangar)
"ma" = (
/obj/effect/turf_decal/trimline/transparent/blue/filled/line,
/turf/open/floor/hangar/plasteel/dark/clipoutpost,
/area/hangar/clip_ocean)
"ml" = (
/obj/structure/platform/industrial_alt/indestructible{
	color = "#999999";
	layer = 2
	},
/obj/structure/platform/industrial_alt/indestructible{
	dir = 4
	},
/turf/open/water/beach/deep/outpost,
/area/hangar/clip_ocean)
"mu" = (
/obj/structure/marker_beacon{
	picked_color = "Teal"
	},
/turf/open/floor/hangar/clipoutpost,
/area/hangar/clip_ocean)
"mV" = (
/obj/effect/turf_decal/trimline/transparent/blue/filled/line{
	dir = 4
	},
/turf/open/floor/hangar/plasteel/dark/clipoutpost,
/area/hangar/clip_ocean)
"nf" = (
/obj/structure/platform/industrial_alt/indestructible{
	dir = 8
	},
/turf/open/floor/hangar/clipoutpost{
	color = "#999999";
	light_power = 0.7
	},
/area/hangar/clip_ocean)
"np" = (
/obj/structure/platform/industrial_alt/corner/indestructible{
	dir = 4
	},
/turf/open/floor/hangar/clipoutpost{
	color = "#999999";
	light_power = 0.7
	},
/area/hangar/clip_ocean)
"nK" = (
/obj/structure/platform/industrial_alt/corner/indestructible{
	color = "#999999";
	layer = 2;
	dir = 4
	},
/turf/open/water/beach/deep/outpost,
/area/hangar/clip_ocean)
"or" = (
/obj/structure/disposalpipe/segment,
/obj/structure/catwalk/over,
/turf/open/water/beach/deep/outpost,
/area/hangar/clip_ocean)
"oR" = (
/obj/structure/platform/industrial_alt/corner/indestructible{
	dir = 4
	},
/turf/open/water/beach/deep/outpost,
/area/hangar/clip_ocean)
"pm" = (
/obj/effect/turf_decal/trimline/transparent/blue/filled/corner{
	dir = 1
	},
/obj/structure/railing/thin{
	dir = 6
	},
/turf/open/floor/hangar/plasteel/dark/clipoutpost,
/area/hangar/clip_ocean)
"pK" = (
/obj/effect/turf_decal/trimline/transparent/blue/filled/line,
/obj/machinery/light/floor,
/turf/open/floor/hangar/plasteel/dark/clipoutpost,
/area/hangar/clip_ocean)
"qW" = (
/obj/structure/platform/industrial_alt/indestructible{
	dir = 9
	},
/turf/open/water/beach/deep/outpost,
/area/hangar/clip_ocean)
"qZ" = (
/obj/structure/platform/industrial_alt/indestructible{
	color = "#999999";
	layer = 2;
	dir = 6
	},
/turf/open/water/beach/deep/outpost,
/area/hangar/clip_ocean)
"rf" = (
/obj/structure/railing{
	dir = 8
	},
/obj/effect/turf_decal/corner_steel_grid{
	dir = 9
	},
/turf/open/floor/hangar/plasteel/dark/clipoutpost,
/area/hangar)
"rX" = (
/obj/structure/sign/departments/cargo,
/turf/closed/indestructible/plastitanium/nodiagnonal,
/area/hangar)
"sU" = (
/obj/effect/turf_decal/trimline/transparent/blue/filled/line{
	dir = 8
	},
/obj/structure/railing/thin{
	dir = 4
	},
/turf/open/floor/hangar/plasteel/dark/clipoutpost,
/area/hangar/clip_ocean)
"tg" = (
/obj/effect/turf_decal/trimline/transparent/blue/filled/line,
/obj/structure/railing/thin/corner{
	dir = 1
	},
/obj/effect/turf_decal/corner_steel_grid{
	dir = 4
	},
/turf/open/floor/hangar/plasteel/dark/clipoutpost,
/area/hangar/clip_ocean)
"tl" = (
/obj/structure/catwalk/over/plated_catwalk/dark,
/turf/open/floor/hangar/clipoutpost,
/area/hangar/clip_ocean)
"tm" = (
/turf/open/floor/plasteel/elevatorshaft,
/area/hangar)
"tp" = (
/obj/effect/turf_decal/trimline/transparent/blue/filled/line{
	dir = 6
	},
/obj/machinery/light/floor,
/turf/open/floor/hangar/plasteel/dark/clipoutpost,
/area/hangar/clip_ocean)
"tq" = (
/obj/effect/turf_decal/corner_steel_grid{
	dir = 1
	},
/obj/effect/turf_decal/trimline/transparent/blue/filled/line,
/turf/open/floor/hangar/plasteel/dark/clipoutpost,
/area/hangar/clip_ocean)
"tr" = (
/obj/effect/turf_decal/trimline/transparent/blue/filled/line,
/turf/open/floor/hangar/plasteel/dark/clipoutpost,
/area/hangar)
"ux" = (
/obj/structure/platform/industrial_alt/indestructible{
	color = "#999999";
	layer = 2;
	dir = 8
	},
/turf/open/water/beach/deep/outpost,
/area/hangar/clip_ocean)
"uC" = (
/obj/structure/railing/thin{
	dir = 1
	},
/obj/structure/chair/bench/blue/directional/south,
/turf/open/floor/hangar/plasteel/dark/clipoutpost,
/area/hangar)
"vn" = (
/obj/structure/platform/industrial_alt/corner/indestructible{
	dir = 1
	},
/turf/open/floor/hangar/clipoutpost{
	color = "#999999";
	light_power = 0.7
	},
/area/hangar/clip_ocean)
"vv" = (
/obj/structure/disposalpipe/trunk{
	dir = 4
	},
/obj/machinery/conveyor/auto/outpost{
	dir = 1
	},
/obj/structure/disposaloutlet{
	dir = 1
	},
/turf/open/floor/pod/dark,
/area/hangar)
"vB" = (
/obj/effect/turf_decal/trimline/transparent/blue/filled/line{
	dir = 8
	},
/obj/structure/railing/thin/corner{
	dir = 4
	},
/turf/open/floor/hangar/plasteel/dark/clipoutpost,
/area/hangar/clip_ocean)
"zs" = (
/obj/structure/platform/industrial_alt/indestructible,
/obj/structure/fluff/arrowsong_big,
/turf/open/floor/hangar/clipoutpost{
	color = "#999999";
	light_power = 0.7
	},
/area/hangar/clip_ocean)
"zu" = (
/obj/structure/platform/industrial_alt/indestructible{
	color = "#999999";
	layer = 2
	},
/obj/structure/disposalpipe/segment,
/obj/structure/catwalk/over,
/turf/open/water/beach/deep/outpost,
/area/hangar/clip_ocean)
"Br" = (
/obj/machinery/conveyor/auto/outpost{
	dir = 8
	},
/obj/machinery/light/directional/north,
/turf/open/floor/pod/dark,
/area/hangar)
"BB" = (
/obj/structure/platform/industrial_alt/indestructible{
	dir = 5
	},
/turf/open/floor/hangar/clipoutpost{
	color = "#999999";
	light_power = 0.7
	},
/area/hangar/clip_ocean)
"Ci" = (
/obj/structure/platform/industrial_alt/corner/indestructible,
/turf/open/floor/hangar/clipoutpost{
	color = "#999999";
	light_power = 0.7
	},
/area/hangar/clip_ocean)
"Ct" = (
/obj/structure/railing/thin{
	dir = 1
	},
/obj/structure/rack,
/obj/item/clothing/neck/poncho/darkblue,
/obj/item/clothing/neck/poncho/darkblue{
	pixel_x = -9;
	pixel_y = 0
	},
/obj/item/clothing/neck/poncho/darkblue{
	pixel_x = 9;
	pixel_y = 0
	},
/obj/machinery/light/directional/east,
/turf/open/floor/hangar/plasteel/dark/clipoutpost,
/area/hangar)
"Cw" = (
/obj/effect/turf_decal/trimline/transparent/blue/filled/corner{
	dir = 8
	},
/obj/structure/railing/thin{
	dir = 4
	},
/turf/open/floor/hangar/plasteel/dark/clipoutpost,
/area/hangar/clip_ocean)
"Cx" = (
/obj/structure/railing/thin{
	dir = 4
	},
/turf/open/floor/hangar/plasteel/dark/clipoutpost,
/area/hangar)
"CV" = (
/obj/structure/platform/industrial_alt/indestructible{
	dir = 8
	},
/turf/open/water/beach/deep/outpost,
/area/hangar/clip_ocean)
"Dv" = (
/obj/structure/platform/industrial_alt/corner/indestructible{
	color = "#999999";
	layer = 2;
	dir = 8
	},
/turf/open/water/beach/deep/outpost,
/area/hangar/clip_ocean)
"DS" = (
/obj/machinery/disposal/deliveryChute{
	dir = 1
	},
/obj/structure/disposalpipe/trunk{
	dir = 8
	},
/turf/open/floor/pod/dark,
/area/hangar)
"Eg" = (
/obj/structure/platform/industrial_alt/indestructible{
	dir = 6
	},
/turf/open/floor/hangar/clipoutpost{
	color = "#999999";
	light_power = 0.7
	},
/area/hangar/clip_ocean)
"Fu" = (
/obj/structure/platform/industrial_alt/indestructible,
/turf/open/floor/hangar/clipoutpost{
	color = "#999999";
	light_power = 0.7
	},
/area/hangar/clip_ocean)
"GD" = (
/obj/structure/platform/industrial_alt/indestructible{
	dir = 10
	},
/turf/open/water/beach/deep/outpost,
/area/hangar/clip_ocean)
"GN" = (
/obj/structure/platform/industrial_alt/indestructible{
	dir = 1
	},
/turf/open/floor/hangar/clipoutpost{
	color = "#999999";
	light_power = 0.7
	},
/area/hangar/clip_ocean)
"Hq" = (
/obj/effect/landmark/outpost/shaft_number,
/turf/open/floor/hangar/plasteel/dark/clipoutpost,
/area/hangar)
"HI" = (
/obj/effect/turf_decal/trimline/transparent/blue/filled/line{
	dir = 5
	},
/obj/machinery/light/floor,
/turf/open/floor/hangar/plasteel/dark/clipoutpost,
/area/hangar/clip_ocean)
"JQ" = (
/turf/open/water/beach/deep/outpost,
/area/hangar/clip_ocean)
"JX" = (
/obj/structure/railing/thin{
	dir = 1
	},
/obj/effect/turf_decal/trimline/transparent/blue/filled/line,
/turf/open/floor/hangar/plasteel/dark/clipoutpost,
/area/hangar/clip_ocean)
"KC" = (
/obj/structure/railing/thin{
	dir = 8
	},
/obj/effect/turf_decal/corner_steel_grid{
	dir = 6
	},
/turf/open/floor/hangar/plasteel/dark/clipoutpost,
/area/hangar)
"KF" = (
/obj/structure/platform/industrial_alt/corner/indestructible{
	dir = 1
	},
/turf/open/water/beach/deep/outpost,
/area/hangar/clip_ocean)
"Lj" = (
/obj/structure/plasticflaps/outpost,
/obj/machinery/conveyor/auto/outpost{
	dir = 8
	},
/turf/open/floor/pod/dark,
/area/hangar)
"Ll" = (
/obj/structure/platform/industrial_alt/indestructible{
	color = "#999999";
	layer = 2;
	dir = 9
	},
/turf/open/water/beach/deep/outpost,
/area/hangar/clip_ocean)
"Nq" = (
/obj/effect/turf_decal/trimline/transparent/blue/filled/line,
/obj/structure/railing/thin{
	dir = 1
	},
/turf/open/floor/hangar/plasteel/dark/clipoutpost,
/area/hangar/clip_ocean)
"Nt" = (
/obj/effect/landmark/outpost/hangar_dock,
/turf/open/floor/hangar/clipoutpost,
/area/hangar/clip_ocean)
"Nz" = (
/obj/machinery/conveyor/auto/outpost{
	dir = 6;
	verted = -1
	},
/turf/open/floor/pod/dark,
/area/hangar)
"Ok" = (
/turf/open/floor/hangar/clipoutpost{
	color = "#999999";
	light_power = 0.7
	},
/area/hangar/clip_ocean)
"OG" = (
/obj/effect/landmark/outpost/elevator{
	shaft = "1"
	},
/turf/open/floor/plasteel/elevatorshaft,
/area/hangar)
"PD" = (
/obj/effect/turf_decal/box,
/turf/open/floor/pod/dark,
/area/hangar)
"Qk" = (
/obj/effect/turf_decal/trimline/transparent/blue/filled/line{
	dir = 8
	},
/turf/open/floor/hangar/plasteel/dark/clipoutpost,
/area/hangar/clip_ocean)
"QA" = (
/obj/structure/platform/industrial_alt/corner/indestructible{
	color = "#999999";
	layer = 2;
	dir = 1
	},
/turf/open/water/beach/deep/outpost,
/area/hangar/clip_ocean)
"QJ" = (
/obj/effect/turf_decal/trimline/transparent/blue/filled/line{
	dir = 1
	},
/turf/open/floor/hangar/plasteel/dark/clipoutpost,
/area/hangar)
"Ry" = (
/obj/structure/platform/industrial_alt/indestructible{
	dir = 10
	},
/turf/open/floor/hangar/clipoutpost{
	color = "#999999";
	light_power = 0.7
	},
/area/hangar/clip_ocean)
"RZ" = (
/obj/machinery/conveyor/auto/outpost{
	dir = 10
	},
/turf/open/floor/pod/dark,
/area/hangar)
"SH" = (
/obj/effect/turf_decal/trimline/transparent/blue/filled/line{
	dir = 1
	},
/turf/open/floor/hangar/plasteel/dark/clipoutpost,
/area/hangar/clip_ocean)
"SR" = (
/obj/effect/turf_decal/trimline/transparent/blue/filled/corner{
	dir = 4
	},
/obj/structure/railing/thin{
	dir = 10
	},
/turf/open/floor/hangar/plasteel/dark/clipoutpost,
/area/hangar/clip_ocean)
"Tk" = (
/obj/structure/disposalpipe/segment{
	dir = 4
	},
/turf/closed/indestructible/plastitanium/nodiagnonal,
/area/hangar)
"TQ" = (
/obj/structure/railing/thin,
/obj/structure/chair/bench/blue/directional/north,
/turf/open/floor/hangar/plasteel/dark/clipoutpost,
/area/hangar)
"UQ" = (
/obj/structure/rack,
/obj/item/weldingtool/mini{
	pixel_x = -3;
	pixel_y = 4
	},
/obj/item/clothing/head/welding{
	pixel_x = 9;
	pixel_y = 0
	},
/turf/open/floor/hangar/plasteel/dark/clipoutpost,
/area/hangar)
"VS" = (
/obj/structure/platform/industrial_alt/indestructible{
	color = "#999999";
	layer = 2;
	dir = 1
	},
/obj/structure/disposalpipe/segment,
/obj/structure/catwalk/over,
/turf/open/water/beach/deep/outpost,
/area/hangar/clip_ocean)
"Wm" = (
/obj/structure/platform/industrial_alt/corner/indestructible{
	color = "#999999";
	layer = 2
	},
/turf/open/water/beach/deep/outpost,
/area/hangar/clip_ocean)
"WB" = (
/turf/open/floor/hangar/plasteel/dark/clipoutpost,
/area/hangar)
"WN" = (
/obj/structure/platform/industrial_alt/corner/indestructible{
	dir = 8
	},
/turf/open/floor/hangar/clipoutpost{
	color = "#999999";
	light_power = 0.7
	},
/area/hangar/clip_ocean)
"WU" = (
/obj/effect/turf_decal/industrial/warning{
	dir = 8
	},
/obj/effect/decal/fakelattice,
/turf/open/floor/hangar/clipoutpost,
/area/hangar/clip_ocean)
"Xa" = (
/obj/effect/turf_decal/industrial/warning{
	dir = 1
	},
/obj/effect/turf_decal/industrial/warning,
/obj/machinery/door/poddoor/ert,
/turf/open/floor/plasteel/tech,
/area/hangar)
"Xh" = (
/obj/structure/platform/industrial_alt/indestructible{
	color = "#999999";
	layer = 2;
	dir = 4
	},
/turf/open/water/beach/deep/outpost,
/area/hangar/clip_ocean)
"Xp" = (
/obj/effect/turf_decal/trimline/transparent/blue/filled/line{
	dir = 9
	},
/obj/machinery/light/floor,
/turf/open/floor/hangar/plasteel/dark/clipoutpost,
/area/hangar/clip_ocean)
"XX" = (
/obj/structure/chair/bench/blue/directional/south,
/turf/open/floor/hangar/plasteel/dark/clipoutpost,
/area/hangar)
"Yj" = (
/obj/effect/turf_decal/trimline/transparent/blue/filled/line{
	dir = 8
	},
/obj/structure/railing/thin/corner,
/turf/open/floor/hangar/plasteel/dark/clipoutpost,
/area/hangar/clip_ocean)
"ZG" = (
/obj/effect/turf_decal/corner_steel_grid{
	dir = 5
	},
/obj/effect/turf_decal/trimline/transparent/blue/filled/line,
/turf/open/floor/hangar/plasteel/dark/clipoutpost,
/area/hangar/clip_ocean)
"ZV" = (
/obj/structure/catwalk/over,
/turf/open/floor/hangar/clipoutpost,
/area/hangar/clip_ocean)

(1,1,1) = {"
JQ
JQ
JQ
JQ
JQ
JQ
JQ
JQ
JQ
JQ
JQ
JQ
JQ
JQ
JQ
JQ
JQ
JQ
JQ
JQ
JQ
JQ
JQ
JQ
JQ
JQ
JQ
JQ
JQ
JQ
JQ
JQ
JQ
JQ
JQ
JQ
JQ
JQ
JQ
JQ
JQ
JQ
JQ
JQ
JQ
"}
(2,1,1) = {"
JQ
JQ
JQ
JQ
JQ
JQ
JQ
JQ
JQ
JQ
JQ
JQ
JQ
JQ
JQ
JQ
JQ
JQ
JQ
JQ
JQ
JQ
JQ
JQ
JQ
JQ
JQ
JQ
JQ
JQ
JQ
JQ
JQ
JQ
JQ
JQ
JQ
JQ
JQ
JQ
JQ
JQ
JQ
JQ
JQ
"}
(3,1,1) = {"
JQ
JQ
JQ
JQ
JQ
JQ
JQ
JQ
JQ
JQ
JQ
JQ
JQ
JQ
JQ
JQ
JQ
JQ
JQ
JQ
JQ
JQ
JQ
JQ
JQ
JQ
JQ
JQ
JQ
JQ
JQ
JQ
JQ
JQ
JQ
JQ
JQ
JQ
JQ
JQ
JQ
JQ
JQ
JQ
JQ
"}
(4,1,1) = {"
JQ
JQ
JQ
JQ
JQ
JQ
JQ
JQ
JQ
JQ
JQ
JQ
JQ
JQ
JQ
JQ
JQ
JQ
JQ
JQ
JQ
JQ
JQ
JQ
JQ
JQ
JQ
JQ
JQ
JQ
JQ
JQ
JQ
JQ
JQ
JQ
JQ
JQ
JQ
JQ
JQ
JQ
JQ
JQ
JQ
"}
(5,1,1) = {"
JQ
JQ
JQ
JQ
JQ
JQ
JQ
JQ
JQ
JQ
JQ
JQ
JQ
JQ
JQ
JQ
JQ
JQ
JQ
JQ
JQ
JQ
JQ
JQ
JQ
JQ
JQ
JQ
JQ
JQ
JQ
JQ
JQ
JQ
JQ
JQ
JQ
JQ
JQ
JQ
JQ
JQ
JQ
JQ
JQ
"}
(6,1,1) = {"
JQ
JQ
JQ
JQ
JQ
JQ
JQ
JQ
JQ
JQ
JQ
JQ
JQ
JQ
JQ
JQ
JQ
JQ
JQ
JQ
JQ
JQ
JQ
JQ
JQ
JQ
JQ
JQ
JQ
JQ
JQ
JQ
JQ
JQ
JQ
JQ
JQ
JQ
JQ
JQ
JQ
JQ
JQ
JQ
JQ
"}
(7,1,1) = {"
JQ
JQ
JQ
JQ
JQ
JQ
JQ
JQ
JQ
JQ
JQ
JQ
JQ
JQ
JQ
JQ
JQ
JQ
JQ
JQ
JQ
JQ
JQ
JQ
JQ
JQ
JQ
JQ
JQ
JQ
JQ
JQ
JQ
JQ
JQ
JQ
JQ
JQ
JQ
JQ
JQ
JQ
JQ
JQ
JQ
"}
(8,1,1) = {"
JQ
JQ
JQ
JQ
JQ
JQ
JQ
JQ
JQ
Wm
Xh
Xh
Xh
Xh
Xh
Xh
Xh
Xh
Xh
Xh
Xh
Xh
Xh
Xh
Xh
Xh
Xh
Xh
Xh
Xh
Xh
Xh
Xh
Xh
Xh
Xh
Xh
Xh
Xh
Dv
JQ
JQ
JQ
JQ
JQ
"}
(9,1,1) = {"
JQ
JQ
JQ
JQ
JQ
JQ
JQ
JQ
JQ
aj
Ci
cu
cu
cu
cu
cu
cu
cu
cu
cu
cu
cu
cu
cu
cu
cu
cu
cu
cu
cu
cu
cu
cu
cu
cu
cu
cu
WN
Ok
he
JQ
JQ
JQ
JQ
JQ
"}
(10,1,1) = {"
JQ
JQ
JQ
JQ
JQ
JQ
JQ
JQ
JQ
aj
Fu
cJ
iE
iE
iE
iE
iE
iE
iE
iE
iE
iE
iE
iE
iE
iE
iE
iE
iE
iE
iE
iE
iE
iE
iE
iE
SR
GN
Ok
he
JQ
JQ
JQ
JQ
JQ
"}
(11,1,1) = {"
JQ
JQ
JQ
JQ
JQ
JQ
JQ
JQ
JQ
aj
Fu
Nq
tl
tl
tl
tl
tl
tl
tl
tl
tl
tl
tl
tl
tl
tl
tl
tl
tl
tl
tl
tl
tl
tl
tl
tl
dA
GN
Ok
he
JQ
JQ
JQ
JQ
JQ
"}
(12,1,1) = {"
JQ
JQ
JQ
JQ
JQ
JQ
JQ
JQ
JQ
aj
Fu
Nq
tl
Xp
Qk
Qk
Qk
Qk
Qk
Qk
Qk
Qk
Qk
Qk
Qk
Qk
Qk
Qk
Qk
Qk
Qk
Qk
Qk
Qk
lC
tl
dA
GN
Ok
he
JQ
JQ
JQ
JQ
JQ
"}
(13,1,1) = {"
JQ
JQ
JQ
JQ
JQ
JQ
JQ
JQ
JQ
aj
Fu
Nq
tl
SH
aY
aY
aY
aY
aY
aY
aY
aY
aY
aY
aY
aY
aY
aY
aY
aY
aY
aY
aY
Nt
ma
tl
dA
GN
Ok
he
JQ
JQ
JQ
JQ
JQ
"}
(14,1,1) = {"
JQ
JQ
JQ
JQ
JQ
JQ
JQ
JQ
JQ
aj
Fu
JX
tl
SH
aY
aY
aY
aY
aY
aY
aY
aY
aY
aY
aY
aY
aY
aY
aY
aY
aY
aY
aY
aY
ma
tl
dA
GN
Ok
he
JQ
JQ
JQ
JQ
JQ
"}
(15,1,1) = {"
JQ
JQ
JQ
JQ
JQ
JQ
JQ
JQ
JQ
aj
Fu
JX
tl
SH
mu
aY
aY
aY
aY
aY
aY
aY
aY
aY
aY
aY
aY
aY
aY
aY
aY
aY
aY
mu
ma
tl
dA
GN
Ok
he
JQ
JQ
JQ
JQ
JQ
"}
(16,1,1) = {"
JQ
JQ
JQ
JQ
JQ
JQ
JQ
JQ
JQ
aj
Fu
JX
tl
SH
aY
aY
aY
aY
aY
aY
aY
aY
aY
aY
aY
aY
aY
aY
aY
aY
aY
aY
aY
aY
ma
tl
dA
GN
Ok
he
JQ
JQ
JQ
JQ
JQ
"}
(17,1,1) = {"
JQ
JQ
JQ
JQ
JQ
JQ
JQ
JQ
JQ
aj
Fu
JX
tl
SH
aY
aY
aY
aY
aY
aY
aY
aY
aY
aY
aY
aY
aY
aY
aY
aY
aY
aY
aY
aY
ma
tl
dA
GN
Ok
he
JQ
JQ
JQ
JQ
JQ
"}
(18,1,1) = {"
JQ
JQ
JQ
JQ
JQ
JQ
JQ
JQ
JQ
aj
Fu
JX
tl
SH
aY
aY
aY
aY
aY
aY
aY
aY
aY
aY
aY
aY
aY
aY
aY
aY
aY
aY
aY
aY
ma
tl
dA
GN
Ok
he
JQ
JQ
JQ
JQ
JQ
"}
(19,1,1) = {"
JQ
JQ
JQ
JQ
JQ
JQ
JQ
JQ
JQ
aj
Fu
Nq
tl
SH
aY
aY
aY
aY
aY
aY
aY
aY
aY
aY
aY
aY
aY
aY
aY
aY
aY
aY
aY
aY
ma
tl
dA
GN
Ok
he
JQ
JQ
JQ
JQ
JQ
"}
(20,1,1) = {"
JQ
JQ
JQ
JQ
JQ
JQ
JQ
JQ
JQ
aj
Fu
Nq
tl
ak
mu
aY
aY
aY
aY
aY
aY
aY
aY
aY
aY
aY
aY
aY
aY
aY
aY
aY
aY
mu
pK
tl
dA
GN
Ok
he
JQ
JQ
JQ
JQ
JQ
"}
(21,1,1) = {"
JQ
JQ
JQ
JQ
JQ
JQ
JQ
JQ
JQ
aj
Fu
Nq
tl
SH
aY
aY
aY
aY
aY
aY
aY
aY
aY
aY
aY
aY
aY
aY
aY
aY
aY
aY
aY
aY
ma
tl
dA
GN
Ok
he
JQ
JQ
JQ
JQ
JQ
"}
(22,1,1) = {"
JQ
JQ
JQ
JQ
JQ
JQ
JQ
JQ
JQ
aj
Fu
Nq
tl
SH
aY
aY
aY
aY
aY
aY
aY
aY
aY
aY
aY
aY
aY
aY
aY
aY
aY
aY
aY
aY
ma
tl
dA
GN
Ok
he
JQ
JQ
JQ
JQ
JQ
"}
(23,1,1) = {"
JQ
JQ
JQ
JQ
JQ
JQ
JQ
JQ
JQ
aj
Fu
Nq
tl
SH
aY
aY
aY
aY
aY
aY
aY
aY
aY
aY
aY
aY
aY
aY
aY
aY
aY
aY
aY
aY
ma
tl
dA
GN
Ok
he
JQ
JQ
JQ
JQ
JQ
"}
(24,1,1) = {"
JQ
JQ
JQ
JQ
JQ
JQ
JQ
Wm
Xh
qZ
Fu
Nq
tl
SH
aY
aY
aY
aY
aY
aY
aY
aY
aY
aY
aY
aY
aY
aY
aY
aY
aY
aY
aY
aY
ma
tl
dA
GN
Ok
he
JQ
JQ
JQ
JQ
JQ
"}
(25,1,1) = {"
JQ
JQ
JQ
JQ
JQ
JQ
Wm
qZ
Ci
cu
Eg
Nq
tl
ak
mu
aY
aY
aY
aY
aY
aY
aY
aY
aY
aY
aY
aY
aY
aY
aY
aY
aY
aY
mu
pK
tl
dA
GN
Ok
he
JQ
JQ
JQ
JQ
JQ
"}
(26,1,1) = {"
JQ
JQ
JQ
JQ
Wm
Xh
qZ
Ok
Fu
ir
KC
tg
tl
SH
aY
aY
aY
aY
aY
aY
aY
aY
aY
aY
aY
aY
aY
aY
aY
aY
aY
aY
aY
aY
ma
tl
dA
GN
Ok
he
JQ
JQ
JQ
JQ
JQ
"}
(27,1,1) = {"
JQ
JQ
JQ
JQ
aj
Ok
Ok
Ok
Fu
ir
PD
ZG
tl
SH
aY
aY
aY
aY
aY
aY
aY
aY
aY
aY
aY
aY
aY
aY
aY
aY
aY
aY
aY
aY
ma
tl
dA
GN
Ok
he
JQ
JQ
JQ
JQ
JQ
"}
(28,1,1) = {"
JQ
JQ
JQ
JQ
aj
Ci
cu
cu
Eg
ir
Br
ZG
tl
SH
aY
aY
aY
aY
aY
aY
aY
aY
aY
aY
aY
aY
aY
aY
aY
aY
aY
aY
aY
aY
ma
tl
dA
GN
Ok
he
JQ
JQ
JQ
JQ
JQ
"}
(29,1,1) = {"
JQ
JQ
JQ
JQ
aj
Fu
ir
ir
ir
ir
lz
ZG
tl
SH
aY
aY
aY
aY
aY
aY
aY
aY
aY
aY
aY
aY
aY
aY
aY
aY
aY
aY
aY
aY
ma
tl
dA
GN
Ok
he
JQ
JQ
JQ
JQ
JQ
"}
(30,1,1) = {"
JQ
JQ
JQ
JQ
aj
Fu
ir
jo
aG
aG
RZ
ZG
tl
SH
mu
aY
aY
aY
aY
aY
aY
aY
aY
aY
aY
aY
aY
aY
aY
aY
aY
aY
aY
mu
ma
tl
dA
GN
Ok
he
JQ
JQ
JQ
JQ
JQ
"}
(31,1,1) = {"
JQ
JQ
JQ
JQ
aj
Fu
ir
Lj
ir
rX
rf
tq
tl
SH
aY
aY
aY
aY
aY
aY
aY
aY
aY
aY
aY
aY
aY
aY
aY
aY
aY
aY
aY
aY
ma
tl
dA
GN
Ok
he
JQ
JQ
JQ
JQ
JQ
"}
(32,1,1) = {"
JQ
JQ
JQ
JQ
aj
Fu
ir
Nz
vv
ir
XX
pK
tl
SH
aY
aY
aY
aY
aY
aY
aY
aY
aY
aY
aY
aY
aY
aY
aY
aY
aY
aY
aY
aY
ma
tl
dA
GN
Ok
he
JQ
JQ
JQ
JQ
JQ
"}
(33,1,1) = {"
JQ
JQ
JQ
JQ
aj
Fu
ir
ir
Tk
ir
UQ
ma
tl
HI
mV
mV
mV
mV
mV
mV
mV
mV
mV
mV
mV
mV
mV
mV
mV
mV
mV
mV
mV
mV
tp
tl
dA
GN
Ok
he
JQ
JQ
JQ
JQ
JQ
"}
(34,1,1) = {"
or
or
or
or
zu
Fu
ir
lT
DS
ir
XX
ma
tl
tl
tl
tl
tl
tl
tl
tl
tl
tl
tl
tl
tl
tl
tl
tl
tl
tl
tl
tl
tl
tl
tl
tl
dA
GN
Ok
VS
or
or
or
or
or
"}
(35,1,1) = {"
JQ
JQ
JQ
JQ
aj
Fu
ir
ir
ir
ir
Cx
Cw
sU
sU
sU
sU
sU
sU
sU
sU
vB
Qk
lC
tl
Xp
Qk
Yj
sU
sU
sU
sU
sU
sU
sU
sU
sU
pm
GN
Ok
he
JQ
JQ
JQ
JQ
JQ
"}
(36,1,1) = {"
JQ
JQ
JQ
JQ
aj
vn
nf
nf
nf
nf
nf
nf
nf
nf
nf
nf
nf
nf
nf
Ry
uC
Hq
tr
ap
QJ
WB
TQ
eI
nf
nf
nf
nf
nf
nf
nf
nf
nf
np
Ok
he
JQ
JQ
JQ
JQ
JQ
"}
(37,1,1) = {"
JQ
JQ
JQ
JQ
QA
ux
ux
ux
ux
ux
ux
ux
ux
ux
ux
ux
ux
ux
hq
zs
kJ
dz
tr
ap
QJ
WB
TQ
GN
Ll
ux
ux
ux
ux
ux
ux
ux
ux
ux
ux
nK
JQ
JQ
JQ
JQ
JQ
"}
(38,1,1) = {"
JQ
JQ
JQ
JQ
JQ
JQ
JQ
JQ
JQ
JQ
JQ
JQ
JQ
JQ
JQ
JQ
JQ
JQ
aj
Fu
Ct
WB
tr
ap
QJ
gt
ch
GN
he
JQ
JQ
JQ
JQ
JQ
JQ
JQ
JQ
JQ
JQ
JQ
JQ
JQ
JQ
JQ
JQ
"}
(39,1,1) = {"
hs
hs
hs
hs
hs
hs
hs
hs
hs
hs
hs
hs
hs
hs
hs
hs
hs
hs
ml
Eg
ir
ir
fb
fb
fb
ir
ir
BB
dv
hs
hs
hs
hs
hs
hs
hs
hs
hs
hs
hs
hs
hs
hs
hs
hs
"}
(40,1,1) = {"
bI
bI
bI
bI
bI
bI
bI
bI
bI
bI
bI
bI
bI
bI
bI
bI
bI
bI
bI
bI
Xa
tm
tm
tm
tm
OG
Xa
bI
bI
bI
bI
bI
bI
bI
bI
bI
bI
bI
bI
bI
bI
bI
bI
bI
bI
"}
(41,1,1) = {"
aJ
ZV
aJ
aJ
aJ
aJ
aJ
aJ
aJ
aJ
aJ
aJ
ZV
aJ
aJ
aJ
aJ
aJ
aJ
aJ
Xa
tm
tm
tm
tm
tm
Xa
aJ
aJ
aJ
aJ
aJ
aJ
aJ
aJ
aJ
ZV
aJ
aJ
aJ
aJ
aJ
aJ
aJ
aJ
"}
(42,1,1) = {"
JQ
aY
JQ
JQ
JQ
JQ
JQ
JQ
JQ
JQ
JQ
JQ
aY
JQ
JQ
JQ
JQ
JQ
JQ
JQ
Xa
tm
tm
tm
tm
tm
Xa
JQ
JQ
JQ
JQ
JQ
JQ
JQ
JQ
JQ
aY
JQ
JQ
JQ
JQ
JQ
JQ
JQ
JQ
"}
(43,1,1) = {"
aJ
ZV
aJ
aJ
aJ
aJ
aJ
aJ
aJ
aJ
aJ
aJ
ZV
aJ
aJ
aJ
aJ
aJ
aJ
aJ
Xa
tm
tm
tm
tm
tm
Xa
aJ
aJ
aJ
aJ
aJ
aJ
aJ
aJ
aJ
ZV
aJ
aJ
aJ
aJ
aJ
aJ
aJ
aJ
"}
(44,1,1) = {"
WU
WU
WU
WU
WU
WU
WU
WU
WU
WU
WU
WU
WU
WU
WU
WU
WU
WU
WU
WU
Xa
tm
tm
tm
tm
tm
Xa
WU
WU
WU
WU
WU
WU
WU
WU
WU
WU
WU
WU
WU
WU
WU
WU
WU
WU
"}
(45,1,1) = {"
CV
CV
CV
CV
CV
CV
CV
CV
CV
CV
CV
CV
CV
CV
CV
CV
CV
CV
CV
GD
ir
ir
ir
ir
ir
ir
ir
qW
CV
CV
CV
CV
CV
CV
CV
CV
CV
CV
CV
CV
CV
CV
CV
CV
CV
"}
(46,1,1) = {"
JQ
JQ
JQ
JQ
JQ
JQ
JQ
JQ
JQ
JQ
JQ
JQ
JQ
JQ
JQ
JQ
JQ
JQ
JQ
KF
CV
CV
CV
CV
CV
CV
CV
oR
JQ
JQ
JQ
JQ
JQ
JQ
JQ
JQ
JQ
JQ
JQ
JQ
JQ
JQ
JQ
JQ
JQ
"}
(47,1,1) = {"
JQ
JQ
JQ
JQ
JQ
JQ
JQ
JQ
JQ
JQ
JQ
JQ
JQ
JQ
JQ
JQ
JQ
JQ
JQ
JQ
JQ
JQ
JQ
JQ
JQ
JQ
JQ
JQ
JQ
JQ
JQ
JQ
JQ
JQ
JQ
JQ
JQ
JQ
JQ
JQ
JQ
JQ
JQ
JQ
JQ
"}
(48,1,1) = {"
JQ
JQ
JQ
JQ
JQ
JQ
JQ
JQ
JQ
JQ
JQ
JQ
JQ
JQ
JQ
JQ
JQ
JQ
JQ
JQ
JQ
JQ
JQ
JQ
JQ
JQ
JQ
JQ
JQ
JQ
JQ
JQ
JQ
JQ
JQ
JQ
JQ
JQ
JQ
JQ
JQ
JQ
JQ
JQ
JQ
"}
(49,1,1) = {"
JQ
JQ
JQ
JQ
JQ
JQ
JQ
JQ
JQ
JQ
JQ
JQ
JQ
JQ
JQ
JQ
JQ
JQ
JQ
JQ
JQ
JQ
JQ
JQ
JQ
JQ
JQ
JQ
JQ
JQ
JQ
JQ
JQ
JQ
JQ
JQ
JQ
JQ
JQ
JQ
JQ
JQ
JQ
JQ
JQ
"}
(50,1,1) = {"
JQ
JQ
JQ
JQ
JQ
JQ
JQ
JQ
JQ
JQ
JQ
JQ
JQ
JQ
JQ
JQ
JQ
JQ
JQ
JQ
JQ
JQ
JQ
JQ
JQ
JQ
JQ
JQ
JQ
JQ
JQ
JQ
JQ
JQ
JQ
JQ
JQ
JQ
JQ
JQ
JQ
JQ
JQ
JQ
JQ
"}
