//MAP CONVERTED BY dmm2tgm.py THIS HEADER COMMENT PREVENTS RECONVERSION, DO NOT REMOVE
"ac" = (
/turf/open/floor/plasteel/tech{
	planetary_atmos = 1
	},
/area/hangar)
"ad" = (
/obj/effect/turf_decal/trimline/opaque/yellow/warning{
	dir = 4
	},
/turf/open/floor/plasteel/tech{
	planetary_atmos = 1
	},
/area/hangar)
"al" = (
/obj/effect/turf_decal/trimline/opaque/yellow/filled/corner{
	dir = 8
	},
/turf/open/floor/plasteel{
	planetary_atmos = 1
	},
/area/hangar)
"am" = (
/turf/closed/indestructible/reinforced,
/area/hangar)
"ao" = (
/obj/effect/turf_decal/trimline/opaque/yellow/filled/warning{
	dir = 1
	},
/turf/open/floor/plasteel{
	planetary_atmos = 1
	},
/area/hangar)
"ap" = (
/obj/structure/marker_beacon{
	picked_color = "Teal"
	},
/turf/open/floor/plating{
	planetary_atmos = 1
	},
/area/hangar)
"aq" = (
/obj/effect/turf_decal/trimline/opaque/yellow/filled/warning{
	dir = 1
	},
/obj/machinery/light/floor/hangar,
/turf/open/floor/plasteel{
	planetary_atmos = 1
	},
/area/hangar)
"av" = (
/obj/effect/turf_decal/trimline/opaque/yellow/filled/warning,
/obj/machinery/light/floor/hangar,
/turf/open/floor/plasteel{
	planetary_atmos = 1
	},
/area/hangar)
"ax" = (
/obj/machinery/door/airlock,
/obj/effect/landmark/outpost/elevator_machine,
/obj/structure/lattice/catwalk,
/turf/open/floor/engine,
/area/hangar)
"ay" = (
/obj/machinery/door/poddoor/multi_tile/four_tile_ver,
/turf/closed/indestructible/reinforced,
/area/hangar)
"az" = (
/obj/effect/turf_decal/arrows{
	dir = 4
	},
/turf/open/floor/plasteel{
	planetary_atmos = 1
	},
/area/hangar)
"aA" = (
/obj/machinery/elevator_call_button{
	pixel_y = 25
	},
/obj/effect/landmark/outpost/elevator_machine,
/turf/open/floor/plasteel{
	planetary_atmos = 1
	},
/area/hangar)
"aB" = (
/obj/effect/landmark/outpost/hangar_dock,
/turf/open/floor/plating{
	planetary_atmos = 1
	},
/area/hangar)
"aC" = (
/obj/effect/turf_decal/arrows{
	dir = 1
	},
/turf/open/floor/plasteel/tech{
	planetary_atmos = 1
	},
/area/hangar)
"aE" = (
/obj/machinery/light/floor/hangar,
/turf/open/floor/plasteel{
	planetary_atmos = 1
	},
/area/hangar)
"aH" = (
/turf/template_noop,
/area/template_noop)
"aJ" = (
/turf/open/floor/plating{
	planetary_atmos = 1
	},
/area/hangar)
"aL" = (
/obj/effect/turf_decal/trimline/opaque/yellow/warning{
	dir = 8
	},
/turf/open/floor/plasteel/tech{
	planetary_atmos = 1
	},
/area/hangar)
"aM" = (
/obj/effect/turf_decal/trimline/opaque/yellow/filled/warning,
/turf/open/floor/plasteel{
	planetary_atmos = 1
	},
/area/hangar)
"aN" = (
/obj/effect/turf_decal/trimline/opaque/yellow/filled/warning{
	dir = 8
	},
/turf/open/floor/plasteel{
	planetary_atmos = 1
	},
/area/hangar)
"aO" = (
/obj/machinery/atmospherics/components/unary/passive_vent{
	dir = 1
	},
/turf/open/floor/plasteel{
	planetary_atmos = 1
	},
/area/hangar)
"aP" = (
/obj/effect/turf_decal/trimline/opaque/yellow/filled/corner{
	dir = 1
	},
/turf/open/floor/plasteel{
	planetary_atmos = 1
	},
/area/hangar)
"aT" = (
/obj/effect/turf_decal/arrows{
	dir = 1
	},
/turf/open/floor/plasteel{
	planetary_atmos = 1
	},
/area/hangar)
"aY" = (
/obj/effect/landmark/outpost/hangar_numbers,
/turf/open/floor/plasteel{
	planetary_atmos = 1
	},
/area/hangar)
"aZ" = (
/turf/open/floor/plasteel{
	planetary_atmos = 1
	},
/area/hangar)
"jk" = (
/obj/effect/landmark/outpost/elevator,
/turf/open/floor/plasteel/elevatorshaft{
	planetary_atmos = 1
	},
/area/hangar)
"qz" = (
/turf/open/floor/plasteel/elevatorshaft{
	planetary_atmos = 1
	},
/area/hangar)
"rQ" = (
/obj/machinery/atmospherics/pipe/simple/general,
/turf/closed/indestructible/reinforced,
/area/hangar)

(1,1,1) = {"
aH
aH
aH
am
am
am
am
am
am
am
ay
am
am
am
ay
am
am
am
ay
am
am
am
ay
am
am
am
ay
am
am
am
am
"}
(2,1,1) = {"
aH
aH
aH
am
aZ
aZ
aM
aL
aL
aL
aL
aL
aL
aL
aL
aL
aL
aL
aL
aL
aL
aL
aL
aL
aL
aL
aL
ao
aZ
aZ
am
"}
(3,1,1) = {"
aH
aH
aH
am
aZ
aZ
aM
ac
ac
aC
ac
ac
ac
ac
aC
ac
ac
ac
ac
aC
ac
ac
ac
ac
aC
ac
ac
ao
aZ
aZ
am
"}
(4,1,1) = {"
aH
aH
aH
am
aZ
aZ
aM
ad
ad
ad
ad
ad
ad
ad
ad
ad
ad
ad
ad
ad
ad
ad
ad
ad
ad
ad
ad
ao
aZ
aZ
am
"}
(5,1,1) = {"
aH
aH
aH
am
aZ
aZ
aM
aJ
aJ
aJ
aJ
aJ
aJ
aJ
aJ
aJ
aJ
aJ
aJ
aJ
aJ
aJ
aJ
aJ
aJ
aJ
aB
ao
aZ
aZ
am
"}
(6,1,1) = {"
aH
aH
aH
am
aZ
aZ
aM
aJ
aJ
aJ
aJ
aJ
aJ
aJ
aJ
aJ
aJ
aJ
aJ
aJ
aJ
aJ
aJ
aJ
aJ
aJ
aJ
ao
aZ
aZ
am
"}
(7,1,1) = {"
aH
aH
aH
am
aZ
az
aM
ap
aJ
aJ
aJ
aJ
aJ
aJ
aJ
aJ
aJ
aJ
aJ
aJ
aJ
aJ
aJ
aJ
aJ
aJ
ap
ao
az
aZ
am
"}
(8,1,1) = {"
aH
aH
aH
am
aZ
aZ
aM
aJ
aJ
aJ
aJ
aJ
aJ
aJ
aJ
aJ
aJ
aJ
aJ
aJ
aJ
aJ
aJ
aJ
aJ
aJ
aJ
ao
aZ
aZ
am
"}
(9,1,1) = {"
aH
aH
aH
am
aZ
aZ
av
aJ
aJ
aJ
aJ
aJ
aJ
aJ
aJ
aJ
aJ
aJ
aJ
aJ
aJ
aJ
aJ
aJ
aJ
aJ
aJ
aq
aZ
aZ
am
"}
(10,1,1) = {"
aH
aH
aH
am
aZ
aZ
aM
aJ
aJ
aJ
aJ
aJ
aJ
aJ
aJ
aJ
aJ
aJ
aJ
aJ
aJ
aJ
aJ
aJ
aJ
aJ
aJ
ao
aZ
aZ
am
"}
(11,1,1) = {"
aH
aH
aH
am
aZ
aZ
aM
aJ
aJ
aJ
aJ
aJ
aJ
aJ
aJ
aJ
aJ
aJ
aJ
aJ
aJ
aJ
aJ
aJ
aJ
aJ
aJ
ao
aZ
aZ
am
"}
(12,1,1) = {"
aH
aH
aH
am
aZ
az
aM
ap
aJ
aJ
aJ
aJ
aJ
aJ
aJ
aJ
aJ
aJ
aJ
aJ
aJ
aJ
aJ
aJ
aJ
aJ
ap
ao
az
aZ
am
"}
(13,1,1) = {"
aH
aH
aH
am
aZ
aZ
aM
aJ
aJ
aJ
aJ
aJ
aJ
aJ
aJ
aJ
aJ
aJ
aJ
aJ
aJ
aJ
aJ
aJ
aJ
aJ
aJ
ao
aZ
aZ
am
"}
(14,1,1) = {"
aH
aH
aH
am
aZ
aZ
aM
aJ
aJ
aJ
aJ
aJ
aJ
aJ
aJ
aJ
aJ
aJ
aJ
aJ
aJ
aJ
aJ
aJ
aJ
aJ
aJ
ao
aZ
aZ
am
"}
(15,1,1) = {"
aH
aH
aH
am
aZ
aZ
aM
aJ
aJ
aJ
aJ
aJ
aJ
aJ
aJ
aJ
aJ
aJ
aJ
aJ
aJ
aJ
aJ
aJ
aJ
aJ
aJ
ao
aZ
aZ
am
"}
(16,1,1) = {"
aH
aH
aH
am
aZ
aZ
aM
aJ
aJ
aJ
aJ
aJ
aJ
aJ
aJ
aJ
aJ
aJ
aJ
aJ
aJ
aJ
aJ
aJ
aJ
aJ
aJ
ao
aZ
aZ
am
"}
(17,1,1) = {"
aH
aH
aH
am
aZ
az
aM
ap
aJ
aJ
aJ
aJ
aJ
aJ
aJ
aJ
aJ
aJ
aJ
aJ
aJ
aJ
aJ
aJ
aJ
aJ
ap
ao
az
aZ
am
"}
(18,1,1) = {"
aH
aH
aH
am
aZ
aZ
aM
aJ
aJ
aJ
aJ
aJ
aJ
aJ
aJ
aJ
aJ
aJ
aJ
aJ
aJ
aJ
aJ
aJ
aJ
aJ
aJ
ao
aZ
aZ
am
"}
(19,1,1) = {"
aH
aH
aH
am
aZ
aZ
av
aJ
aJ
aJ
aJ
aJ
aJ
aJ
aJ
aJ
aJ
aJ
aJ
aJ
aJ
aJ
aJ
aJ
aJ
aJ
aJ
aq
aZ
aZ
am
"}
(20,1,1) = {"
aH
aH
aH
am
aZ
aZ
aM
aJ
aJ
aJ
aJ
aJ
aJ
aJ
aJ
aJ
aJ
aJ
aJ
aJ
aJ
aJ
aJ
aJ
aJ
aJ
aJ
ao
aZ
aZ
am
"}
(21,1,1) = {"
aH
aH
aH
am
aZ
aZ
aM
aJ
aJ
aJ
aJ
aJ
aJ
aJ
aJ
aJ
aJ
aJ
aJ
aJ
aJ
aJ
aJ
aJ
aJ
aJ
aJ
ao
aZ
aZ
am
"}
(22,1,1) = {"
aH
aH
aH
am
aZ
az
aM
ap
aJ
aJ
aJ
aJ
aJ
aJ
aJ
aJ
aJ
aJ
aJ
aJ
aJ
aJ
aJ
aJ
aJ
aJ
ap
ao
az
aZ
am
"}
(23,1,1) = {"
aH
aH
aH
rQ
aO
aZ
aM
aJ
aJ
aJ
aJ
aJ
aJ
aJ
aJ
aJ
aJ
aJ
aJ
aJ
aJ
aJ
aJ
aJ
aJ
aJ
aJ
ao
aZ
aZ
am
"}
(24,1,1) = {"
am
am
am
am
am
aA
aM
aJ
aJ
aJ
aJ
aJ
aJ
aJ
aJ
aJ
aJ
aJ
aJ
aJ
aJ
aJ
aJ
aJ
aJ
aJ
aJ
ao
aZ
aZ
am
"}
(25,1,1) = {"
am
qz
qz
jk
ax
aZ
al
aN
aN
aN
aN
aN
aN
aN
aN
aN
aN
aN
aN
aN
aN
aN
aN
aN
aN
aN
aN
aP
aZ
aZ
am
"}
(26,1,1) = {"
am
qz
qz
qz
ax
aY
aZ
aZ
aZ
aT
aZ
aZ
aZ
aZ
aT
aZ
aZ
aZ
aZ
aT
aZ
aZ
aZ
aZ
aT
aZ
aZ
aZ
aZ
aZ
am
"}
(27,1,1) = {"
am
qz
qz
qz
ax
aZ
aZ
aZ
aE
aZ
aZ
aZ
aZ
aZ
aZ
aZ
aZ
aZ
aZ
aZ
aZ
aZ
aZ
aZ
aZ
aE
aZ
aZ
aZ
aZ
am
"}
(28,1,1) = {"
am
am
am
am
am
am
am
am
am
am
am
am
am
am
am
am
am
am
am
am
am
am
am
am
am
am
am
am
am
am
am
"}
