//MAP CONVERTED BY dmm2tgm.py THIS HEADER COMMENT PREVENTS RECONVERSION, DO NOT REMOVE
"ac" = (
/turf/open/floor/plasteel/tech{
	planetary_atmos = 1
	},
/area/hangar)
"ad" = (
/obj/effect/turf_decal/trimline/opaque/yellow/warning{
	dir = 4
	},
/turf/open/floor/plasteel/tech{
	planetary_atmos = 1
	},
/area/hangar)
"al" = (
/obj/effect/turf_decal/arrows{
	dir = 4
	},
/turf/open/floor/hangar/plasteel,
/area/hangar)
"am" = (
/turf/closed/indestructible/reinforced,
/area/hangar)
"ao" = (
/obj/effect/landmark/outpost/hangar_dock,
/turf/open/floor/hangar,
/area/hangar)
"ap" = (
/obj/effect/turf_decal/trimline/opaque/yellow/filled/warning,
/turf/open/floor/hangar/plasteel,
/area/hangar)
"aq" = (
/turf/open/floor/plasteel/grimy,
/area/hangar)
"av" = (
/obj/machinery/light/floor/hangar,
/turf/open/floor/plasteel/tech{
	planetary_atmos = 1
	},
/area/hangar)
"ax" = (
/obj/machinery/door/airlock,
/obj/effect/landmark/outpost/elevator_machine,
/obj/structure/lattice/catwalk,
/turf/open/floor/engine,
/area/hangar)
"ay" = (
/obj/machinery/door/poddoor/multi_tile/four_tile_ver,
/turf/closed/indestructible/reinforced,
/area/hangar)
"az" = (
/obj/effect/turf_decal/trimline/opaque/yellow/filled/warning{
	dir = 1
	},
/turf/open/floor/hangar/plasteel,
/area/hangar)
"aA" = (
/obj/effect/turf_decal/siding/wood,
/turf/open/floor/plasteel/grimy,
/area/hangar)
"aB" = (
/turf/closed/indestructible/reinforced/rust,
/area/hangar)
"aC" = (
/obj/effect/turf_decal/arrows{
	dir = 1
	},
/turf/open/floor/plasteel/tech{
	planetary_atmos = 1
	},
/area/hangar)
"aE" = (
/obj/effect/turf_decal/trimline/opaque/yellow/filled/warning{
	dir = 1
	},
/obj/machinery/light/floor/hangar,
/turf/open/floor/hangar/plasteel,
/area/hangar)
"aH" = (
/turf/template_noop,
/area/template_noop)
"aJ" = (
/turf/open/floor/hangar,
/area/hangar)
"aL" = (
/obj/effect/turf_decal/trimline/opaque/yellow/warning{
	dir = 8
	},
/turf/open/floor/plasteel/tech{
	planetary_atmos = 1
	},
/area/hangar)
"aM" = (
/obj/structure/catwalk/over/plated_catwalk,
/turf/open/floor/hangar,
/area/hangar)
"aN" = (
/obj/effect/turf_decal/trimline/opaque/yellow/filled/corner{
	dir = 8
	},
/turf/open/floor/hangar/plasteel,
/area/hangar)
"aO" = (
/obj/effect/turf_decal/siding/wood{
	dir = 8
	},
/turf/open/floor/plasteel/grimy,
/area/hangar)
"aP" = (
/obj/effect/turf_decal/trimline/opaque/yellow/filled/warning{
	dir = 8
	},
/turf/open/floor/hangar/plasteel,
/area/hangar)
"aT" = (
/obj/structure/table,
/turf/open/floor/plasteel/grimy,
/area/hangar)
"aY" = (
/obj/effect/turf_decal/trimline/opaque/yellow/filled/warning{
	dir = 9
	},
/turf/open/floor/hangar/plasteel,
/area/hangar)
"aZ" = (
/turf/open/floor/hangar/plasteel,
/area/hangar)
"gQ" = (
/obj/effect/turf_decal/trimline/opaque/yellow/filled/warning,
/obj/machinery/light/floor/hangar,
/turf/open/floor/hangar/plasteel,
/area/hangar)
"jk" = (
/obj/effect/landmark/outpost/elevator,
/turf/open/floor/plasteel/elevatorshaft{
	planetary_atmos = 1
	},
/area/hangar)
"jL" = (
/obj/effect/turf_decal/trimline/opaque/yellow/filled/corner{
	dir = 1
	},
/turf/open/floor/hangar/plasteel,
/area/hangar)
"kI" = (
/obj/effect/landmark/outpost/elevator_machine,
/obj/machinery/elevator_call_button{
	pixel_y = 25
	},
/turf/open/floor/hangar/plasteel,
/area/hangar)
"qz" = (
/turf/open/floor/plasteel/elevatorshaft{
	planetary_atmos = 1
	},
/area/hangar)
"rC" = (
/obj/effect/turf_decal/arrows{
	dir = 1
	},
/turf/open/floor/hangar/plasteel,
/area/hangar)
"rQ" = (
/turf/closed/indestructible/reinforced,
/area/template_noop)
"ud" = (
/obj/structure/chair/plastic{
	dir = 8
	},
/turf/open/floor/plasteel/grimy,
/area/hangar)
"yo" = (
/obj/structure/chair/plastic{
	dir = 4
	},
/turf/open/floor/plasteel/grimy,
/area/hangar)
"Co" = (
/obj/effect/turf_decal/arrows{
	dir = 8
	},
/turf/open/floor/hangar/plasteel,
/area/hangar)
"Kl" = (
/obj/effect/turf_decal/trimline/opaque/yellow/filled/warning{
	dir = 10
	},
/turf/open/floor/hangar/plasteel,
/area/hangar)
"LV" = (
/obj/machinery/light/floor/hangar,
/turf/open/floor/hangar/plasteel,
/area/hangar)
"Qc" = (
/obj/structure/marker_beacon{
	picked_color = "Teal"
	},
/turf/open/floor/hangar,
/area/hangar)
"Rz" = (
/obj/effect/turf_decal/siding/wood{
	dir = 10
	},
/turf/open/floor/plasteel/grimy,
/area/hangar)
"WI" = (
/obj/effect/landmark/outpost/hangar_numbers,
/turf/open/floor/hangar/plasteel,
/area/hangar)

(1,1,1) = {"
aH
aH
aH
aH
aH
aB
aB
aB
am
am
am
am
ay
am
am
am
ay
am
am
am
ay
am
am
am
ay
am
am
am
ay
am
aB
am
"}
(2,1,1) = {"
aH
aH
aH
aH
aH
aB
aP
aP
Kl
aL
aL
aL
aL
aL
aL
aL
aL
aL
aL
aL
aL
aL
aL
aL
aL
aL
aL
aL
aL
aY
aP
aB
"}
(3,1,1) = {"
aH
aH
aH
aH
aH
aB
aZ
aM
ap
ac
ac
aC
ac
av
ac
ac
aC
ac
av
ac
ac
aC
ac
av
ac
ac
aC
ac
ac
az
aM
aB
"}
(4,1,1) = {"
aH
aH
aH
aH
aH
aB
aZ
aM
ap
ad
ad
ad
ad
ad
ad
ad
ad
ad
ad
ad
ad
ad
ad
ad
ad
ad
ad
ad
ad
az
aM
aB
"}
(5,1,1) = {"
aH
aH
aH
aH
aH
am
aZ
aM
ap
aJ
aJ
aJ
aJ
aJ
aJ
aJ
aJ
aJ
aJ
aJ
aJ
aJ
aJ
aJ
aJ
aJ
aJ
aJ
ao
az
aM
aB
"}
(6,1,1) = {"
aH
aH
aH
aH
aH
am
aZ
aM
ap
aJ
aJ
aJ
aJ
aJ
aJ
aJ
aJ
aJ
aJ
aJ
aJ
aJ
aJ
aJ
aJ
aJ
aJ
aJ
aJ
az
aM
aB
"}
(7,1,1) = {"
aH
aH
aH
aH
aH
aB
aZ
al
ap
Qc
aJ
aJ
aJ
aJ
aJ
aJ
aJ
aJ
aJ
aJ
aJ
aJ
aJ
aJ
aJ
aJ
aJ
aJ
Qc
az
al
am
"}
(8,1,1) = {"
aH
aH
aH
aH
aH
aB
aZ
aM
ap
aJ
aJ
aJ
aJ
aJ
aJ
aJ
aJ
aJ
aJ
aJ
aJ
aJ
aJ
aJ
aJ
aJ
aJ
aJ
aJ
az
aM
am
"}
(9,1,1) = {"
aH
aH
aH
aH
aH
aB
aZ
aM
gQ
aJ
aJ
aJ
aJ
aJ
aJ
aJ
aJ
aJ
aJ
aJ
aJ
aJ
aJ
aJ
aJ
aJ
aJ
aJ
aJ
aE
aM
am
"}
(10,1,1) = {"
aH
aH
aH
aH
aH
aB
aZ
aM
ap
aJ
aJ
aJ
aJ
aJ
aJ
aJ
aJ
aJ
aJ
aJ
aJ
aJ
aJ
aJ
aJ
aJ
aJ
aJ
aJ
az
aM
am
"}
(11,1,1) = {"
am
am
am
am
am
aB
am
aM
ap
aJ
aJ
aJ
aJ
aJ
aJ
aJ
aJ
aJ
aJ
aJ
aJ
aJ
aJ
aJ
aJ
aJ
aJ
aJ
aJ
az
aM
am
"}
(12,1,1) = {"
am
qz
qz
qz
qz
jk
am
kI
ap
Qc
aJ
aJ
aJ
aJ
aJ
aJ
aJ
aJ
aJ
aJ
aJ
aJ
aJ
aJ
aJ
aJ
aJ
aJ
Qc
az
al
am
"}
(13,1,1) = {"
am
qz
qz
qz
qz
qz
ax
aZ
ap
aJ
aJ
aJ
aJ
aJ
aJ
aJ
aJ
aJ
aJ
aJ
aJ
aJ
aJ
aJ
aJ
aJ
aJ
aJ
aJ
az
aM
am
"}
(14,1,1) = {"
am
qz
qz
qz
qz
qz
ax
WI
ap
aJ
aJ
aJ
aJ
aJ
aJ
aJ
aJ
aJ
aJ
aJ
aJ
aJ
aJ
aJ
aJ
aJ
aJ
aJ
aJ
az
aM
aB
"}
(15,1,1) = {"
am
qz
qz
qz
qz
qz
ax
aZ
ap
aJ
aJ
aJ
aJ
aJ
aJ
aJ
aJ
aJ
aJ
aJ
aJ
aJ
aJ
aJ
aJ
aJ
aJ
aJ
aJ
az
aM
aB
"}
(16,1,1) = {"
am
qz
qz
qz
qz
qz
am
aZ
ap
aJ
aJ
aJ
aJ
aJ
aJ
aJ
aJ
aJ
aJ
aJ
aJ
aJ
aJ
aJ
aJ
aJ
aJ
aJ
aJ
az
aM
aB
"}
(17,1,1) = {"
am
am
am
am
am
am
am
aM
ap
Qc
aJ
aJ
aJ
aJ
aJ
aJ
aJ
aJ
aJ
aJ
aJ
aJ
aJ
aJ
aJ
aJ
aJ
aJ
Qc
az
al
aB
"}
(18,1,1) = {"
aH
aH
aH
aH
aH
am
aZ
aM
ap
aJ
aJ
aJ
aJ
aJ
aJ
aJ
aJ
aJ
aJ
aJ
aJ
aJ
aJ
aJ
aJ
aJ
aJ
aJ
aJ
az
aM
am
"}
(19,1,1) = {"
aH
aH
aH
aH
aH
am
aZ
aM
gQ
aJ
aJ
aJ
aJ
aJ
aJ
aJ
aJ
aJ
aJ
aJ
aJ
aJ
aJ
aJ
aJ
aJ
aJ
aJ
aJ
aE
aM
am
"}
(20,1,1) = {"
aH
aH
aH
aH
aH
am
aZ
aM
ap
aJ
aJ
aJ
aJ
aJ
aJ
aJ
aJ
aJ
aJ
aJ
aJ
aJ
aJ
aJ
aJ
aJ
aJ
aJ
aJ
az
aM
am
"}
(21,1,1) = {"
aH
aH
aH
aH
aH
am
aZ
aM
ap
aJ
aJ
aJ
aJ
aJ
aJ
aJ
aJ
aJ
aJ
aJ
aJ
aJ
aJ
aJ
aJ
aJ
aJ
aJ
aJ
az
aM
am
"}
(22,1,1) = {"
aH
aH
aH
aH
rQ
am
aZ
Co
ap
Qc
aJ
aJ
aJ
aJ
aJ
aJ
aJ
aJ
aJ
aJ
aJ
aJ
aJ
aJ
aJ
aJ
aJ
aJ
Qc
az
al
am
"}
(23,1,1) = {"
aH
aH
aH
aH
rQ
aO
Rz
aM
ap
aJ
aJ
aJ
aJ
aJ
aJ
aJ
aJ
aJ
aJ
aJ
aJ
aJ
aJ
aJ
aJ
aJ
aJ
aJ
aJ
az
aM
am
"}
(24,1,1) = {"
aH
aH
aH
aH
rQ
yo
aA
aM
ap
aJ
aJ
aJ
aJ
aJ
aJ
aJ
aJ
aJ
aJ
aJ
aJ
aJ
aJ
aJ
aJ
aJ
aJ
aJ
aJ
az
aM
am
"}
(25,1,1) = {"
aH
aH
aH
aH
rQ
aT
aA
aM
aN
aP
aP
aP
aP
aP
aP
aP
aP
aP
aP
aP
aP
aP
aP
aP
aP
aP
aP
aP
aP
jL
aM
am
"}
(26,1,1) = {"
aH
aH
aH
aH
rQ
ud
aA
aM
aM
aM
aM
rC
aM
aM
aM
aM
rC
aM
aM
aM
aM
rC
aM
aM
aM
aM
rC
aM
aM
aM
aM
am
"}
(27,1,1) = {"
aH
aH
aH
aH
rQ
aq
aA
aZ
aZ
aZ
LV
aZ
aZ
aZ
aZ
aZ
aZ
aZ
aZ
aZ
aZ
aZ
aZ
aZ
aZ
aZ
aZ
LV
aZ
aZ
aZ
aB
"}
(28,1,1) = {"
aH
aH
aH
aH
rQ
am
am
am
am
am
am
am
am
am
am
am
am
am
am
am
aB
aB
aB
am
am
am
am
am
aB
am
aB
aB
"}
