//MAP CONVERTED BY dmm2tgm.py THIS HEADER COMMENT PREVENTS RECONVERSION, DO NOT REMOVE
"aa" = (
/turf/closed/indestructible/reinforced,
/area/hangar)
"ab" = (
/obj/effect/turf_decal/trimline/opaque/yellow/filled/warning{
	dir = 1
	},
/turf/open/floor/hangar/plasteel,
/area/hangar)
"ac" = (
/obj/structure/marker_beacon{
	picked_color = "Teal"
	},
/turf/open/floor/hangar,
/area/hangar)
"ag" = (
/obj/effect/turf_decal/trimline/opaque/yellow/filled/warning{
	dir = 8
	},
/turf/open/floor/hangar/plasteel,
/area/hangar)
"ah" = (
/obj/effect/turf_decal/trimline/opaque/yellow/filled/warning,
/turf/open/floor/hangar/plasteel,
/area/hangar)
"ak" = (
/obj/effect/turf_decal/trimline/opaque/yellow/filled/warning{
	dir = 1
	},
/obj/machinery/light/floor/hangar,
/turf/open/floor/hangar/plasteel,
/area/hangar)
"am" = (
/obj/machinery/elevator_call_button{
	pixel_y = 25
	},
/obj/effect/landmark/outpost/elevator_machine,
/turf/open/floor/hangar/plasteel,
/area/hangar)
"an" = (
/obj/effect/turf_decal/trimline/opaque/yellow/warning{
	dir = 8
	},
/turf/open/floor/plasteel/tech{
	planetary_atmos = 1
	},
/area/hangar)
"ap" = (
/obj/machinery/door/poddoor/multi_tile/four_tile_ver,
/turf/closed/indestructible/reinforced,
/area/hangar)
"as" = (
/obj/effect/turf_decal/arrows{
	dir = 1
	},
/turf/open/floor/plasteel/tech{
	planetary_atmos = 1
	},
/area/hangar)
"at" = (
/turf/open/floor/plasteel/tech{
	planetary_atmos = 1
	},
/area/hangar)
"au" = (
/turf/template_noop,
/area/template_noop)
"aw" = (
/obj/effect/turf_decal/arrows{
	dir = 1
	},
/turf/open/floor/hangar/plasteel,
/area/hangar)
"ax" = (
/obj/effect/turf_decal/trimline/opaque/yellow/filled/warning,
/obj/machinery/light/floor/hangar,
/turf/open/floor/hangar/plasteel,
/area/hangar)
"ay" = (
/obj/effect/turf_decal/arrows{
	dir = 4
	},
/turf/open/floor/hangar/plasteel,
/area/hangar)
"aC" = (
/obj/effect/turf_decal/trimline/opaque/yellow/filled/corner{
	dir = 8
	},
/turf/open/floor/hangar/plasteel,
/area/hangar)
"aF" = (
/turf/open/floor/hangar,
/area/hangar)
"aH" = (
/obj/effect/landmark/outpost/hangar_dock,
/turf/open/floor/hangar,
/area/hangar)
"aP" = (
/obj/effect/turf_decal/arrows{
	dir = 8
	},
/turf/open/floor/hangar/plasteel,
/area/hangar)
"aQ" = (
/obj/effect/turf_decal/trimline/opaque/yellow/warning{
	dir = 4
	},
/turf/open/floor/plasteel/tech{
	planetary_atmos = 1
	},
/area/hangar)
"aS" = (
/obj/machinery/light/floor/hangar,
/turf/open/floor/hangar/plasteel,
/area/hangar)
"aT" = (
/obj/structure/catwalk/over/plated_catwalk,
/turf/open/floor/hangar,
/area/hangar)
"aX" = (
/obj/effect/turf_decal/trimline/opaque/yellow/filled/corner{
	dir = 1
	},
/turf/open/floor/hangar/plasteel,
/area/hangar)
"aY" = (
/turf/open/floor/hangar/plasteel,
/area/hangar)
"aZ" = (
/obj/machinery/door/airlock,
/obj/effect/landmark/outpost/elevator_machine,
/obj/structure/lattice/catwalk,
/turf/open/floor/engine,
/area/hangar)
"cE" = (
/obj/structure/disposalpipe/trunk{
	dir = 4
	},
/obj/machinery/conveyor/auto/outpost{
	dir = 1
	},
/obj/structure/disposaloutlet{
	dir = 1
	},
/turf/open/floor/plasteel{
	planetary_atmos = 1
	},
/area/hangar)
"ey" = (
/obj/machinery/conveyor/auto/outpost,
/obj/effect/landmark/outpost/hangar_crate_spawner,
/turf/open/floor/plasteel{
	planetary_atmos = 1
	},
/area/hangar)
"hU" = (
/obj/effect/turf_decal/industrial/hatch/yellow,
/turf/open/floor/plasteel{
	planetary_atmos = 1
	},
/area/hangar)
"ib" = (
/obj/machinery/conveyor/auto/outpost{
	dir = 6;
	verted = -1
	},
/turf/open/floor/plasteel{
	planetary_atmos = 1
	},
/area/hangar)
"je" = (
/obj/machinery/conveyor/auto/outpost{
	dir = 8
	},
/turf/open/floor/hangar/plasteel,
/area/hangar)
"jy" = (
/obj/structure/plasticflaps/outpost,
/obj/machinery/conveyor/auto/outpost{
	dir = 5;
	verted = -1
	},
/turf/open/floor/plasteel{
	planetary_atmos = 1
	},
/area/hangar)
"jY" = (
/turf/open/floor/plasteel/elevatorshaft{
	planetary_atmos = 1
	},
/area/hangar)
"qg" = (
/obj/effect/turf_decal/arrows{
	dir = 8
	},
/turf/open/floor/plasteel{
	planetary_atmos = 1
	},
/area/hangar)
"vf" = (
/turf/open/floor/plasteel{
	planetary_atmos = 1
	},
/area/hangar)
"vh" = (
/obj/machinery/light/floor/hangar,
/turf/open/floor/plasteel/tech{
	planetary_atmos = 1
	},
/area/hangar)
"wz" = (
/obj/machinery/conveyor/auto/outpost{
	dir = 8
	},
/turf/open/floor/plasteel{
	planetary_atmos = 1
	},
/area/hangar)
"zp" = (
/obj/structure/railing{
	dir = 8
	},
/obj/structure/chair,
/turf/open/floor/plasteel{
	planetary_atmos = 1
	},
/area/hangar)
"BE" = (
/obj/effect/landmark/outpost/hangar_numbers,
/turf/open/floor/hangar/plasteel,
/area/hangar)
"Fm" = (
/obj/machinery/disposal/deliveryChute{
	dir = 1
	},
/obj/structure/disposalpipe/trunk{
	dir = 8
	},
/turf/open/floor/plasteel{
	planetary_atmos = 1
	},
/area/hangar)
"FJ" = (
/obj/machinery/conveyor/auto/outpost{
	dir = 10
	},
/turf/open/floor/plasteel{
	planetary_atmos = 1
	},
/area/hangar)
"FY" = (
/obj/structure/plasticflaps/outpost,
/obj/machinery/conveyor/auto/outpost{
	dir = 8
	},
/turf/open/floor/plasteel{
	planetary_atmos = 1
	},
/area/hangar)
"HU" = (
/obj/structure/railing{
	dir = 1
	},
/turf/open/floor/plasteel{
	planetary_atmos = 1
	},
/area/hangar)
"JI" = (
/obj/effect/landmark/outpost/elevator,
/turf/open/floor/plasteel/elevatorshaft{
	planetary_atmos = 1
	},
/area/hangar)
"Mf" = (
/obj/machinery/conveyor/auto/outpost,
/obj/structure/plasticflaps/outpost,
/turf/open/floor/plasteel{
	planetary_atmos = 1
	},
/area/hangar)
"Ob" = (
/obj/structure/railing/corner{
	dir = 1;
	layer = 4.1
	},
/turf/open/floor/plasteel{
	planetary_atmos = 1
	},
/area/hangar)
"Ul" = (
/obj/structure/sign/departments/cargo,
/turf/closed/indestructible/reinforced,
/area/hangar)
"UW" = (
/obj/structure/railing/corner{
	dir = 4
	},
/turf/open/floor/plasteel{
	planetary_atmos = 1
	},
/area/hangar)
"XP" = (
/obj/structure/disposalpipe/segment{
	dir = 4
	},
/turf/closed/indestructible/reinforced,
/area/hangar)
"YX" = (
/obj/effect/turf_decal/industrial/loading,
/turf/open/floor/plasteel{
	planetary_atmos = 1
	},
/area/hangar)

(1,1,1) = {"
au
au
au
au
au
aa
aa
aa
aa
aa
aa
aa
ap
aa
aa
aa
ap
aa
aa
aa
ap
aa
aa
aa
ap
aa
aa
aa
ap
aa
aa
aa
ap
aa
aa
aa
ap
aa
aa
aa
ap
aa
aa
aa
ap
aa
aa
aa
ap
aa
aa
aa
aa
"}
(2,1,1) = {"
au
au
au
au
au
aa
aY
aY
ah
an
an
an
an
an
an
an
an
an
an
an
an
an
an
an
an
an
an
an
an
an
an
an
an
an
an
an
an
an
an
an
an
an
an
an
an
an
an
an
an
ab
aY
aY
aa
"}
(3,1,1) = {"
au
au
au
au
au
aa
aY
aT
ah
at
at
as
at
vh
at
at
as
at
vh
at
at
as
at
vh
at
at
as
at
vh
at
at
as
at
vh
at
at
as
at
vh
at
at
as
at
vh
at
at
as
at
at
ab
aY
aY
aa
"}
(4,1,1) = {"
au
au
au
au
au
aa
aY
aT
ah
aQ
aQ
aQ
aQ
aQ
aQ
aQ
aQ
aQ
aQ
aQ
aQ
aQ
aQ
aQ
aQ
aQ
aQ
aQ
aQ
aQ
aQ
aQ
aQ
aQ
aQ
aQ
aQ
aQ
aQ
aQ
aQ
aQ
aQ
aQ
aQ
aQ
aQ
aQ
aQ
ab
aY
aY
aa
"}
(5,1,1) = {"
au
au
au
au
au
aa
aY
aT
ah
aF
aF
aF
aF
aF
aF
aF
aF
aF
aF
aF
aF
aF
aF
aF
aF
aF
aF
aF
aF
aF
aF
aF
aF
aF
aF
aF
aF
aF
aF
aF
aF
aF
aF
aF
aF
aF
aF
aF
aH
ab
aY
aY
aa
"}
(6,1,1) = {"
au
au
au
au
au
aa
aY
aT
ah
aF
aF
aF
aF
aF
aF
aF
aF
aF
aF
aF
aF
aF
aF
aF
aF
aF
aF
aF
aF
aF
aF
aF
aF
aF
aF
aF
aF
aF
aF
aF
aF
aF
aF
aF
aF
aF
aF
aF
aF
ab
aY
aY
aa
"}
(7,1,1) = {"
au
au
au
au
au
aa
aY
ay
ah
ac
aF
aF
aF
aF
aF
aF
aF
aF
aF
aF
aF
aF
aF
aF
aF
aF
aF
aF
aF
aF
aF
aF
aF
aF
aF
aF
aF
aF
aF
aF
aF
aF
aF
aF
aF
aF
aF
aF
ac
ab
ay
aY
aa
"}
(8,1,1) = {"
au
au
au
au
au
aa
aY
aT
ah
aF
aF
aF
aF
aF
aF
aF
aF
aF
aF
aF
aF
aF
aF
aF
aF
aF
aF
aF
aF
aF
aF
aF
aF
aF
aF
aF
aF
aF
aF
aF
aF
aF
aF
aF
aF
aF
aF
aF
aF
ab
aT
aY
aa
"}
(9,1,1) = {"
au
au
au
au
au
aa
aY
aT
ax
aF
aF
aF
aF
aF
aF
aF
aF
aF
aF
aF
aF
aF
aF
aF
aF
aF
aF
aF
aF
aF
aF
aF
aF
aF
aF
aF
aF
aF
aF
aF
aF
aF
aF
aF
aF
aF
aF
aF
aF
ak
aT
aY
aa
"}
(10,1,1) = {"
au
au
au
au
au
aa
aY
aT
ah
aF
aF
aF
aF
aF
aF
aF
aF
aF
aF
aF
aF
aF
aF
aF
aF
aF
aF
aF
aF
aF
aF
aF
aF
aF
aF
aF
aF
aF
aF
aF
aF
aF
aF
aF
aF
aF
aF
aF
aF
ab
aT
aY
aa
"}
(11,1,1) = {"
au
au
au
au
au
aa
aY
aT
ah
aF
aF
aF
aF
aF
aF
aF
aF
aF
aF
aF
aF
aF
aF
aF
aF
aF
aF
aF
aF
aF
aF
aF
aF
aF
aF
aF
aF
aF
aF
aF
aF
aF
aF
aF
aF
aF
aF
aF
aF
ab
aT
aY
aa
"}
(12,1,1) = {"
au
au
au
au
au
aa
aY
ay
ah
ac
aF
aF
aF
aF
aF
aF
aF
aF
aF
aF
aF
aF
aF
aF
aF
aF
aF
aF
aF
aF
aF
aF
aF
aF
aF
aF
aF
aF
aF
aF
aF
aF
aF
aF
aF
aF
aF
aF
ac
ab
ay
aY
aa
"}
(13,1,1) = {"
au
au
au
au
au
aa
aY
aT
ah
aF
aF
aF
aF
aF
aF
aF
aF
aF
aF
aF
aF
aF
aF
aF
aF
aF
aF
aF
aF
aF
aF
aF
aF
aF
aF
aF
aF
aF
aF
aF
aF
aF
aF
aF
aF
aF
aF
aF
aF
ab
aT
aY
aa
"}
(14,1,1) = {"
au
au
au
au
au
aa
aY
aT
ah
aF
aF
aF
aF
aF
aF
aF
aF
aF
aF
aF
aF
aF
aF
aF
aF
aF
aF
aF
aF
aF
aF
aF
aF
aF
aF
aF
aF
aF
aF
aF
aF
aF
aF
aF
aF
aF
aF
aF
aF
ab
aT
aY
aa
"}
(15,1,1) = {"
au
au
au
au
au
aa
aY
aT
ah
aF
aF
aF
aF
aF
aF
aF
aF
aF
aF
aF
aF
aF
aF
aF
aF
aF
aF
aF
aF
aF
aF
aF
aF
aF
aF
aF
aF
aF
aF
aF
aF
aF
aF
aF
aF
aF
aF
aF
aF
ab
aT
aY
aa
"}
(16,1,1) = {"
au
au
au
au
au
aa
aY
aT
ah
aF
aF
aF
aF
aF
aF
aF
aF
aF
aF
aF
aF
aF
aF
aF
aF
aF
aF
aF
aF
aF
aF
aF
aF
aF
aF
aF
aF
aF
aF
aF
aF
aF
aF
aF
aF
aF
aF
aF
aF
ab
aT
aY
aa
"}
(17,1,1) = {"
au
au
au
au
au
aa
aY
ay
ah
ac
aF
aF
aF
aF
aF
aF
aF
aF
aF
aF
aF
aF
aF
aF
aF
aF
aF
aF
aF
aF
aF
aF
aF
aF
aF
aF
aF
aF
aF
aF
aF
aF
aF
aF
aF
aF
aF
aF
ac
ab
ay
aY
aa
"}
(18,1,1) = {"
au
au
au
au
au
aa
aY
aT
ah
aF
aF
aF
aF
aF
aF
aF
aF
aF
aF
aF
aF
aF
aF
aF
aF
aF
aF
aF
aF
aF
aF
aF
aF
aF
aF
aF
aF
aF
aF
aF
aF
aF
aF
aF
aF
aF
aF
aF
aF
ab
aT
aY
aa
"}
(19,1,1) = {"
aa
aa
aa
aa
aa
aa
aa
aY
ax
aF
aF
aF
aF
aF
aF
aF
aF
aF
aF
aF
aF
aF
aF
aF
aF
aF
aF
aF
aF
aF
aF
aF
aF
aF
aF
aF
aF
aF
aF
aF
aF
aF
aF
aF
aF
aF
aF
aF
aF
ak
aT
aY
aa
"}
(20,1,1) = {"
aa
jY
jY
jY
jY
JI
aa
am
ah
aF
aF
aF
aF
aF
aF
aF
aF
aF
aF
aF
aF
aF
aF
aF
aF
aF
aF
aF
aF
aF
aF
aF
aF
aF
aF
aF
aF
aF
aF
aF
aF
aF
aF
aF
aF
aF
aF
aF
aF
ab
aT
aY
aa
"}
(21,1,1) = {"
aa
jY
jY
jY
jY
jY
aZ
aY
ah
aF
aF
aF
aF
aF
aF
aF
aF
aF
aF
aF
aF
aF
aF
aF
aF
aF
aF
aF
aF
aF
aF
aF
aF
aF
aF
aF
aF
aF
aF
aF
aF
aF
aF
aF
aF
aF
aF
aF
aF
ab
aT
aY
aa
"}
(22,1,1) = {"
aa
jY
jY
jY
jY
jY
aZ
BE
ah
ac
aF
aF
aF
aF
aF
aF
aF
aF
aF
aF
aF
aF
aF
aF
aF
aF
aF
aF
aF
aF
aF
aF
aF
aF
aF
aF
aF
aF
aF
aF
aF
aF
aF
aF
aF
aF
aF
aF
ac
ab
ay
aY
aa
"}
(23,1,1) = {"
aa
jY
jY
jY
jY
jY
aZ
aY
ah
aF
aF
aF
aF
aF
aF
aF
aF
aF
aF
aF
aF
aF
aF
aF
aF
aF
aF
aF
aF
aF
aF
aF
aF
aF
aF
aF
aF
aF
aF
aF
aF
aF
aF
aF
aF
aF
aF
aF
aF
ab
aT
aY
aa
"}
(24,1,1) = {"
aa
jY
jY
jY
jY
jY
aa
aY
ah
aF
aF
aF
aF
aF
aF
aF
aF
aF
aF
aF
aF
aF
aF
aF
aF
aF
aF
aF
aF
aF
aF
aF
aF
aF
aF
aF
aF
aF
aF
aF
aF
aF
aF
aF
aF
aF
aF
aF
aF
ab
aT
aY
aa
"}
(25,1,1) = {"
aa
aa
aa
aa
aa
aa
aa
aY
ah
aF
aF
aF
aF
aF
aF
aF
aF
aF
aF
aF
aF
aF
aF
aF
aF
aF
aF
aF
aF
aF
aF
aF
aF
aF
aF
aF
aF
aF
aF
aF
aF
aF
aF
aF
aF
aF
aF
aF
aF
ab
aT
aY
aa
"}
(26,1,1) = {"
au
au
au
au
au
aa
hU
YX
ah
aF
aF
aF
aF
aF
aF
aF
aF
aF
aF
aF
aF
aF
aF
aF
aF
aF
aF
aF
aF
aF
aF
aF
aF
aF
aF
aF
aF
aF
aF
aF
aF
aF
aF
aF
aF
aF
aF
aF
aF
ab
aT
aY
aa
"}
(27,1,1) = {"
au
au
au
au
au
aa
wz
aY
ah
ac
aF
aF
aF
aF
aF
aF
aF
aF
aF
aF
aF
aF
aF
aF
aF
aF
aF
aF
aF
aF
aF
aF
aF
aF
aF
aF
aF
aF
aF
aF
aF
aF
aF
aF
aF
aF
aF
aF
ac
ab
ay
aY
aa
"}
(28,1,1) = {"
au
au
au
au
au
aa
je
vf
ah
aF
aF
aF
aF
aF
aF
aF
aF
aF
aF
aF
aF
aF
aF
aF
aF
aF
aF
aF
aF
aF
aF
aF
aF
aF
aF
aF
aF
aF
aF
aF
aF
aF
aF
aF
aF
aF
aF
aF
aF
ab
aT
aY
aa
"}
(29,1,1) = {"
au
au
aa
aa
aa
aa
wz
UW
ax
aF
aF
aF
aF
aF
aF
aF
aF
aF
aF
aF
aF
aF
aF
aF
aF
aF
aF
aF
aF
aF
aF
aF
aF
aF
aF
aF
aF
aF
aF
aF
aF
aF
aF
aF
aF
aF
aF
aF
aF
ak
aT
aY
aa
"}
(30,1,1) = {"
au
au
aa
jy
Mf
Mf
FJ
HU
ah
aF
aF
aF
aF
aF
aF
aF
aF
aF
aF
aF
aF
aF
aF
aF
aF
aF
aF
aF
aF
aF
aF
aF
aF
aF
aF
aF
aF
aF
aF
aF
aF
aF
aF
aF
aF
aF
aF
aF
aF
ab
aT
aY
aa
"}
(31,1,1) = {"
au
au
aa
FY
aa
Ul
zp
Ob
ah
aF
aF
aF
aF
aF
aF
aF
aF
aF
aF
aF
aF
aF
aF
aF
aF
aF
aF
aF
aF
aF
aF
aF
aF
aF
aF
aF
aF
aF
aF
aF
aF
aF
aF
aF
aF
aF
aF
aF
aF
ab
aT
aY
aa
"}
(32,1,1) = {"
au
au
aa
ib
cE
aa
vf
qg
ah
ac
aF
aF
aF
aF
aF
aF
aF
aF
aF
aF
aF
aF
aF
aF
aF
aF
aF
aF
aF
aF
aF
aF
aF
aF
aF
aF
aF
aF
aF
aF
aF
aF
aF
aF
aF
aF
aF
aF
ac
ab
ay
aY
aa
"}
(33,1,1) = {"
au
au
aa
aa
XP
aa
vf
aT
ah
aF
aF
aF
aF
aF
aF
aF
aF
aF
aF
aF
aF
aF
aF
aF
aF
aF
aF
aF
aF
aF
aF
aF
aF
aF
aF
aF
aF
aF
aF
aF
aF
aF
aF
aF
aF
aF
aF
aF
aF
ab
aT
aY
aa
"}
(34,1,1) = {"
au
au
aa
ey
Fm
aa
vf
aT
ah
aF
aF
aF
aF
aF
aF
aF
aF
aF
aF
aF
aF
aF
aF
aF
aF
aF
aF
aF
aF
aF
aF
aF
aF
aF
aF
aF
aF
aF
aF
aF
aF
aF
aF
aF
aF
aF
aF
aF
aF
ab
aT
aY
aa
"}
(35,1,1) = {"
au
au
aa
aa
aa
aa
vf
aT
ah
aF
aF
aF
aF
aF
aF
aF
aF
aF
aF
aF
aF
aF
aF
aF
aF
aF
aF
aF
aF
aF
aF
aF
aF
aF
aF
aF
aF
aF
aF
aF
aF
aF
aF
aF
aF
aF
aF
aF
aF
ab
aT
aY
aa
"}
(36,1,1) = {"
au
au
au
au
au
aa
aY
aT
ah
aF
aF
aF
aF
aF
aF
aF
aF
aF
aF
aF
aF
aF
aF
aF
aF
aF
aF
aF
aF
aF
aF
aF
aF
aF
aF
aF
aF
aF
aF
aF
aF
aF
aF
aF
aF
aF
aF
aF
aF
ab
aT
aY
aa
"}
(37,1,1) = {"
au
au
au
au
au
aa
aY
aP
ah
ac
aF
aF
aF
aF
aF
aF
aF
aF
aF
aF
aF
aF
aF
aF
aF
aF
aF
aF
aF
aF
aF
aF
aF
aF
aF
aF
aF
aF
aF
aF
aF
aF
aF
aF
aF
aF
aF
aF
ac
ab
ay
aY
aa
"}
(38,1,1) = {"
au
au
au
au
au
aa
aY
aT
ah
aF
aF
aF
aF
aF
aF
aF
aF
aF
aF
aF
aF
aF
aF
aF
aF
aF
aF
aF
aF
aF
aF
aF
aF
aF
aF
aF
aF
aF
aF
aF
aF
aF
aF
aF
aF
aF
aF
aF
aF
ab
aT
aY
aa
"}
(39,1,1) = {"
au
au
au
au
au
aa
aY
aT
ax
aF
aF
aF
aF
aF
aF
aF
aF
aF
aF
aF
aF
aF
aF
aF
aF
aF
aF
aF
aF
aF
aF
aF
aF
aF
aF
aF
aF
aF
aF
aF
aF
aF
aF
aF
aF
aF
aF
aF
aF
ak
aT
aY
aa
"}
(40,1,1) = {"
au
au
au
au
au
aa
aY
aT
ah
aF
aF
aF
aF
aF
aF
aF
aF
aF
aF
aF
aF
aF
aF
aF
aF
aF
aF
aF
aF
aF
aF
aF
aF
aF
aF
aF
aF
aF
aF
aF
aF
aF
aF
aF
aF
aF
aF
aF
aF
ab
aT
aY
aa
"}
(41,1,1) = {"
au
au
au
au
au
aa
aY
aT
ah
aF
aF
aF
aF
aF
aF
aF
aF
aF
aF
aF
aF
aF
aF
aF
aF
aF
aF
aF
aF
aF
aF
aF
aF
aF
aF
aF
aF
aF
aF
aF
aF
aF
aF
aF
aF
aF
aF
aF
aF
ab
aT
aY
aa
"}
(42,1,1) = {"
au
au
au
au
au
aa
aY
aP
ah
ac
aF
aF
aF
aF
aF
aF
aF
aF
aF
aF
aF
aF
aF
aF
aF
aF
aF
aF
aF
aF
aF
aF
aF
aF
aF
aF
aF
aF
aF
aF
aF
aF
aF
aF
aF
aF
aF
aF
ac
ab
ay
aY
aa
"}
(43,1,1) = {"
au
au
au
au
au
aa
aY
aT
ah
aF
aF
aF
aF
aF
aF
aF
aF
aF
aF
aF
aF
aF
aF
aF
aF
aF
aF
aF
aF
aF
aF
aF
aF
aF
aF
aF
aF
aF
aF
aF
aF
aF
aF
aF
aF
aF
aF
aF
aF
ab
aT
aY
aa
"}
(44,1,1) = {"
au
au
au
au
au
aa
aY
aT
ah
aF
aF
aF
aF
aF
aF
aF
aF
aF
aF
aF
aF
aF
aF
aF
aF
aF
aF
aF
aF
aF
aF
aF
aF
aF
aF
aF
aF
aF
aF
aF
aF
aF
aF
aF
aF
aF
aF
aF
aF
ab
aT
aY
aa
"}
(45,1,1) = {"
au
au
au
au
au
aa
aY
aT
aC
ag
ag
ag
ag
ag
ag
ag
ag
ag
ag
ag
ag
ag
ag
ag
ag
ag
ag
ag
ag
ag
ag
ag
ag
ag
ag
ag
ag
ag
ag
ag
ag
ag
ag
ag
ag
ag
ag
ag
ag
aX
aT
aY
aa
"}
(46,1,1) = {"
au
au
au
au
au
aa
aY
aT
aT
aT
aT
aw
aT
aT
aT
aT
aw
aT
aT
aT
aT
aw
aT
aT
aT
aT
aw
aT
aT
aT
aT
aw
aT
aT
aT
aT
aw
aT
aT
aT
aT
aw
aT
aT
aT
aT
aw
aT
aT
aT
aT
aY
aa
"}
(47,1,1) = {"
au
au
au
au
au
aa
aY
aY
aY
aS
aY
aY
aY
aY
aY
aY
aY
aY
aY
aS
aY
aY
aY
aY
aY
aY
aY
aY
aS
aS
aY
aY
aY
aY
aY
aY
aY
aY
aS
aY
aY
aY
aY
aY
aY
aY
aY
aY
aS
aY
aY
aY
aa
"}
(48,1,1) = {"
au
au
au
au
au
aa
aa
aa
aa
aa
aa
aa
aa
aa
aa
aa
aa
aa
aa
aa
aa
aa
aa
aa
aa
aa
aa
aa
aa
aa
aa
aa
aa
aa
aa
aa
aa
aa
aa
aa
aa
aa
aa
aa
aa
aa
aa
aa
aa
aa
aa
aa
aa
"}
