//MAP CONVERTED BY dmm2tgm.py THIS HEADER COMMENT PREVENTS RECONVERSION, DO NOT REMOVE
"ac" = (
/turf/open/floor/plasteel/tech{
	planetary_atmos = 1
	},
/area/hangar)
"ad" = (
/obj/effect/turf_decal/trimline/opaque/yellow/warning{
	dir = 4
	},
/turf/open/floor/plasteel/tech{
	planetary_atmos = 1
	},
/area/hangar)
"al" = (
/obj/effect/turf_decal/trimline/opaque/yellow/filled/corner{
	dir = 8
	},
/turf/open/floor/plasteel{
	planetary_atmos = 1
	},
/area/hangar)
"am" = (
/turf/closed/indestructible/reinforced,
/area/hangar)
"ao" = (
/obj/effect/turf_decal/trimline/opaque/yellow/filled/warning{
	dir = 1
	},
/turf/open/floor/plasteel{
	planetary_atmos = 1
	},
/area/hangar)
"ap" = (
/obj/structure/marker_beacon{
	picked_color = "Teal"
	},
/turf/open/floor/plating{
	planetary_atmos = 1
	},
/area/hangar)
"aq" = (
/obj/effect/turf_decal/trimline/opaque/yellow/filled/warning{
	dir = 1
	},
/obj/machinery/light/floor/hangar,
/turf/open/floor/plasteel{
	planetary_atmos = 1
	},
/area/hangar)
"av" = (
/obj/effect/turf_decal/trimline/opaque/yellow/filled/warning,
/obj/machinery/light/floor/hangar,
/turf/open/floor/plasteel{
	planetary_atmos = 1
	},
/area/hangar)
"ax" = (
/obj/machinery/door/airlock,
/obj/effect/landmark/outpost/elevator_machine,
/obj/structure/lattice/catwalk,
/turf/open/floor/engine,
/area/hangar)
"ay" = (
/obj/machinery/door/poddoor/multi_tile/four_tile_ver,
/turf/closed/indestructible/reinforced,
/area/hangar)
"az" = (
/obj/structure/catwalk/over/plated_catwalk,
/obj/machinery/atmospherics/pipe/simple/orange/hidden{
	dir = 4
	},
/turf/open/floor/plating{
	planetary_atmos = 1
	},
/area/hangar)
"aA" = (
/obj/machinery/elevator_call_button{
	pixel_y = 25
	},
/obj/effect/landmark/outpost/elevator_machine,
/obj/machinery/atmospherics/pipe/simple/orange/hidden{
	dir = 4
	},
/obj/structure/catwalk/over/plated_catwalk,
/turf/open/floor/plating{
	planetary_atmos = 1
	},
/area/hangar)
"aB" = (
/obj/effect/landmark/outpost/hangar_dock,
/turf/open/floor/plating{
	planetary_atmos = 1
	},
/area/hangar)
"aC" = (
/obj/effect/turf_decal/arrows{
	dir = 1
	},
/turf/open/floor/plasteel/tech{
	planetary_atmos = 1
	},
/area/hangar)
"aE" = (
/obj/machinery/light/floor/hangar,
/turf/open/floor/plasteel{
	planetary_atmos = 1
	},
/area/hangar)
"aH" = (
/turf/template_noop,
/area/template_noop)
"aJ" = (
/turf/open/floor/plating{
	planetary_atmos = 1
	},
/area/hangar)
"aL" = (
/obj/effect/turf_decal/trimline/opaque/yellow/warning{
	dir = 8
	},
/turf/open/floor/plasteel/tech{
	planetary_atmos = 1
	},
/area/hangar)
"aM" = (
/obj/effect/turf_decal/trimline/opaque/yellow/filled/warning,
/turf/open/floor/plasteel{
	planetary_atmos = 1
	},
/area/hangar)
"aN" = (
/obj/effect/turf_decal/trimline/opaque/yellow/filled/warning{
	dir = 8
	},
/turf/open/floor/plasteel{
	planetary_atmos = 1
	},
/area/hangar)
"aO" = (
/obj/structure/railing{
	dir = 1
	},
/turf/open/floor/plasteel/tech/techmaint,
/area/hangar)
"aP" = (
/obj/effect/turf_decal/trimline/opaque/yellow/filled/corner{
	dir = 1
	},
/turf/open/floor/plasteel{
	planetary_atmos = 1
	},
/area/hangar)
"aT" = (
/obj/structure/catwalk/over/plated_catwalk,
/obj/machinery/atmospherics/pipe/simple/orange/hidden,
/turf/open/floor/plating{
	planetary_atmos = 1
	},
/area/hangar)
"aY" = (
/obj/effect/landmark/outpost/hangar_numbers,
/obj/machinery/atmospherics/pipe/simple/orange/hidden{
	dir = 10
	},
/turf/open/floor/plasteel/tech/techmaint,
/area/hangar)
"aZ" = (
/turf/open/floor/plasteel{
	planetary_atmos = 1
	},
/area/hangar)
"dR" = (
/obj/machinery/atmospherics/pipe/simple/orange/hidden{
	dir = 4
	},
/obj/structure/catwalk/over/plated_catwalk,
/turf/open/floor/plating{
	planetary_atmos = 1
	},
/area/hangar)
"fT" = (
/obj/machinery/atmospherics/pipe/simple/orange/hidden{
	dir = 4
	},
/turf/open/floor/plasteel/tech/techmaint,
/area/hangar)
"fU" = (
/obj/structure/catwalk/over/plated_catwalk,
/turf/open/floor/plating{
	planetary_atmos = 1
	},
/area/hangar)
"gu" = (
/obj/structure/catwalk/over/plated_catwalk,
/obj/machinery/atmospherics/pipe/simple/orange/hidden{
	dir = 5
	},
/turf/open/floor/plating{
	planetary_atmos = 1
	},
/area/hangar)
"iT" = (
/obj/structure/railing/corner{
	dir = 4
	},
/turf/open/floor/plasteel{
	planetary_atmos = 1
	},
/area/hangar)
"jk" = (
/obj/effect/landmark/outpost/elevator,
/turf/open/floor/plasteel/elevatorshaft{
	planetary_atmos = 1
	},
/area/hangar)
"qz" = (
/turf/open/floor/plasteel/elevatorshaft{
	planetary_atmos = 1
	},
/area/hangar)
"qO" = (
/obj/structure/table/reinforced,
/obj/structure/sign/warning/nosmoking/burnt{
	pixel_y = 28
	},
/turf/open/floor/plasteel/tech/techmaint,
/area/hangar)
"rQ" = (
/obj/machinery/atmospherics/components/unary/portables_connector{
	dir = 8
	},
/obj/effect/turf_decal/industrial/outline/yellow,
/turf/open/floor/plasteel/tech/techmaint,
/area/hangar)
"un" = (
/turf/open/floor/plasteel/tech/techmaint,
/area/hangar)
"zH" = (
/obj/structure/catwalk/over/plated_catwalk,
/obj/machinery/atmospherics/pipe/manifold4w/orange/hidden,
/turf/open/floor/plating{
	planetary_atmos = 1
	},
/area/hangar)
"Af" = (
/obj/machinery/door/airlock/maintenance{
	req_access_txt = "101"
	},
/turf/open/floor/plating{
	planetary_atmos = 1
	},
/area/hangar)
"Aj" = (
/obj/machinery/computer/hydrogen_exchange,
/turf/open/floor/plasteel/tech/techmaint,
/area/hangar)
"An" = (
/obj/structure/catwalk/over/plated_catwalk,
/obj/machinery/atmospherics/pipe/simple/orange/hidden{
	dir = 9
	},
/turf/open/floor/plating{
	planetary_atmos = 1
	},
/area/hangar)
"DI" = (
/obj/structure/catwalk/over/plated_catwalk,
/obj/machinery/atmospherics/pipe/manifold/orange/hidden{
	dir = 1
	},
/turf/open/floor/plating{
	planetary_atmos = 1
	},
/area/hangar)
"Ie" = (
/obj/structure/catwalk/over/plated_catwalk,
/obj/machinery/atmospherics/pipe/simple/orange/hidden{
	dir = 6
	},
/turf/open/floor/plating{
	planetary_atmos = 1
	},
/area/hangar)
"IW" = (
/obj/structure/catwalk/over/plated_catwalk,
/obj/machinery/atmospherics/pipe/manifold/orange/hidden,
/turf/open/floor/plating{
	planetary_atmos = 1
	},
/area/hangar)
"Ks" = (
/obj/effect/turf_decal/industrial/shutoff,
/obj/machinery/atmospherics/components/binary/volume_pump{
	dir = 4
	},
/turf/open/floor/plasteel{
	planetary_atmos = 1
	},
/area/hangar)
"Li" = (
/obj/structure/railing/corner{
	dir = 4
	},
/turf/open/floor/plasteel/tech/techmaint,
/area/hangar)
"Oa" = (
/obj/effect/turf_decal/trimline/opaque/yellow/filled/warning,
/obj/machinery/atmospherics/components/binary/valve/digital,
/turf/open/floor/plasteel{
	planetary_atmos = 1
	},
/area/hangar)
"Sr" = (
/obj/effect/turf_decal/trimline/opaque/yellow/filled/warning{
	dir = 1
	},
/obj/machinery/atmospherics/components/binary/valve/digital,
/turf/open/floor/plasteel{
	planetary_atmos = 1
	},
/area/hangar)
"VO" = (
/obj/structure/railing/corner{
	dir = 1;
	layer = 4.1
	},
/turf/open/floor/plasteel/tech/techmaint,
/area/hangar)
"Wk" = (
/obj/structure/catwalk/over/plated_catwalk,
/obj/machinery/atmospherics/pipe/simple/orange/hidden{
	dir = 8
	},
/turf/open/floor/plating{
	planetary_atmos = 1
	},
/area/hangar)
"Xu" = (
/obj/machinery/atmospherics/components/unary/hydrogen_pump{
	dir = 4
	},
/obj/effect/turf_decal/industrial/outline/yellow,
/turf/open/floor/plasteel/tech/techmaint,
/area/hangar)
"Xy" = (
/obj/machinery/atmospherics/components/binary/volume_pump{
	dir = 4
	},
/obj/effect/turf_decal/industrial/shutoff,
/turf/open/floor/plasteel{
	planetary_atmos = 1
	},
/area/hangar)

(1,1,1) = {"
aH
aH
aH
am
am
am
am
am
am
am
ay
am
am
am
ay
am
am
am
ay
am
am
am
ay
am
am
am
ay
am
am
am
am
"}
(2,1,1) = {"
aH
aH
aH
am
aZ
aZ
aM
aL
aL
aL
aL
aL
aL
aL
aL
aL
aL
aL
aL
aL
aL
aL
aL
aL
aL
aL
aL
ao
aZ
aZ
am
"}
(3,1,1) = {"
aH
aH
aH
am
aZ
fU
aM
ac
ac
aC
ac
ac
ac
ac
aC
ac
ac
ac
ac
aC
ac
ac
ac
ac
aC
ac
ac
ao
fU
aZ
am
"}
(4,1,1) = {"
aH
aH
aH
am
aZ
fU
aM
ad
ad
ad
ad
ad
ad
ad
ad
ad
ad
ad
ad
ad
ad
ad
ad
ad
ad
ad
ad
ao
fU
aZ
am
"}
(5,1,1) = {"
aH
aH
aH
am
aZ
fU
aM
aJ
aJ
aJ
aJ
aJ
aJ
aJ
aJ
aJ
aJ
aJ
aJ
aJ
aJ
aJ
aJ
aJ
aJ
aJ
aB
ao
fU
aZ
am
"}
(6,1,1) = {"
aH
aH
aH
am
aZ
fU
aM
aJ
aJ
aJ
aJ
aJ
aJ
aJ
aJ
aJ
aJ
aJ
aJ
aJ
aJ
aJ
aJ
aJ
aJ
aJ
aJ
ao
fU
aZ
am
"}
(7,1,1) = {"
aH
aH
aH
am
aZ
fU
aM
ap
aJ
aJ
aJ
aJ
aJ
aJ
aJ
aJ
aJ
aJ
aJ
aJ
aJ
aJ
aJ
aJ
aJ
aJ
ap
ao
fU
aZ
am
"}
(8,1,1) = {"
aH
aH
aH
am
aZ
Ie
Oa
aJ
aJ
aJ
aJ
aJ
aJ
aJ
aJ
aJ
aJ
aJ
aJ
aJ
aJ
aJ
aJ
aJ
aJ
aJ
aJ
Sr
gu
aZ
am
"}
(9,1,1) = {"
aH
aH
aH
am
aZ
az
av
aJ
aJ
aJ
aJ
aJ
aJ
aJ
aJ
aJ
aJ
aJ
aJ
aJ
aJ
aJ
aJ
aJ
aJ
aJ
aJ
aq
Wk
aZ
am
"}
(10,1,1) = {"
aH
aH
aH
am
aZ
az
aM
aJ
aJ
aJ
aJ
aJ
aJ
aJ
aJ
aJ
aJ
aJ
aJ
aJ
aJ
aJ
aJ
aJ
aJ
aJ
aJ
ao
Wk
aZ
am
"}
(11,1,1) = {"
aH
aH
aH
am
aZ
az
aM
aJ
aJ
aJ
aJ
aJ
aJ
aJ
aJ
aJ
aJ
aJ
aJ
aJ
aJ
aJ
aJ
aJ
aJ
aJ
aJ
ao
Wk
aZ
am
"}
(12,1,1) = {"
aH
aH
aH
am
aZ
az
aM
ap
aJ
aJ
aJ
aJ
aJ
aJ
aJ
aJ
aJ
aJ
aJ
aJ
aJ
aJ
aJ
aJ
aJ
aJ
ap
ao
Wk
aZ
am
"}
(13,1,1) = {"
aH
aH
aH
am
aZ
az
aM
aJ
aJ
aJ
aJ
aJ
aJ
aJ
aJ
aJ
aJ
aJ
aJ
aJ
aJ
aJ
aJ
aJ
aJ
aJ
aJ
ao
Wk
aZ
am
"}
(14,1,1) = {"
aH
aH
aH
am
aZ
az
aM
aJ
aJ
aJ
aJ
aJ
aJ
aJ
aJ
aJ
aJ
aJ
aJ
aJ
aJ
aJ
aJ
aJ
aJ
aJ
aJ
ao
Wk
aZ
am
"}
(15,1,1) = {"
aH
aH
aH
am
aZ
az
aM
aJ
aJ
aJ
aJ
aJ
aJ
aJ
aJ
aJ
aJ
aJ
aJ
aJ
aJ
aJ
aJ
aJ
aJ
aJ
aJ
ao
Wk
aZ
am
"}
(16,1,1) = {"
aH
aH
aH
am
aZ
az
aM
aJ
aJ
aJ
aJ
aJ
aJ
aJ
aJ
aJ
aJ
aJ
aJ
aJ
aJ
aJ
aJ
aJ
aJ
aJ
aJ
ao
Wk
aZ
am
"}
(17,1,1) = {"
aH
aH
aH
am
aZ
az
aM
ap
aJ
aJ
aJ
aJ
aJ
aJ
aJ
aJ
aJ
aJ
aJ
aJ
aJ
aJ
aJ
aJ
aJ
aJ
ap
ao
Wk
aZ
am
"}
(18,1,1) = {"
aH
aH
am
am
iT
az
aM
aJ
aJ
aJ
aJ
aJ
aJ
aJ
aJ
aJ
aJ
aJ
aJ
aJ
aJ
aJ
aJ
aJ
aJ
aJ
aJ
ao
Wk
aZ
am
"}
(19,1,1) = {"
am
am
am
Xu
aO
az
av
aJ
aJ
aJ
aJ
aJ
aJ
aJ
aJ
aJ
aJ
aJ
aJ
aJ
aJ
aJ
aJ
aJ
aJ
aJ
aJ
aq
Wk
aZ
am
"}
(20,1,1) = {"
am
Af
un
Xy
VO
az
aM
aJ
aJ
aJ
aJ
aJ
aJ
aJ
aJ
aJ
aJ
aJ
aJ
aJ
aJ
aJ
aJ
aJ
aJ
aJ
aJ
ao
Wk
aZ
am
"}
(21,1,1) = {"
am
am
Aj
DI
aT
zH
Oa
aJ
aJ
aJ
aJ
aJ
aJ
aJ
aJ
aJ
aJ
aJ
aJ
aJ
aJ
aJ
aJ
aJ
aJ
aJ
aJ
Sr
IW
aZ
am
"}
(22,1,1) = {"
aH
am
qO
Ks
Li
az
aM
ap
aJ
aJ
aJ
aJ
aJ
aJ
aJ
aJ
aJ
aJ
aJ
aJ
aJ
aJ
aJ
aJ
aJ
aJ
ap
ao
Wk
aZ
am
"}
(23,1,1) = {"
aH
am
am
rQ
aO
dR
aM
aJ
aJ
aJ
aJ
aJ
aJ
aJ
aJ
aJ
aJ
aJ
aJ
aJ
aJ
aJ
aJ
aJ
aJ
aJ
aJ
ao
Wk
aZ
am
"}
(24,1,1) = {"
am
am
am
am
am
aA
aM
aJ
aJ
aJ
aJ
aJ
aJ
aJ
aJ
aJ
aJ
aJ
aJ
aJ
aJ
aJ
aJ
aJ
aJ
aJ
aJ
ao
Wk
aZ
am
"}
(25,1,1) = {"
am
qz
qz
jk
ax
fT
al
aN
aN
aN
aN
aN
aN
aN
aN
aN
aN
aN
aN
aN
aN
aN
aN
aN
aN
aN
aN
aP
Wk
aZ
am
"}
(26,1,1) = {"
am
qz
qz
qz
ax
aY
aT
aT
aT
aT
aT
aT
aT
aT
aT
aT
aT
aT
aT
aT
aT
aT
aT
aT
aT
aT
aT
aT
An
aZ
am
"}
(27,1,1) = {"
am
qz
qz
qz
ax
un
aZ
aZ
aE
aZ
aZ
aZ
aZ
aZ
aZ
aZ
aZ
aZ
aZ
aZ
aZ
aZ
aZ
aZ
aZ
aE
aZ
aZ
aZ
aZ
am
"}
(28,1,1) = {"
am
am
am
am
am
am
am
am
am
am
am
am
am
am
am
am
am
am
am
am
am
am
am
am
am
am
am
am
am
am
am
"}
