//MAP CONVERTED BY dmm2tgm.py THIS HEADER COMMENT PREVENTS RECONVERSION, DO NOT REMOVE
"aa" = (
/turf/closed/indestructible/reinforced,
/area/hangar)
"ab" = (
/obj/effect/turf_decal/trimline/opaque/yellow/filled/warning{
	dir = 1
	},
/turf/open/floor/plasteel{
	planetary_atmos = 1
	},
/area/hangar)
"ac" = (
/obj/structure/marker_beacon{
	picked_color = "Teal"
	},
/turf/open/floor/plating{
	planetary_atmos = 1
	},
/area/hangar)
"ag" = (
/obj/effect/turf_decal/trimline/opaque/yellow/filled/warning{
	dir = 8
	},
/turf/open/floor/plasteel{
	planetary_atmos = 1
	},
/area/hangar)
"ah" = (
/obj/effect/turf_decal/trimline/opaque/yellow/filled/warning,
/turf/open/floor/plasteel{
	planetary_atmos = 1
	},
/area/hangar)
"ak" = (
/obj/effect/turf_decal/trimline/opaque/yellow/filled/warning{
	dir = 1
	},
/obj/machinery/light/floor/hangar,
/turf/open/floor/plasteel{
	planetary_atmos = 1
	},
/area/hangar)
"am" = (
/obj/machinery/elevator_call_button{
	pixel_y = 25
	},
/obj/effect/landmark/outpost/elevator_machine,
/turf/open/floor/plasteel{
	planetary_atmos = 1
	},
/area/hangar)
"an" = (
/obj/effect/turf_decal/trimline/opaque/yellow/warning{
	dir = 8
	},
/turf/open/floor/plasteel/tech{
	planetary_atmos = 1
	},
/area/hangar)
"ap" = (
/obj/machinery/door/poddoor/multi_tile/four_tile_ver,
/turf/closed/indestructible/reinforced,
/area/hangar)
"as" = (
/obj/effect/turf_decal/arrows{
	dir = 1
	},
/turf/open/floor/plasteel/tech{
	planetary_atmos = 1
	},
/area/hangar)
"at" = (
/turf/open/floor/plasteel/tech{
	planetary_atmos = 1
	},
/area/hangar)
"au" = (
/turf/template_noop,
/area/template_noop)
"aw" = (
/obj/effect/turf_decal/arrows{
	dir = 1
	},
/turf/open/floor/plasteel{
	planetary_atmos = 1
	},
/area/hangar)
"ax" = (
/obj/effect/turf_decal/trimline/opaque/yellow/filled/warning,
/obj/machinery/light/floor/hangar,
/turf/open/floor/plasteel{
	planetary_atmos = 1
	},
/area/hangar)
"ay" = (
/obj/effect/turf_decal/arrows{
	dir = 4
	},
/turf/open/floor/plasteel{
	planetary_atmos = 1
	},
/area/hangar)
"aC" = (
/obj/effect/turf_decal/trimline/opaque/yellow/filled/corner{
	dir = 8
	},
/turf/open/floor/plasteel{
	planetary_atmos = 1
	},
/area/hangar)
"aF" = (
/turf/open/floor/plating{
	planetary_atmos = 1
	},
/area/hangar)
"aH" = (
/obj/effect/landmark/outpost/hangar_dock,
/turf/open/floor/plating{
	planetary_atmos = 1
	},
/area/hangar)
"aP" = (
/obj/effect/landmark/outpost/hangar_numbers,
/turf/open/floor/plasteel{
	planetary_atmos = 1
	},
/area/hangar)
"aQ" = (
/obj/effect/turf_decal/trimline/opaque/yellow/warning{
	dir = 4
	},
/turf/open/floor/plasteel/tech{
	planetary_atmos = 1
	},
/area/hangar)
"aS" = (
/obj/machinery/light/floor/hangar,
/turf/open/floor/plasteel{
	planetary_atmos = 1
	},
/area/hangar)
"aT" = (
/turf/open/floor/plasteel{
	planetary_atmos = 1
	},
/area/hangar)
"aX" = (
/obj/effect/turf_decal/trimline/opaque/yellow/filled/corner{
	dir = 1
	},
/turf/open/floor/plasteel{
	planetary_atmos = 1
	},
/area/hangar)
"aY" = (
/obj/machinery/atmospherics/components/unary/passive_vent{
	dir = 1
	},
/turf/open/floor/plasteel{
	planetary_atmos = 1
	},
/area/hangar)
"aZ" = (
/obj/machinery/door/airlock,
/obj/effect/landmark/outpost/elevator_machine,
/obj/structure/lattice/catwalk,
/turf/open/floor/engine,
/area/hangar)
"jY" = (
/turf/open/floor/plasteel/elevatorshaft{
	planetary_atmos = 1
	},
/area/hangar)
"BE" = (
/obj/machinery/atmospherics/pipe/simple/general,
/turf/closed/indestructible/reinforced,
/area/hangar)
"JI" = (
/obj/effect/landmark/outpost/elevator,
/turf/open/floor/plasteel/elevatorshaft{
	planetary_atmos = 1
	},
/area/hangar)

(1,1,1) = {"
au
au
au
aa
aa
aa
aa
aa
aa
aa
ap
aa
aa
aa
ap
aa
aa
aa
ap
aa
aa
aa
ap
aa
aa
aa
ap
aa
aa
aa
ap
aa
aa
aa
ap
aa
aa
aa
ap
aa
aa
aa
ap
aa
aa
aa
ap
aa
aa
aa
aa
"}
(2,1,1) = {"
au
au
au
aa
aT
aT
ah
an
an
an
an
an
an
an
an
an
an
an
an
an
an
an
an
an
an
an
an
an
an
an
an
an
an
an
an
an
an
an
an
an
an
an
an
an
an
an
an
ab
aT
aT
aa
"}
(3,1,1) = {"
au
au
au
aa
aT
aT
ah
at
at
as
at
at
at
at
as
at
at
at
at
as
at
at
at
at
as
at
at
at
at
as
at
at
at
at
as
at
at
at
at
as
at
at
at
at
as
at
at
ab
aT
aT
aa
"}
(4,1,1) = {"
au
au
au
aa
aT
aT
ah
aQ
aQ
aQ
aQ
aQ
aQ
aQ
aQ
aQ
aQ
aQ
aQ
aQ
aQ
aQ
aQ
aQ
aQ
aQ
aQ
aQ
aQ
aQ
aQ
aQ
aQ
aQ
aQ
aQ
aQ
aQ
aQ
aQ
aQ
aQ
aQ
aQ
aQ
aQ
aQ
ab
aT
aT
aa
"}
(5,1,1) = {"
au
au
au
aa
aT
aT
ah
aF
aF
aF
aF
aF
aF
aF
aF
aF
aF
aF
aF
aF
aF
aF
aF
aF
aF
aF
aF
aF
aF
aF
aF
aF
aF
aF
aF
aF
aF
aF
aF
aF
aF
aF
aF
aF
aF
aF
aH
ab
aT
aT
aa
"}
(6,1,1) = {"
au
au
au
aa
aT
aT
ah
aF
aF
aF
aF
aF
aF
aF
aF
aF
aF
aF
aF
aF
aF
aF
aF
aF
aF
aF
aF
aF
aF
aF
aF
aF
aF
aF
aF
aF
aF
aF
aF
aF
aF
aF
aF
aF
aF
aF
aF
ab
aT
aT
aa
"}
(7,1,1) = {"
au
au
au
aa
aT
ay
ah
ac
aF
aF
aF
aF
aF
aF
aF
aF
aF
aF
aF
aF
aF
aF
aF
aF
aF
aF
aF
aF
aF
aF
aF
aF
aF
aF
aF
aF
aF
aF
aF
aF
aF
aF
aF
aF
aF
aF
ac
ab
ay
aT
aa
"}
(8,1,1) = {"
au
au
au
aa
aT
aT
ah
aF
aF
aF
aF
aF
aF
aF
aF
aF
aF
aF
aF
aF
aF
aF
aF
aF
aF
aF
aF
aF
aF
aF
aF
aF
aF
aF
aF
aF
aF
aF
aF
aF
aF
aF
aF
aF
aF
aF
aF
ab
aT
aT
aa
"}
(9,1,1) = {"
au
au
au
aa
aT
aT
ax
aF
aF
aF
aF
aF
aF
aF
aF
aF
aF
aF
aF
aF
aF
aF
aF
aF
aF
aF
aF
aF
aF
aF
aF
aF
aF
aF
aF
aF
aF
aF
aF
aF
aF
aF
aF
aF
aF
aF
aF
ak
aT
aT
aa
"}
(10,1,1) = {"
au
au
au
aa
aT
aT
ah
aF
aF
aF
aF
aF
aF
aF
aF
aF
aF
aF
aF
aF
aF
aF
aF
aF
aF
aF
aF
aF
aF
aF
aF
aF
aF
aF
aF
aF
aF
aF
aF
aF
aF
aF
aF
aF
aF
aF
aF
ab
aT
aT
aa
"}
(11,1,1) = {"
au
au
au
aa
aT
aT
ah
aF
aF
aF
aF
aF
aF
aF
aF
aF
aF
aF
aF
aF
aF
aF
aF
aF
aF
aF
aF
aF
aF
aF
aF
aF
aF
aF
aF
aF
aF
aF
aF
aF
aF
aF
aF
aF
aF
aF
aF
ab
aT
aT
aa
"}
(12,1,1) = {"
au
au
au
aa
aT
ay
ah
ac
aF
aF
aF
aF
aF
aF
aF
aF
aF
aF
aF
aF
aF
aF
aF
aF
aF
aF
aF
aF
aF
aF
aF
aF
aF
aF
aF
aF
aF
aF
aF
aF
aF
aF
aF
aF
aF
aF
ac
ab
ay
aT
aa
"}
(13,1,1) = {"
au
au
au
aa
aT
aT
ah
aF
aF
aF
aF
aF
aF
aF
aF
aF
aF
aF
aF
aF
aF
aF
aF
aF
aF
aF
aF
aF
aF
aF
aF
aF
aF
aF
aF
aF
aF
aF
aF
aF
aF
aF
aF
aF
aF
aF
aF
ab
aT
aT
aa
"}
(14,1,1) = {"
au
au
au
aa
aT
aT
ah
aF
aF
aF
aF
aF
aF
aF
aF
aF
aF
aF
aF
aF
aF
aF
aF
aF
aF
aF
aF
aF
aF
aF
aF
aF
aF
aF
aF
aF
aF
aF
aF
aF
aF
aF
aF
aF
aF
aF
aF
ab
aT
aT
aa
"}
(15,1,1) = {"
au
au
au
aa
aT
aT
ah
aF
aF
aF
aF
aF
aF
aF
aF
aF
aF
aF
aF
aF
aF
aF
aF
aF
aF
aF
aF
aF
aF
aF
aF
aF
aF
aF
aF
aF
aF
aF
aF
aF
aF
aF
aF
aF
aF
aF
aF
ab
aT
aT
aa
"}
(16,1,1) = {"
au
au
au
aa
aT
aT
ah
aF
aF
aF
aF
aF
aF
aF
aF
aF
aF
aF
aF
aF
aF
aF
aF
aF
aF
aF
aF
aF
aF
aF
aF
aF
aF
aF
aF
aF
aF
aF
aF
aF
aF
aF
aF
aF
aF
aF
aF
ab
aT
aT
aa
"}
(17,1,1) = {"
au
au
au
aa
aT
ay
ah
ac
aF
aF
aF
aF
aF
aF
aF
aF
aF
aF
aF
aF
aF
aF
aF
aF
aF
aF
aF
aF
aF
aF
aF
aF
aF
aF
aF
aF
aF
aF
aF
aF
aF
aF
aF
aF
aF
aF
ac
ab
ay
aT
aa
"}
(18,1,1) = {"
au
au
au
aa
aT
aT
ah
aF
aF
aF
aF
aF
aF
aF
aF
aF
aF
aF
aF
aF
aF
aF
aF
aF
aF
aF
aF
aF
aF
aF
aF
aF
aF
aF
aF
aF
aF
aF
aF
aF
aF
aF
aF
aF
aF
aF
aF
ab
aT
aT
aa
"}
(19,1,1) = {"
au
au
au
aa
aT
aT
ax
aF
aF
aF
aF
aF
aF
aF
aF
aF
aF
aF
aF
aF
aF
aF
aF
aF
aF
aF
aF
aF
aF
aF
aF
aF
aF
aF
aF
aF
aF
aF
aF
aF
aF
aF
aF
aF
aF
aF
aF
ak
aT
aT
aa
"}
(20,1,1) = {"
au
au
au
aa
aT
aT
ah
aF
aF
aF
aF
aF
aF
aF
aF
aF
aF
aF
aF
aF
aF
aF
aF
aF
aF
aF
aF
aF
aF
aF
aF
aF
aF
aF
aF
aF
aF
aF
aF
aF
aF
aF
aF
aF
aF
aF
aF
ab
aT
aT
aa
"}
(21,1,1) = {"
au
au
au
aa
aT
aT
ah
aF
aF
aF
aF
aF
aF
aF
aF
aF
aF
aF
aF
aF
aF
aF
aF
aF
aF
aF
aF
aF
aF
aF
aF
aF
aF
aF
aF
aF
aF
aF
aF
aF
aF
aF
aF
aF
aF
aF
aF
ab
aT
aT
aa
"}
(22,1,1) = {"
au
au
au
aa
aT
ay
ah
ac
aF
aF
aF
aF
aF
aF
aF
aF
aF
aF
aF
aF
aF
aF
aF
aF
aF
aF
aF
aF
aF
aF
aF
aF
aF
aF
aF
aF
aF
aF
aF
aF
aF
aF
aF
aF
aF
aF
ac
ab
ay
aT
aa
"}
(23,1,1) = {"
au
au
au
aa
aT
aT
ah
aF
aF
aF
aF
aF
aF
aF
aF
aF
aF
aF
aF
aF
aF
aF
aF
aF
aF
aF
aF
aF
aF
aF
aF
aF
aF
aF
aF
aF
aF
aF
aF
aF
aF
aF
aF
aF
aF
aF
aF
ab
aT
aT
aa
"}
(24,1,1) = {"
au
au
au
aa
aT
aT
ah
aF
aF
aF
aF
aF
aF
aF
aF
aF
aF
aF
aF
aF
aF
aF
aF
aF
aF
aF
aF
aF
aF
aF
aF
aF
aF
aF
aF
aF
aF
aF
aF
aF
aF
aF
aF
aF
aF
aF
aF
ab
aT
aT
aa
"}
(25,1,1) = {"
au
au
au
aa
aT
aT
ah
aF
aF
aF
aF
aF
aF
aF
aF
aF
aF
aF
aF
aF
aF
aF
aF
aF
aF
aF
aF
aF
aF
aF
aF
aF
aF
aF
aF
aF
aF
aF
aF
aF
aF
aF
aF
aF
aF
aF
aF
ab
aT
aT
aa
"}
(26,1,1) = {"
au
au
au
aa
aT
aT
ah
aF
aF
aF
aF
aF
aF
aF
aF
aF
aF
aF
aF
aF
aF
aF
aF
aF
aF
aF
aF
aF
aF
aF
aF
aF
aF
aF
aF
aF
aF
aF
aF
aF
aF
aF
aF
aF
aF
aF
aF
ab
aT
aT
aa
"}
(27,1,1) = {"
au
au
au
aa
aT
ay
ah
ac
aF
aF
aF
aF
aF
aF
aF
aF
aF
aF
aF
aF
aF
aF
aF
aF
aF
aF
aF
aF
aF
aF
aF
aF
aF
aF
aF
aF
aF
aF
aF
aF
aF
aF
aF
aF
aF
aF
ac
ab
ay
aT
aa
"}
(28,1,1) = {"
au
au
au
aa
aT
aT
ah
aF
aF
aF
aF
aF
aF
aF
aF
aF
aF
aF
aF
aF
aF
aF
aF
aF
aF
aF
aF
aF
aF
aF
aF
aF
aF
aF
aF
aF
aF
aF
aF
aF
aF
aF
aF
aF
aF
aF
aF
ab
aT
aT
aa
"}
(29,1,1) = {"
au
au
au
aa
aT
aT
ax
aF
aF
aF
aF
aF
aF
aF
aF
aF
aF
aF
aF
aF
aF
aF
aF
aF
aF
aF
aF
aF
aF
aF
aF
aF
aF
aF
aF
aF
aF
aF
aF
aF
aF
aF
aF
aF
aF
aF
aF
ak
aT
aT
aa
"}
(30,1,1) = {"
au
au
au
aa
aT
aT
ah
aF
aF
aF
aF
aF
aF
aF
aF
aF
aF
aF
aF
aF
aF
aF
aF
aF
aF
aF
aF
aF
aF
aF
aF
aF
aF
aF
aF
aF
aF
aF
aF
aF
aF
aF
aF
aF
aF
aF
aF
ab
aT
aT
aa
"}
(31,1,1) = {"
au
au
au
aa
aT
aT
ah
aF
aF
aF
aF
aF
aF
aF
aF
aF
aF
aF
aF
aF
aF
aF
aF
aF
aF
aF
aF
aF
aF
aF
aF
aF
aF
aF
aF
aF
aF
aF
aF
aF
aF
aF
aF
aF
aF
aF
aF
ab
aT
aT
aa
"}
(32,1,1) = {"
au
au
au
aa
aT
ay
ah
ac
aF
aF
aF
aF
aF
aF
aF
aF
aF
aF
aF
aF
aF
aF
aF
aF
aF
aF
aF
aF
aF
aF
aF
aF
aF
aF
aF
aF
aF
aF
aF
aF
aF
aF
aF
aF
aF
aF
ac
ab
ay
aT
aa
"}
(33,1,1) = {"
au
au
au
aa
aT
aT
ah
aF
aF
aF
aF
aF
aF
aF
aF
aF
aF
aF
aF
aF
aF
aF
aF
aF
aF
aF
aF
aF
aF
aF
aF
aF
aF
aF
aF
aF
aF
aF
aF
aF
aF
aF
aF
aF
aF
aF
aF
ab
aT
aT
aa
"}
(34,1,1) = {"
au
au
au
aa
aT
aT
ah
aF
aF
aF
aF
aF
aF
aF
aF
aF
aF
aF
aF
aF
aF
aF
aF
aF
aF
aF
aF
aF
aF
aF
aF
aF
aF
aF
aF
aF
aF
aF
aF
aF
aF
aF
aF
aF
aF
aF
aF
ab
aT
aT
aa
"}
(35,1,1) = {"
au
au
au
aa
aT
aT
ah
aF
aF
aF
aF
aF
aF
aF
aF
aF
aF
aF
aF
aF
aF
aF
aF
aF
aF
aF
aF
aF
aF
aF
aF
aF
aF
aF
aF
aF
aF
aF
aF
aF
aF
aF
aF
aF
aF
aF
aF
ab
aT
aT
aa
"}
(36,1,1) = {"
au
au
au
aa
aT
aT
ah
aF
aF
aF
aF
aF
aF
aF
aF
aF
aF
aF
aF
aF
aF
aF
aF
aF
aF
aF
aF
aF
aF
aF
aF
aF
aF
aF
aF
aF
aF
aF
aF
aF
aF
aF
aF
aF
aF
aF
aF
ab
aT
aT
aa
"}
(37,1,1) = {"
au
au
au
aa
aT
ay
ah
ac
aF
aF
aF
aF
aF
aF
aF
aF
aF
aF
aF
aF
aF
aF
aF
aF
aF
aF
aF
aF
aF
aF
aF
aF
aF
aF
aF
aF
aF
aF
aF
aF
aF
aF
aF
aF
aF
aF
ac
ab
ay
aT
aa
"}
(38,1,1) = {"
au
au
au
aa
aT
aT
ah
aF
aF
aF
aF
aF
aF
aF
aF
aF
aF
aF
aF
aF
aF
aF
aF
aF
aF
aF
aF
aF
aF
aF
aF
aF
aF
aF
aF
aF
aF
aF
aF
aF
aF
aF
aF
aF
aF
aF
aF
ab
aT
aT
aa
"}
(39,1,1) = {"
au
au
au
aa
aT
aT
ax
aF
aF
aF
aF
aF
aF
aF
aF
aF
aF
aF
aF
aF
aF
aF
aF
aF
aF
aF
aF
aF
aF
aF
aF
aF
aF
aF
aF
aF
aF
aF
aF
aF
aF
aF
aF
aF
aF
aF
aF
ak
aT
aT
aa
"}
(40,1,1) = {"
au
au
au
aa
aT
aT
ah
aF
aF
aF
aF
aF
aF
aF
aF
aF
aF
aF
aF
aF
aF
aF
aF
aF
aF
aF
aF
aF
aF
aF
aF
aF
aF
aF
aF
aF
aF
aF
aF
aF
aF
aF
aF
aF
aF
aF
aF
ab
aT
aT
aa
"}
(41,1,1) = {"
au
au
au
aa
aT
aT
ah
aF
aF
aF
aF
aF
aF
aF
aF
aF
aF
aF
aF
aF
aF
aF
aF
aF
aF
aF
aF
aF
aF
aF
aF
aF
aF
aF
aF
aF
aF
aF
aF
aF
aF
aF
aF
aF
aF
aF
aF
ab
aT
aT
aa
"}
(42,1,1) = {"
au
au
au
aa
aT
ay
ah
ac
aF
aF
aF
aF
aF
aF
aF
aF
aF
aF
aF
aF
aF
aF
aF
aF
aF
aF
aF
aF
aF
aF
aF
aF
aF
aF
aF
aF
aF
aF
aF
aF
aF
aF
aF
aF
aF
aF
ac
ab
ay
aT
aa
"}
(43,1,1) = {"
au
au
au
BE
aY
aT
ah
aF
aF
aF
aF
aF
aF
aF
aF
aF
aF
aF
aF
aF
aF
aF
aF
aF
aF
aF
aF
aF
aF
aF
aF
aF
aF
aF
aF
aF
aF
aF
aF
aF
aF
aF
aF
aF
aF
aF
aF
ab
aT
aT
aa
"}
(44,1,1) = {"
aa
aa
aa
aa
aa
am
ah
aF
aF
aF
aF
aF
aF
aF
aF
aF
aF
aF
aF
aF
aF
aF
aF
aF
aF
aF
aF
aF
aF
aF
aF
aF
aF
aF
aF
aF
aF
aF
aF
aF
aF
aF
aF
aF
aF
aF
aF
ab
aT
aT
aa
"}
(45,1,1) = {"
aa
jY
jY
JI
aZ
aT
aC
ag
ag
ag
ag
ag
ag
ag
ag
ag
ag
ag
ag
ag
ag
ag
ag
ag
ag
ag
ag
ag
ag
ag
ag
ag
ag
ag
ag
ag
ag
ag
ag
ag
ag
ag
ag
ag
ag
ag
ag
aX
aT
aT
aa
"}
(46,1,1) = {"
aa
jY
jY
jY
aZ
aP
aT
aT
aT
aw
aT
aT
aT
aT
aw
aT
aT
aT
aT
aw
aT
aT
aT
aT
aw
aT
aT
aT
aT
aw
aT
aT
aT
aT
aw
aT
aT
aT
aT
aw
aT
aT
aT
aT
aw
aT
aT
aT
aT
aT
aa
"}
(47,1,1) = {"
aa
jY
jY
jY
aZ
aT
aT
aS
aT
aT
aT
aT
aT
aT
aT
aT
aT
aS
aT
aT
aT
aT
aT
aT
aT
aT
aS
aS
aT
aT
aT
aT
aT
aT
aT
aT
aS
aT
aT
aT
aT
aT
aT
aT
aT
aT
aS
aT
aT
aT
aa
"}
(48,1,1) = {"
aa
aa
aa
aa
aa
aa
aa
aa
aa
aa
aa
aa
aa
aa
aa
aa
aa
aa
aa
aa
aa
aa
aa
aa
aa
aa
aa
aa
aa
aa
aa
aa
aa
aa
aa
aa
aa
aa
aa
aa
aa
aa
aa
aa
aa
aa
aa
aa
aa
aa
aa
"}
