//MAP CONVERTED BY dmm2tgm.py THIS HEADER COMMENT PREVENTS RECONVERSION, DO NOT REMOVE
"ad" = (
/obj/machinery/door/poddoor/multi_tile/four_tile_ver,
/turf/closed/indestructible/reinforced,
/area/hangar)
"ae" = (
/turf/open/floor/plasteel/tech{
	planetary_atmos = 1
	},
/area/hangar)
"af" = (
/obj/effect/landmark/outpost/hangar_dock,
/turf/open/floor/plating{
	planetary_atmos = 1
	},
/area/hangar)
"ag" = (
/turf/closed/indestructible/reinforced,
/area/hangar)
"ah" = (
/obj/machinery/atmospherics/pipe/simple/orange/hidden{
	dir = 4
	},
/turf/open/floor/plasteel/tech/techmaint,
/area/hangar)
"ai" = (
/obj/effect/turf_decal/arrows{
	dir = 1
	},
/turf/open/floor/plasteel/tech{
	planetary_atmos = 1
	},
/area/hangar)
"aj" = (
/obj/machinery/door/airlock,
/obj/effect/landmark/outpost/elevator_machine,
/obj/structure/lattice/catwalk,
/turf/open/floor/engine,
/area/hangar)
"al" = (
/obj/structure/marker_beacon{
	picked_color = "Teal"
	},
/turf/open/floor/plating{
	planetary_atmos = 1
	},
/area/hangar)
"am" = (
/obj/effect/turf_decal/trimline/opaque/yellow/filled/corner{
	dir = 1
	},
/turf/open/floor/plasteel{
	planetary_atmos = 1
	},
/area/hangar)
"an" = (
/turf/open/floor/plasteel{
	planetary_atmos = 1
	},
/area/hangar)
"ap" = (
/obj/effect/turf_decal/trimline/opaque/yellow/filled/corner{
	dir = 8
	},
/turf/open/floor/plasteel{
	planetary_atmos = 1
	},
/area/hangar)
"as" = (
/obj/machinery/elevator_call_button{
	pixel_y = 25
	},
/obj/effect/landmark/outpost/elevator_machine,
/obj/machinery/atmospherics/pipe/simple/orange/hidden{
	dir = 4
	},
/obj/structure/catwalk/over/plated_catwalk,
/turf/open/floor/plating{
	planetary_atmos = 1
	},
/area/hangar)
"ax" = (
/obj/effect/turf_decal/trimline/opaque/yellow/warning{
	dir = 4
	},
/turf/open/floor/plasteel/tech{
	planetary_atmos = 1
	},
/area/hangar)
"ay" = (
/obj/structure/railing{
	dir = 1
	},
/turf/open/floor/plasteel/tech/techmaint,
/area/hangar)
"aB" = (
/obj/effect/landmark/outpost/hangar_numbers,
/obj/machinery/atmospherics/pipe/simple/orange/hidden{
	dir = 10
	},
/turf/open/floor/plasteel/tech/techmaint,
/area/hangar)
"aC" = (
/obj/effect/turf_decal/trimline/opaque/yellow/filled/warning{
	dir = 1
	},
/turf/open/floor/plasteel{
	planetary_atmos = 1
	},
/area/hangar)
"aD" = (
/obj/structure/catwalk/over/plated_catwalk,
/obj/machinery/atmospherics/pipe/simple/orange/hidden,
/turf/open/floor/plating{
	planetary_atmos = 1
	},
/area/hangar)
"aE" = (
/obj/effect/turf_decal/trimline/opaque/yellow/filled/warning{
	dir = 8
	},
/turf/open/floor/plasteel{
	planetary_atmos = 1
	},
/area/hangar)
"aG" = (
/obj/structure/catwalk/over/plated_catwalk,
/obj/machinery/atmospherics/pipe/manifold/orange/hidden{
	dir = 1
	},
/turf/open/floor/plating{
	planetary_atmos = 1
	},
/area/hangar)
"aI" = (
/obj/effect/turf_decal/trimline/opaque/yellow/filled/warning,
/obj/machinery/light/floor/hangar,
/turf/open/floor/plasteel{
	planetary_atmos = 1
	},
/area/hangar)
"aJ" = (
/obj/effect/turf_decal/trimline/opaque/yellow/filled/warning,
/turf/open/floor/plasteel{
	planetary_atmos = 1
	},
/area/hangar)
"aK" = (
/obj/effect/turf_decal/trimline/opaque/yellow/filled/warning{
	dir = 1
	},
/obj/machinery/light/floor/hangar,
/turf/open/floor/plasteel{
	planetary_atmos = 1
	},
/area/hangar)
"aN" = (
/turf/open/floor/plating{
	planetary_atmos = 1
	},
/area/hangar)
"aP" = (
/obj/machinery/light/floor/hangar,
/turf/open/floor/plasteel{
	planetary_atmos = 1
	},
/area/hangar)
"aX" = (
/obj/effect/turf_decal/trimline/opaque/yellow/warning{
	dir = 8
	},
/turf/open/floor/plasteel/tech{
	planetary_atmos = 1
	},
/area/hangar)
"aZ" = (
/turf/template_noop,
/area/template_noop)
"jJ" = (
/obj/effect/landmark/outpost/elevator,
/turf/open/floor/plasteel/elevatorshaft{
	planetary_atmos = 1
	},
/area/hangar)
"lA" = (
/obj/structure/catwalk/over/plated_catwalk,
/obj/machinery/atmospherics/pipe/simple/orange/hidden{
	dir = 9
	},
/turf/open/floor/plating{
	planetary_atmos = 1
	},
/area/hangar)
"mV" = (
/turf/open/floor/plasteel/tech/techmaint,
/area/hangar)
"mX" = (
/turf/open/floor/plasteel/elevatorshaft{
	planetary_atmos = 1
	},
/area/hangar)
"pt" = (
/obj/structure/catwalk/over/plated_catwalk,
/turf/open/floor/plating{
	planetary_atmos = 1
	},
/area/hangar)
"qG" = (
/obj/effect/turf_decal/trimline/opaque/yellow/filled/warning,
/obj/machinery/atmospherics/components/binary/valve/digital,
/turf/open/floor/plasteel{
	planetary_atmos = 1
	},
/area/hangar)
"rb" = (
/obj/structure/railing/corner{
	dir = 4;
	layer = 4.1
	},
/turf/open/floor/plasteel{
	planetary_atmos = 1
	},
/area/hangar)
"st" = (
/obj/structure/catwalk/over/plated_catwalk,
/obj/machinery/atmospherics/pipe/simple/orange/hidden{
	dir = 6
	},
/turf/open/floor/plating{
	planetary_atmos = 1
	},
/area/hangar)
"vM" = (
/obj/machinery/atmospherics/components/unary/portables_connector{
	dir = 8
	},
/obj/effect/turf_decal/industrial/outline/yellow,
/turf/open/floor/plasteel/tech/techmaint,
/area/hangar)
"wb" = (
/obj/structure/table/reinforced,
/obj/structure/sign/warning/nosmoking/burnt{
	pixel_y = 28
	},
/turf/open/floor/plasteel/tech/techmaint,
/area/hangar)
"xG" = (
/obj/machinery/computer/hydrogen_exchange,
/turf/open/floor/plasteel/tech/techmaint,
/area/hangar)
"DF" = (
/obj/effect/turf_decal/industrial/shutoff,
/obj/machinery/atmospherics/components/binary/volume_pump{
	dir = 4
	},
/turf/open/floor/plasteel{
	planetary_atmos = 1
	},
/area/hangar)
"EZ" = (
/obj/structure/railing/corner{
	dir = 1
	},
/turf/open/floor/plasteel/tech/techmaint,
/area/hangar)
"GM" = (
/obj/machinery/door/airlock/maintenance{
	req_access_txt = "101"
	},
/turf/open/floor/plating{
	planetary_atmos = 1
	},
/area/hangar)
"Jt" = (
/obj/structure/catwalk/over/plated_catwalk,
/obj/machinery/atmospherics/pipe/simple/orange/hidden{
	dir = 4
	},
/turf/open/floor/plating{
	planetary_atmos = 1
	},
/area/hangar)
"Ld" = (
/obj/structure/catwalk/over/plated_catwalk,
/obj/machinery/atmospherics/pipe/manifold4w/orange/hidden,
/turf/open/floor/plating{
	planetary_atmos = 1
	},
/area/hangar)
"MY" = (
/obj/machinery/atmospherics/components/unary/hydrogen_pump{
	dir = 4
	},
/obj/effect/turf_decal/industrial/outline/yellow,
/turf/open/floor/plasteel/tech/techmaint,
/area/hangar)
"Td" = (
/obj/machinery/atmospherics/components/binary/volume_pump{
	dir = 4
	},
/obj/effect/turf_decal/industrial/shutoff,
/turf/open/floor/plasteel{
	planetary_atmos = 1
	},
/area/hangar)
"TZ" = (
/obj/structure/railing/corner{
	dir = 4;
	layer = 4.1
	},
/turf/open/floor/plasteel/tech/techmaint,
/area/hangar)
"Ua" = (
/obj/structure/catwalk/over/plated_catwalk,
/obj/machinery/atmospherics/pipe/simple/orange/hidden{
	dir = 5
	},
/turf/open/floor/plating{
	planetary_atmos = 1
	},
/area/hangar)
"Ud" = (
/obj/effect/turf_decal/trimline/opaque/yellow/filled/warning{
	dir = 1
	},
/obj/machinery/atmospherics/components/binary/valve/digital,
/turf/open/floor/plasteel{
	planetary_atmos = 1
	},
/area/hangar)
"UF" = (
/obj/structure/catwalk/over/plated_catwalk,
/obj/machinery/atmospherics/pipe/manifold/orange/hidden,
/turf/open/floor/plating{
	planetary_atmos = 1
	},
/area/hangar)
"WZ" = (
/obj/machinery/atmospherics/pipe/simple/orange/hidden{
	dir = 4
	},
/obj/structure/catwalk/over/plated_catwalk,
/turf/open/floor/plating{
	planetary_atmos = 1
	},
/area/hangar)

(1,1,1) = {"
aZ
aZ
aZ
ag
ag
ag
ag
ag
ag
ag
ad
ag
ag
ag
ad
ag
ag
ag
ad
ag
ag
ag
ad
ag
ag
ag
ad
ag
ag
ag
ag
"}
(2,1,1) = {"
aZ
aZ
aZ
ag
an
an
aJ
aX
aX
aX
aX
aX
aX
aX
aX
aX
aX
aX
aX
aX
aX
aX
aX
aX
aX
aX
aX
aC
an
an
ag
"}
(3,1,1) = {"
aZ
aZ
aZ
ag
an
pt
aJ
ae
ae
ai
ae
ae
ae
ae
ai
ae
ae
ae
ae
ai
ae
ae
ae
ae
ai
ae
ae
aC
pt
an
ag
"}
(4,1,1) = {"
aZ
aZ
aZ
ag
an
pt
aJ
ax
ax
ax
ax
ax
ax
ax
ax
ax
ax
ax
ax
ax
ax
ax
ax
ax
ax
ax
ax
aC
pt
an
ag
"}
(5,1,1) = {"
aZ
aZ
aZ
ag
an
pt
aJ
aN
aN
aN
aN
aN
aN
aN
aN
aN
aN
aN
aN
aN
aN
aN
aN
aN
aN
aN
af
aC
pt
an
ag
"}
(6,1,1) = {"
aZ
aZ
aZ
ag
an
pt
aJ
aN
aN
aN
aN
aN
aN
aN
aN
aN
aN
aN
aN
aN
aN
aN
aN
aN
aN
aN
aN
aC
pt
an
ag
"}
(7,1,1) = {"
aZ
aZ
aZ
ag
an
pt
aJ
al
aN
aN
aN
aN
aN
aN
aN
aN
aN
aN
aN
aN
aN
aN
aN
aN
aN
aN
al
aC
pt
an
ag
"}
(8,1,1) = {"
aZ
aZ
aZ
ag
an
st
qG
aN
aN
aN
aN
aN
aN
aN
aN
aN
aN
aN
aN
aN
aN
aN
aN
aN
aN
aN
aN
Ud
Ua
an
ag
"}
(9,1,1) = {"
aZ
aZ
aZ
ag
an
Jt
aI
aN
aN
aN
aN
aN
aN
aN
aN
aN
aN
aN
aN
aN
aN
aN
aN
aN
aN
aN
aN
aK
Jt
an
ag
"}
(10,1,1) = {"
aZ
aZ
aZ
ag
an
Jt
aJ
aN
aN
aN
aN
aN
aN
aN
aN
aN
aN
aN
aN
aN
aN
aN
aN
aN
aN
aN
aN
aC
Jt
an
ag
"}
(11,1,1) = {"
aZ
aZ
aZ
ag
an
Jt
aJ
aN
aN
aN
aN
aN
aN
aN
aN
aN
aN
aN
aN
aN
aN
aN
aN
aN
aN
aN
aN
aC
Jt
an
ag
"}
(12,1,1) = {"
aZ
aZ
aZ
ag
an
Jt
aJ
al
aN
aN
aN
aN
aN
aN
aN
aN
aN
aN
aN
aN
aN
aN
aN
aN
aN
aN
al
aC
Jt
an
ag
"}
(13,1,1) = {"
aZ
aZ
aZ
ag
an
Jt
aJ
aN
aN
aN
aN
aN
aN
aN
aN
aN
aN
aN
aN
aN
aN
aN
aN
aN
aN
aN
aN
aC
Jt
an
ag
"}
(14,1,1) = {"
aZ
aZ
aZ
ag
an
Jt
aJ
aN
aN
aN
aN
aN
aN
aN
aN
aN
aN
aN
aN
aN
aN
aN
aN
aN
aN
aN
aN
aC
Jt
an
ag
"}
(15,1,1) = {"
aZ
aZ
aZ
ag
an
Jt
aJ
aN
aN
aN
aN
aN
aN
aN
aN
aN
aN
aN
aN
aN
aN
aN
aN
aN
aN
aN
aN
aC
Jt
an
ag
"}
(16,1,1) = {"
aZ
aZ
aZ
ag
an
Jt
aJ
aN
aN
aN
aN
aN
aN
aN
aN
aN
aN
aN
aN
aN
aN
aN
aN
aN
aN
aN
aN
aC
Jt
an
ag
"}
(17,1,1) = {"
aZ
aZ
aZ
ag
an
Jt
aJ
al
aN
aN
aN
aN
aN
aN
aN
aN
aN
aN
aN
aN
aN
aN
aN
aN
aN
aN
al
aC
Jt
an
ag
"}
(18,1,1) = {"
aZ
aZ
aZ
ag
an
Jt
aJ
aN
aN
aN
aN
aN
aN
aN
aN
aN
aN
aN
aN
aN
aN
aN
aN
aN
aN
aN
aN
aC
Jt
an
ag
"}
(19,1,1) = {"
aZ
aZ
aZ
ag
an
Jt
aI
aN
aN
aN
aN
aN
aN
aN
aN
aN
aN
aN
aN
aN
aN
aN
aN
aN
aN
aN
aN
aK
Jt
an
ag
"}
(20,1,1) = {"
aZ
aZ
aZ
ag
an
Jt
aJ
aN
aN
aN
aN
aN
aN
aN
aN
aN
aN
aN
aN
aN
aN
aN
aN
aN
aN
aN
aN
aC
Jt
an
ag
"}
(21,1,1) = {"
aZ
aZ
aZ
ag
an
Jt
aJ
aN
aN
aN
aN
aN
aN
aN
aN
aN
aN
aN
aN
aN
aN
aN
aN
aN
aN
aN
aN
aC
Jt
an
ag
"}
(22,1,1) = {"
aZ
aZ
aZ
ag
an
Jt
aJ
al
aN
aN
aN
aN
aN
aN
aN
aN
aN
aN
aN
aN
aN
aN
aN
aN
aN
aN
al
aC
Jt
an
ag
"}
(23,1,1) = {"
aZ
aZ
aZ
ag
an
Jt
aJ
aN
aN
aN
aN
aN
aN
aN
aN
aN
aN
aN
aN
aN
aN
aN
aN
aN
aN
aN
aN
aC
Jt
an
ag
"}
(24,1,1) = {"
aZ
aZ
aZ
ag
an
Jt
aJ
aN
aN
aN
aN
aN
aN
aN
aN
aN
aN
aN
aN
aN
aN
aN
aN
aN
aN
aN
aN
aC
Jt
an
ag
"}
(25,1,1) = {"
aZ
aZ
aZ
ag
an
Jt
aJ
aN
aN
aN
aN
aN
aN
aN
aN
aN
aN
aN
aN
aN
aN
aN
aN
aN
aN
aN
aN
aC
Jt
an
ag
"}
(26,1,1) = {"
aZ
aZ
aZ
ag
an
Jt
aJ
aN
aN
aN
aN
aN
aN
aN
aN
aN
aN
aN
aN
aN
aN
aN
aN
aN
aN
aN
aN
aC
Jt
an
ag
"}
(27,1,1) = {"
aZ
aZ
aZ
ag
an
aG
qG
al
aN
aN
aN
aN
aN
aN
aN
aN
aN
aN
aN
aN
aN
aN
aN
aN
aN
aN
al
Ud
UF
an
ag
"}
(28,1,1) = {"
aZ
aZ
aZ
ag
an
Jt
aJ
aN
aN
aN
aN
aN
aN
aN
aN
aN
aN
aN
aN
aN
aN
aN
aN
aN
aN
aN
aN
aC
Jt
an
ag
"}
(29,1,1) = {"
aZ
aZ
aZ
ag
an
Jt
aI
aN
aN
aN
aN
aN
aN
aN
aN
aN
aN
aN
aN
aN
aN
aN
aN
aN
aN
aN
aN
aK
Jt
an
ag
"}
(30,1,1) = {"
aZ
aZ
aZ
ag
an
Jt
aJ
aN
aN
aN
aN
aN
aN
aN
aN
aN
aN
aN
aN
aN
aN
aN
aN
aN
aN
aN
aN
aC
Jt
an
ag
"}
(31,1,1) = {"
aZ
aZ
aZ
ag
an
Jt
aJ
aN
aN
aN
aN
aN
aN
aN
aN
aN
aN
aN
aN
aN
aN
aN
aN
aN
aN
aN
aN
aC
Jt
an
ag
"}
(32,1,1) = {"
aZ
aZ
aZ
ag
an
Jt
aJ
al
aN
aN
aN
aN
aN
aN
aN
aN
aN
aN
aN
aN
aN
aN
aN
aN
aN
aN
al
aC
Jt
an
ag
"}
(33,1,1) = {"
aZ
aZ
aZ
ag
an
Jt
aJ
aN
aN
aN
aN
aN
aN
aN
aN
aN
aN
aN
aN
aN
aN
aN
aN
aN
aN
aN
aN
aC
Jt
an
ag
"}
(34,1,1) = {"
aZ
aZ
aZ
ag
an
Jt
aJ
aN
aN
aN
aN
aN
aN
aN
aN
aN
aN
aN
aN
aN
aN
aN
aN
aN
aN
aN
aN
aC
Jt
an
ag
"}
(35,1,1) = {"
aZ
aZ
aZ
ag
an
Jt
aJ
aN
aN
aN
aN
aN
aN
aN
aN
aN
aN
aN
aN
aN
aN
aN
aN
aN
aN
aN
aN
aC
Jt
an
ag
"}
(36,1,1) = {"
aZ
aZ
aZ
ag
an
Jt
aJ
aN
aN
aN
aN
aN
aN
aN
aN
aN
aN
aN
aN
aN
aN
aN
aN
aN
aN
aN
aN
aC
Jt
an
ag
"}
(37,1,1) = {"
aZ
aZ
aZ
ag
an
Jt
aJ
al
aN
aN
aN
aN
aN
aN
aN
aN
aN
aN
aN
aN
aN
aN
aN
aN
aN
aN
al
aC
Jt
an
ag
"}
(38,1,1) = {"
aZ
aZ
aZ
ag
an
Jt
aJ
aN
aN
aN
aN
aN
aN
aN
aN
aN
aN
aN
aN
aN
aN
aN
aN
aN
aN
aN
aN
aC
Jt
an
ag
"}
(39,1,1) = {"
aZ
aZ
aZ
ag
an
Jt
aI
aN
aN
aN
aN
aN
aN
aN
aN
aN
aN
aN
aN
aN
aN
aN
aN
aN
aN
aN
aN
aK
Jt
an
ag
"}
(40,1,1) = {"
aZ
aZ
aZ
ag
an
Jt
aJ
aN
aN
aN
aN
aN
aN
aN
aN
aN
aN
aN
aN
aN
aN
aN
aN
aN
aN
aN
aN
aC
Jt
an
ag
"}
(41,1,1) = {"
aZ
aZ
aZ
ag
an
aG
qG
aN
aN
aN
aN
aN
aN
aN
aN
aN
aN
aN
aN
aN
aN
aN
aN
aN
aN
aN
aN
Ud
UF
an
ag
"}
(42,1,1) = {"
aZ
aZ
aZ
ag
an
Jt
aJ
al
aN
aN
aN
aN
aN
aN
aN
aN
aN
aN
aN
aN
aN
aN
aN
aN
aN
aN
al
aC
Jt
an
ag
"}
(43,1,1) = {"
aZ
aZ
aZ
ag
an
Jt
aJ
aN
aN
aN
aN
aN
aN
aN
aN
aN
aN
aN
aN
aN
aN
aN
aN
aN
aN
aN
aN
aC
Jt
an
ag
"}
(44,1,1) = {"
aZ
aZ
aZ
ag
an
Jt
aJ
aN
aN
aN
aN
aN
aN
aN
aN
aN
aN
aN
aN
aN
aN
aN
aN
aN
aN
aN
aN
aC
Jt
an
ag
"}
(45,1,1) = {"
aZ
aZ
aZ
ag
an
Jt
aJ
aN
aN
aN
aN
aN
aN
aN
aN
aN
aN
aN
aN
aN
aN
aN
aN
aN
aN
aN
aN
aC
Jt
an
ag
"}
(46,1,1) = {"
aZ
aZ
aZ
ag
an
Jt
aJ
aN
aN
aN
aN
aN
aN
aN
aN
aN
aN
aN
aN
aN
aN
aN
aN
aN
aN
aN
aN
aC
Jt
an
ag
"}
(47,1,1) = {"
aZ
aZ
aZ
ag
an
Jt
aJ
al
aN
aN
aN
aN
aN
aN
aN
aN
aN
aN
aN
aN
aN
aN
aN
aN
aN
aN
al
aC
Jt
an
ag
"}
(48,1,1) = {"
aZ
aZ
aZ
ag
an
Jt
aJ
aN
aN
aN
aN
aN
aN
aN
aN
aN
aN
aN
aN
aN
aN
aN
aN
aN
aN
aN
aN
aC
Jt
an
ag
"}
(49,1,1) = {"
aZ
aZ
aZ
ag
an
Jt
aI
aN
aN
aN
aN
aN
aN
aN
aN
aN
aN
aN
aN
aN
aN
aN
aN
aN
aN
aN
aN
aK
Jt
an
ag
"}
(50,1,1) = {"
aZ
aZ
aZ
ag
an
Jt
aJ
aN
aN
aN
aN
aN
aN
aN
aN
aN
aN
aN
aN
aN
aN
aN
aN
aN
aN
aN
aN
aC
Jt
an
ag
"}
(51,1,1) = {"
aZ
aZ
aZ
ag
an
Jt
aJ
aN
aN
aN
aN
aN
aN
aN
aN
aN
aN
aN
aN
aN
aN
aN
aN
aN
aN
aN
aN
aC
Jt
an
ag
"}
(52,1,1) = {"
aZ
aZ
aZ
ag
an
Jt
aJ
al
aN
aN
aN
aN
aN
aN
aN
aN
aN
aN
aN
aN
aN
aN
aN
aN
aN
aN
al
aC
Jt
an
ag
"}
(53,1,1) = {"
aZ
aZ
aZ
ag
an
Jt
aJ
aN
aN
aN
aN
aN
aN
aN
aN
aN
aN
aN
aN
aN
aN
aN
aN
aN
aN
aN
aN
aC
Jt
an
ag
"}
(54,1,1) = {"
aZ
aZ
ag
ag
rb
Jt
aJ
aN
aN
aN
aN
aN
aN
aN
aN
aN
aN
aN
aN
aN
aN
aN
aN
aN
aN
aN
aN
aC
Jt
an
ag
"}
(55,1,1) = {"
ag
ag
ag
MY
ay
Jt
aJ
aN
aN
aN
aN
aN
aN
aN
aN
aN
aN
aN
aN
aN
aN
aN
aN
aN
aN
aN
aN
aC
Jt
an
ag
"}
(56,1,1) = {"
ag
GM
mV
Td
EZ
Jt
aJ
aN
aN
aN
aN
aN
aN
aN
aN
aN
aN
aN
aN
aN
aN
aN
aN
aN
aN
aN
aN
aC
Jt
an
ag
"}
(57,1,1) = {"
ag
ag
xG
aG
aD
Ld
qG
al
aN
aN
aN
aN
aN
aN
aN
aN
aN
aN
aN
aN
aN
aN
aN
aN
aN
aN
al
Ud
UF
an
ag
"}
(58,1,1) = {"
aZ
ag
wb
DF
TZ
Jt
aJ
aN
aN
aN
aN
aN
aN
aN
aN
aN
aN
aN
aN
aN
aN
aN
aN
aN
aN
aN
aN
aC
Jt
an
ag
"}
(59,1,1) = {"
aZ
ag
ag
vM
ay
WZ
aI
aN
aN
aN
aN
aN
aN
aN
aN
aN
aN
aN
aN
aN
aN
aN
aN
aN
aN
aN
aN
aK
Jt
an
ag
"}
(60,1,1) = {"
ag
ag
ag
ag
ag
as
aJ
aN
aN
aN
aN
aN
aN
aN
aN
aN
aN
aN
aN
aN
aN
aN
aN
aN
aN
aN
aN
aC
Jt
an
ag
"}
(61,1,1) = {"
ag
mX
mX
jJ
aj
ah
ap
aE
aE
aE
aE
aE
aE
aE
aE
aE
aE
aE
aE
aE
aE
aE
aE
aE
aE
aE
aE
am
Jt
an
ag
"}
(62,1,1) = {"
ag
mX
mX
mX
aj
aB
aD
aD
aD
aD
aD
aD
aD
aD
aD
aD
aD
aD
aD
aD
aD
aD
aD
aD
aD
aD
aD
aD
lA
an
ag
"}
(63,1,1) = {"
ag
mX
mX
mX
aj
mV
an
an
aP
an
an
an
an
an
an
an
an
an
an
an
an
an
an
an
an
aP
an
an
an
an
ag
"}
(64,1,1) = {"
ag
ag
ag
ag
ag
ag
ag
ag
ag
ag
ag
ag
ag
ag
ag
ag
ag
ag
ag
ag
ag
ag
ag
ag
ag
ag
ag
ag
ag
ag
ag
"}
