//MAP CONVERTED BY dmm2tgm.py THIS HEADER COMMENT PREVENTS RECONVERSION, DO NOT REMOVE
"ab" = (
/turf/closed/indestructible/reinforced,
/area/hangar)
"ae" = (
/obj/effect/turf_decal/trimline/opaque/yellow/filled/corner{
	dir = 1
	},
/turf/open/floor/plasteel{
	planetary_atmos = 1
	},
/area/hangar)
"af" = (
/obj/effect/landmark/outpost/hangar_numbers,
/turf/open/floor/plasteel{
	planetary_atmos = 1
	},
/area/hangar)
"ai" = (
/obj/effect/turf_decal/trimline/opaque/yellow/filled/warning,
/obj/machinery/light/floor/hangar,
/turf/open/floor/plasteel{
	planetary_atmos = 1
	},
/area/hangar)
"aj" = (
/turf/open/floor/plasteel{
	planetary_atmos = 1
	},
/area/hangar)
"al" = (
/obj/effect/turf_decal/trimline/opaque/yellow/filled/warning{
	dir = 1
	},
/turf/open/floor/plasteel{
	planetary_atmos = 1
	},
/area/hangar)
"am" = (
/obj/effect/turf_decal/trimline/opaque/yellow/warning{
	dir = 4
	},
/turf/open/floor/plasteel/tech{
	planetary_atmos = 1
	},
/area/hangar)
"ap" = (
/obj/effect/landmark/outpost/hangar_dock,
/turf/open/floor/plating{
	planetary_atmos = 1
	},
/area/hangar)
"as" = (
/obj/effect/turf_decal/arrows{
	dir = 1
	},
/turf/open/floor/plasteel{
	planetary_atmos = 1
	},
/area/hangar)
"av" = (
/obj/machinery/atmospherics/components/unary/passive_vent{
	dir = 1
	},
/turf/open/floor/plasteel{
	planetary_atmos = 1
	},
/area/hangar)
"aw" = (
/obj/effect/turf_decal/arrows{
	dir = 1
	},
/turf/open/floor/plasteel/tech{
	planetary_atmos = 1
	},
/area/hangar)
"aA" = (
/obj/machinery/light/floor/hangar,
/turf/open/floor/plasteel{
	planetary_atmos = 1
	},
/area/hangar)
"aD" = (
/turf/open/floor/plating{
	planetary_atmos = 1
	},
/area/hangar)
"aF" = (
/obj/machinery/door/airlock,
/obj/effect/landmark/outpost/elevator_machine,
/obj/structure/lattice/catwalk,
/turf/open/floor/engine,
/area/hangar)
"aG" = (
/obj/structure/marker_beacon{
	picked_color = "Teal"
	},
/turf/open/floor/plating{
	planetary_atmos = 1
	},
/area/hangar)
"aH" = (
/turf/open/floor/plasteel/tech{
	planetary_atmos = 1
	},
/area/hangar)
"aL" = (
/obj/effect/turf_decal/trimline/opaque/yellow/filled/warning,
/turf/open/floor/plasteel{
	planetary_atmos = 1
	},
/area/hangar)
"aM" = (
/obj/effect/turf_decal/trimline/opaque/yellow/filled/corner{
	dir = 8
	},
/turf/open/floor/plasteel{
	planetary_atmos = 1
	},
/area/hangar)
"aO" = (
/obj/effect/turf_decal/trimline/opaque/yellow/warning{
	dir = 8
	},
/turf/open/floor/plasteel/tech{
	planetary_atmos = 1
	},
/area/hangar)
"aP" = (
/turf/template_noop,
/area/template_noop)
"aR" = (
/obj/machinery/elevator_call_button{
	pixel_y = 25
	},
/obj/effect/landmark/outpost/elevator_machine,
/turf/open/floor/plasteel{
	planetary_atmos = 1
	},
/area/hangar)
"aT" = (
/obj/machinery/door/poddoor/multi_tile/four_tile_ver,
/turf/closed/indestructible/reinforced,
/area/hangar)
"aU" = (
/obj/effect/turf_decal/trimline/opaque/yellow/filled/warning{
	dir = 8
	},
/turf/open/floor/plasteel{
	planetary_atmos = 1
	},
/area/hangar)
"aX" = (
/obj/effect/turf_decal/arrows{
	dir = 4
	},
/turf/open/floor/plasteel{
	planetary_atmos = 1
	},
/area/hangar)
"aY" = (
/obj/effect/turf_decal/trimline/opaque/yellow/filled/warning{
	dir = 1
	},
/obj/machinery/light/floor/hangar,
/turf/open/floor/plasteel{
	planetary_atmos = 1
	},
/area/hangar)
"JT" = (
/turf/open/floor/plasteel/elevatorshaft{
	planetary_atmos = 1
	},
/area/hangar)
"OP" = (
/obj/effect/landmark/outpost/elevator,
/turf/open/floor/plasteel/elevatorshaft{
	planetary_atmos = 1
	},
/area/hangar)
"TX" = (
/obj/machinery/atmospherics/pipe/simple/general,
/turf/closed/indestructible/reinforced,
/area/hangar)

(1,1,1) = {"
aP
aP
aP
ab
ab
ab
ab
ab
ab
ab
aT
ab
ab
ab
aT
ab
ab
ab
aT
ab
ab
ab
aT
ab
ab
ab
aT
ab
ab
ab
ab
"}
(2,1,1) = {"
aP
aP
aP
ab
aj
aj
aL
aO
aO
aO
aO
aO
aO
aO
aO
aO
aO
aO
aO
aO
aO
aO
aO
aO
aO
aO
aO
al
aj
aj
ab
"}
(3,1,1) = {"
aP
aP
aP
ab
aj
aj
aL
aH
aH
aw
aH
aH
aH
aH
aw
aH
aH
aH
aH
aw
aH
aH
aH
aH
aw
aH
aH
al
aj
aj
ab
"}
(4,1,1) = {"
aP
aP
aP
ab
aj
aj
aL
am
am
am
am
am
am
am
am
am
am
am
am
am
am
am
am
am
am
am
am
al
aj
aj
ab
"}
(5,1,1) = {"
aP
aP
aP
ab
aj
aj
aL
aD
aD
aD
aD
aD
aD
aD
aD
aD
aD
aD
aD
aD
aD
aD
aD
aD
aD
aD
ap
al
aj
aj
ab
"}
(6,1,1) = {"
aP
aP
aP
ab
aj
aj
aL
aD
aD
aD
aD
aD
aD
aD
aD
aD
aD
aD
aD
aD
aD
aD
aD
aD
aD
aD
aD
al
aj
aj
ab
"}
(7,1,1) = {"
aP
aP
aP
ab
aj
aX
aL
aG
aD
aD
aD
aD
aD
aD
aD
aD
aD
aD
aD
aD
aD
aD
aD
aD
aD
aD
aG
al
aX
aj
ab
"}
(8,1,1) = {"
aP
aP
aP
ab
aj
aj
aL
aD
aD
aD
aD
aD
aD
aD
aD
aD
aD
aD
aD
aD
aD
aD
aD
aD
aD
aD
aD
al
aj
aj
ab
"}
(9,1,1) = {"
aP
aP
aP
ab
aj
aj
ai
aD
aD
aD
aD
aD
aD
aD
aD
aD
aD
aD
aD
aD
aD
aD
aD
aD
aD
aD
aD
aY
aj
aj
ab
"}
(10,1,1) = {"
aP
aP
aP
ab
aj
aj
aL
aD
aD
aD
aD
aD
aD
aD
aD
aD
aD
aD
aD
aD
aD
aD
aD
aD
aD
aD
aD
al
aj
aj
ab
"}
(11,1,1) = {"
aP
aP
aP
ab
aj
aj
aL
aD
aD
aD
aD
aD
aD
aD
aD
aD
aD
aD
aD
aD
aD
aD
aD
aD
aD
aD
aD
al
aj
aj
ab
"}
(12,1,1) = {"
aP
aP
aP
ab
aj
aX
aL
aG
aD
aD
aD
aD
aD
aD
aD
aD
aD
aD
aD
aD
aD
aD
aD
aD
aD
aD
aG
al
aX
aj
ab
"}
(13,1,1) = {"
aP
aP
aP
ab
aj
aj
aL
aD
aD
aD
aD
aD
aD
aD
aD
aD
aD
aD
aD
aD
aD
aD
aD
aD
aD
aD
aD
al
aj
aj
ab
"}
(14,1,1) = {"
aP
aP
aP
ab
aj
aj
aL
aD
aD
aD
aD
aD
aD
aD
aD
aD
aD
aD
aD
aD
aD
aD
aD
aD
aD
aD
aD
al
aj
aj
ab
"}
(15,1,1) = {"
aP
aP
aP
ab
aj
aj
aL
aD
aD
aD
aD
aD
aD
aD
aD
aD
aD
aD
aD
aD
aD
aD
aD
aD
aD
aD
aD
al
aj
aj
ab
"}
(16,1,1) = {"
aP
aP
aP
ab
aj
aj
aL
aD
aD
aD
aD
aD
aD
aD
aD
aD
aD
aD
aD
aD
aD
aD
aD
aD
aD
aD
aD
al
aj
aj
ab
"}
(17,1,1) = {"
aP
aP
aP
ab
aj
aX
aL
aG
aD
aD
aD
aD
aD
aD
aD
aD
aD
aD
aD
aD
aD
aD
aD
aD
aD
aD
aG
al
aX
aj
ab
"}
(18,1,1) = {"
aP
aP
aP
ab
aj
aj
aL
aD
aD
aD
aD
aD
aD
aD
aD
aD
aD
aD
aD
aD
aD
aD
aD
aD
aD
aD
aD
al
aj
aj
ab
"}
(19,1,1) = {"
aP
aP
aP
ab
aj
aj
ai
aD
aD
aD
aD
aD
aD
aD
aD
aD
aD
aD
aD
aD
aD
aD
aD
aD
aD
aD
aD
aY
aj
aj
ab
"}
(20,1,1) = {"
aP
aP
aP
ab
aj
aj
aL
aD
aD
aD
aD
aD
aD
aD
aD
aD
aD
aD
aD
aD
aD
aD
aD
aD
aD
aD
aD
al
aj
aj
ab
"}
(21,1,1) = {"
aP
aP
aP
ab
aj
aj
aL
aD
aD
aD
aD
aD
aD
aD
aD
aD
aD
aD
aD
aD
aD
aD
aD
aD
aD
aD
aD
al
aj
aj
ab
"}
(22,1,1) = {"
aP
aP
aP
ab
aj
aX
aL
aG
aD
aD
aD
aD
aD
aD
aD
aD
aD
aD
aD
aD
aD
aD
aD
aD
aD
aD
aG
al
aX
aj
ab
"}
(23,1,1) = {"
aP
aP
aP
ab
aj
aj
aL
aD
aD
aD
aD
aD
aD
aD
aD
aD
aD
aD
aD
aD
aD
aD
aD
aD
aD
aD
aD
al
aj
aj
ab
"}
(24,1,1) = {"
aP
aP
aP
ab
aj
aj
aL
aD
aD
aD
aD
aD
aD
aD
aD
aD
aD
aD
aD
aD
aD
aD
aD
aD
aD
aD
aD
al
aj
aj
ab
"}
(25,1,1) = {"
aP
aP
aP
ab
aj
aj
aL
aD
aD
aD
aD
aD
aD
aD
aD
aD
aD
aD
aD
aD
aD
aD
aD
aD
aD
aD
aD
al
aj
aj
ab
"}
(26,1,1) = {"
aP
aP
aP
ab
aj
aj
aL
aD
aD
aD
aD
aD
aD
aD
aD
aD
aD
aD
aD
aD
aD
aD
aD
aD
aD
aD
aD
al
aj
aj
ab
"}
(27,1,1) = {"
aP
aP
aP
ab
aj
aX
aL
aG
aD
aD
aD
aD
aD
aD
aD
aD
aD
aD
aD
aD
aD
aD
aD
aD
aD
aD
aG
al
aX
aj
ab
"}
(28,1,1) = {"
aP
aP
aP
ab
aj
aj
aL
aD
aD
aD
aD
aD
aD
aD
aD
aD
aD
aD
aD
aD
aD
aD
aD
aD
aD
aD
aD
al
aj
aj
ab
"}
(29,1,1) = {"
aP
aP
aP
ab
aj
aj
ai
aD
aD
aD
aD
aD
aD
aD
aD
aD
aD
aD
aD
aD
aD
aD
aD
aD
aD
aD
aD
aY
aj
aj
ab
"}
(30,1,1) = {"
aP
aP
aP
ab
aj
aj
aL
aD
aD
aD
aD
aD
aD
aD
aD
aD
aD
aD
aD
aD
aD
aD
aD
aD
aD
aD
aD
al
aj
aj
ab
"}
(31,1,1) = {"
aP
aP
aP
ab
aj
aj
aL
aD
aD
aD
aD
aD
aD
aD
aD
aD
aD
aD
aD
aD
aD
aD
aD
aD
aD
aD
aD
al
aj
aj
ab
"}
(32,1,1) = {"
aP
aP
aP
ab
aj
aX
aL
aG
aD
aD
aD
aD
aD
aD
aD
aD
aD
aD
aD
aD
aD
aD
aD
aD
aD
aD
aG
al
aX
aj
ab
"}
(33,1,1) = {"
aP
aP
aP
ab
aj
aj
aL
aD
aD
aD
aD
aD
aD
aD
aD
aD
aD
aD
aD
aD
aD
aD
aD
aD
aD
aD
aD
al
aj
aj
ab
"}
(34,1,1) = {"
aP
aP
aP
ab
aj
aj
aL
aD
aD
aD
aD
aD
aD
aD
aD
aD
aD
aD
aD
aD
aD
aD
aD
aD
aD
aD
aD
al
aj
aj
ab
"}
(35,1,1) = {"
aP
aP
aP
ab
aj
aj
aL
aD
aD
aD
aD
aD
aD
aD
aD
aD
aD
aD
aD
aD
aD
aD
aD
aD
aD
aD
aD
al
aj
aj
ab
"}
(36,1,1) = {"
aP
aP
aP
ab
aj
aj
aL
aD
aD
aD
aD
aD
aD
aD
aD
aD
aD
aD
aD
aD
aD
aD
aD
aD
aD
aD
aD
al
aj
aj
ab
"}
(37,1,1) = {"
aP
aP
aP
ab
aj
aX
aL
aG
aD
aD
aD
aD
aD
aD
aD
aD
aD
aD
aD
aD
aD
aD
aD
aD
aD
aD
aG
al
aX
aj
ab
"}
(38,1,1) = {"
aP
aP
aP
ab
aj
aj
aL
aD
aD
aD
aD
aD
aD
aD
aD
aD
aD
aD
aD
aD
aD
aD
aD
aD
aD
aD
aD
al
aj
aj
ab
"}
(39,1,1) = {"
aP
aP
aP
ab
aj
aj
ai
aD
aD
aD
aD
aD
aD
aD
aD
aD
aD
aD
aD
aD
aD
aD
aD
aD
aD
aD
aD
aY
aj
aj
ab
"}
(40,1,1) = {"
aP
aP
aP
ab
aj
aj
aL
aD
aD
aD
aD
aD
aD
aD
aD
aD
aD
aD
aD
aD
aD
aD
aD
aD
aD
aD
aD
al
aj
aj
ab
"}
(41,1,1) = {"
aP
aP
aP
ab
aj
aj
aL
aD
aD
aD
aD
aD
aD
aD
aD
aD
aD
aD
aD
aD
aD
aD
aD
aD
aD
aD
aD
al
aj
aj
ab
"}
(42,1,1) = {"
aP
aP
aP
ab
aj
aX
aL
aG
aD
aD
aD
aD
aD
aD
aD
aD
aD
aD
aD
aD
aD
aD
aD
aD
aD
aD
aG
al
aX
aj
ab
"}
(43,1,1) = {"
aP
aP
aP
TX
av
aj
aL
aD
aD
aD
aD
aD
aD
aD
aD
aD
aD
aD
aD
aD
aD
aD
aD
aD
aD
aD
aD
al
aj
aj
ab
"}
(44,1,1) = {"
ab
ab
ab
ab
ab
aR
aL
aD
aD
aD
aD
aD
aD
aD
aD
aD
aD
aD
aD
aD
aD
aD
aD
aD
aD
aD
aD
al
aj
aj
ab
"}
(45,1,1) = {"
ab
JT
JT
OP
aF
aj
aM
aU
aU
aU
aU
aU
aU
aU
aU
aU
aU
aU
aU
aU
aU
aU
aU
aU
aU
aU
aU
ae
aj
aj
ab
"}
(46,1,1) = {"
ab
JT
JT
JT
aF
af
aj
aj
aj
as
aj
aj
aj
aj
as
aj
aj
aj
aj
as
aj
aj
aj
aj
as
aj
aj
aj
aj
aj
ab
"}
(47,1,1) = {"
ab
JT
JT
JT
aF
aj
aj
aj
aA
aj
aj
aj
aj
aj
aj
aj
aj
aj
aj
aj
aj
aj
aj
aj
aj
aA
aj
aj
aj
aj
ab
"}
(48,1,1) = {"
ab
ab
ab
ab
ab
ab
ab
ab
ab
ab
ab
ab
ab
ab
ab
ab
ab
ab
ab
ab
ab
ab
ab
ab
ab
ab
ab
ab
ab
ab
ab
"}
