//MAP CONVERTED BY dmm2tgm.py THIS HEADER COMMENT PREVENTS RECONVERSION, DO NOT REMOVE
"ac" = (
/obj/machinery/atmospherics/pipe/simple/orange/hidden{
	dir = 10
	},
/turf/open/floor/plasteel/tech/techmaint,
/area/hangar)
"al" = (
/obj/structure/catwalk/over/plated_catwalk,
/turf/open/floor/plating{
	planetary_atmos = 1
	},
/area/hangar)
"ar" = (
/obj/effect/turf_decal/corner/transparent/bottlegreen/three_quarters,
/turf/open/floor/plasteel{
	planetary_atmos = 1
	},
/area/hangar)
"av" = (
/obj/structure/catwalk/over/plated_catwalk,
/obj/machinery/atmospherics/pipe/manifold4w/orange/hidden,
/turf/open/floor/plating{
	planetary_atmos = 1
	},
/area/hangar)
"bv" = (
/obj/machinery/light/floor/hangar,
/obj/effect/turf_decal/corner/transparent/bottlegreen{
	dir = 5
	},
/turf/open/floor/plasteel{
	planetary_atmos = 1
	},
/area/hangar)
"cI" = (
/obj/structure/catwalk/over/plated_catwalk,
/obj/machinery/atmospherics/pipe/simple/orange/hidden{
	dir = 6
	},
/turf/open/floor/plating{
	planetary_atmos = 1
	},
/area/hangar)
"dp" = (
/obj/structure/catwalk/over/plated_catwalk,
/obj/machinery/atmospherics/pipe/simple/orange/hidden{
	dir = 8
	},
/turf/open/floor/plating{
	planetary_atmos = 1
	},
/area/hangar)
"dM" = (
/obj/structure/platform/industrial_alt/corner{
	dir = 1
	},
/turf/open/water/beach/deep,
/area/hangar)
"ec" = (
/obj/effect/turf_decal/corner/transparent/bottlegreen/three_quarters{
	dir = 4
	},
/turf/open/floor/plasteel{
	planetary_atmos = 1
	},
/area/hangar)
"eM" = (
/obj/effect/turf_decal/corner/transparent/bottlegreen{
	dir = 1
	},
/turf/open/floor/plasteel{
	planetary_atmos = 1
	},
/area/hangar)
"fC" = (
/obj/structure/platform/industrial,
/obj/structure/platform/industrial{
	dir = 1
	},
/obj/effect/decal/fakelattice,
/turf/open/floor/plasteel/elevatorshaft,
/area/hangar)
"fQ" = (
/obj/effect/turf_decal/techfloor{
	dir = 4
	},
/turf/open/floor/plasteel/tech{
	planetary_atmos = 1
	},
/area/hangar)
"ho" = (
/obj/structure/catwalk/over/plated_catwalk/dark,
/turf/open/floor/plating{
	planetary_atmos = 1
	},
/area/hangar)
"jB" = (
/obj/effect/landmark/outpost/hangar_dock,
/turf/open/floor/plating{
	planetary_atmos = 1
	},
/area/hangar)
"jC" = (
/turf/open/floor/plating{
	planetary_atmos = 1
	},
/area/hangar)
"jQ" = (
/obj/machinery/atmospherics/components/binary/valve/digital,
/obj/effect/turf_decal/corner/transparent/bottlegreen{
	dir = 10
	},
/turf/open/floor/plasteel{
	planetary_atmos = 1
	},
/area/hangar)
"kx" = (
/obj/machinery/light/floor/hangar,
/obj/effect/turf_decal/corner/transparent/bottlegreen{
	dir = 6
	},
/turf/open/floor/plasteel{
	planetary_atmos = 1
	},
/area/hangar)
"kC" = (
/turf/open/floor/plating/rust,
/area/hangar)
"lR" = (
/obj/structure/catwalk/over/plated_catwalk,
/obj/machinery/atmospherics/pipe/manifold/orange/hidden{
	dir = 1
	},
/turf/open/floor/plating{
	planetary_atmos = 1
	},
/area/hangar)
"mg" = (
/obj/structure/catwalk/over/plated_catwalk,
/obj/machinery/atmospherics/pipe/simple/orange/hidden{
	dir = 5
	},
/turf/open/floor/plating{
	planetary_atmos = 1
	},
/area/hangar)
"mv" = (
/obj/structure/marker_beacon{
	picked_color = "Teal"
	},
/turf/open/floor/plating/rust,
/area/hangar)
"mB" = (
/obj/structure/railing/corner{
	dir = 1;
	layer = 4.1
	},
/obj/effect/turf_decal/corner/transparent/bottlegreen{
	dir = 5
	},
/turf/open/floor/plasteel/tech/techmaint,
/area/hangar)
"mJ" = (
/obj/effect/turf_decal/corner/transparent/bottlegreen{
	dir = 8
	},
/turf/open/floor/plasteel{
	planetary_atmos = 1
	},
/area/hangar)
"mN" = (
/obj/effect/turf_decal/techfloor{
	dir = 1
	},
/obj/structure/platform/ship,
/turf/open/floor/plasteel/tech,
/area/hangar)
"mS" = (
/turf/open/water/beach/deep,
/area/hangar)
"pi" = (
/turf/open/floor/plasteel/tech/techmaint,
/area/hangar)
"qh" = (
/obj/effect/turf_decal/corner/transparent/bottlegreen{
	dir = 6
	},
/turf/open/floor/plasteel{
	planetary_atmos = 1
	},
/area/hangar)
"qk" = (
/obj/effect/turf_decal/techfloor{
	dir = 1
	},
/obj/structure/platform/ship,
/obj/machinery/elevator_call_button{
	pixel_x = -23
	},
/obj/effect/landmark/outpost/elevator_machine,
/turf/open/floor/plasteel/tech,
/area/hangar)
"qG" = (
/obj/effect/decal/fakelattice,
/turf/open/floor/plating/rust,
/area/hangar)
"qW" = (
/obj/structure/platform/industrial_alt{
	dir = 4
	},
/obj/structure/platform/industrial_alt/corner,
/turf/open/water/beach/deep,
/area/hangar)
"rT" = (
/obj/structure/marker_beacon{
	picked_color = "Teal"
	},
/turf/open/floor/plating{
	planetary_atmos = 1
	},
/area/hangar)
"ur" = (
/obj/structure/railing/corner{
	dir = 4
	},
/obj/effect/turf_decal/corner/transparent/bottlegreen{
	dir = 5
	},
/turf/open/floor/plasteel/tech/techmaint,
/area/hangar)
"vw" = (
/obj/effect/landmark/outpost/elevator,
/turf/open/floor/plasteel/elevatorshaft{
	planetary_atmos = 1
	},
/area/hangar)
"vx" = (
/obj/structure/platform/industrial_alt{
	dir = 8
	},
/obj/structure/platform/industrial_alt,
/obj/structure/platform/industrial_alt/corner{
	dir = 6
	},
/turf/open/water/beach/deep,
/area/hangar)
"wk" = (
/obj/effect/turf_decal/techfloor{
	dir = 8
	},
/turf/open/floor/plasteel/tech{
	planetary_atmos = 1
	},
/area/hangar)
"xd" = (
/obj/machinery/atmospherics/components/binary/valve/digital,
/obj/effect/turf_decal/corner/transparent/bottlegreen{
	dir = 5
	},
/turf/open/floor/plasteel{
	planetary_atmos = 1
	},
/area/hangar)
"yh" = (
/turf/closed/indestructible/reinforced,
/area/hangar)
"yA" = (
/obj/machinery/atmospherics/pipe/simple/orange/hidden{
	dir = 4
	},
/turf/open/floor/plasteel/tech/techmaint,
/area/hangar)
"yH" = (
/obj/structure/railing{
	dir = 1
	},
/obj/effect/turf_decal/corner/transparent/bottlegreen{
	dir = 5
	},
/turf/open/floor/plasteel/tech/techmaint,
/area/hangar)
"zh" = (
/obj/effect/turf_decal/corner/transparent/bottlegreen{
	dir = 10
	},
/turf/open/floor/plasteel{
	planetary_atmos = 1
	},
/area/hangar)
"zo" = (
/obj/effect/landmark/outpost/elevator_machine,
/obj/structure/lattice/catwalk,
/obj/machinery/door/airlock/hatch,
/turf/open/floor/engine,
/area/hangar)
"zq" = (
/obj/structure/platform/industrial_alt,
/obj/structure/platform/industrial_alt{
	dir = 4
	},
/obj/structure/platform/industrial_alt/corner{
	dir = 10
	},
/turf/open/water/beach/deep,
/area/hangar)
"zx" = (
/obj/structure/platform/industrial_alt{
	dir = 4
	},
/turf/open/water/beach/deep,
/area/hangar)
"zS" = (
/obj/effect/turf_decal/industrial/shutoff,
/obj/machinery/atmospherics/components/binary/volume_pump{
	dir = 4
	},
/turf/open/floor/plasteel{
	planetary_atmos = 1
	},
/area/hangar)
"AL" = (
/turf/closed/indestructible/fakeglass,
/area/hangar)
"CD" = (
/obj/structure/platform/industrial,
/obj/structure/platform/industrial{
	dir = 1
	},
/turf/open/floor/plasteel/elevatorshaft,
/area/hangar)
"CG" = (
/turf/open/floor/plasteel{
	planetary_atmos = 1
	},
/area/hangar)
"Dp" = (
/obj/machinery/atmospherics/components/unary/portables_connector{
	dir = 8
	},
/obj/effect/turf_decal/industrial/outline/yellow,
/turf/open/floor/plasteel/tech/techmaint,
/area/hangar)
"EF" = (
/obj/structure/catwalk/over/plated_catwalk,
/obj/machinery/atmospherics/pipe/simple/orange/hidden{
	dir = 4
	},
/turf/open/floor/plating{
	planetary_atmos = 1
	},
/area/hangar)
"EP" = (
/obj/machinery/computer/hydrogen_exchange,
/turf/open/floor/plasteel/tech/techmaint,
/area/hangar)
"EW" = (
/obj/effect/turf_decal/corner/transparent/bottlegreen{
	dir = 5
	},
/turf/open/floor/plasteel{
	planetary_atmos = 1
	},
/area/hangar)
"Fj" = (
/obj/structure/platform/industrial_alt,
/turf/open/water/beach/deep,
/area/hangar)
"Gq" = (
/turf/closed/indestructible/rock,
/area/hangar)
"Hd" = (
/obj/effect/turf_decal/corner/transparent/bottlegreen/three_quarters{
	dir = 1
	},
/turf/open/floor/plasteel{
	planetary_atmos = 1
	},
/area/hangar)
"HC" = (
/obj/effect/decal/fakelattice,
/turf/open/floor/plating,
/area/hangar)
"Iu" = (
/obj/machinery/atmospherics/pipe/simple/orange/hidden{
	dir = 4
	},
/obj/structure/catwalk/over/plated_catwalk,
/turf/open/floor/plating{
	planetary_atmos = 1
	},
/area/hangar)
"IP" = (
/obj/structure/platform/industrial_alt{
	dir = 1
	},
/turf/open/water/beach/deep,
/area/hangar)
"Kw" = (
/turf/open/floor/plasteel/elevatorshaft{
	planetary_atmos = 1
	},
/area/hangar)
"KP" = (
/obj/effect/landmark/outpost/hangar_numbers,
/turf/open/floor/plasteel{
	planetary_atmos = 1
	},
/area/hangar)
"Mp" = (
/obj/structure/catwalk/over/plated_catwalk,
/obj/machinery/atmospherics/pipe/simple/orange/hidden,
/turf/open/floor/plating{
	planetary_atmos = 1
	},
/area/hangar)
"MV" = (
/obj/machinery/door/poddoor/shutters/indestructible{
	dir = 4;
	id = "ocean_ERT_bay"
	},
/turf/open/floor/plasteel{
	planetary_atmos = 1
	},
/area/hangar)
"Nd" = (
/obj/machinery/door/poddoor/shutters/indestructible{
	dir = 4;
	id = "ocean_ERT_bay"
	},
/turf/open/floor/plasteel/elevatorshaft,
/area/hangar)
"OB" = (
/obj/effect/turf_decal/corner/transparent/bottlegreen{
	dir = 10
	},
/obj/effect/turf_decal/corner/transparent/bottlegreen/three_quarters{
	dir = 1
	},
/turf/open/floor/plasteel{
	planetary_atmos = 1
	},
/area/hangar)
"OL" = (
/obj/structure/platform/industrial_alt/corner{
	dir = 8
	},
/turf/open/water/beach/deep,
/area/hangar)
"Py" = (
/obj/structure/table/reinforced,
/obj/structure/sign/warning/nosmoking/burnt{
	pixel_y = 28
	},
/turf/open/floor/plasteel/tech/techmaint,
/area/hangar)
"QJ" = (
/obj/structure/platform/industrial_alt/corner{
	dir = 4
	},
/turf/open/water/beach/deep,
/area/hangar)
"QN" = (
/obj/structure/platform/industrial_alt{
	dir = 8
	},
/obj/structure/platform/industrial_alt{
	dir = 4
	},
/turf/open/water/beach/deep,
/area/hangar)
"Rz" = (
/obj/structure/platform/industrial_alt{
	dir = 8
	},
/turf/open/water/beach/deep,
/area/hangar)
"Ti" = (
/obj/structure/catwalk/over/plated_catwalk,
/obj/machinery/atmospherics/pipe/manifold/orange/hidden,
/turf/open/floor/plating{
	planetary_atmos = 1
	},
/area/hangar)
"UD" = (
/obj/structure/catwalk/over/plated_catwalk,
/obj/machinery/atmospherics/pipe/simple/orange/hidden{
	dir = 9
	},
/turf/open/floor/plating{
	planetary_atmos = 1
	},
/area/hangar)
"VN" = (
/obj/machinery/atmospherics/components/unary/hydrogen_pump{
	dir = 4
	},
/obj/effect/turf_decal/industrial/outline/yellow,
/turf/open/floor/plasteel/tech/techmaint,
/area/hangar)
"We" = (
/obj/machinery/atmospherics/components/binary/volume_pump{
	dir = 4
	},
/obj/effect/turf_decal/industrial/shutoff,
/turf/open/floor/plasteel{
	planetary_atmos = 1
	},
/area/hangar)
"Xz" = (
/obj/machinery/light/floor/hangar,
/obj/effect/turf_decal/corner/transparent/bottlegreen{
	dir = 10
	},
/turf/open/floor/plasteel{
	planetary_atmos = 1
	},
/area/hangar)
"XW" = (
/obj/effect/turf_decal/corner/transparent/bottlegreen{
	dir = 9
	},
/turf/open/floor/plasteel{
	planetary_atmos = 1
	},
/area/hangar)
"YG" = (
/obj/machinery/door/airlock/maintenance{
	req_access_txt = "101"
	},
/turf/open/floor/plating{
	planetary_atmos = 1
	},
/area/hangar)
"YU" = (
/obj/structure/platform/industrial_alt{
	dir = 1
	},
/obj/structure/platform/industrial_alt{
	dir = 4
	},
/obj/structure/platform/industrial_alt/corner{
	dir = 5
	},
/turf/open/water/beach/deep,
/area/hangar)
"Zz" = (
/obj/structure/catwalk/over/plated_catwalk/dark,
/turf/open/floor/plating/rust,
/area/hangar)

(1,1,1) = {"
Gq
Gq
Gq
Gq
Gq
Gq
Gq
Gq
Gq
Gq
Gq
Gq
Gq
Gq
Gq
Gq
Gq
Gq
Gq
Gq
Gq
Gq
Gq
Gq
Gq
Gq
Gq
Gq
Gq
Gq
Gq
Gq
Gq
Gq
Gq
Gq
Gq
Gq
Gq
Gq
Gq
Gq
Gq
Gq
Gq
Gq
Gq
Gq
Gq
Gq
Gq
Gq
Gq
Gq
Gq
Gq
Gq
Gq
Gq
Gq
Gq
Gq
Gq
Gq
Gq
"}
(2,1,1) = {"
Gq
Gq
Gq
Gq
Gq
Gq
Gq
mS
mS
mS
Gq
Gq
Gq
Gq
Gq
Gq
Gq
mS
mS
mS
mS
mS
Gq
Gq
Gq
mS
mS
Gq
Gq
Gq
Gq
Gq
mS
mS
Gq
Gq
Gq
Gq
Gq
mS
Gq
Gq
Gq
Gq
Gq
Gq
Gq
mS
mS
Gq
Gq
Gq
Gq
mS
mS
mS
mS
mS
mS
Gq
Gq
Gq
Gq
Gq
Gq
"}
(3,1,1) = {"
Gq
Gq
Gq
Gq
Gq
Gq
mS
mS
mS
mS
mS
mS
mS
mS
mS
mS
mS
mS
mS
mS
mS
mS
mS
Gq
Gq
mS
mS
mS
Gq
Gq
Gq
mS
mS
mS
mS
mS
mS
mS
mS
mS
mS
mS
Gq
Gq
mS
Gq
mS
mS
mS
mS
mS
Gq
mS
mS
mS
mS
mS
mS
mS
mS
mS
Gq
Gq
Gq
Gq
"}
(4,1,1) = {"
Gq
Gq
Gq
Gq
mS
mS
mS
mS
mS
mS
mS
mS
mS
mS
mS
mS
mS
mS
mS
mS
mS
mS
mS
Gq
mS
mS
mS
mS
mS
mS
mS
mS
mS
mS
mS
mS
mS
mS
mS
mS
mS
mS
mS
mS
mS
mS
mS
mS
mS
mS
mS
mS
mS
mS
mS
mS
mS
mS
mS
mS
mS
mS
Gq
Gq
Gq
"}
(5,1,1) = {"
Gq
Gq
Gq
mS
mS
mS
mS
mS
mS
mS
mS
mS
mS
mS
mS
mS
mS
mS
mS
mS
mS
mS
mS
mS
mS
mS
mS
mS
mS
mS
mS
mS
mS
mS
mS
mS
mS
mS
mS
mS
mS
mS
mS
mS
mS
mS
mS
mS
mS
mS
mS
mS
mS
mS
mS
mS
mS
mS
mS
mS
mS
mS
mS
Gq
Gq
"}
(6,1,1) = {"
Gq
Gq
mS
mS
mS
mS
mS
mS
mS
mS
mS
mS
yh
mS
mS
mS
mS
mS
mS
mS
mS
mS
mS
mS
mS
mS
mS
mS
mS
mS
mS
mS
mS
mS
mS
mS
mS
mS
mS
mS
mS
mS
mS
mS
mS
mS
mS
mS
mS
mS
mS
mS
mS
mS
mS
mS
mS
yh
mS
mS
mS
mS
mS
Gq
Gq
"}
(7,1,1) = {"
Gq
mS
mS
mS
mS
mS
mS
mS
mS
mS
mS
mS
yh
Rz
Rz
Rz
Rz
Rz
Rz
Rz
Rz
Rz
Rz
Rz
Rz
Rz
Rz
Rz
Rz
Rz
Rz
Rz
Rz
Rz
Rz
Rz
Rz
Rz
Rz
Rz
Rz
Rz
Rz
Rz
Rz
Rz
Rz
Rz
Rz
Rz
Rz
Rz
Rz
Rz
Rz
Rz
Rz
yh
mS
mS
mS
mS
mS
Gq
Gq
"}
(8,1,1) = {"
Gq
mS
mS
mS
mS
mS
mS
mS
mS
mS
mS
yh
yh
yh
jC
kC
kC
kC
jC
jC
kC
jC
jC
yh
yh
kC
kC
jC
kC
kC
kC
jC
kC
jC
kC
jC
jC
kC
kC
jC
jC
jC
kC
kC
jC
yh
yh
kC
kC
jC
jC
jC
kC
jC
kC
jC
yh
yh
yh
mS
mS
mS
mS
Gq
Gq
"}
(9,1,1) = {"
Gq
mS
mS
mS
mS
mS
mS
mS
mS
yh
yh
yh
ec
XW
OB
wk
wk
wk
wk
wk
wk
wk
wk
wk
wk
wk
wk
wk
wk
wk
wk
wk
wk
wk
wk
wk
wk
wk
wk
wk
wk
wk
wk
wk
wk
wk
wk
wk
wk
wk
wk
wk
wk
wk
wk
ec
XW
Hd
yh
yh
yh
mS
mS
Gq
Gq
"}
(10,1,1) = {"
Gq
mS
mS
mS
mS
mS
mS
mS
mS
mS
Fj
yh
EW
al
zh
Zz
ho
ho
ho
Zz
ho
Zz
ho
ho
ho
Zz
Zz
Zz
ho
ho
ho
ho
ho
Zz
ho
Zz
ho
ho
ho
Zz
ho
Zz
ho
ho
ho
Zz
Zz
Zz
ho
ho
ho
ho
ho
Zz
ho
EW
al
zh
yh
IP
mS
mS
mS
mS
Gq
"}
(11,1,1) = {"
Gq
mS
mS
mS
mS
mS
mS
mS
mS
mS
Fj
kC
EW
al
zh
fQ
fQ
fQ
fQ
fQ
fQ
fQ
fQ
fQ
fQ
fQ
fQ
fQ
fQ
fQ
fQ
fQ
fQ
fQ
fQ
fQ
fQ
fQ
fQ
fQ
fQ
fQ
fQ
fQ
fQ
fQ
fQ
fQ
fQ
fQ
fQ
fQ
fQ
fQ
fQ
EW
al
zh
jC
IP
mS
mS
mS
mS
Gq
"}
(12,1,1) = {"
Gq
Gq
mS
mS
mS
mS
mS
mS
mS
mS
Fj
kC
EW
al
zh
kC
kC
kC
kC
kC
jC
jC
jC
jC
jC
jC
jC
jC
jC
jC
jC
jC
jC
jC
jC
jC
jC
jC
jC
jC
jC
jC
jC
jC
jC
jC
jC
jC
jC
jC
jC
jC
jC
kC
jB
EW
al
zh
kC
IP
mS
mS
mS
mS
Gq
"}
(13,1,1) = {"
Gq
Gq
Gq
mS
mS
mS
mS
mS
mS
mS
Fj
jC
EW
al
zh
kC
kC
jC
jC
jC
jC
jC
jC
jC
kC
jC
jC
jC
jC
jC
jC
jC
jC
jC
jC
jC
jC
jC
jC
jC
jC
jC
jC
jC
jC
jC
kC
jC
jC
jC
jC
jC
jC
jC
kC
EW
al
zh
kC
IP
mS
mS
mS
mS
Gq
"}
(14,1,1) = {"
Gq
Gq
Gq
Gq
mS
mS
mS
mS
mS
mS
Fj
jC
EW
al
zh
rT
kC
jC
jC
jC
jC
jC
jC
jC
kC
jC
jC
jC
kC
kC
jC
jC
jC
jC
jC
jC
jC
jC
jC
kC
kC
kC
kC
jC
jC
kC
kC
kC
kC
jC
jC
kC
jC
jC
mv
EW
al
zh
kC
IP
mS
mS
mS
mS
Gq
"}
(15,1,1) = {"
Gq
Gq
mS
mS
mS
mS
mS
mS
mS
mS
Fj
kC
EW
cI
jQ
kC
jC
jC
jC
jC
jC
kC
jC
jC
jC
jC
jC
jC
jC
jC
jC
jC
jC
kC
jC
jC
kC
jC
jC
jC
jC
jC
kC
kC
jC
kC
kC
jC
jC
jC
jC
kC
jC
jC
kC
xd
mg
zh
kC
IP
mS
mS
mS
mS
Gq
"}
(16,1,1) = {"
Gq
Gq
mS
mS
mS
mS
mS
mS
mS
mS
Fj
jC
EW
EF
Xz
kC
jC
jC
jC
kC
jC
kC
jC
jC
jC
jC
jC
jC
jC
jC
jC
jC
jC
kC
jC
jC
kC
kC
jC
jC
jC
jC
jC
jC
jC
kC
kC
jC
jC
jC
kC
kC
jC
jC
jC
bv
dp
zh
jC
IP
mS
mS
mS
mS
Gq
"}
(17,1,1) = {"
Gq
mS
mS
mS
mS
mS
mS
mS
mS
mS
Fj
jC
EW
EF
zh
kC
jC
jC
kC
kC
jC
jC
jC
kC
jC
jC
jC
jC
jC
jC
jC
jC
kC
jC
jC
jC
jC
jC
kC
kC
jC
jC
jC
jC
jC
jC
kC
jC
jC
jC
kC
kC
jC
jC
jC
EW
dp
zh
jC
IP
mS
mS
mS
mS
Gq
"}
(18,1,1) = {"
Gq
Gq
mS
mS
mS
mS
mS
mS
mS
mS
Fj
kC
EW
EF
zh
jC
jC
jC
jC
jC
jC
jC
jC
jC
jC
jC
jC
jC
jC
jC
jC
jC
jC
jC
jC
jC
jC
jC
jC
kC
kC
kC
jC
jC
jC
jC
jC
jC
jC
jC
jC
jC
jC
jC
jC
EW
dp
zh
kC
IP
mS
mS
mS
mS
Gq
"}
(19,1,1) = {"
Gq
Gq
Gq
mS
mS
mS
mS
mS
mS
mS
Fj
kC
EW
EF
zh
rT
jC
jC
jC
jC
jC
jC
kC
jC
jC
jC
kC
jC
kC
kC
jC
jC
jC
jC
jC
jC
jC
jC
jC
jC
jC
jC
jC
jC
jC
jC
jC
kC
jC
jC
jC
jC
kC
jC
rT
EW
dp
zh
jC
IP
mS
mS
mS
Gq
Gq
"}
(20,1,1) = {"
Gq
mS
mS
mS
mS
mS
mS
mS
mS
mS
Fj
kC
EW
EF
zh
jC
jC
kC
jC
jC
jC
jC
jC
jC
jC
jC
kC
jC
jC
jC
kC
jC
jC
jC
jC
jC
jC
jC
jC
jC
jC
jC
jC
jC
jC
kC
jC
jC
kC
kC
jC
jC
jC
jC
jC
EW
dp
zh
kC
IP
mS
mS
Gq
Gq
Gq
"}
(21,1,1) = {"
Gq
mS
mS
mS
mS
mS
mS
mS
mS
mS
Fj
kC
EW
EF
zh
jC
kC
jC
jC
jC
jC
jC
jC
jC
jC
kC
jC
jC
jC
jC
jC
kC
jC
jC
jC
jC
jC
jC
kC
kC
jC
jC
jC
jC
jC
jC
jC
jC
jC
kC
jC
jC
jC
jC
jC
EW
dp
zh
kC
IP
mS
mS
Gq
Gq
Gq
"}
(22,1,1) = {"
Gq
mS
mS
mS
mS
mS
mS
mS
mS
mS
Fj
jC
EW
EF
Xz
jC
jC
jC
jC
jC
jC
jC
jC
jC
jC
jC
kC
jC
jC
jC
jC
jC
jC
jC
jC
kC
kC
jC
jC
kC
jC
jC
kC
jC
jC
jC
jC
jC
jC
jC
jC
jC
jC
jC
jC
bv
dp
zh
jC
IP
mS
mS
mS
Gq
Gq
"}
(23,1,1) = {"
Gq
Gq
mS
mS
mS
mS
mS
mS
mS
mS
Fj
jC
EW
EF
zh
jC
jC
jC
jC
jC
jC
kC
jC
jC
jC
jC
jC
jC
jC
kC
jC
jC
jC
jC
jC
jC
kC
kC
jC
jC
jC
jC
jC
jC
jC
jC
jC
jC
jC
jC
jC
kC
jC
jC
jC
EW
dp
zh
jC
IP
mS
mS
mS
Gq
Gq
"}
(24,1,1) = {"
Gq
Gq
mS
mS
mS
mS
mS
mS
mS
mS
Fj
jC
EW
EF
zh
rT
jC
jC
jC
jC
jC
jC
jC
jC
jC
jC
jC
jC
jC
kC
jC
jC
jC
jC
jC
jC
jC
kC
jC
jC
jC
jC
jC
jC
jC
jC
jC
kC
jC
jC
jC
kC
kC
jC
rT
EW
dp
zh
kC
IP
mS
mS
mS
Gq
Gq
"}
(25,1,1) = {"
Gq
Gq
Gq
mS
mS
mS
mS
mS
mS
mS
Fj
kC
EW
EF
zh
jC
jC
jC
jC
jC
jC
jC
jC
jC
jC
jC
jC
jC
jC
kC
jC
jC
jC
jC
jC
jC
jC
jC
jC
jC
jC
jC
kC
jC
jC
jC
jC
jC
jC
jC
jC
kC
kC
jC
kC
EW
dp
zh
jC
IP
mS
mS
mS
mS
Gq
"}
(26,1,1) = {"
Gq
Gq
Gq
mS
mS
mS
mS
mS
mS
mS
Fj
kC
EW
EF
zh
kC
jC
jC
jC
kC
jC
jC
jC
kC
kC
jC
jC
jC
jC
kC
jC
jC
jC
jC
jC
jC
jC
jC
jC
jC
jC
kC
jC
jC
jC
kC
jC
jC
jC
jC
jC
kC
kC
jC
kC
EW
dp
zh
kC
IP
mS
mS
mS
mS
Gq
"}
(27,1,1) = {"
Gq
Gq
mS
mS
mS
mS
mS
mS
mS
mS
Fj
jC
EW
EF
zh
jC
jC
jC
jC
jC
kC
jC
kC
kC
kC
jC
kC
kC
jC
kC
kC
jC
jC
kC
jC
jC
jC
jC
jC
jC
jC
jC
jC
jC
jC
jC
jC
jC
jC
jC
jC
jC
jC
jC
kC
EW
dp
zh
jC
IP
mS
mS
mS
mS
Gq
"}
(28,1,1) = {"
Gq
Gq
mS
mS
mS
mS
mS
mS
mS
mS
Fj
jC
EW
EF
Xz
kC
jC
jC
jC
kC
kC
jC
jC
kC
kC
jC
jC
kC
jC
jC
kC
jC
jC
kC
jC
jC
jC
jC
jC
jC
kC
jC
jC
jC
jC
jC
jC
jC
kC
jC
jC
jC
jC
jC
kC
bv
dp
zh
jC
IP
mS
mS
mS
mS
Gq
"}
(29,1,1) = {"
Gq
mS
mS
mS
mS
mS
mS
mS
mS
mS
Fj
kC
EW
EF
zh
mv
jC
jC
jC
jC
jC
jC
jC
kC
jC
jC
jC
jC
jC
jC
jC
jC
jC
jC
jC
kC
jC
jC
jC
jC
kC
kC
jC
jC
jC
jC
jC
kC
kC
jC
jC
jC
jC
jC
rT
EW
dp
zh
kC
IP
mS
mS
mS
mS
Gq
"}
(30,1,1) = {"
Gq
Gq
mS
mS
mS
mS
mS
mS
mS
mS
Fj
jC
EW
EF
zh
kC
jC
jC
kC
jC
jC
jC
jC
jC
jC
jC
jC
jC
jC
jC
jC
jC
jC
jC
jC
kC
kC
jC
jC
jC
jC
kC
jC
jC
jC
jC
jC
kC
jC
jC
jC
jC
jC
jC
kC
EW
dp
zh
kC
IP
mS
mS
mS
Gq
Gq
"}
(31,1,1) = {"
Gq
mS
mS
mS
mS
mS
mS
mS
mS
mS
Fj
kC
EW
av
jQ
jC
jC
jC
jC
kC
jC
jC
jC
jC
jC
jC
jC
jC
jC
jC
jC
jC
jC
jC
jC
jC
kC
jC
jC
jC
jC
jC
jC
jC
jC
jC
jC
jC
jC
jC
kC
jC
jC
jC
jC
xd
Ti
zh
kC
IP
mS
mS
mS
Gq
Gq
"}
(32,1,1) = {"
Gq
mS
mS
mS
mS
mS
mS
mS
mS
mS
Fj
kC
EW
EF
zh
jC
jC
jC
jC
jC
jC
jC
jC
jC
kC
jC
jC
kC
jC
jC
jC
jC
kC
jC
jC
jC
kC
jC
jC
kC
kC
jC
jC
kC
jC
jC
jC
jC
jC
kC
kC
kC
jC
jC
kC
EW
dp
zh
jC
IP
mS
mS
Gq
Gq
Gq
"}
(33,1,1) = {"
Gq
mS
mS
mS
mS
mS
mS
mS
mS
mS
Fj
kC
EW
EF
zh
jC
jC
jC
jC
kC
jC
jC
jC
jC
jC
jC
jC
kC
jC
jC
jC
jC
jC
kC
jC
jC
jC
kC
kC
jC
jC
jC
jC
jC
jC
jC
jC
jC
jC
jC
kC
kC
jC
jC
kC
EW
dp
zh
kC
IP
mS
mS
mS
Gq
Gq
"}
(34,1,1) = {"
Gq
mS
mS
mS
mS
mS
mS
mS
mS
mS
Fj
kC
EW
EF
Xz
mv
jC
jC
kC
kC
kC
kC
jC
jC
jC
jC
jC
jC
kC
kC
jC
jC
kC
jC
jC
jC
jC
jC
jC
jC
jC
jC
kC
jC
jC
jC
jC
jC
jC
jC
jC
jC
jC
jC
mv
bv
dp
zh
jC
IP
mS
mS
mS
mS
Gq
"}
(35,1,1) = {"
Gq
Gq
mS
mS
mS
mS
mS
mS
mS
mS
Fj
jC
EW
EF
zh
jC
jC
jC
jC
jC
kC
jC
jC
jC
jC
jC
jC
jC
kC
jC
jC
jC
kC
jC
jC
jC
jC
jC
jC
jC
jC
jC
kC
jC
jC
kC
kC
kC
jC
jC
jC
jC
jC
jC
kC
EW
dp
zh
jC
IP
mS
mS
mS
mS
Gq
"}
(36,1,1) = {"
Gq
Gq
Gq
mS
mS
Gq
mS
mS
mS
mS
Fj
jC
EW
EF
zh
jC
jC
jC
jC
jC
jC
jC
jC
jC
kC
jC
jC
kC
kC
jC
jC
jC
jC
jC
jC
jC
jC
jC
jC
jC
jC
kC
jC
jC
jC
kC
kC
kC
jC
jC
jC
jC
jC
jC
jC
EW
dp
zh
jC
IP
mS
mS
mS
Gq
Gq
"}
(37,1,1) = {"
Gq
Gq
Gq
Gq
Gq
mS
mS
mS
mS
mS
Fj
jC
EW
EF
zh
jC
kC
jC
jC
jC
jC
jC
jC
jC
jC
jC
jC
kC
jC
jC
jC
jC
jC
jC
jC
jC
jC
jC
jC
jC
jC
jC
jC
jC
jC
jC
kC
jC
jC
jC
jC
kC
jC
jC
jC
EW
dp
zh
kC
IP
mS
mS
mS
Gq
Gq
"}
(38,1,1) = {"
Gq
Gq
Gq
mS
mS
mS
mS
mS
mS
mS
Fj
jC
EW
EF
zh
jC
jC
jC
jC
jC
jC
kC
kC
jC
jC
jC
jC
kC
jC
jC
kC
jC
jC
jC
jC
jC
kC
kC
jC
jC
jC
jC
kC
kC
jC
jC
jC
jC
jC
jC
kC
kC
jC
jC
kC
EW
dp
zh
kC
IP
mS
Gq
Gq
Gq
Gq
"}
(39,1,1) = {"
Gq
Gq
Gq
mS
mS
mS
mS
mS
mS
mS
Fj
kC
EW
EF
zh
mv
jC
jC
jC
jC
kC
jC
jC
jC
jC
jC
jC
jC
jC
jC
jC
jC
jC
kC
jC
jC
jC
jC
jC
jC
jC
jC
kC
jC
jC
jC
jC
jC
jC
kC
kC
jC
jC
jC
mv
EW
dp
zh
kC
IP
mS
mS
Gq
Gq
Gq
"}
(40,1,1) = {"
Gq
Gq
Gq
mS
mS
mS
mS
mS
mS
mS
Fj
jC
EW
EF
Xz
kC
jC
jC
jC
jC
jC
jC
jC
jC
jC
kC
jC
jC
jC
jC
jC
jC
jC
jC
kC
kC
kC
kC
kC
jC
jC
jC
jC
jC
jC
jC
jC
jC
jC
kC
kC
jC
jC
jC
jC
bv
dp
zh
jC
IP
mS
mS
mS
Gq
Gq
"}
(41,1,1) = {"
Gq
Gq
mS
mS
mS
mS
mS
mS
mS
mS
Fj
jC
EW
EF
zh
kC
jC
jC
jC
jC
jC
jC
jC
jC
jC
jC
kC
jC
jC
jC
jC
jC
jC
jC
jC
jC
jC
jC
jC
jC
jC
jC
jC
jC
jC
jC
jC
jC
jC
jC
kC
jC
jC
jC
jC
EW
dp
zh
kC
IP
mS
mS
mS
mS
Gq
"}
(42,1,1) = {"
Gq
Gq
mS
mS
mS
mS
mS
mS
mS
mS
Fj
jC
EW
EF
zh
jC
jC
jC
jC
kC
jC
jC
jC
jC
jC
jC
jC
jC
jC
kC
kC
kC
jC
jC
jC
jC
jC
jC
jC
jC
jC
kC
jC
jC
jC
kC
jC
jC
jC
jC
jC
jC
jC
jC
kC
EW
dp
zh
kC
IP
mS
mS
mS
Gq
Gq
"}
(43,1,1) = {"
Gq
mS
mS
mS
mS
mS
mS
mS
mS
mS
Fj
kC
EW
EF
zh
jC
jC
jC
jC
jC
jC
jC
kC
kC
kC
jC
jC
jC
jC
kC
jC
jC
jC
jC
jC
jC
jC
jC
jC
jC
jC
kC
jC
jC
jC
kC
kC
jC
jC
jC
jC
jC
jC
kC
jC
EW
dp
zh
jC
IP
mS
mS
Gq
Gq
Gq
"}
(44,1,1) = {"
Gq
mS
mS
mS
mS
mS
mS
Rz
Rz
Rz
vx
kC
EW
EF
zh
rT
jC
jC
jC
jC
jC
jC
jC
kC
kC
jC
jC
jC
jC
jC
kC
jC
jC
jC
jC
jC
jC
jC
jC
kC
jC
kC
jC
jC
jC
kC
kC
jC
jC
jC
jC
jC
jC
kC
rT
EW
dp
zh
jC
IP
mS
mS
Gq
Gq
Gq
"}
(45,1,1) = {"
Gq
mS
mS
mS
mS
mS
Fj
yh
yh
yh
yh
yh
EW
EF
zh
jC
jC
jC
jC
jC
kC
kC
kC
kC
jC
jC
kC
jC
jC
jC
kC
jC
jC
jC
jC
kC
kC
jC
jC
jC
jC
jC
jC
jC
jC
kC
kC
kC
jC
jC
jC
jC
jC
kC
kC
EW
dp
zh
kC
IP
mS
mS
mS
Gq
Gq
"}
(46,1,1) = {"
Gq
Gq
mS
mS
mS
mS
Fj
yh
pi
yh
yh
VN
yH
EF
Xz
jC
jC
jC
jC
jC
jC
jC
jC
jC
jC
jC
jC
jC
jC
kC
jC
jC
jC
kC
kC
kC
kC
jC
kC
jC
jC
jC
jC
jC
jC
jC
kC
jC
kC
jC
jC
jC
jC
jC
kC
bv
dp
zh
jC
IP
mS
mS
mS
Gq
Gq
"}
(47,1,1) = {"
Gq
mS
mS
mS
mS
mS
Fj
yh
pi
YG
pi
We
mB
EF
zh
kC
jC
jC
kC
jC
jC
jC
jC
jC
jC
jC
jC
jC
kC
jC
jC
jC
jC
jC
kC
jC
jC
jC
jC
jC
jC
jC
jC
kC
jC
jC
kC
kC
kC
jC
jC
jC
jC
jC
kC
EW
dp
zh
jC
IP
mS
mS
mS
Gq
Gq
"}
(48,1,1) = {"
Gq
Gq
mS
mS
mS
mS
Fj
yh
pi
yh
EP
lR
Mp
av
jQ
kC
kC
jC
jC
kC
kC
jC
jC
jC
jC
jC
jC
jC
kC
jC
jC
jC
jC
jC
jC
jC
jC
jC
jC
jC
jC
jC
kC
kC
jC
jC
jC
jC
jC
jC
jC
jC
kC
jC
jC
xd
Ti
zh
kC
IP
mS
mS
mS
mS
Gq
"}
(49,1,1) = {"
Gq
Gq
mS
mS
mS
mS
Fj
yh
pi
yh
Py
zS
ur
EF
zh
mv
kC
jC
jC
jC
jC
jC
jC
jC
jC
jC
jC
jC
jC
jC
jC
jC
jC
jC
jC
jC
jC
kC
kC
jC
kC
jC
jC
jC
jC
jC
jC
jC
jC
jC
jC
kC
jC
jC
mv
EW
dp
zh
jC
IP
mS
mS
mS
mS
Gq
"}
(50,1,1) = {"
Gq
Gq
mS
mS
mS
mS
Fj
yh
pi
yh
yh
Dp
yH
Iu
zh
kC
kC
kC
kC
jC
jC
jC
jC
jC
jC
jC
jC
jC
jC
jC
kC
jC
jC
jC
jC
jC
kC
kC
jC
jC
jC
jC
jC
jC
jC
jC
jC
jC
jC
jC
jC
jC
jC
jC
kC
EW
dp
zh
jC
IP
mS
mS
mS
mS
Gq
"}
(51,1,1) = {"
Gq
Gq
mS
mS
mS
mS
Fj
yh
yh
yh
yh
yh
mB
Iu
zh
kC
kC
kC
kC
kC
kC
kC
kC
jC
jC
jC
jC
jC
jC
jC
jC
jC
jC
jC
jC
jC
jC
jC
jC
jC
jC
jC
jC
jC
jC
kC
jC
jC
jC
jC
jC
jC
jC
kC
kC
EW
dp
zh
jC
IP
mS
mS
mS
mS
Gq
"}
(52,1,1) = {"
Gq
mS
mS
mS
mS
mS
mS
zx
zx
zx
zq
jC
EW
yA
mJ
XW
XW
XW
XW
XW
XW
XW
XW
XW
XW
XW
XW
XW
XW
XW
XW
XW
XW
XW
XW
XW
XW
XW
XW
XW
XW
XW
XW
XW
XW
XW
XW
XW
XW
XW
XW
XW
XW
XW
XW
eM
dp
zh
jC
IP
mS
mS
mS
mS
Gq
"}
(53,1,1) = {"
Gq
Gq
mS
mS
mS
mS
mS
mS
mS
mS
Fj
kC
EW
ac
Mp
Mp
Mp
Mp
Mp
Mp
Mp
Mp
Mp
Mp
Mp
Mp
Mp
Mp
Mp
Mp
Mp
Mp
Mp
Mp
Mp
Mp
Mp
Mp
Mp
Mp
Mp
Mp
Mp
Mp
Mp
Mp
Mp
Mp
Mp
Mp
Mp
Mp
Mp
Mp
Mp
Mp
UD
zh
yh
IP
mS
mS
mS
mS
Gq
"}
(54,1,1) = {"
Gq
mS
mS
mS
mS
mS
mS
mS
mS
mS
Fj
kC
EW
pi
CG
qh
kx
qh
qh
qh
qh
qh
qh
qh
qh
qh
kx
qh
qh
qh
qh
qh
qh
qh
qh
kx
qh
qh
qh
qh
qh
qh
qh
qh
kx
qh
qh
qh
qh
qh
qh
qh
qh
kx
qh
qh
qh
ar
yh
yh
yh
mS
mS
mS
Gq
"}
(55,1,1) = {"
Gq
mS
mS
mS
mS
mS
mS
mS
mS
mS
Fj
jC
EW
CG
zh
yh
yh
yh
yh
yh
yh
yh
yh
MV
MV
MV
MV
yh
kC
kC
kC
jC
kC
jC
jC
kC
kC
jC
kC
jC
jC
kC
kC
jC
jC
jC
kC
jC
kC
jC
kC
jC
jC
kC
kC
jC
yh
yh
yh
mS
mS
mS
mS
Gq
Gq
"}
(56,1,1) = {"
Gq
Gq
mS
mS
mS
mS
mS
mS
mS
mS
Fj
kC
EW
CG
zh
YU
CD
zx
zx
zx
CD
zx
yh
CG
CG
CG
CG
yh
zx
zx
zx
zx
zx
zx
zx
zx
zx
zx
zx
zx
zx
zx
zx
zx
zx
zx
zx
zx
zx
zx
zx
zx
zx
zx
zx
zx
zx
yh
mS
mS
mS
mS
mS
Gq
Gq
"}
(57,1,1) = {"
Gq
mS
mS
mS
mS
mS
mS
mS
mS
mS
Fj
jC
EW
CG
zh
yh
yh
yh
yh
yh
yh
mS
yh
CG
CG
CG
CG
yh
mS
mS
mS
mS
mS
mS
mS
mS
mS
mS
mS
mS
mS
mS
mS
mS
mS
mS
mS
mS
mS
mS
mS
mS
mS
mS
mS
mS
mS
yh
mS
mS
mS
mS
mS
Gq
Gq
"}
(58,1,1) = {"
Gq
mS
mS
mS
mS
mS
mS
mS
mS
mS
Fj
jC
XW
XW
XW
qk
zo
Kw
Kw
vw
AL
mS
yh
CG
CG
yh
yh
yh
mS
mS
mS
mS
mS
mS
mS
mS
mS
mS
mS
mS
mS
mS
mS
mS
mS
mS
mS
mS
mS
mS
mS
mS
mS
mS
mS
mS
mS
mS
mS
mS
mS
mS
mS
Gq
Gq
"}
(59,1,1) = {"
Gq
Gq
mS
mS
mS
mS
mS
mS
mS
mS
Fj
kC
CG
CG
KP
mN
zo
Kw
Kw
Kw
AL
mS
yh
CG
CG
yh
mS
mS
mS
mS
mS
mS
mS
mS
mS
mS
mS
mS
mS
mS
mS
mS
mS
mS
mS
mS
mS
mS
mS
mS
mS
mS
mS
mS
mS
mS
mS
mS
mS
mS
mS
mS
mS
Gq
Gq
"}
(60,1,1) = {"
Gq
Gq
mS
mS
mS
mS
mS
mS
mS
mS
Fj
yh
qh
qh
qh
mN
zo
Kw
Kw
Kw
AL
mS
yh
yh
yh
yh
mS
mS
mS
mS
mS
mS
mS
mS
mS
mS
mS
mS
mS
mS
mS
mS
mS
mS
mS
mS
mS
mS
mS
mS
mS
mS
mS
mS
mS
mS
mS
mS
mS
mS
mS
mS
mS
Gq
Gq
"}
(61,1,1) = {"
Gq
Gq
mS
mS
mS
mS
mS
mS
mS
mS
Fj
yh
yh
kC
kC
yh
yh
yh
yh
yh
yh
mS
mS
mS
mS
mS
mS
mS
mS
mS
mS
mS
mS
mS
mS
mS
mS
mS
mS
mS
mS
mS
mS
mS
mS
mS
mS
mS
mS
mS
mS
mS
mS
mS
mS
mS
mS
mS
mS
mS
mS
mS
mS
mS
Gq
"}
(62,1,1) = {"
Gq
mS
mS
mS
mS
mS
mS
mS
mS
mS
dM
zx
zx
zx
qW
QN
CD
mS
mS
mS
CD
Rz
OL
mS
mS
mS
mS
mS
mS
mS
mS
mS
mS
mS
mS
mS
mS
mS
mS
mS
mS
mS
mS
mS
mS
mS
mS
mS
mS
mS
mS
mS
mS
mS
mS
mS
mS
mS
mS
mS
mS
mS
mS
mS
Gq
"}
(63,1,1) = {"
Gq
Gq
mS
mS
mS
mS
mS
mS
mS
mS
mS
mS
mS
mS
Fj
yh
fC
HC
HC
qG
fC
yh
IP
mS
mS
mS
mS
mS
mS
mS
mS
mS
mS
mS
mS
mS
mS
mS
mS
mS
mS
mS
mS
mS
mS
mS
mS
mS
mS
mS
mS
mS
mS
mS
mS
mS
mS
mS
mS
mS
mS
mS
mS
mS
Gq
"}
(64,1,1) = {"
Gq
Gq
mS
mS
mS
mS
mS
mS
mS
mS
mS
mS
mS
mS
dM
zx
CD
mS
mS
mS
CD
zx
QJ
mS
mS
mS
mS
mS
mS
mS
mS
mS
mS
mS
mS
mS
mS
mS
mS
mS
mS
mS
mS
mS
mS
mS
mS
mS
mS
mS
mS
mS
mS
mS
mS
mS
mS
mS
mS
mS
mS
mS
mS
mS
Gq
"}
(65,1,1) = {"
Gq
Gq
Gq
mS
mS
mS
Gq
mS
mS
mS
mS
mS
mS
mS
mS
mS
CD
mS
mS
mS
CD
mS
mS
mS
mS
mS
mS
mS
mS
mS
mS
mS
mS
mS
mS
mS
mS
mS
mS
mS
mS
mS
mS
mS
mS
mS
mS
mS
mS
mS
mS
mS
mS
mS
mS
mS
mS
mS
mS
mS
mS
mS
mS
mS
Gq
"}
(66,1,1) = {"
Gq
Gq
Gq
Gq
mS
Gq
Gq
mS
mS
mS
mS
mS
mS
mS
mS
mS
CD
mS
mS
mS
CD
mS
mS
mS
mS
mS
mS
mS
mS
mS
mS
mS
mS
mS
mS
mS
mS
mS
mS
mS
mS
mS
mS
mS
mS
mS
mS
mS
mS
mS
mS
mS
mS
mS
mS
mS
mS
mS
mS
Gq
Gq
mS
mS
Gq
Gq
"}
(67,1,1) = {"
Gq
Gq
Gq
Gq
Gq
mS
mS
mS
mS
mS
mS
mS
mS
mS
mS
mS
CD
mS
mS
mS
CD
mS
mS
mS
mS
mS
mS
mS
mS
mS
mS
mS
mS
mS
mS
mS
mS
mS
mS
Gq
mS
mS
mS
mS
mS
mS
mS
mS
mS
mS
mS
mS
mS
mS
mS
mS
mS
mS
mS
mS
Gq
mS
mS
Gq
Gq
"}
(68,1,1) = {"
Gq
Gq
Gq
Gq
Gq
Gq
mS
mS
mS
mS
mS
mS
mS
mS
mS
mS
CD
mS
mS
mS
CD
mS
mS
mS
mS
mS
mS
mS
mS
mS
mS
mS
mS
mS
mS
mS
mS
Gq
Gq
Gq
mS
mS
mS
mS
mS
mS
mS
mS
mS
mS
mS
mS
mS
mS
mS
mS
mS
mS
mS
mS
mS
mS
Gq
Gq
Gq
"}
(69,1,1) = {"
Gq
Gq
Gq
Gq
Gq
Gq
Gq
mS
mS
mS
mS
mS
mS
mS
mS
yh
Nd
Nd
Nd
Nd
Nd
yh
mS
mS
mS
mS
Gq
Gq
mS
mS
mS
mS
mS
mS
mS
Gq
Gq
Gq
Gq
Gq
Gq
mS
mS
mS
mS
Gq
Gq
Gq
Gq
Gq
Gq
mS
mS
mS
mS
mS
mS
mS
Gq
Gq
Gq
Gq
Gq
Gq
Gq
"}
(70,1,1) = {"
Gq
Gq
Gq
Gq
Gq
Gq
Gq
Gq
Gq
Gq
Gq
Gq
Gq
Gq
Gq
yh
Gq
Gq
Gq
Gq
Gq
yh
Gq
Gq
Gq
Gq
Gq
Gq
Gq
Gq
Gq
Gq
Gq
Gq
Gq
Gq
Gq
Gq
Gq
Gq
Gq
Gq
Gq
Gq
Gq
Gq
Gq
Gq
Gq
Gq
Gq
Gq
Gq
Gq
Gq
Gq
Gq
Gq
Gq
Gq
Gq
Gq
Gq
Gq
Gq
"}
