//MAP CONVERTED BY dmm2tgm.py THIS HEADER COMMENT PREVENTS RECONVERSION, DO NOT REMOVE
"af" = (
/obj/effect/turf_decal/weather/rock{
	dir = 10
	},
/turf/open/floor/plasteel/dark,
/area/hangar)
"ap" = (
/obj/effect/turf_decal/corner/opaque/bar/half,
/turf/open/floor/plasteel/tech,
/area/hangar)
"bX" = (
/obj/structure/railing/corner{
	dir = 1;
	layer = 4.1
	},
/obj/effect/turf_decal/corner/opaque/bar/half{
	dir = 1
	},
/obj/machinery/atmospherics/pipe/simple/orange/hidden{
	dir = 4
	},
/turf/open/floor/plasteel/dark,
/area/hangar)
"co" = (
/turf/open/floor/plasteel/elevatorshaft{
	planetary_atmos = 1
	},
/area/hangar)
"dh" = (
/obj/structure/flora/tree/cactus,
/turf/open/floor/plating/asteroid/rockplanet/safe/lit,
/area/hangar)
"di" = (
/obj/effect/turf_decal/corner/opaque/bar/three_quarters{
	dir = 1
	},
/obj/effect/turf_decal/weather/rock{
	dir = 8
	},
/turf/open/floor/plasteel/dark,
/area/hangar)
"dl" = (
/obj/effect/turf_decal/corner/opaque/bar/three_quarters,
/turf/open/floor/plasteel/tech,
/area/hangar)
"fe" = (
/obj/effect/turf_decal/corner/opaque/bar/half{
	dir = 8
	},
/turf/open/floor/plasteel/dark,
/area/hangar)
"gf" = (
/obj/effect/landmark/outpost/hangar_dock,
/turf/open/floor/plating{
	planetary_atmos = 1
	},
/area/hangar)
"gp" = (
/obj/machinery/door/poddoor/ert,
/turf/open/space/basic,
/area/hangar)
"gs" = (
/obj/machinery/light/floor/hangar,
/obj/effect/turf_decal/corner/opaque/bar/half{
	dir = 1
	},
/turf/open/floor/plasteel/dark,
/area/hangar)
"gR" = (
/obj/machinery/atmospherics/pipe/simple/orange/hidden{
	dir = 4
	},
/obj/structure/catwalk/over/plated_catwalk/dark,
/obj/effect/turf_decal/weather/rock{
	dir = 1
	},
/turf/open/floor/plating{
	planetary_atmos = 1
	},
/area/hangar)
"hB" = (
/obj/structure/catwalk/over/plated_catwalk/dark,
/obj/machinery/atmospherics/pipe/simple/orange/hidden{
	dir = 5
	},
/turf/open/floor/plating{
	planetary_atmos = 1
	},
/area/hangar)
"hJ" = (
/turf/open/floor/plating{
	planetary_atmos = 1
	},
/area/hangar)
"ia" = (
/obj/effect/decal/fakelattice,
/turf/open/floor/plasteel/stairs/mid{
	dir = 1;
	color = "#2e2e2e"
	},
/area/hangar)
"if" = (
/obj/structure/flora/rock/pile/rockplanet,
/turf/open/floor/plating/asteroid/rockplanet/safe/lit,
/area/hangar)
"jk" = (
/obj/effect/turf_decal/corner/opaque/bar/half{
	dir = 1
	},
/obj/machinery/atmospherics/components/binary/volume_pump{
	dir = 4
	},
/obj/effect/turf_decal/industrial/shutoff,
/turf/open/floor/plasteel/dark,
/area/hangar)
"jr" = (
/obj/effect/turf_decal/corner/opaque/bar/half{
	dir = 8
	},
/obj/effect/turf_decal/weather/rock{
	dir = 8
	},
/turf/open/floor/plasteel/dark,
/area/hangar)
"jy" = (
/obj/structure/railing{
	dir = 1
	},
/obj/effect/turf_decal/corner/opaque/bar/half{
	dir = 1
	},
/obj/machinery/atmospherics/pipe/manifold/orange/hidden{
	dir = 8
	},
/turf/open/floor/plasteel/dark,
/area/hangar)
"jG" = (
/obj/effect/turf_decal/corner/opaque/bar/three_quarters{
	dir = 4
	},
/obj/effect/turf_decal/weather/rock{
	dir = 9
	},
/turf/open/floor/plasteel/dark,
/area/hangar)
"kb" = (
/obj/structure/flora/tree/cactus,
/turf/open/floor/plating/asteroid/rockplanet/safe/cracked/lit,
/area/hangar)
"kn" = (
/obj/structure/flora/rock/rockplanet,
/turf/open/floor/plating/asteroid/snow/lit,
/area/hangar)
"kK" = (
/obj/effect/turf_decal/corner/opaque/bar/half{
	dir = 1
	},
/obj/machinery/atmospherics/pipe/simple/orange/hidden{
	dir = 4
	},
/turf/open/floor/plasteel/dark,
/area/hangar)
"kR" = (
/obj/structure/flora/rock/pile/rockplanet,
/turf/open/floor/plating/asteroid/rockplanet/safe/cracked/lit,
/area/hangar)
"lU" = (
/obj/machinery/atmospherics/components/binary/volume_pump,
/obj/effect/turf_decal/industrial/shutoff{
	dir = 8
	},
/obj/effect/turf_decal/weather/rock{
	dir = 8
	},
/turf/open/floor/plasteel/tech/grid,
/area/hangar)
"mi" = (
/obj/item/toy/plush/moth/deadhead,
/turf/open/floor/plasteel/tech,
/area/hangar)
"op" = (
/obj/effect/turf_decal/weather/rock,
/turf/open/floor/plasteel/dark,
/area/hangar)
"pG" = (
/obj/structure/flora/rock/rockplanet,
/turf/open/floor/plating/asteroid/rockplanet/safe/lit,
/area/hangar)
"qo" = (
/obj/machinery/light/floor/hangar,
/turf/open/floor/plasteel/tech{
	planetary_atmos = 1
	},
/area/hangar)
"ri" = (
/obj/effect/turf_decal/corner/opaque/bar/three_quarters{
	dir = 1
	},
/obj/effect/turf_decal/weather/rock{
	dir = 10
	},
/turf/open/floor/plasteel/dark,
/area/hangar)
"rZ" = (
/obj/effect/landmark/outpost/elevator_machine,
/obj/structure/lattice/catwalk,
/obj/machinery/door/airlock/grunge,
/turf/open/floor/engine,
/area/hangar)
"sy" = (
/obj/effect/turf_decal/corner/opaque/bar/half,
/turf/open/floor/plasteel/dark,
/area/hangar)
"sG" = (
/obj/effect/turf_decal/corner/opaque/bar/half{
	dir = 4
	},
/turf/open/floor/plasteel/tech,
/area/hangar)
"sQ" = (
/obj/machinery/door/poddoor/ert,
/turf/open/floor/plasteel/elevatorshaft{
	planetary_atmos = 1
	},
/area/hangar)
"tf" = (
/obj/effect/turf_decal/corner/opaque/bar/half{
	dir = 4
	},
/obj/effect/turf_decal/weather/rock{
	dir = 5
	},
/turf/open/floor/plasteel/dark,
/area/hangar)
"tt" = (
/obj/effect/landmark/outpost/elevator_machine,
/obj/machinery/elevator_call_button{
	pixel_y = 25
	},
/obj/effect/turf_decal/weather/rock{
	dir = 8
	},
/turf/open/floor/plasteel/dark,
/area/hangar)
"tE" = (
/obj/structure/catwalk/over/plated_catwalk/dark,
/obj/machinery/atmospherics/pipe/simple/orange/hidden,
/turf/open/floor/plating{
	planetary_atmos = 1
	},
/area/hangar)
"uf" = (
/turf/open/floor/plasteel/tech,
/area/hangar)
"vu" = (
/obj/effect/landmark/outpost/hangar_numbers,
/obj/effect/turf_decal/corner/opaque/bar/half{
	dir = 1
	},
/turf/open/floor/plasteel/tech,
/area/hangar)
"xl" = (
/obj/effect/turf_decal/corner/opaque/bar/three_quarters{
	dir = 1
	},
/turf/open/floor/plasteel/tech,
/area/hangar)
"xK" = (
/obj/machinery/atmospherics/components/binary/valve/digital,
/obj/effect/turf_decal/corner/opaque/bar/half,
/turf/open/floor/plasteel/dark,
/area/hangar)
"xP" = (
/obj/effect/landmark/outpost/elevator,
/turf/open/floor/plasteel/elevatorshaft{
	planetary_atmos = 1
	},
/area/hangar)
"yy" = (
/obj/effect/turf_decal/corner/opaque/bar/half{
	dir = 8
	},
/obj/machinery/light/floor/hangar,
/turf/open/floor/plasteel/dark,
/area/hangar)
"yE" = (
/obj/machinery/light/floor/hangar,
/obj/effect/turf_decal/corner/opaque/bar/half,
/turf/open/floor/plasteel/dark,
/area/hangar)
"yL" = (
/obj/machinery/atmospherics/pipe/simple/orange/hidden{
	dir = 4
	},
/obj/structure/catwalk/over/plated_catwalk/dark,
/turf/open/floor/plating{
	planetary_atmos = 1
	},
/area/hangar)
"yR" = (
/obj/structure/flora/grass/rockplanet/dead,
/turf/open/floor/plating/asteroid/rockplanet/safe/cracked/lit,
/area/hangar)
"zF" = (
/turf/open/floor/plasteel/tech{
	planetary_atmos = 1
	},
/area/hangar)
"zG" = (
/obj/effect/turf_decal/corner/opaque/bar/half{
	dir = 1
	},
/obj/machinery/atmospherics/components/unary/portables_connector{
	dir = 8
	},
/obj/effect/turf_decal/industrial/outline/yellow,
/obj/effect/turf_decal/weather/rock{
	dir = 5
	},
/turf/open/floor/plasteel/tech/grid,
/area/hangar)
"zK" = (
/obj/machinery/atmospherics/pipe/simple/orange/hidden,
/obj/structure/catwalk/over/plated_catwalk/dark,
/turf/open/floor/plating{
	planetary_atmos = 1
	},
/area/hangar)
"BV" = (
/obj/effect/turf_decal/corner/opaque/bar/half{
	dir = 1
	},
/turf/open/floor/plasteel/dark,
/area/hangar)
"CC" = (
/obj/machinery/atmospherics/pipe/simple/orange/hidden{
	dir = 10
	},
/obj/effect/turf_decal/weather/rock{
	dir = 1
	},
/turf/open/floor/plasteel/dark,
/area/hangar)
"CS" = (
/obj/effect/turf_decal/weather/rock{
	dir = 4
	},
/turf/open/floor/plasteel/tech,
/area/hangar)
"Dq" = (
/obj/effect/turf_decal/corner/opaque/bar/three_quarters{
	dir = 4
	},
/obj/effect/turf_decal/weather/rock{
	dir = 8
	},
/turf/open/floor/plasteel/dark,
/area/hangar)
"DU" = (
/obj/effect/turf_decal/corner/opaque/bar/three_quarters{
	dir = 8
	},
/turf/open/floor/plasteel/tech,
/area/hangar)
"EL" = (
/obj/effect/turf_decal/trimline/opaque/yellow/warning{
	dir = 4
	},
/turf/open/floor/plasteel/tech{
	planetary_atmos = 1
	},
/area/hangar)
"EM" = (
/obj/effect/turf_decal/corner/opaque/bar/three_quarters,
/obj/effect/turf_decal/weather/rock{
	dir = 6
	},
/turf/open/floor/plasteel/dark,
/area/hangar)
"Fe" = (
/obj/structure/catwalk/over/plated_catwalk/dark,
/obj/machinery/light/floor/hangar,
/turf/open/floor/plating{
	planetary_atmos = 1
	},
/area/hangar)
"Fw" = (
/obj/effect/turf_decal/corner/opaque/bar/half{
	dir = 4
	},
/obj/effect/turf_decal/weather/rock{
	dir = 4
	},
/turf/open/floor/plasteel/dark,
/area/hangar)
"FD" = (
/turf/open/floor/plating/asteroid/rockplanet/safe/lit,
/area/hangar)
"FI" = (
/obj/structure/flora/grass/rockplanet/dead,
/turf/open/floor/plating/asteroid/snow/lit,
/area/hangar)
"FN" = (
/obj/structure/railing/corner{
	dir = 4
	},
/obj/effect/turf_decal/corner/opaque/bar/half{
	dir = 1
	},
/obj/effect/turf_decal/weather/rock{
	dir = 1
	},
/turf/open/floor/plasteel/dark,
/area/hangar)
"FZ" = (
/turf/open/floor/plating/asteroid/snow/lit,
/area/hangar)
"GK" = (
/obj/structure/catwalk/over/plated_catwalk/dark,
/obj/machinery/atmospherics/pipe/simple/orange/hidden{
	dir = 9
	},
/turf/open/floor/plating{
	planetary_atmos = 1
	},
/area/hangar)
"Hw" = (
/obj/machinery/atmospherics/pipe/simple/orange/hidden{
	dir = 4
	},
/obj/effect/turf_decal/weather/rock{
	dir = 1
	},
/turf/open/floor/plasteel/dark,
/area/hangar)
"HD" = (
/obj/machinery/atmospherics/components/binary/valve/digital,
/obj/effect/turf_decal/corner/opaque/bar/half{
	dir = 1
	},
/turf/open/floor/plasteel/dark,
/area/hangar)
"Ir" = (
/obj/structure/catwalk/over/plated_catwalk/dark,
/turf/open/floor/plating{
	planetary_atmos = 1
	},
/area/hangar)
"Iw" = (
/obj/machinery/door/airlock/maintenance{
	req_access_txt = "101"
	},
/turf/open/floor/plating{
	planetary_atmos = 1
	},
/area/hangar)
"II" = (
/obj/effect/turf_decal/corner/opaque/bar{
	dir = 1
	},
/turf/open/floor/plasteel/dark,
/area/hangar)
"Ja" = (
/turf/closed/indestructible/rock/rockplanet,
/area/hangar)
"JC" = (
/obj/machinery/atmospherics/pipe/manifold/orange/hidden{
	dir = 1
	},
/obj/structure/catwalk/over/plated_catwalk/dark,
/turf/open/floor/plating{
	planetary_atmos = 1
	},
/area/hangar)
"JL" = (
/obj/structure/catwalk/over/plated_catwalk/dark,
/obj/machinery/atmospherics/pipe/manifold/orange/hidden,
/turf/open/floor/plating{
	planetary_atmos = 1
	},
/area/hangar)
"Ka" = (
/obj/effect/turf_decal/weather/rock{
	dir = 4
	},
/turf/open/floor/plasteel/dark,
/area/hangar)
"Kg" = (
/obj/structure/marker_beacon{
	picked_color = "Teal"
	},
/turf/open/floor/plating{
	planetary_atmos = 1
	},
/area/hangar)
"Kk" = (
/obj/machinery/atmospherics/pipe/manifold/orange/hidden,
/obj/structure/catwalk/over/plated_catwalk/dark,
/turf/open/floor/plating{
	planetary_atmos = 1
	},
/area/hangar)
"MS" = (
/turf/open/floor/plating/asteroid/rockplanet/safe/cracked/lit,
/area/hangar)
"MT" = (
/obj/effect/turf_decal/corner/opaque/bar/half{
	dir = 1
	},
/obj/machinery/light/floor/hangar,
/turf/open/floor/plasteel/dark,
/area/hangar)
"Nu" = (
/obj/effect/turf_decal/trimline/opaque/yellow/warning{
	dir = 8
	},
/obj/effect/turf_decal/weather/rock{
	dir = 8
	},
/turf/open/floor/plasteel/tech{
	planetary_atmos = 1
	},
/area/hangar)
"NK" = (
/obj/effect/turf_decal/corner/opaque/bar/half{
	dir = 1
	},
/obj/effect/turf_decal/weather/rock{
	dir = 1
	},
/turf/open/floor/plasteel/dark,
/area/hangar)
"Ov" = (
/obj/effect/turf_decal/arrows{
	dir = 1
	},
/turf/open/floor/plasteel/tech{
	planetary_atmos = 1
	},
/area/hangar)
"OT" = (
/obj/effect/turf_decal/corner/opaque/bar/half{
	dir = 8
	},
/turf/open/floor/plasteel/tech,
/area/hangar)
"Qr" = (
/obj/structure/catwalk/over/plated_catwalk/dark,
/obj/machinery/atmospherics/pipe/simple/orange/hidden{
	dir = 4
	},
/turf/open/floor/plating{
	planetary_atmos = 1
	},
/area/hangar)
"Rt" = (
/obj/effect/turf_decal/corner/opaque/bar/half,
/obj/machinery/atmospherics/components/binary/valve/digital,
/turf/open/floor/plasteel/dark,
/area/hangar)
"RL" = (
/obj/structure/flora/grass/rockplanet/dead,
/turf/open/floor/plating/asteroid/rockplanet/safe/lit,
/area/hangar)
"SG" = (
/obj/effect/turf_decal/weather/rock{
	dir = 6
	},
/turf/open/floor/plasteel/dark,
/area/hangar)
"TB" = (
/obj/effect/turf_decal/weather/rock{
	dir = 8
	},
/turf/open/floor/plasteel/dark,
/area/hangar)
"TN" = (
/obj/effect/turf_decal/corner/opaque/bar/three_quarters{
	dir = 4
	},
/turf/open/floor/plasteel/tech,
/area/hangar)
"UG" = (
/obj/effect/decal/fakelattice,
/turf/open/floor/plasteel/elevatorshaft{
	planetary_atmos = 1
	},
/area/hangar)
"Vw" = (
/turf/closed/indestructible/syndicate,
/area/hangar)
"Wy" = (
/obj/effect/turf_decal/corner/opaque/bar/half,
/obj/machinery/light/floor/hangar,
/turf/open/floor/plasteel/dark,
/area/hangar)
"WS" = (
/obj/structure/catwalk/over/plated_catwalk/dark,
/obj/machinery/atmospherics/pipe/simple/orange/hidden{
	dir = 6
	},
/turf/open/floor/plating{
	planetary_atmos = 1
	},
/area/hangar)
"Xb" = (
/obj/structure/sign/warning/nosmoking/burnt{
	pixel_y = 28
	},
/obj/machinery/computer/hydrogen_exchange,
/turf/open/floor/plasteel/tech,
/area/hangar)
"Xh" = (
/obj/structure/flora/rock/rockplanet,
/turf/open/floor/plating/asteroid/rockplanet/safe/cracked/lit,
/area/hangar)
"Xl" = (
/obj/structure/flora/rock/pile/rockplanet,
/turf/open/floor/plating/asteroid/snow/lit,
/area/hangar)
"Xt" = (
/obj/structure/table/reinforced,
/turf/open/floor/plasteel/tech,
/area/hangar)
"XI" = (
/turf/open/floor/plasteel/stairs/mid{
	dir = 1;
	color = "#2e2e2e"
	},
/area/hangar)
"YL" = (
/obj/effect/turf_decal/industrial/outline/yellow,
/obj/machinery/atmospherics/components/unary/hydrogen_pump{
	dir = 4
	},
/turf/open/floor/plasteel/tech/grid,
/area/hangar)
"Zj" = (
/obj/structure/catwalk/over/plated_catwalk/dark,
/obj/machinery/atmospherics/pipe/simple/orange/hidden{
	dir = 8
	},
/turf/open/floor/plating{
	planetary_atmos = 1
	},
/area/hangar)
"ZC" = (
/obj/effect/turf_decal/corner/opaque/bar{
	dir = 8
	},
/turf/open/floor/plasteel/dark,
/area/hangar)
"ZX" = (
/obj/effect/turf_decal/corner/opaque/bar/half,
/obj/effect/turf_decal/weather/rock,
/turf/open/floor/plasteel/dark,
/area/hangar)

(1,1,1) = {"
Ja
Ja
Ja
Ja
Ja
Ja
Ja
Ja
Ja
Ja
Ja
Ja
Ja
Ja
Ja
Ja
Ja
Ja
Ja
Ja
Ja
Ja
Ja
Ja
Ja
Ja
Ja
Ja
Ja
Ja
Ja
Ja
Ja
Ja
Ja
Ja
Ja
Ja
Ja
Ja
Ja
Ja
Ja
Ja
Ja
Ja
Ja
Ja
Ja
Ja
Ja
Ja
Ja
Ja
Ja
Ja
Ja
Ja
Ja
"}
(2,1,1) = {"
Ja
Ja
Ja
Ja
Ja
Ja
Ja
Ja
Ja
Ja
Ja
Ja
Ja
Ja
Ja
Ja
Ja
Ja
Ja
Ja
Ja
Ja
Ja
Ja
Ja
Ja
Ja
Ja
Ja
Ja
Ja
Ja
Ja
Ja
Ja
Ja
Ja
Ja
Ja
Ja
Ja
Ja
Ja
Ja
Ja
Ja
Ja
Ja
Ja
Ja
Ja
Ja
Ja
Ja
Ja
Ja
Ja
Ja
Ja
"}
(3,1,1) = {"
Ja
Ja
Ja
Ja
Ja
Ja
Ja
Ja
Ja
Ja
Ja
Ja
Ja
Ja
Ja
Ja
Ja
Ja
Ja
Ja
Ja
Ja
Ja
Ja
Ja
Ja
Ja
Ja
Ja
Ja
Ja
Ja
Ja
Ja
Ja
Ja
Ja
Ja
Ja
Ja
Ja
Ja
Ja
Ja
Ja
Ja
Ja
Ja
Ja
Ja
Ja
Ja
Ja
Ja
Ja
Ja
Ja
Ja
Ja
"}
(4,1,1) = {"
Ja
Ja
Ja
Ja
Ja
Ja
Ja
Ja
Ja
jG
jr
di
Nu
Nu
Nu
Nu
Nu
Nu
Nu
Nu
Nu
Nu
Nu
Nu
Nu
Nu
Nu
Nu
Nu
Nu
Nu
Nu
Nu
Nu
Nu
Nu
Nu
Nu
Nu
Nu
Nu
Nu
Nu
Nu
Nu
Nu
Nu
Nu
Nu
Nu
Nu
Nu
Dq
jr
ri
Ja
Ja
Ja
Ja
"}
(5,1,1) = {"
Ja
Ja
Ja
Ja
Ja
Ja
Ja
Ja
Ja
NK
Ir
sy
zF
zF
Ov
zF
qo
zF
zF
Ov
zF
zF
zF
zF
Ov
zF
qo
zF
zF
Ov
zF
zF
zF
zF
Ov
zF
qo
zF
zF
Ov
zF
zF
zF
zF
Ov
zF
qo
zF
zF
Ov
zF
zF
BV
Ir
ZX
FZ
Ja
Ja
Ja
"}
(6,1,1) = {"
Ja
Ja
Ja
Ja
Ja
Ja
Ja
Ja
Ja
NK
Ir
sy
EL
EL
EL
EL
EL
EL
EL
EL
EL
EL
EL
EL
EL
EL
EL
EL
EL
EL
EL
EL
EL
EL
EL
EL
EL
EL
EL
EL
EL
EL
EL
EL
EL
EL
EL
EL
EL
EL
EL
EL
BV
Ir
ZX
yR
Ja
Ja
Ja
"}
(7,1,1) = {"
Ja
Ja
Ja
Ja
Ja
Ja
Ja
Ja
Xl
NK
Ir
sy
hJ
hJ
hJ
hJ
hJ
hJ
hJ
hJ
hJ
hJ
hJ
hJ
hJ
hJ
hJ
hJ
hJ
hJ
hJ
hJ
hJ
hJ
hJ
hJ
hJ
hJ
hJ
hJ
hJ
hJ
hJ
hJ
hJ
hJ
hJ
hJ
hJ
hJ
hJ
gf
BV
Ir
ZX
MS
Ja
Ja
Ja
"}
(8,1,1) = {"
Ja
Ja
Ja
Ja
Ja
Ja
Ja
Ja
MS
NK
Ir
sy
hJ
hJ
hJ
hJ
hJ
hJ
hJ
hJ
hJ
hJ
hJ
hJ
hJ
hJ
hJ
hJ
hJ
hJ
hJ
hJ
hJ
hJ
hJ
hJ
hJ
hJ
hJ
hJ
hJ
hJ
hJ
hJ
hJ
hJ
hJ
hJ
hJ
hJ
hJ
hJ
BV
Ir
ZX
pG
Ja
Ja
Ja
"}
(9,1,1) = {"
Ja
Ja
Ja
Ja
Ja
Ja
Ja
Ja
yR
NK
Ir
sy
Kg
hJ
hJ
hJ
hJ
hJ
hJ
hJ
hJ
hJ
hJ
hJ
hJ
hJ
hJ
hJ
hJ
hJ
hJ
hJ
hJ
hJ
hJ
hJ
hJ
hJ
hJ
hJ
hJ
hJ
hJ
hJ
hJ
hJ
hJ
hJ
hJ
hJ
hJ
Kg
BV
Ir
ZX
FZ
Ja
Ja
Ja
"}
(10,1,1) = {"
Ja
Ja
Ja
Ja
Ja
Ja
Ja
Ja
MS
NK
WS
xK
hJ
hJ
hJ
hJ
hJ
hJ
hJ
hJ
hJ
hJ
hJ
hJ
hJ
hJ
hJ
hJ
hJ
hJ
hJ
hJ
hJ
hJ
hJ
hJ
hJ
hJ
hJ
hJ
hJ
hJ
hJ
hJ
hJ
hJ
hJ
hJ
hJ
hJ
hJ
hJ
HD
hB
ZX
FZ
FZ
Ja
Ja
"}
(11,1,1) = {"
Ja
Ja
Ja
Ja
Ja
Ja
Ja
FZ
FD
NK
Qr
yE
hJ
hJ
hJ
hJ
hJ
hJ
hJ
hJ
hJ
hJ
hJ
hJ
hJ
hJ
hJ
hJ
hJ
hJ
hJ
hJ
hJ
hJ
hJ
hJ
hJ
hJ
hJ
hJ
hJ
hJ
hJ
hJ
hJ
hJ
hJ
hJ
hJ
hJ
hJ
hJ
gs
Zj
ZX
FD
FZ
Ja
Ja
"}
(12,1,1) = {"
Ja
Ja
Ja
Ja
Ja
Ja
Ja
FZ
FD
NK
Qr
sy
hJ
hJ
hJ
hJ
hJ
hJ
hJ
hJ
hJ
hJ
hJ
hJ
hJ
hJ
hJ
hJ
hJ
hJ
hJ
hJ
hJ
hJ
hJ
hJ
hJ
hJ
hJ
hJ
hJ
hJ
hJ
hJ
hJ
hJ
hJ
hJ
hJ
hJ
hJ
hJ
BV
Zj
ZX
FD
FZ
Ja
Ja
"}
(13,1,1) = {"
Ja
Ja
Ja
Ja
Ja
Ja
Ja
FZ
dh
NK
Qr
sy
hJ
hJ
hJ
hJ
hJ
hJ
hJ
hJ
hJ
hJ
hJ
hJ
hJ
hJ
hJ
hJ
hJ
hJ
hJ
hJ
hJ
hJ
hJ
hJ
hJ
hJ
hJ
hJ
hJ
hJ
hJ
hJ
hJ
hJ
hJ
hJ
hJ
hJ
hJ
hJ
BV
Zj
ZX
RL
if
Ja
Ja
"}
(14,1,1) = {"
Ja
Ja
Ja
Ja
Ja
Ja
FZ
yR
MS
NK
Qr
sy
Kg
hJ
hJ
hJ
hJ
hJ
hJ
hJ
hJ
hJ
hJ
hJ
hJ
hJ
hJ
hJ
hJ
hJ
hJ
hJ
hJ
hJ
hJ
hJ
hJ
hJ
hJ
hJ
hJ
hJ
hJ
hJ
hJ
hJ
hJ
hJ
hJ
hJ
hJ
Kg
BV
Zj
ZX
FD
MS
FZ
Ja
"}
(15,1,1) = {"
Ja
Ja
Ja
Ja
Ja
Ja
Xl
FD
MS
NK
Qr
sy
hJ
hJ
hJ
hJ
hJ
hJ
hJ
hJ
hJ
hJ
hJ
hJ
hJ
hJ
hJ
hJ
hJ
hJ
hJ
hJ
hJ
hJ
hJ
hJ
hJ
hJ
hJ
hJ
hJ
hJ
hJ
hJ
hJ
hJ
hJ
hJ
hJ
hJ
hJ
hJ
BV
Zj
ZX
FD
dh
FZ
Ja
"}
(16,1,1) = {"
Ja
Ja
Ja
Ja
Ja
Ja
Ja
Ja
Xh
NK
Qr
sy
hJ
hJ
hJ
hJ
hJ
hJ
hJ
hJ
hJ
hJ
hJ
hJ
hJ
hJ
hJ
hJ
hJ
hJ
hJ
hJ
hJ
hJ
hJ
hJ
hJ
hJ
hJ
hJ
hJ
hJ
hJ
hJ
hJ
hJ
hJ
hJ
hJ
hJ
hJ
hJ
BV
Zj
ZX
FD
MS
kn
Ja
"}
(17,1,1) = {"
Ja
Ja
Ja
Ja
Ja
Ja
Ja
Ja
FD
NK
Qr
sy
hJ
hJ
hJ
hJ
hJ
hJ
hJ
hJ
hJ
hJ
hJ
hJ
hJ
hJ
hJ
hJ
hJ
hJ
hJ
hJ
hJ
hJ
hJ
hJ
hJ
hJ
hJ
hJ
hJ
hJ
hJ
hJ
hJ
hJ
hJ
hJ
hJ
hJ
hJ
hJ
BV
Zj
ZX
FD
FD
FD
Ja
"}
(18,1,1) = {"
Ja
Ja
Ja
Ja
Ja
Ja
Ja
Ja
FD
NK
Qr
sy
hJ
hJ
hJ
hJ
hJ
hJ
hJ
hJ
hJ
hJ
hJ
hJ
hJ
hJ
hJ
hJ
hJ
hJ
hJ
hJ
hJ
hJ
hJ
hJ
hJ
hJ
hJ
hJ
hJ
hJ
hJ
hJ
hJ
hJ
hJ
hJ
hJ
hJ
hJ
hJ
BV
Zj
ZX
MS
yR
FZ
Ja
"}
(19,1,1) = {"
Ja
Ja
Ja
Ja
Ja
Ja
Ja
Ja
RL
NK
Qr
sy
Kg
hJ
hJ
hJ
hJ
hJ
hJ
hJ
hJ
hJ
hJ
hJ
hJ
hJ
hJ
hJ
hJ
hJ
hJ
hJ
hJ
hJ
hJ
hJ
hJ
hJ
hJ
hJ
hJ
hJ
hJ
hJ
hJ
hJ
hJ
hJ
hJ
hJ
hJ
Kg
BV
Zj
ZX
FD
MS
FZ
Ja
"}
(20,1,1) = {"
Ja
Ja
Ja
Ja
Ja
Ja
Ja
Ja
FD
NK
Qr
sy
hJ
hJ
hJ
hJ
hJ
hJ
hJ
hJ
hJ
hJ
hJ
hJ
hJ
hJ
hJ
hJ
hJ
hJ
hJ
hJ
hJ
hJ
hJ
hJ
hJ
hJ
hJ
hJ
hJ
hJ
hJ
hJ
hJ
hJ
hJ
hJ
hJ
hJ
hJ
hJ
BV
Zj
ZX
FD
MS
Ja
Ja
"}
(21,1,1) = {"
Ja
Ja
Ja
Ja
Ja
Ja
Ja
Ja
Ja
NK
Qr
Wy
hJ
hJ
hJ
hJ
hJ
hJ
hJ
hJ
hJ
hJ
hJ
hJ
hJ
hJ
hJ
hJ
hJ
hJ
hJ
hJ
hJ
hJ
hJ
hJ
hJ
hJ
hJ
hJ
hJ
hJ
hJ
hJ
hJ
hJ
hJ
hJ
hJ
hJ
hJ
hJ
MT
Zj
ZX
MS
FZ
Ja
Ja
"}
(22,1,1) = {"
Ja
Ja
Ja
Ja
Ja
Ja
Ja
Ja
Ja
NK
Qr
sy
hJ
hJ
hJ
hJ
hJ
hJ
hJ
hJ
hJ
hJ
hJ
hJ
hJ
hJ
hJ
hJ
hJ
hJ
hJ
hJ
hJ
hJ
hJ
hJ
hJ
hJ
hJ
hJ
hJ
hJ
hJ
hJ
hJ
hJ
hJ
hJ
hJ
hJ
hJ
hJ
BV
Zj
ZX
MS
FZ
Ja
Ja
"}
(23,1,1) = {"
Ja
Ja
Ja
Ja
Ja
Ja
Ja
Ja
Ja
NK
Qr
sy
hJ
hJ
hJ
hJ
hJ
hJ
hJ
hJ
hJ
hJ
hJ
hJ
hJ
hJ
hJ
hJ
hJ
hJ
hJ
hJ
hJ
hJ
hJ
hJ
hJ
hJ
hJ
hJ
hJ
hJ
hJ
hJ
hJ
hJ
hJ
hJ
hJ
hJ
hJ
hJ
BV
Zj
ZX
FD
Xl
Ja
Ja
"}
(24,1,1) = {"
Ja
Ja
Ja
Ja
Ja
Ja
Ja
Ja
Ja
NK
Qr
sy
Kg
hJ
hJ
hJ
hJ
hJ
hJ
hJ
hJ
hJ
hJ
hJ
hJ
hJ
hJ
hJ
hJ
hJ
hJ
hJ
hJ
hJ
hJ
hJ
hJ
hJ
hJ
hJ
hJ
hJ
hJ
hJ
hJ
hJ
hJ
hJ
hJ
hJ
hJ
Kg
BV
Zj
ZX
RL
FZ
Ja
Ja
"}
(25,1,1) = {"
Ja
Ja
Ja
Ja
Ja
Ja
Ja
Ja
pG
NK
Qr
sy
hJ
hJ
hJ
hJ
hJ
hJ
hJ
hJ
hJ
hJ
hJ
hJ
hJ
hJ
hJ
hJ
hJ
hJ
hJ
hJ
hJ
hJ
hJ
hJ
hJ
hJ
hJ
hJ
hJ
hJ
hJ
hJ
hJ
hJ
hJ
hJ
hJ
hJ
hJ
hJ
BV
Zj
ZX
FD
FD
Ja
Ja
"}
(26,1,1) = {"
Ja
Ja
Ja
Ja
Ja
Ja
Ja
Ja
RL
NK
JC
Rt
hJ
hJ
hJ
hJ
hJ
hJ
hJ
hJ
hJ
hJ
hJ
hJ
hJ
hJ
hJ
hJ
hJ
hJ
hJ
hJ
hJ
hJ
hJ
hJ
hJ
hJ
hJ
hJ
hJ
hJ
hJ
hJ
hJ
hJ
hJ
hJ
hJ
hJ
hJ
hJ
HD
JL
ZX
dh
RL
Ja
Ja
"}
(27,1,1) = {"
Ja
Ja
Ja
Ja
Ja
Ja
Ja
Ja
dh
NK
yL
sy
hJ
hJ
hJ
hJ
hJ
hJ
hJ
hJ
hJ
hJ
hJ
hJ
hJ
hJ
hJ
hJ
hJ
hJ
hJ
hJ
hJ
hJ
hJ
hJ
hJ
hJ
hJ
hJ
hJ
hJ
hJ
hJ
hJ
hJ
hJ
hJ
hJ
hJ
hJ
hJ
BV
Zj
ZX
FD
kn
Ja
Ja
"}
(28,1,1) = {"
Ja
Ja
Ja
Ja
Ja
Ja
Ja
Ja
Ja
NK
Qr
sy
hJ
hJ
hJ
hJ
hJ
hJ
hJ
hJ
hJ
hJ
hJ
hJ
hJ
hJ
hJ
hJ
hJ
hJ
hJ
hJ
hJ
hJ
hJ
hJ
hJ
hJ
hJ
hJ
hJ
hJ
hJ
hJ
hJ
hJ
hJ
hJ
hJ
hJ
hJ
hJ
BV
Zj
ZX
FD
Ja
Ja
Ja
"}
(29,1,1) = {"
Ja
Ja
Ja
Ja
Ja
Ja
Ja
Ja
Ja
NK
Qr
sy
hJ
hJ
hJ
hJ
hJ
hJ
hJ
hJ
hJ
hJ
hJ
hJ
hJ
hJ
hJ
hJ
hJ
hJ
hJ
hJ
hJ
hJ
hJ
hJ
hJ
hJ
hJ
hJ
hJ
hJ
hJ
hJ
hJ
hJ
hJ
hJ
hJ
hJ
hJ
hJ
BV
Zj
ZX
MS
Ja
Ja
Ja
"}
(30,1,1) = {"
Ja
Ja
Ja
Ja
Ja
Ja
Ja
Ja
Ja
NK
Qr
sy
Kg
hJ
hJ
hJ
hJ
hJ
hJ
hJ
hJ
hJ
hJ
hJ
hJ
hJ
hJ
hJ
hJ
hJ
hJ
hJ
hJ
hJ
hJ
hJ
hJ
hJ
hJ
hJ
hJ
hJ
hJ
hJ
hJ
hJ
hJ
hJ
hJ
hJ
hJ
Kg
BV
Zj
ZX
yR
Ja
Ja
Ja
"}
(31,1,1) = {"
Ja
Ja
Ja
Ja
Ja
Ja
Ja
Ja
RL
NK
Qr
yE
hJ
hJ
hJ
hJ
hJ
hJ
hJ
hJ
hJ
hJ
hJ
hJ
hJ
hJ
hJ
hJ
hJ
hJ
hJ
hJ
hJ
hJ
hJ
hJ
hJ
hJ
hJ
hJ
hJ
hJ
hJ
hJ
hJ
hJ
hJ
hJ
hJ
hJ
hJ
hJ
MT
Zj
ZX
MS
Ja
Ja
Ja
"}
(32,1,1) = {"
Ja
Ja
Ja
Ja
Ja
Ja
Ja
Ja
MS
NK
Qr
sy
hJ
hJ
hJ
hJ
hJ
hJ
hJ
hJ
hJ
hJ
hJ
hJ
hJ
hJ
hJ
hJ
hJ
hJ
hJ
hJ
hJ
hJ
hJ
hJ
hJ
hJ
hJ
hJ
hJ
hJ
hJ
hJ
hJ
hJ
hJ
hJ
hJ
hJ
hJ
hJ
BV
Zj
ZX
MS
Ja
Ja
Ja
"}
(33,1,1) = {"
Ja
Ja
Ja
Ja
Ja
Ja
Ja
Ja
kR
NK
Qr
sy
hJ
hJ
hJ
hJ
hJ
hJ
hJ
hJ
hJ
hJ
hJ
hJ
hJ
hJ
hJ
hJ
hJ
hJ
hJ
hJ
hJ
hJ
hJ
hJ
hJ
hJ
hJ
hJ
hJ
hJ
hJ
hJ
hJ
hJ
hJ
hJ
hJ
hJ
hJ
hJ
BV
Zj
ZX
FD
Ja
Ja
Ja
"}
(34,1,1) = {"
Ja
Ja
Ja
Ja
Ja
Ja
Ja
Ja
MS
NK
Qr
sy
hJ
hJ
hJ
hJ
hJ
hJ
hJ
hJ
hJ
hJ
hJ
hJ
hJ
hJ
hJ
hJ
hJ
hJ
hJ
hJ
hJ
hJ
hJ
hJ
hJ
hJ
hJ
hJ
hJ
hJ
hJ
hJ
hJ
hJ
hJ
hJ
hJ
hJ
hJ
hJ
BV
Zj
ZX
dh
Ja
Ja
Ja
"}
(35,1,1) = {"
Ja
Ja
Ja
Ja
Ja
Ja
Ja
Ja
FD
NK
Qr
sy
Kg
hJ
hJ
hJ
hJ
hJ
hJ
hJ
hJ
hJ
hJ
hJ
hJ
hJ
hJ
hJ
hJ
hJ
hJ
hJ
hJ
hJ
hJ
hJ
hJ
hJ
hJ
hJ
hJ
hJ
hJ
hJ
hJ
hJ
hJ
hJ
hJ
hJ
hJ
Kg
BV
Zj
ZX
if
Ja
Ja
Ja
"}
(36,1,1) = {"
Ja
Ja
Ja
Ja
Ja
Ja
Ja
FZ
FD
NK
Qr
sy
hJ
hJ
hJ
hJ
hJ
hJ
hJ
hJ
hJ
hJ
hJ
hJ
hJ
hJ
hJ
hJ
hJ
hJ
hJ
hJ
hJ
hJ
hJ
hJ
hJ
hJ
hJ
hJ
hJ
hJ
hJ
hJ
hJ
hJ
hJ
hJ
hJ
hJ
hJ
hJ
BV
Zj
ZX
RL
Ja
Ja
Ja
"}
(37,1,1) = {"
Ja
Ja
Ja
Ja
Ja
Ja
Ja
FI
FD
NK
Qr
sy
hJ
hJ
hJ
hJ
hJ
hJ
hJ
hJ
hJ
hJ
hJ
hJ
hJ
hJ
hJ
hJ
hJ
hJ
hJ
hJ
hJ
hJ
hJ
hJ
hJ
hJ
hJ
hJ
hJ
hJ
hJ
hJ
hJ
hJ
hJ
hJ
hJ
hJ
hJ
hJ
BV
Zj
ZX
Ja
Ja
Ja
Ja
"}
(38,1,1) = {"
Ja
Ja
Ja
Ja
Ja
Ja
Ja
FZ
dh
NK
Qr
sy
hJ
hJ
hJ
hJ
hJ
hJ
hJ
hJ
hJ
hJ
hJ
hJ
hJ
hJ
hJ
hJ
hJ
hJ
hJ
hJ
hJ
hJ
hJ
hJ
hJ
hJ
hJ
hJ
hJ
hJ
hJ
hJ
hJ
hJ
hJ
hJ
hJ
hJ
hJ
hJ
BV
Zj
ZX
Ja
Ja
Ja
Ja
"}
(39,1,1) = {"
Ja
Ja
Ja
Ja
Ja
Ja
Ja
Ja
FZ
NK
Qr
sy
hJ
hJ
hJ
hJ
hJ
hJ
hJ
hJ
hJ
hJ
hJ
hJ
hJ
hJ
hJ
hJ
hJ
hJ
hJ
hJ
hJ
hJ
hJ
hJ
hJ
hJ
hJ
hJ
hJ
hJ
hJ
hJ
hJ
hJ
hJ
hJ
hJ
hJ
hJ
hJ
BV
Zj
ZX
Ja
Ja
Ja
Ja
"}
(40,1,1) = {"
Ja
Ja
Ja
Ja
Ja
Ja
Ja
Ja
MS
NK
Qr
sy
Kg
hJ
hJ
hJ
hJ
hJ
hJ
hJ
hJ
hJ
hJ
hJ
hJ
hJ
hJ
hJ
hJ
hJ
hJ
hJ
hJ
hJ
hJ
hJ
hJ
hJ
hJ
hJ
hJ
hJ
hJ
hJ
hJ
hJ
hJ
hJ
hJ
hJ
hJ
Kg
BV
Zj
ZX
MS
Ja
Ja
Ja
"}
(41,1,1) = {"
Ja
Ja
Ja
Ja
Ja
Ja
Ja
Ja
yR
NK
Qr
Wy
hJ
hJ
hJ
hJ
hJ
hJ
hJ
hJ
hJ
hJ
hJ
hJ
hJ
hJ
hJ
hJ
hJ
hJ
hJ
hJ
hJ
hJ
hJ
hJ
hJ
hJ
hJ
hJ
hJ
hJ
hJ
hJ
hJ
hJ
hJ
hJ
hJ
hJ
hJ
hJ
MT
Zj
ZX
yR
Ja
Ja
Ja
"}
(42,1,1) = {"
Ja
Ja
Ja
Ja
Ja
Ja
Ja
Ja
Ja
NK
JC
Rt
hJ
hJ
hJ
hJ
hJ
hJ
hJ
hJ
hJ
hJ
hJ
hJ
hJ
hJ
hJ
hJ
hJ
hJ
hJ
hJ
hJ
hJ
hJ
hJ
hJ
hJ
hJ
hJ
hJ
hJ
hJ
hJ
hJ
hJ
hJ
hJ
hJ
hJ
hJ
hJ
HD
JL
ZX
FD
FD
Ja
Ja
"}
(43,1,1) = {"
Ja
Ja
Ja
Ja
Ja
Ja
Ja
Ja
Ja
NK
Qr
sy
hJ
hJ
hJ
hJ
hJ
hJ
hJ
hJ
hJ
hJ
hJ
hJ
hJ
hJ
hJ
hJ
hJ
hJ
hJ
hJ
hJ
hJ
hJ
hJ
hJ
hJ
hJ
hJ
hJ
hJ
hJ
hJ
hJ
hJ
hJ
hJ
hJ
hJ
hJ
hJ
BV
Zj
ZX
FD
FD
Ja
Ja
"}
(44,1,1) = {"
Ja
Ja
Ja
Ja
Ja
Ja
Ja
Ja
Ja
NK
Qr
sy
hJ
hJ
hJ
hJ
hJ
hJ
hJ
hJ
hJ
hJ
hJ
hJ
hJ
hJ
hJ
hJ
hJ
hJ
hJ
hJ
hJ
hJ
hJ
hJ
hJ
hJ
hJ
hJ
hJ
hJ
hJ
hJ
hJ
hJ
hJ
hJ
hJ
hJ
hJ
hJ
BV
Zj
ZX
FD
FZ
Ja
Ja
"}
(45,1,1) = {"
Ja
Ja
Ja
Ja
Ja
Ja
Ja
Ja
Ja
NK
Qr
sy
Kg
hJ
hJ
hJ
hJ
hJ
hJ
hJ
hJ
hJ
hJ
hJ
hJ
hJ
hJ
hJ
hJ
hJ
hJ
hJ
hJ
hJ
hJ
hJ
hJ
hJ
hJ
hJ
hJ
hJ
hJ
hJ
hJ
hJ
hJ
hJ
hJ
hJ
hJ
Kg
BV
Zj
ZX
FD
FZ
Ja
Ja
"}
(46,1,1) = {"
Ja
Ja
Ja
Ja
Ja
Ja
Ja
Ja
Ja
NK
Qr
sy
hJ
hJ
hJ
hJ
hJ
hJ
hJ
hJ
hJ
hJ
hJ
hJ
hJ
hJ
hJ
hJ
hJ
hJ
hJ
hJ
hJ
hJ
hJ
hJ
hJ
hJ
hJ
hJ
hJ
hJ
hJ
hJ
hJ
hJ
hJ
hJ
hJ
hJ
hJ
hJ
BV
Zj
ZX
RL
FZ
Ja
Ja
"}
(47,1,1) = {"
Ja
Ja
Ja
Ja
Ja
Ja
Ja
Ja
Ja
NK
Qr
Wy
hJ
hJ
hJ
hJ
hJ
hJ
hJ
hJ
hJ
hJ
hJ
hJ
hJ
hJ
hJ
hJ
hJ
hJ
hJ
hJ
hJ
hJ
hJ
hJ
hJ
hJ
hJ
hJ
hJ
hJ
hJ
hJ
hJ
hJ
hJ
hJ
hJ
hJ
hJ
hJ
MT
Zj
ZX
FD
RL
Xl
Ja
"}
(48,1,1) = {"
Ja
Ja
Ja
Ja
Ja
Ja
Ja
Ja
Ja
NK
Qr
sy
hJ
hJ
hJ
hJ
hJ
hJ
hJ
hJ
hJ
hJ
hJ
hJ
hJ
hJ
hJ
hJ
hJ
hJ
hJ
hJ
hJ
hJ
hJ
hJ
hJ
hJ
hJ
hJ
hJ
hJ
hJ
hJ
hJ
hJ
hJ
hJ
hJ
hJ
hJ
hJ
BV
Zj
ZX
FD
MS
FZ
Ja
"}
(49,1,1) = {"
Ja
Ja
Ja
Ja
Ja
Ja
Ja
Ja
Ja
NK
Qr
sy
hJ
hJ
hJ
hJ
hJ
hJ
hJ
hJ
hJ
hJ
hJ
hJ
hJ
hJ
hJ
hJ
hJ
hJ
hJ
hJ
hJ
hJ
hJ
hJ
hJ
hJ
hJ
hJ
hJ
hJ
hJ
hJ
hJ
hJ
hJ
hJ
hJ
hJ
hJ
hJ
BV
Zj
ZX
MS
FD
FZ
Ja
"}
(50,1,1) = {"
Ja
Ja
Ja
Ja
Ja
Ja
Ja
Ja
Ja
NK
Qr
sy
Kg
hJ
hJ
hJ
hJ
hJ
hJ
hJ
hJ
hJ
hJ
hJ
hJ
hJ
hJ
hJ
hJ
hJ
hJ
hJ
hJ
hJ
hJ
hJ
hJ
hJ
hJ
hJ
hJ
hJ
hJ
hJ
hJ
hJ
hJ
hJ
hJ
hJ
hJ
Kg
BV
Zj
ZX
FD
kb
FD
Ja
"}
(51,1,1) = {"
Ja
Ja
Ja
Ja
Ja
Ja
Ja
Ja
if
NK
Qr
sy
hJ
hJ
hJ
hJ
hJ
hJ
hJ
hJ
hJ
hJ
hJ
hJ
hJ
hJ
hJ
hJ
hJ
hJ
hJ
hJ
hJ
hJ
hJ
hJ
hJ
hJ
hJ
hJ
hJ
hJ
hJ
hJ
hJ
hJ
hJ
hJ
hJ
hJ
hJ
hJ
BV
Zj
ZX
RL
MS
FD
Ja
"}
(52,1,1) = {"
Ja
Ja
Ja
Ja
Ja
Ja
Ja
Ja
RL
NK
Qr
sy
hJ
hJ
hJ
hJ
hJ
hJ
hJ
hJ
hJ
hJ
hJ
hJ
hJ
hJ
hJ
hJ
hJ
hJ
hJ
hJ
hJ
hJ
hJ
hJ
hJ
hJ
hJ
hJ
hJ
hJ
hJ
hJ
hJ
hJ
hJ
hJ
hJ
hJ
hJ
hJ
BV
Zj
ZX
FD
FD
MS
Ja
"}
(53,1,1) = {"
Ja
Ja
Ja
Ja
Ja
Ja
Ja
Ja
FZ
NK
Qr
sy
hJ
hJ
hJ
hJ
hJ
hJ
hJ
hJ
hJ
hJ
hJ
hJ
hJ
hJ
hJ
hJ
hJ
hJ
hJ
hJ
hJ
hJ
hJ
hJ
hJ
hJ
hJ
hJ
hJ
hJ
hJ
hJ
hJ
hJ
hJ
hJ
hJ
hJ
hJ
hJ
BV
Zj
ZX
FD
yR
Xl
Ja
"}
(54,1,1) = {"
Ja
Ja
Ja
Ja
Ja
Ja
Ja
Ja
Ja
NK
Qr
sy
hJ
hJ
hJ
hJ
hJ
hJ
hJ
hJ
hJ
hJ
hJ
hJ
hJ
hJ
hJ
hJ
hJ
hJ
hJ
hJ
hJ
hJ
hJ
hJ
hJ
hJ
hJ
hJ
hJ
hJ
hJ
hJ
hJ
hJ
hJ
hJ
hJ
hJ
hJ
hJ
BV
Zj
ZX
MS
FZ
Ja
Ja
"}
(55,1,1) = {"
Ja
Ja
Ja
Ja
Ja
Ja
Ja
Ja
Ja
NK
Qr
sy
Kg
hJ
hJ
hJ
hJ
hJ
hJ
hJ
hJ
hJ
hJ
hJ
hJ
hJ
hJ
hJ
hJ
hJ
hJ
hJ
hJ
hJ
hJ
hJ
hJ
hJ
hJ
hJ
hJ
hJ
hJ
hJ
hJ
hJ
hJ
hJ
hJ
hJ
hJ
Kg
BV
Zj
ZX
yR
Ja
Ja
Ja
"}
(56,1,1) = {"
Ja
Vw
Vw
Vw
Vw
Vw
Ja
Vw
Ja
FN
Qr
sy
hJ
hJ
hJ
hJ
hJ
hJ
hJ
hJ
hJ
hJ
hJ
hJ
hJ
hJ
hJ
hJ
hJ
hJ
hJ
hJ
hJ
hJ
hJ
hJ
hJ
hJ
hJ
hJ
hJ
hJ
hJ
hJ
hJ
hJ
hJ
hJ
hJ
hJ
hJ
hJ
BV
Zj
ZX
RL
Ja
Ja
Ja
"}
(57,1,1) = {"
Ja
Vw
dh
FD
dh
Vw
Vw
YL
lU
jy
Kk
yE
hJ
hJ
hJ
hJ
hJ
hJ
hJ
hJ
hJ
hJ
hJ
hJ
hJ
hJ
hJ
hJ
hJ
hJ
hJ
hJ
hJ
hJ
hJ
hJ
hJ
hJ
hJ
hJ
hJ
hJ
hJ
hJ
hJ
hJ
hJ
hJ
hJ
hJ
hJ
hJ
gs
Zj
ZX
FZ
Ja
Ja
Ja
"}
(58,1,1) = {"
Ja
Vw
FD
mi
FD
FD
Iw
uf
uf
bX
Ir
sy
hJ
hJ
hJ
hJ
hJ
hJ
hJ
hJ
hJ
hJ
hJ
hJ
hJ
hJ
hJ
hJ
hJ
hJ
hJ
hJ
hJ
hJ
hJ
hJ
hJ
hJ
hJ
hJ
hJ
hJ
hJ
hJ
hJ
hJ
hJ
hJ
hJ
hJ
hJ
hJ
BV
Zj
ZX
FZ
Ja
Ja
Ja
"}
(59,1,1) = {"
Ja
Vw
dh
FD
dh
Vw
Vw
Xt
uf
kK
JC
xK
hJ
hJ
hJ
hJ
hJ
hJ
hJ
hJ
hJ
hJ
hJ
hJ
hJ
hJ
hJ
hJ
hJ
hJ
hJ
hJ
hJ
hJ
hJ
hJ
hJ
hJ
hJ
hJ
hJ
hJ
hJ
hJ
hJ
hJ
hJ
hJ
hJ
hJ
hJ
hJ
HD
JL
ZX
Ja
Ja
Ja
Ja
"}
(60,1,1) = {"
Ja
Vw
Vw
Vw
Vw
Vw
Vw
Xb
CS
jk
Qr
sy
Kg
hJ
hJ
hJ
hJ
hJ
hJ
hJ
hJ
hJ
hJ
hJ
hJ
hJ
hJ
hJ
hJ
hJ
hJ
hJ
hJ
hJ
hJ
hJ
hJ
hJ
hJ
hJ
hJ
hJ
hJ
hJ
hJ
hJ
hJ
hJ
hJ
hJ
hJ
Kg
BV
Zj
ZX
Ja
Ja
Ja
Ja
"}
(61,1,1) = {"
Ja
Ja
Ja
Ja
Ja
Ja
Vw
Vw
Ja
zG
yL
sy
hJ
hJ
hJ
hJ
hJ
hJ
hJ
hJ
hJ
hJ
hJ
hJ
hJ
hJ
hJ
hJ
hJ
hJ
hJ
hJ
hJ
hJ
hJ
hJ
hJ
hJ
hJ
hJ
hJ
hJ
hJ
hJ
hJ
hJ
hJ
hJ
hJ
hJ
hJ
hJ
BV
Zj
ZX
Ja
Ja
Ja
Ja
"}
(62,1,1) = {"
Ja
Ja
Ja
Ja
Ja
Ja
Ja
Ja
Ja
Ja
gR
sy
hJ
hJ
hJ
hJ
hJ
hJ
hJ
hJ
hJ
hJ
hJ
hJ
hJ
hJ
hJ
hJ
hJ
hJ
hJ
hJ
hJ
hJ
hJ
hJ
hJ
hJ
hJ
hJ
hJ
hJ
hJ
hJ
hJ
hJ
hJ
hJ
hJ
hJ
hJ
hJ
BV
Zj
ZX
Ja
Ja
Ja
Ja
"}
(63,1,1) = {"
Ja
Ja
Ja
Ja
Ja
Ja
Ja
Ja
Ja
FD
Hw
ZC
fe
fe
fe
fe
yy
fe
fe
fe
fe
fe
fe
fe
fe
fe
yy
fe
fe
fe
fe
fe
fe
fe
fe
fe
yy
fe
fe
fe
fe
fe
fe
fe
fe
fe
yy
fe
fe
fe
fe
fe
II
Zj
ZX
Ja
Ja
Ja
Ja
"}
(64,1,1) = {"
Ja
Ja
Ja
Ja
Ja
Ja
Ja
Ja
RL
FD
CC
tE
tE
tE
tE
tE
tE
tE
tE
tE
tE
zK
tE
tE
tE
tE
tE
tE
tE
zK
tE
tE
tE
tE
tE
tE
tE
tE
tE
tE
tE
zK
tE
tE
tE
tE
tE
tE
tE
tE
tE
tE
tE
GK
ZX
FZ
Ja
Ja
Ja
"}
(65,1,1) = {"
Ja
Ja
Ja
Ja
Ja
Ja
Ja
Ja
Ja
pG
tf
Fw
Fw
Fw
Fw
Fw
Fw
Fw
Fw
Fw
Fw
Fw
Fw
Fw
Fw
Fw
Fw
Fw
Fw
Fw
Fw
Fw
Fw
Fw
Fw
Fw
Fw
Fw
Fw
Fw
Fw
Fw
Fw
Fw
Fw
Fw
Fw
Fw
Fw
Fw
Fw
Fw
Fw
Fw
EM
RL
Ja
Ja
Ja
"}
(66,1,1) = {"
Ja
Ja
Ja
Ja
Ja
Ja
Ja
Ja
Ja
Ja
Ja
Ja
Ja
Ja
Ja
Ja
Ja
Ja
yR
MS
FD
FD
RL
MS
MS
Ja
Ja
Ja
Ja
Ja
Ja
Ja
Ja
RL
FD
FD
FD
Ja
Ja
Ja
Ja
FD
FD
dh
FD
Ja
Ja
Ja
Ja
FZ
yR
FD
FD
FD
MS
kR
FZ
Ja
Ja
"}
(67,1,1) = {"
Ja
Ja
Ja
Vw
Ja
Ja
Vw
Ja
Ja
Vw
Ja
Ja
Vw
Ja
Ja
Vw
Vw
Vw
Vw
Vw
tt
TB
TB
af
MS
Ja
Ja
Ja
Ja
Ja
Ja
Ja
Ja
Ja
Ja
MS
dh
yR
Ja
Ja
Ja
FD
MS
Ja
Ja
Ja
Ja
Ja
Ja
FZ
FZ
kb
Xh
RL
FZ
Ja
Ja
Ja
Ja
"}
(68,1,1) = {"
Ja
Ja
Ja
gp
co
co
XI
co
co
XI
co
co
XI
co
co
sQ
co
UG
xP
rZ
TN
OT
xl
op
yR
FD
Ja
Ja
Ja
Ja
Ja
Ja
Ja
Ja
Ja
Ja
MS
MS
MS
Ja
FD
FD
yR
Ja
Ja
Ja
Ja
Ja
Ja
Ja
FZ
FZ
FZ
FZ
Ja
Ja
Ja
Ja
Ja
"}
(69,1,1) = {"
Ja
Ja
Ja
gp
UG
UG
ia
UG
UG
ia
UG
UG
ia
UG
UG
Vw
UG
UG
UG
rZ
vu
Fe
ap
op
FD
dh
Ja
Ja
Ja
Ja
Ja
Ja
Ja
Ja
Ja
Ja
Ja
MS
RL
MS
FD
MS
Ja
Ja
Ja
Ja
Ja
Ja
Ja
Ja
Ja
FZ
Ja
Ja
Ja
Ja
Ja
Ja
Ja
"}
(70,1,1) = {"
Ja
Ja
Ja
gp
co
co
XI
co
co
XI
co
co
XI
co
co
sQ
co
UG
co
rZ
DU
sG
dl
op
FD
Ja
Ja
Ja
Ja
Ja
Ja
Ja
Ja
Ja
Ja
Ja
Ja
Ja
Ja
Ja
Ja
Ja
Ja
Ja
Ja
Ja
Ja
Ja
Ja
Ja
Ja
Ja
Ja
Ja
Ja
Ja
Ja
Ja
Ja
"}
(71,1,1) = {"
Ja
Ja
Ja
Vw
Ja
Ja
Vw
Ja
Ja
Vw
Ja
Ja
Vw
Ja
Ja
Vw
Vw
Vw
Vw
Vw
Ka
Ka
Ka
SG
MS
Ja
Ja
Ja
Ja
Ja
Ja
Ja
Ja
Ja
Ja
Ja
Ja
Ja
Ja
Ja
Ja
Ja
Ja
Ja
Ja
Ja
Ja
Ja
Ja
Ja
Ja
Ja
Ja
Ja
Ja
Ja
Ja
Ja
Ja
"}
(72,1,1) = {"
Ja
Ja
Ja
Ja
Ja
Ja
Ja
Ja
Ja
Ja
Ja
Ja
Ja
Ja
Ja
Ja
Ja
Ja
Ja
Ja
Ja
Ja
Ja
pG
kR
Ja
Ja
Ja
Ja
Ja
Ja
Ja
Ja
Ja
Ja
Ja
Ja
Ja
Ja
Ja
Ja
Ja
Ja
Ja
Ja
Ja
Ja
Ja
Ja
Ja
Ja
Ja
Ja
Ja
Ja
Ja
Ja
Ja
Ja
"}
(73,1,1) = {"
Ja
Ja
Ja
Ja
Ja
Ja
Ja
Ja
Ja
Ja
Ja
Ja
Ja
Ja
Ja
Ja
Ja
Ja
Ja
Ja
Ja
Ja
Ja
Ja
Ja
Ja
Ja
Ja
Ja
Ja
Ja
Ja
Ja
Ja
Ja
Ja
Ja
Ja
Ja
Ja
Ja
Ja
Ja
Ja
Ja
Ja
Ja
Ja
Ja
Ja
Ja
Ja
Ja
Ja
Ja
Ja
Ja
Ja
Ja
"}
(74,1,1) = {"
Ja
Ja
Ja
Ja
Ja
Ja
Ja
Ja
Ja
Ja
Ja
Ja
Ja
Ja
Ja
Ja
Ja
Ja
Ja
Ja
Ja
Ja
Ja
Ja
Ja
Ja
Ja
Ja
Ja
Ja
Ja
Ja
Ja
Ja
Ja
Ja
Ja
Ja
Ja
Ja
Ja
Ja
Ja
Ja
Ja
Ja
Ja
Ja
Ja
Ja
Ja
Ja
Ja
Ja
Ja
Ja
Ja
Ja
Ja
"}
(75,1,1) = {"
Ja
Ja
Ja
Ja
Ja
Ja
Ja
Ja
Ja
Ja
Ja
Ja
Ja
Ja
Ja
Ja
Ja
Ja
Ja
Ja
Ja
Ja
Ja
Ja
Ja
Ja
Ja
Ja
Ja
Ja
Ja
Ja
Ja
Ja
Ja
Ja
Ja
Ja
Ja
Ja
Ja
Ja
Ja
Ja
Ja
Ja
Ja
Ja
Ja
Ja
Ja
Ja
Ja
Ja
Ja
Ja
Ja
Ja
Ja
"}
(76,1,1) = {"
Ja
Ja
Ja
Ja
Ja
Ja
Ja
Ja
Ja
Ja
Ja
Ja
Ja
Ja
Ja
Ja
Ja
Ja
Ja
Ja
Ja
Ja
Ja
Ja
Ja
Ja
Ja
Ja
Ja
Ja
Ja
Ja
Ja
Ja
Ja
Ja
Ja
Ja
Ja
Ja
Ja
Ja
Ja
Ja
Ja
Ja
Ja
Ja
Ja
Ja
Ja
Ja
Ja
Ja
Ja
Ja
Ja
Ja
Ja
"}
