//MAP CONVERTED BY dmm2tgm.py THIS HEADER COMMENT PREVENTS RECONVERSION, DO NOT REMOVE
"aU" = (
/obj/structure/platform/industrial_alt/corner{
	dir = 8
	},
/turf/open/water/beach/deep,
/area/hangar)
"bt" = (
/obj/structure/platform/industrial_alt/corner{
	dir = 1
	},
/turf/open/water/beach/deep,
/area/hangar)
"bY" = (
/obj/effect/turf_decal/corner/transparent/bottlegreen/three_quarters,
/turf/open/floor/plasteel{
	planetary_atmos = 1
	},
/area/hangar)
"cx" = (
/obj/effect/turf_decal/techfloor{
	dir = 1
	},
/obj/machinery/door/airlock/hatch,
/obj/effect/mapping_helpers/airlock/locked,
/turf/open/floor/plasteel/tech,
/area/hangar)
"dD" = (
/turf/closed/indestructible/reinforced,
/area/hangar)
"eI" = (
/obj/structure/railing/corner{
	dir = 1;
	layer = 4.1
	},
/obj/effect/turf_decal/corner/transparent/bottlegreen{
	dir = 5
	},
/turf/open/floor/plasteel/tech/techmaint,
/area/hangar)
"fw" = (
/obj/structure/railing/corner{
	dir = 4
	},
/obj/effect/turf_decal/corner/transparent/bottlegreen{
	dir = 5
	},
/turf/open/floor/plasteel{
	planetary_atmos = 1
	},
/area/hangar)
"fH" = (
/obj/effect/turf_decal/corner/transparent/bottlegreen{
	dir = 8
	},
/turf/open/floor/plasteel{
	planetary_atmos = 1
	},
/area/hangar)
"fQ" = (
/obj/structure/catwalk/over/plated_catwalk,
/obj/machinery/atmospherics/pipe/manifold/orange/hidden{
	dir = 1
	},
/turf/open/floor/plating{
	planetary_atmos = 1
	},
/area/hangar)
"gd" = (
/obj/structure/catwalk/over/plated_catwalk,
/obj/machinery/atmospherics/pipe/simple/orange/hidden{
	dir = 8
	},
/turf/open/floor/plating{
	planetary_atmos = 1
	},
/area/hangar)
"hF" = (
/turf/open/floor/plasteel/tech/techmaint,
/area/hangar)
"iN" = (
/obj/machinery/atmospherics/components/binary/valve/digital,
/obj/effect/turf_decal/corner/transparent/bottlegreen{
	dir = 10
	},
/turf/open/floor/plasteel{
	planetary_atmos = 1
	},
/area/hangar)
"ji" = (
/obj/structure/platform/industrial_alt{
	dir = 1
	},
/obj/structure/platform/industrial_alt{
	dir = 4
	},
/obj/structure/platform/industrial_alt/corner{
	dir = 5
	},
/obj/effect/forcefield/mime/advanced{
	name = "long fall";
	desc = "You don't want to jump off. You probably won't be saved.";
	timeleft = null
	},
/turf/open/water/beach/deep,
/area/hangar)
"jw" = (
/obj/machinery/atmospherics/components/unary/portables_connector{
	dir = 8
	},
/obj/effect/turf_decal/industrial/outline/yellow,
/turf/open/floor/plasteel/tech/techmaint,
/area/hangar)
"ki" = (
/turf/closed/indestructible/fakeglass,
/area/hangar)
"kk" = (
/obj/machinery/atmospherics/pipe/simple/orange/hidden{
	dir = 4
	},
/obj/structure/catwalk/over/plated_catwalk,
/turf/open/floor/plating{
	planetary_atmos = 1
	},
/area/hangar)
"kA" = (
/obj/structure/platform/industrial_alt{
	dir = 4
	},
/obj/effect/forcefield/mime/advanced{
	name = "long fall";
	desc = "You don't want to jump off. You probably won't be saved.";
	timeleft = null
	},
/turf/open/water/beach/deep,
/area/hangar)
"lt" = (
/obj/machinery/door/poddoor/shutters/indestructible{
	dir = 4;
	id = "ocean_ERT_bay"
	},
/turf/open/floor/plasteel/elevatorshaft,
/area/hangar)
"lI" = (
/obj/machinery/atmospherics/pipe/simple/orange/hidden{
	dir = 4
	},
/turf/open/floor/plasteel/tech/techmaint,
/area/hangar)
"nC" = (
/obj/structure/platform/industrial_alt{
	dir = 8
	},
/turf/open/water/beach/deep,
/area/hangar)
"oz" = (
/obj/effect/turf_decal/corner/transparent/bottlegreen{
	dir = 5
	},
/turf/open/floor/plasteel{
	planetary_atmos = 1
	},
/area/hangar)
"oB" = (
/obj/structure/railing/corner{
	dir = 4
	},
/obj/effect/turf_decal/corner/transparent/bottlegreen{
	dir = 5
	},
/turf/open/floor/plasteel/tech/techmaint,
/area/hangar)
"oR" = (
/obj/structure/railing{
	dir = 1
	},
/obj/effect/turf_decal/corner/transparent/bottlegreen{
	dir = 5
	},
/turf/open/floor/plasteel/tech/techmaint,
/area/hangar)
"oW" = (
/obj/machinery/light/floor/hangar,
/obj/effect/turf_decal/corner/transparent/bottlegreen{
	dir = 10
	},
/turf/open/floor/plasteel{
	planetary_atmos = 1
	},
/area/hangar)
"pf" = (
/obj/effect/turf_decal/techfloor{
	dir = 8
	},
/turf/open/floor/plasteel/tech{
	planetary_atmos = 1
	},
/area/hangar)
"pt" = (
/obj/structure/catwalk/over/plated_catwalk/dark,
/turf/open/floor/plating/rust,
/area/hangar)
"pA" = (
/obj/effect/turf_decal/techfloor{
	dir = 4
	},
/turf/open/floor/plasteel/tech{
	planetary_atmos = 1
	},
/area/hangar)
"rJ" = (
/obj/structure/marker_beacon{
	picked_color = "Teal"
	},
/turf/open/floor/plating{
	planetary_atmos = 1
	},
/area/hangar)
"rS" = (
/obj/machinery/atmospherics/components/binary/volume_pump{
	dir = 4
	},
/obj/effect/turf_decal/industrial/shutoff,
/turf/open/floor/plasteel{
	planetary_atmos = 1
	},
/area/hangar)
"sG" = (
/obj/machinery/light/floor/hangar,
/obj/effect/turf_decal/corner/transparent/bottlegreen{
	dir = 6
	},
/turf/open/floor/plasteel{
	planetary_atmos = 1
	},
/area/hangar)
"sH" = (
/obj/structure/catwalk/over/plated_catwalk,
/turf/open/floor/plating{
	planetary_atmos = 1
	},
/area/hangar)
"sI" = (
/turf/open/floor/plating{
	planetary_atmos = 1
	},
/area/hangar)
"tG" = (
/obj/structure/platform/industrial_alt{
	dir = 8
	},
/obj/structure/platform/industrial_alt{
	dir = 4
	},
/turf/open/water/beach/deep,
/area/hangar)
"ux" = (
/obj/structure/lattice/catwalk,
/turf/open/floor/plasteel/elevatorshaft{
	planetary_atmos = 1
	},
/area/hangar)
"vA" = (
/turf/closed/indestructible/rock,
/area/hangar)
"vE" = (
/obj/structure/platform/industrial_alt{
	dir = 4
	},
/turf/open/water/beach/deep,
/area/hangar)
"vW" = (
/obj/structure/platform/industrial,
/obj/structure/platform/industrial{
	dir = 1
	},
/turf/open/floor/plasteel/elevatorshaft,
/area/hangar)
"xg" = (
/obj/structure/catwalk/over/plated_catwalk/dark,
/turf/open/floor/plating{
	planetary_atmos = 1
	},
/area/hangar)
"xO" = (
/obj/structure/platform/industrial_alt/corner{
	dir = 4
	},
/turf/open/water/beach/deep,
/area/hangar)
"yq" = (
/obj/effect/turf_decal/corner/transparent/bottlegreen/three_quarters{
	dir = 1
	},
/turf/open/floor/plasteel{
	planetary_atmos = 1
	},
/area/hangar)
"yL" = (
/obj/effect/turf_decal/corner/transparent/bottlegreen{
	dir = 9
	},
/turf/open/floor/plasteel{
	planetary_atmos = 1
	},
/area/hangar)
"Ag" = (
/obj/structure/platform/industrial_alt{
	dir = 4
	},
/obj/structure/platform/industrial_alt/corner,
/obj/effect/forcefield/mime/advanced{
	name = "long fall";
	desc = "You don't want to jump off. You probably won't be saved.";
	timeleft = null
	},
/turf/open/water/beach/deep,
/area/hangar)
"AH" = (
/obj/effect/landmark/outpost/hangar_numbers,
/turf/open/floor/plasteel{
	planetary_atmos = 1
	},
/area/hangar)
"AV" = (
/obj/machinery/computer/hydrogen_exchange,
/turf/open/floor/plasteel/tech/techmaint,
/area/hangar)
"Cu" = (
/obj/machinery/atmospherics/pipe/simple/orange/hidden{
	dir = 10
	},
/turf/open/floor/plasteel/tech/techmaint,
/area/hangar)
"Dp" = (
/obj/structure/table/reinforced,
/obj/structure/sign/warning/nosmoking/burnt{
	pixel_y = 28
	},
/turf/open/floor/plasteel/tech/techmaint,
/area/hangar)
"DH" = (
/obj/structure/platform/industrial_alt{
	dir = 8
	},
/obj/structure/platform/industrial_alt,
/obj/structure/platform/industrial_alt/corner{
	dir = 6
	},
/obj/effect/forcefield/mime/advanced{
	name = "long fall";
	desc = "You don't want to jump off. You probably won't be saved.";
	timeleft = null
	},
/turf/open/water/beach/deep,
/area/hangar)
"DO" = (
/obj/effect/turf_decal/corner/transparent/bottlegreen{
	dir = 10
	},
/obj/effect/turf_decal/corner/transparent/bottlegreen/three_quarters{
	dir = 1
	},
/turf/open/floor/plasteel{
	planetary_atmos = 1
	},
/area/hangar)
"El" = (
/obj/effect/turf_decal/corner/transparent/bottlegreen{
	dir = 6
	},
/turf/open/floor/plasteel{
	planetary_atmos = 1
	},
/area/hangar)
"Et" = (
/turf/open/floor/plasteel{
	planetary_atmos = 1
	},
/area/hangar)
"Fa" = (
/obj/structure/platform/industrial_alt{
	dir = 1
	},
/turf/open/water/beach/deep,
/area/hangar)
"Fj" = (
/obj/machinery/door/poddoor/shutters/indestructible{
	dir = 4;
	id = "ocean_ERT_bay"
	},
/turf/open/floor/plasteel{
	planetary_atmos = 1
	},
/area/hangar)
"FI" = (
/obj/effect/turf_decal/corner/transparent/bottlegreen{
	dir = 10
	},
/obj/effect/landmark/outpost/elevator_machine,
/obj/machinery/elevator_call_button{
	dir = 1;
	pixel_y = -24
	},
/turf/open/floor/plasteel{
	planetary_atmos = 1
	},
/area/hangar)
"GE" = (
/obj/effect/landmark/outpost/hangar_dock,
/turf/open/floor/plating{
	planetary_atmos = 1
	},
/area/hangar)
"HF" = (
/obj/structure/catwalk/over/plated_catwalk,
/obj/machinery/atmospherics/pipe/simple/orange/hidden{
	dir = 5
	},
/turf/open/floor/plating{
	planetary_atmos = 1
	},
/area/hangar)
"HR" = (
/obj/machinery/atmospherics/components/unary/hydrogen_pump{
	dir = 4
	},
/obj/effect/turf_decal/industrial/outline/yellow,
/turf/open/floor/plasteel/tech/techmaint,
/area/hangar)
"Ir" = (
/obj/structure/catwalk/over/plated_catwalk,
/obj/machinery/atmospherics/pipe/manifold4w/orange/hidden,
/turf/open/floor/plating{
	planetary_atmos = 1
	},
/area/hangar)
"IT" = (
/obj/machinery/door/airlock/maintenance{
	req_access_txt = "101"
	},
/turf/open/floor/plating{
	planetary_atmos = 1
	},
/area/hangar)
"Ld" = (
/turf/open/floor/plating/rust,
/area/hangar)
"Le" = (
/turf/open/water/beach/deep,
/area/hangar)
"Lu" = (
/obj/effect/turf_decal/techfloor{
	dir = 1
	},
/obj/machinery/door/airlock/hatch,
/obj/effect/landmark/outpost/elevator_machine,
/turf/open/floor/plasteel/tech,
/area/hangar)
"LB" = (
/obj/effect/turf_decal/corner/transparent/bottlegreen/three_quarters{
	dir = 4
	},
/turf/open/floor/plasteel{
	planetary_atmos = 1
	},
/area/hangar)
"Me" = (
/obj/machinery/light/floor/hangar,
/obj/effect/turf_decal/corner/transparent/bottlegreen{
	dir = 5
	},
/turf/open/floor/plasteel{
	planetary_atmos = 1
	},
/area/hangar)
"MF" = (
/obj/structure/platform/industrial_alt,
/turf/open/water/beach/deep,
/area/hangar)
"MU" = (
/obj/structure/catwalk/over/plated_catwalk,
/obj/machinery/atmospherics/pipe/simple/orange/hidden{
	dir = 4
	},
/turf/open/floor/plating{
	planetary_atmos = 1
	},
/area/hangar)
"NM" = (
/obj/effect/turf_decal/corner/transparent/bottlegreen{
	dir = 1
	},
/turf/open/floor/plasteel{
	planetary_atmos = 1
	},
/area/hangar)
"OA" = (
/obj/structure/catwalk/over/plated_catwalk,
/obj/machinery/atmospherics/pipe/simple/orange/hidden{
	dir = 6
	},
/turf/open/floor/plating{
	planetary_atmos = 1
	},
/area/hangar)
"OS" = (
/obj/effect/turf_decal/corner/transparent/bottlegreen/full,
/obj/effect/turf_decal/techfloor/orange,
/turf/open/floor/plasteel,
/area/hangar)
"PF" = (
/obj/effect/landmark/outpost/elevator,
/turf/open/floor/plasteel/elevatorshaft{
	planetary_atmos = 1
	},
/area/hangar)
"PJ" = (
/obj/structure/platform/industrial_alt,
/obj/structure/platform/industrial_alt{
	dir = 4
	},
/obj/structure/platform/industrial_alt/corner{
	dir = 10
	},
/obj/effect/forcefield/mime/advanced{
	name = "long fall";
	desc = "You don't want to jump off. You probably won't be saved.";
	timeleft = null
	},
/turf/open/water/beach/deep,
/area/hangar)
"SZ" = (
/obj/structure/catwalk/over/plated_catwalk,
/obj/machinery/atmospherics/pipe/manifold/orange/hidden,
/turf/open/floor/plating{
	planetary_atmos = 1
	},
/area/hangar)
"Tz" = (
/obj/machinery/atmospherics/components/binary/valve/digital,
/obj/effect/turf_decal/corner/transparent/bottlegreen{
	dir = 5
	},
/turf/open/floor/plasteel{
	planetary_atmos = 1
	},
/area/hangar)
"Ue" = (
/obj/structure/platform/industrial_alt{
	dir = 1
	},
/obj/effect/forcefield/mime/advanced{
	name = "long fall";
	desc = "You don't want to jump off. You probably won't be saved.";
	timeleft = null
	},
/turf/open/water/beach/deep,
/area/hangar)
"UD" = (
/obj/structure/catwalk/over/plated_catwalk,
/obj/machinery/atmospherics/pipe/simple/orange/hidden{
	dir = 9
	},
/turf/open/floor/plating{
	planetary_atmos = 1
	},
/area/hangar)
"VB" = (
/obj/structure/platform/industrial_alt{
	dir = 8
	},
/obj/effect/forcefield/mime/advanced{
	name = "long fall";
	desc = "You don't want to jump off. You probably won't be saved.";
	timeleft = null
	},
/turf/open/water/beach/deep,
/area/hangar)
"XX" = (
/turf/open/floor/plasteel/elevatorshaft{
	planetary_atmos = 1
	},
/area/hangar)
"Yx" = (
/obj/effect/turf_decal/industrial/shutoff,
/obj/machinery/atmospherics/components/binary/volume_pump{
	dir = 4
	},
/turf/open/floor/plasteel{
	planetary_atmos = 1
	},
/area/hangar)
"YK" = (
/obj/structure/catwalk/over/plated_catwalk,
/obj/machinery/atmospherics/pipe/simple/orange/hidden,
/turf/open/floor/plating{
	planetary_atmos = 1
	},
/area/hangar)
"YO" = (
/obj/effect/turf_decal/corner/transparent/bottlegreen{
	dir = 10
	},
/turf/open/floor/plasteel{
	planetary_atmos = 1
	},
/area/hangar)
"Zd" = (
/obj/structure/marker_beacon{
	picked_color = "Teal"
	},
/turf/open/floor/plating/rust,
/area/hangar)
"Zz" = (
/obj/structure/platform/industrial_alt,
/obj/effect/forcefield/mime/advanced{
	name = "long fall";
	desc = "You don't want to jump off. You probably won't be saved.";
	timeleft = null
	},
/turf/open/water/beach/deep,
/area/hangar)

(1,1,1) = {"
vA
vA
vA
vA
vA
vA
vA
vA
vA
vA
vA
vA
vA
vA
vA
vA
vA
vA
vA
vA
vA
vA
vA
vA
vA
vA
vA
vA
vA
vA
vA
vA
vA
vA
vA
vA
vA
vA
vA
vA
vA
vA
vA
vA
vA
"}
(2,1,1) = {"
vA
vA
vA
vA
vA
vA
vA
Le
Le
Le
vA
vA
vA
vA
vA
vA
vA
Le
Le
Le
Le
Le
vA
vA
vA
vA
vA
Le
Le
vA
vA
vA
vA
Le
Le
Le
Le
Le
Le
vA
vA
vA
vA
vA
vA
"}
(3,1,1) = {"
vA
vA
vA
vA
vA
vA
Le
Le
Le
Le
Le
Le
Le
Le
Le
Le
Le
Le
Le
Le
Le
Le
Le
vA
vA
vA
Le
Le
Le
Le
Le
vA
Le
Le
Le
Le
Le
Le
Le
Le
Le
vA
vA
vA
vA
"}
(4,1,1) = {"
vA
vA
vA
vA
Le
Le
Le
Le
Le
Le
Le
Le
Le
Le
Le
Le
Le
Le
Le
Le
Le
Le
Le
vA
Le
Le
Le
Le
Le
Le
Le
Le
Le
Le
Le
Le
Le
Le
Le
Le
Le
Le
vA
vA
vA
"}
(5,1,1) = {"
vA
vA
vA
Le
Le
Le
Le
Le
Le
Le
Le
Le
Le
Le
Le
Le
Le
Le
Le
Le
Le
Le
Le
Le
Le
Le
Le
Le
Le
Le
Le
Le
Le
Le
Le
Le
Le
Le
Le
Le
Le
Le
Le
vA
vA
"}
(6,1,1) = {"
vA
vA
Le
Le
Le
Le
Le
Le
Le
Le
Le
Le
dD
Le
Le
Le
Le
Le
Le
Le
Le
Le
Le
Le
Le
Le
Le
Le
Le
Le
Le
Le
Le
Le
Le
Le
Le
dD
Le
Le
Le
Le
Le
vA
vA
"}
(7,1,1) = {"
vA
Le
Le
Le
Le
Le
Le
Le
Le
Le
Le
Le
dD
nC
VB
VB
VB
VB
VB
VB
VB
VB
VB
nC
nC
nC
nC
VB
VB
VB
VB
VB
VB
VB
VB
VB
nC
dD
Le
Le
Le
Le
Le
vA
vA
"}
(8,1,1) = {"
vA
Le
Le
Le
Le
Le
Le
Le
Le
Le
Le
dD
dD
dD
sI
Ld
Ld
Ld
sI
sI
Ld
sI
sI
dD
dD
dD
dD
Ld
Ld
sI
sI
sI
sI
sI
Ld
sI
dD
dD
dD
Le
Le
Le
Le
vA
vA
"}
(9,1,1) = {"
vA
Le
Le
Le
Le
Le
Le
Le
Le
dD
dD
dD
LB
yL
DO
pf
pf
pf
pf
pf
pf
pf
pf
pf
pf
pf
pf
pf
pf
pf
pf
pf
pf
pf
pf
LB
yL
yq
dD
dD
dD
Le
Le
vA
vA
"}
(10,1,1) = {"
vA
Le
Le
Le
Le
Le
Le
Le
Le
Le
MF
dD
oz
sH
YO
pt
xg
xg
xg
pt
xg
pt
xg
xg
xg
pt
pt
pt
xg
xg
xg
xg
xg
pt
xg
oz
sH
YO
dD
Fa
Le
Le
Le
Le
vA
"}
(11,1,1) = {"
vA
Le
Le
Le
Le
Le
Le
Le
Le
Le
Zz
Ld
oz
sH
YO
pA
pA
pA
pA
pA
pA
pA
pA
pA
pA
pA
pA
pA
pA
pA
pA
pA
pA
pA
pA
oz
sH
YO
sI
Ue
Le
Le
Le
Le
vA
"}
(12,1,1) = {"
vA
vA
Le
Le
Le
Le
Le
Le
Le
Le
Zz
Ld
oz
sH
YO
Ld
Ld
Ld
Ld
Ld
sI
sI
sI
sI
sI
sI
sI
sI
sI
sI
sI
sI
sI
Ld
GE
oz
sH
YO
Ld
Ue
Le
Le
Le
Le
vA
"}
(13,1,1) = {"
vA
vA
vA
Le
Le
Le
Le
Le
Le
Le
Zz
sI
oz
sH
YO
Ld
Ld
sI
sI
sI
sI
sI
sI
sI
Ld
sI
Ld
sI
sI
sI
sI
sI
sI
sI
Ld
oz
sH
YO
Ld
Ue
Le
Le
Le
Le
vA
"}
(14,1,1) = {"
vA
vA
vA
vA
Le
Le
Le
Le
Le
Le
Zz
sI
oz
sH
YO
rJ
Ld
sI
sI
sI
sI
sI
sI
sI
Ld
Ld
Ld
Ld
Ld
sI
sI
Ld
sI
sI
Zd
oz
sH
YO
Ld
Ue
Le
Le
Le
Le
vA
"}
(15,1,1) = {"
vA
vA
Le
Le
Le
Le
Le
Le
Le
Le
Zz
Ld
oz
OA
iN
Ld
sI
sI
sI
sI
sI
Ld
sI
sI
sI
Ld
Ld
sI
sI
sI
sI
Ld
sI
sI
Ld
Tz
HF
YO
Ld
Ue
Le
Le
Le
Le
vA
"}
(16,1,1) = {"
vA
vA
Le
Le
Le
Le
Le
Le
Le
Le
Zz
sI
oz
MU
oW
Ld
sI
sI
sI
Ld
sI
Ld
sI
sI
sI
Ld
Ld
sI
sI
sI
Ld
Ld
sI
sI
sI
Me
gd
YO
sI
Ue
Le
Le
Le
Le
vA
"}
(17,1,1) = {"
vA
Le
Le
Le
Le
Le
Le
Le
Le
Le
Zz
sI
oz
MU
YO
Ld
sI
sI
Ld
Ld
sI
sI
sI
Ld
sI
sI
Ld
sI
sI
sI
Ld
Ld
sI
sI
sI
oz
gd
YO
sI
Ue
Le
Le
Le
Le
vA
"}
(18,1,1) = {"
vA
vA
Le
Le
Le
Le
Le
Le
Le
Le
Zz
Ld
oz
MU
YO
sI
sI
sI
sI
sI
sI
sI
sI
sI
sI
sI
sI
sI
sI
sI
sI
sI
sI
sI
sI
oz
gd
YO
Ld
Ue
Le
Le
Le
Le
vA
"}
(19,1,1) = {"
vA
vA
vA
Le
Le
Le
Le
Le
Le
Le
Zz
Ld
oz
MU
YO
rJ
sI
sI
sI
sI
sI
sI
Ld
sI
sI
sI
sI
Ld
sI
sI
sI
sI
Ld
sI
rJ
oz
gd
YO
sI
Ue
Le
Le
Le
vA
vA
"}
(20,1,1) = {"
vA
Le
Le
Le
Le
Le
Le
Le
Le
Le
Zz
Ld
oz
MU
YO
sI
sI
Ld
sI
sI
sI
sI
sI
sI
sI
sI
sI
sI
Ld
Ld
sI
sI
sI
sI
sI
oz
gd
YO
Ld
Ue
Le
Le
vA
vA
vA
"}
(21,1,1) = {"
vA
Le
Le
Le
Le
Le
Le
Le
Le
Le
Zz
Ld
oz
MU
YO
sI
Ld
sI
sI
sI
sI
sI
sI
sI
sI
sI
sI
sI
sI
Ld
sI
sI
sI
sI
sI
oz
gd
YO
Ld
Ue
Le
Le
vA
vA
vA
"}
(22,1,1) = {"
vA
Le
Le
Le
Le
Le
Le
Le
Le
Le
Zz
sI
oz
MU
YO
sI
sI
sI
sI
Ld
sI
sI
sI
sI
sI
Ld
sI
sI
sI
sI
sI
sI
sI
sI
sI
oz
gd
YO
Ld
Ue
Le
Le
Le
vA
vA
"}
(23,1,1) = {"
vA
Le
Le
Le
Le
Le
Le
Le
Le
Le
Zz
Ld
oz
MU
YO
sI
sI
sI
sI
sI
sI
sI
Ld
Ld
Ld
Ld
Ld
sI
sI
sI
sI
sI
sI
Ld
sI
oz
gd
YO
sI
Ue
Le
Le
Le
vA
vA
"}
(24,1,1) = {"
vA
Le
Le
Le
Le
Le
Le
nC
nC
nC
DH
Ld
oz
MU
YO
rJ
sI
sI
sI
sI
sI
sI
sI
Ld
Ld
Ld
Ld
sI
sI
sI
sI
sI
sI
Ld
rJ
oz
gd
YO
sI
Ue
Le
Le
Le
vA
vA
"}
(25,1,1) = {"
vA
Le
Le
Le
Le
Le
MF
dD
dD
dD
dD
dD
fw
MU
YO
sI
sI
sI
sI
sI
Ld
Ld
Ld
Ld
sI
Ld
Ld
Ld
sI
sI
sI
sI
sI
Ld
Ld
oz
gd
YO
Ld
Ue
Le
Le
Le
vA
vA
"}
(26,1,1) = {"
vA
vA
Le
Le
Le
Le
MF
dD
hF
dD
dD
HR
oR
MU
oW
sI
sI
sI
sI
sI
sI
sI
sI
sI
sI
sI
Ld
sI
Ld
sI
sI
sI
sI
sI
Ld
Me
gd
YO
sI
Ue
Le
Le
Le
vA
vA
"}
(27,1,1) = {"
vA
Le
Le
Le
Le
Le
MF
dD
hF
IT
hF
rS
eI
MU
YO
Ld
sI
sI
Ld
sI
sI
sI
sI
sI
sI
sI
Ld
Ld
Ld
sI
sI
sI
sI
sI
Ld
oz
gd
YO
sI
Ue
Le
Le
Le
vA
vA
"}
(28,1,1) = {"
vA
vA
Le
Le
Le
Le
MF
dD
hF
dD
AV
fQ
YK
Ir
iN
Ld
Ld
sI
sI
Ld
Ld
sI
sI
sI
sI
sI
sI
sI
sI
sI
sI
sI
Ld
sI
sI
Tz
SZ
YO
Ld
Ue
Le
Le
Le
Le
vA
"}
(29,1,1) = {"
vA
vA
Le
Le
Le
Le
MF
dD
hF
dD
Dp
Yx
oB
MU
YO
Zd
Ld
sI
sI
sI
sI
sI
sI
sI
sI
sI
sI
sI
sI
sI
sI
Ld
sI
sI
Zd
oz
gd
YO
sI
Ue
Le
Le
Le
Le
vA
"}
(30,1,1) = {"
vA
vA
Le
Le
Le
Le
MF
dD
hF
dD
dD
jw
oR
kk
YO
Ld
Ld
Ld
Ld
sI
sI
sI
sI
sI
sI
sI
sI
sI
sI
sI
sI
sI
sI
sI
Ld
oz
gd
YO
sI
Ue
Le
Le
Le
Le
vA
"}
(31,1,1) = {"
vA
vA
Le
Le
Le
Le
MF
dD
dD
dD
dD
dD
eI
kk
YO
Ld
Ld
Ld
Ld
Ld
Ld
Ld
Ld
sI
sI
Ld
sI
sI
sI
sI
sI
sI
sI
Ld
Ld
oz
gd
YO
sI
Ue
Le
Le
Le
Le
vA
"}
(32,1,1) = {"
vA
Le
Le
Le
Le
Le
Le
vE
vE
vE
PJ
sI
oz
lI
fH
yL
yL
yL
yL
yL
yL
yL
yL
yL
yL
yL
yL
yL
yL
yL
yL
yL
yL
yL
yL
NM
gd
YO
sI
Ue
Le
Le
Le
Le
vA
"}
(33,1,1) = {"
vA
vA
Le
Le
Le
Le
Le
Le
Le
Le
Zz
Ld
oz
Cu
YK
YK
YK
YK
YK
YK
YK
YK
YK
YK
YK
YK
YK
YK
YK
YK
YK
YK
YK
YK
YK
YK
UD
YO
dD
Fa
Le
Le
Le
Le
vA
"}
(34,1,1) = {"
vA
Le
Le
Le
Le
Le
Le
Le
Le
Le
Zz
Ld
oz
hF
Et
El
sG
El
El
El
El
El
El
El
El
El
El
El
El
El
El
El
El
sG
El
El
El
bY
dD
dD
dD
Le
Le
Le
vA
"}
(35,1,1) = {"
vA
Le
Le
Le
Le
Le
Le
Le
Le
Le
Zz
sI
oz
Et
YO
dD
dD
dD
dD
dD
dD
dD
dD
Fj
Fj
Fj
Fj
dD
Ld
sI
Ld
sI
sI
Ld
Ld
sI
dD
dD
dD
Le
Le
Le
Le
vA
vA
"}
(36,1,1) = {"
vA
Le
Le
Le
Le
Le
Le
Le
Le
Le
Zz
Ld
oz
Et
YO
ji
vW
vE
vE
vE
vW
vE
dD
Et
Et
Et
Et
dD
kA
kA
kA
kA
kA
kA
kA
kA
vE
dD
Le
Le
Le
Le
Le
vA
vA
"}
(37,1,1) = {"
vA
Le
Le
Le
Le
Le
Le
Le
Le
Le
Zz
sI
oz
Et
FI
dD
dD
dD
dD
dD
dD
Le
dD
Et
Et
Et
Et
dD
Le
Le
Le
Le
Le
Le
Le
Le
Le
dD
Le
Le
Le
Le
Le
vA
vA
"}
(38,1,1) = {"
vA
Le
Le
Le
Le
Le
Le
Le
Le
Le
Zz
sI
yL
yL
yL
OS
Lu
XX
XX
PF
ki
Le
dD
Et
Et
dD
dD
dD
Le
Le
Le
Le
Le
Le
Le
Le
Le
Le
Le
Le
Le
Le
Le
vA
vA
"}
(39,1,1) = {"
vA
Le
Le
Le
Le
Le
Le
Le
Le
Le
Zz
Ld
Et
Et
AH
OS
Lu
XX
XX
XX
ki
Le
dD
Et
Et
dD
Le
Le
Le
Le
Le
Le
Le
Le
Le
Le
Le
Le
Le
Le
Le
Le
Le
vA
vA
"}
(40,1,1) = {"
vA
Le
Le
Le
Le
Le
Le
Le
Le
Le
MF
dD
El
El
El
OS
Lu
XX
XX
XX
ki
Le
dD
dD
dD
dD
Le
Le
Le
Le
Le
Le
Le
Le
Le
Le
Le
Le
Le
Le
Le
Le
Le
vA
vA
"}
(41,1,1) = {"
vA
Le
Le
Le
Le
Le
Le
Le
Le
Le
MF
dD
dD
Ld
Ld
dD
dD
dD
dD
dD
dD
Le
Le
Le
Le
Le
Le
Le
Le
Le
Le
Le
Le
Le
Le
Le
Le
Le
Le
Le
Le
Le
Le
Le
vA
"}
(42,1,1) = {"
vA
Le
Le
Le
Le
Le
Le
Le
Le
Le
bt
vE
vE
kA
Ag
tG
cx
ux
ux
ux
ki
nC
aU
Le
Le
Le
Le
Le
Le
Le
Le
Le
Le
Le
Le
Le
Le
Le
Le
Le
Le
Le
Le
Le
vA
"}
(43,1,1) = {"
vA
vA
Le
Le
Le
Le
Le
Le
Le
Le
Le
Le
Le
Le
MF
dD
cx
ux
ux
ux
ki
dD
Fa
Le
Le
Le
Le
Le
Le
Le
Le
Le
Le
Le
Le
Le
Le
Le
Le
Le
Le
Le
Le
Le
vA
"}
(44,1,1) = {"
vA
vA
Le
Le
Le
Le
Le
Le
Le
Le
Le
Le
Le
Le
bt
vE
cx
ux
ux
ux
ki
vE
xO
Le
Le
Le
Le
Le
Le
Le
Le
Le
Le
Le
Le
Le
Le
Le
Le
Le
Le
Le
Le
Le
vA
"}
(45,1,1) = {"
vA
vA
vA
Le
Le
Le
vA
Le
Le
Le
Le
Le
Le
Le
Le
Le
dD
dD
dD
dD
dD
Le
Le
Le
Le
Le
Le
Le
Le
Le
Le
Le
Le
Le
Le
Le
Le
Le
Le
Le
Le
Le
Le
Le
vA
"}
(46,1,1) = {"
vA
vA
vA
vA
Le
vA
vA
Le
Le
Le
Le
Le
Le
Le
Le
Le
cx
ux
ux
ux
ki
Le
Le
Le
Le
Le
Le
Le
Le
Le
Le
Le
Le
Le
Le
Le
Le
Le
Le
vA
vA
Le
Le
vA
vA
"}
(47,1,1) = {"
vA
vA
vA
vA
vA
Le
Le
Le
Le
Le
Le
Le
Le
Le
Le
Le
cx
ux
ux
ux
ki
Le
Le
Le
Le
Le
Le
Le
Le
Le
Le
Le
Le
Le
Le
Le
Le
Le
Le
Le
vA
Le
Le
vA
vA
"}
(48,1,1) = {"
vA
vA
vA
vA
vA
vA
Le
Le
Le
Le
Le
Le
Le
Le
Le
Le
cx
ux
ux
ux
ki
Le
Le
Le
Le
Le
Le
Le
Le
Le
Le
Le
Le
Le
Le
Le
Le
Le
Le
Le
Le
Le
vA
vA
vA
"}
(49,1,1) = {"
vA
vA
vA
vA
vA
vA
vA
Le
Le
Le
Le
Le
Le
Le
Le
dD
lt
lt
lt
lt
lt
dD
Le
Le
Le
vA
vA
vA
vA
vA
vA
Le
Le
Le
Le
Le
Le
Le
vA
vA
vA
vA
vA
vA
vA
"}
(50,1,1) = {"
vA
vA
vA
vA
vA
vA
vA
vA
vA
vA
vA
vA
vA
vA
vA
dD
vA
vA
vA
vA
vA
dD
vA
vA
vA
vA
vA
vA
vA
vA
vA
vA
vA
vA
vA
vA
vA
vA
vA
vA
vA
vA
vA
vA
vA
"}
