//MAP CONVERTED BY dmm2tgm.py THIS HEADER COMMENT PREVENTS RECONVERSION, DO NOT REMOVE
"bI" = (
/obj/machinery/light/floor/hangar,
/obj/effect/turf_decal/corner/opaque/brown{
	dir = 4
	},
/obj/effect/turf_decal/corner/opaque/yellow,
/turf/open/floor/plasteel/patterned/grid,
/area/hangar)
"dk" = (
/obj/effect/landmark/outpost/elevator{
	shaft = "1"
	},
/turf/open/floor/plasteel/elevatorshaft,
/area/hangar)
"dC" = (
/turf/open/floor/plating{
	planetary_atmos = 1
	},
/area/hangar)
"eA" = (
/obj/effect/turf_decal/corner/opaque/brown{
	dir = 8
	},
/obj/effect/turf_decal/corner/opaque/yellow,
/turf/open/floor/plasteel/patterned/grid,
/area/hangar)
"fu" = (
/obj/machinery/elevator_call_button{
	dir = 8;
	pixel_x = 23
	},
/turf/closed/indestructible/reinforced,
/area/hangar)
"fS" = (
/obj/structure/platform/industrial_alt/corner{
	dir = 1
	},
/turf/open/water/beach/deep,
/area/hangar)
"gA" = (
/obj/effect/turf_decal/corner/opaque/yellow,
/turf/open/floor/plasteel/patterned/grid,
/area/hangar)
"gR" = (
/obj/effect/landmark/outpost/hangar_numbers,
/turf/open/floor/plasteel/patterned/grid,
/area/hangar)
"hV" = (
/obj/structure/platform/industrial_alt{
	dir = 1
	},
/obj/effect/forcefield/mime/advanced{
	name = "long fall";
	desc = "You don't want to jump off. You probably won't be saved.";
	timeleft = null
	},
/turf/open/water/beach/deep,
/area/hangar)
"hW" = (
/obj/structure/platform/industrial_alt{
	dir = 8
	},
/turf/open/water/beach/deep,
/area/hangar)
"iA" = (
/turf/open/floor/plasteel/patterned/grid,
/area/hangar)
"iD" = (
/obj/effect/turf_decal/corner/opaque/brown{
	dir = 8
	},
/obj/effect/turf_decal/corner/opaque/brown{
	dir = 4
	},
/obj/effect/turf_decal/corner/opaque/yellow,
/turf/open/floor/plasteel/patterned/grid,
/area/hangar)
"jO" = (
/obj/effect/turf_decal/techfloor{
	dir = 4
	},
/turf/open/floor/plasteel/tech{
	planetary_atmos = 1
	},
/area/hangar)
"lu" = (
/obj/effect/turf_decal/corner/opaque/brown{
	dir = 8
	},
/obj/effect/turf_decal/corner/opaque/yellow{
	dir = 1
	},
/turf/open/floor/plasteel/patterned/grid,
/area/hangar)
"lY" = (
/obj/structure/catwalk/over/plated_catwalk/dark,
/turf/open/floor/plating{
	planetary_atmos = 1
	},
/area/hangar)
"nb" = (
/obj/effect/turf_decal/corner/opaque/brown{
	dir = 4
	},
/obj/effect/turf_decal/corner/opaque/yellow,
/obj/effect/turf_decal/corner/opaque/yellow{
	dir = 1
	},
/turf/open/floor/plasteel/patterned/grid,
/area/hangar)
"nf" = (
/obj/effect/landmark/outpost/elevator_machine{
	shaft = "1"
	},
/obj/machinery/door/airlock/hatch{
	dir = 4
	},
/turf/open/floor/plating/rust,
/area/hangar)
"ov" = (
/obj/effect/turf_decal/corner/opaque/yellow{
	dir = 1
	},
/turf/open/floor/plasteel/patterned/grid,
/area/hangar)
"oI" = (
/obj/structure/marker_beacon{
	picked_color = "Teal"
	},
/turf/open/floor/plating/rust,
/area/hangar)
"qC" = (
/obj/effect/turf_decal/corner/opaque/yellow{
	dir = 4
	},
/obj/effect/turf_decal/corner/opaque/yellow,
/turf/open/floor/plasteel/patterned/grid,
/area/hangar)
"sa" = (
/obj/effect/turf_decal/corner/opaque/brown{
	dir = 8
	},
/turf/open/floor/plasteel/patterned/grid,
/area/hangar)
"tY" = (
/turf/open/floor/plasteel/elevatorshaft,
/area/hangar)
"uF" = (
/turf/closed/indestructible/reinforced,
/area/hangar)
"vg" = (
/obj/effect/turf_decal/corner/opaque/brown{
	dir = 4
	},
/obj/effect/turf_decal/corner/opaque/yellow{
	dir = 1
	},
/turf/open/floor/plasteel/patterned/grid,
/area/hangar)
"vP" = (
/obj/structure/platform/industrial{
	dir = 4
	},
/obj/structure/platform/industrial{
	dir = 8
	},
/turf/open/floor/plasteel/elevatorshaft,
/area/hangar)
"wf" = (
/obj/effect/turf_decal/corner/opaque/yellow{
	dir = 8
	},
/obj/effect/turf_decal/corner/opaque/yellow,
/turf/open/floor/plasteel/patterned/grid,
/area/hangar)
"zv" = (
/obj/structure/catwalk/over/plated_catwalk,
/turf/open/floor/plating{
	planetary_atmos = 1
	},
/area/hangar)
"AZ" = (
/obj/structure/platform/industrial_alt/corner{
	dir = 4
	},
/turf/open/water/beach/deep,
/area/hangar)
"Bb" = (
/obj/effect/turf_decal/techfloor{
	dir = 4
	},
/obj/effect/turf_decal/trimline/opaque/yellow/line{
	dir = 8
	},
/turf/open/floor/plasteel/patterned/grid,
/area/hangar)
"Dj" = (
/obj/structure/catwalk/over/plated_catwalk/dark,
/turf/open/floor/plating/rust,
/area/hangar)
"DS" = (
/obj/effect/turf_decal/corner/opaque/yellow{
	dir = 1
	},
/obj/effect/turf_decal/corner/opaque/yellow{
	dir = 8
	},
/turf/open/floor/plasteel/patterned/grid,
/area/hangar)
"Ey" = (
/obj/machinery/door/poddoor/shutters/indestructible{
	dir = 4
	},
/turf/closed/indestructible/fakeglass,
/area/hangar)
"EU" = (
/obj/effect/turf_decal/corner/opaque/brown{
	dir = 4
	},
/obj/effect/turf_decal/corner/opaque/brown{
	dir = 8
	},
/obj/effect/turf_decal/corner/opaque/yellow{
	dir = 1
	},
/turf/open/floor/plasteel/patterned/grid,
/area/hangar)
"EX" = (
/obj/effect/landmark/outpost/hangar_dock,
/turf/open/floor/plating{
	planetary_atmos = 1
	},
/area/hangar)
"FX" = (
/obj/structure/marker_beacon{
	picked_color = "Teal"
	},
/turf/open/floor/plating{
	planetary_atmos = 1
	},
/area/hangar)
"Go" = (
/obj/structure/platform/industrial_alt,
/obj/effect/forcefield/mime/advanced{
	name = "long fall";
	desc = "You don't want to jump off. You probably won't be saved.";
	timeleft = null
	},
/turf/open/water/beach/deep,
/area/hangar)
"Gs" = (
/obj/effect/turf_decal/corner/opaque/yellow,
/obj/effect/turf_decal/corner/opaque/yellow{
	dir = 8
	},
/turf/open/floor/plasteel/patterned/grid,
/area/hangar)
"HB" = (
/obj/structure/catwalk/over/plated_catwalk,
/obj/machinery/atmospherics/pipe/manifold/orange/hidden,
/turf/open/floor/plating{
	planetary_atmos = 1
	},
/area/hangar)
"Iy" = (
/obj/structure/platform/industrial_alt{
	dir = 8
	},
/obj/effect/forcefield/mime/advanced{
	name = "long fall";
	desc = "You don't want to jump off. You probably won't be saved.";
	timeleft = null
	},
/turf/open/water/beach/deep,
/area/hangar)
"IT" = (
/obj/effect/turf_decal/corner/opaque/brown{
	dir = 8
	},
/obj/effect/turf_decal/corner/opaque/yellow{
	dir = 1
	},
/obj/effect/turf_decal/corner/opaque/yellow,
/turf/open/floor/plasteel/patterned/grid,
/area/hangar)
"Js" = (
/turf/closed/indestructible/rock,
/area/hangar)
"Lw" = (
/obj/effect/turf_decal/corner/opaque/yellow{
	dir = 1
	},
/obj/effect/turf_decal/corner/opaque/yellow{
	dir = 4
	},
/turf/open/floor/plasteel/patterned/grid,
/area/hangar)
"LJ" = (
/obj/structure/platform/industrial_alt,
/turf/open/water/beach/deep,
/area/hangar)
"No" = (
/obj/effect/turf_decal/corner/opaque/brown{
	dir = 4
	},
/obj/effect/turf_decal/corner/opaque/yellow,
/turf/open/floor/plasteel/patterned/grid,
/area/hangar)
"NQ" = (
/turf/closed/indestructible/fakeglass,
/area/hangar)
"OH" = (
/obj/effect/turf_decal/corner/opaque/yellow{
	dir = 4
	},
/obj/effect/turf_decal/corner/opaque/yellow{
	dir = 1
	},
/turf/open/floor/plasteel/patterned/grid,
/area/hangar)
"OM" = (
/obj/machinery/light/floor/hangar,
/obj/effect/turf_decal/corner/opaque/brown{
	dir = 8
	},
/obj/effect/turf_decal/corner/opaque/yellow,
/turf/open/floor/plasteel/patterned/grid,
/area/hangar)
"PA" = (
/obj/effect/turf_decal/corner/opaque/brown{
	dir = 4
	},
/turf/open/floor/plasteel/patterned/grid,
/area/hangar)
"Qg" = (
/obj/structure/platform/industrial_alt{
	dir = 1
	},
/turf/open/water/beach/deep,
/area/hangar)
"Qk" = (
/obj/machinery/light/floor/hangar,
/obj/effect/turf_decal/corner/opaque/brown{
	dir = 4
	},
/obj/effect/turf_decal/corner/opaque/yellow{
	dir = 1
	},
/turf/open/floor/plasteel/patterned/grid,
/area/hangar)
"Qx" = (
/obj/effect/landmark/outpost/elevator_machine{
	shaft = "1"
	},
/obj/machinery/door/airlock/hatch{
	dir = 4
	},
/turf/open/floor/plating{
	planetary_atmos = 1
	},
/area/hangar)
"QF" = (
/turf/open/water/beach/deep,
/area/hangar)
"Sq" = (
/obj/effect/turf_decal/corner/opaque/yellow/full,
/obj/effect/landmark/outpost/hangar_numbers,
/turf/open/floor/plasteel/patterned/grid,
/area/hangar)
"Tw" = (
/obj/machinery/door/poddoor/shutters/indestructible{
	dir = 4
	},
/turf/open/floor/plating{
	planetary_atmos = 1
	},
/area/hangar)
"Xs" = (
/obj/effect/turf_decal/techfloor{
	dir = 8
	},
/turf/open/floor/plasteel/tech{
	planetary_atmos = 1
	},
/area/hangar)
"XC" = (
/turf/open/floor/plating/rust,
/area/hangar)
"YA" = (
/obj/machinery/door/poddoor/ert,
/turf/open/floor/plasteel/elevatorshaft,
/area/hangar)
"YH" = (
/obj/structure/platform/industrial_alt{
	dir = 4
	},
/obj/effect/forcefield/mime/advanced{
	name = "long fall";
	desc = "You don't want to jump off. You probably won't be saved.";
	timeleft = null
	},
/turf/open/water/beach/deep,
/area/hangar)
"ZB" = (
/obj/machinery/door/poddoor/shutters/indestructible{
	dir = 4
	},
/turf/open/floor/plating/rust,
/area/hangar)
"ZG" = (
/obj/machinery/elevator_call_button{
	dir = 1;
	pixel_y = -24
	},
/obj/effect/landmark/outpost/elevator_machine{
	shaft = "1"
	},
/obj/effect/turf_decal/techfloor{
	dir = 4
	},
/obj/effect/turf_decal/trimline/opaque/yellow/line{
	dir = 8
	},
/turf/open/floor/plasteel/patterned/grid,
/area/hangar)

(1,1,1) = {"
Js
Js
Js
Js
Js
Js
Js
Js
Js
Js
Js
Js
Js
Js
Js
Js
Js
Js
Js
Js
Js
Js
Js
Js
Js
Js
Js
Js
Js
Js
Js
Js
Js
Js
Js
Js
Js
Js
Js
Js
Js
Js
Js
Js
Js
"}
(2,1,1) = {"
Js
Js
Js
Js
Js
Js
Js
QF
QF
QF
Js
Js
Js
Js
Js
Js
Js
QF
QF
QF
QF
QF
Js
Js
Js
Js
Js
QF
QF
Js
Js
Js
Js
QF
QF
QF
QF
QF
QF
Js
Js
Js
Js
Js
Js
"}
(3,1,1) = {"
Js
Js
Js
Js
Js
Js
QF
QF
QF
QF
QF
QF
QF
QF
QF
QF
QF
QF
QF
QF
QF
QF
QF
Js
Js
Js
QF
QF
QF
QF
QF
Js
QF
QF
QF
QF
QF
QF
QF
QF
QF
Js
Js
Js
Js
"}
(4,1,1) = {"
Js
Js
Js
Js
QF
QF
QF
QF
QF
QF
QF
QF
QF
QF
QF
QF
QF
QF
QF
QF
QF
QF
QF
Js
QF
QF
QF
QF
QF
QF
QF
QF
QF
QF
QF
QF
QF
QF
QF
QF
QF
QF
Js
Js
Js
"}
(5,1,1) = {"
Js
Js
Js
QF
QF
QF
QF
QF
QF
QF
QF
QF
QF
QF
QF
QF
QF
QF
QF
QF
QF
QF
QF
QF
QF
QF
QF
QF
QF
QF
QF
QF
QF
QF
QF
QF
QF
QF
QF
QF
QF
QF
QF
Js
Js
"}
(6,1,1) = {"
Js
Js
QF
QF
QF
QF
QF
QF
QF
QF
QF
QF
uF
QF
QF
QF
QF
QF
QF
QF
QF
QF
QF
QF
QF
QF
QF
QF
QF
QF
QF
QF
QF
QF
QF
QF
QF
uF
QF
QF
QF
QF
QF
Js
Js
"}
(7,1,1) = {"
Js
QF
QF
QF
QF
QF
QF
QF
QF
QF
QF
QF
uF
YH
YH
YH
YH
YH
YH
YH
YH
YH
YH
YH
YH
YH
YH
YH
YH
YH
YH
YH
YH
YH
YH
YH
YH
uF
QF
QF
QF
QF
QF
Js
Js
"}
(8,1,1) = {"
Js
QF
QF
QF
QF
QF
QF
QF
QF
QF
QF
uF
uF
uF
dC
XC
XC
XC
dC
dC
XC
dC
dC
uF
uF
uF
uF
XC
XC
dC
dC
dC
dC
dC
XC
dC
uF
uF
uF
QF
QF
QF
QF
Js
Js
"}
(9,1,1) = {"
Js
QF
QF
QF
QF
QF
QF
QF
QF
uF
uF
uF
EU
lu
IT
Xs
Xs
Xs
Xs
Xs
Xs
Xs
Xs
Xs
Xs
Xs
Xs
Xs
Xs
Xs
Xs
Xs
Xs
Xs
Xs
EU
lu
IT
uF
uF
uF
QF
QF
Js
Js
"}
(10,1,1) = {"
Js
QF
QF
QF
QF
QF
QF
QF
QF
QF
Go
uF
vg
zv
eA
Dj
lY
lY
lY
Dj
lY
Dj
lY
lY
lY
Dj
Dj
Dj
lY
lY
lY
lY
lY
Dj
lY
vg
zv
eA
uF
hV
QF
QF
QF
QF
Js
"}
(11,1,1) = {"
Js
QF
QF
QF
QF
QF
QF
QF
QF
QF
Go
XC
vg
zv
eA
jO
jO
jO
jO
jO
jO
jO
jO
jO
jO
jO
jO
jO
jO
jO
jO
jO
jO
jO
jO
vg
zv
eA
dC
hV
QF
QF
QF
QF
Js
"}
(12,1,1) = {"
Js
Js
QF
QF
QF
QF
QF
QF
QF
QF
Go
XC
vg
zv
eA
XC
XC
XC
XC
XC
dC
dC
dC
dC
dC
dC
dC
dC
dC
dC
dC
dC
dC
XC
EX
vg
zv
eA
XC
hV
QF
QF
QF
QF
Js
"}
(13,1,1) = {"
Js
Js
Js
QF
QF
QF
QF
QF
QF
QF
Go
dC
vg
zv
eA
XC
XC
dC
dC
dC
dC
dC
dC
dC
XC
dC
XC
dC
dC
dC
dC
dC
dC
dC
XC
vg
zv
eA
XC
hV
QF
QF
QF
QF
Js
"}
(14,1,1) = {"
Js
Js
Js
Js
QF
QF
QF
QF
QF
QF
Go
dC
vg
zv
eA
FX
XC
dC
dC
dC
dC
dC
dC
dC
XC
XC
XC
XC
XC
dC
dC
XC
dC
dC
oI
vg
zv
eA
XC
hV
QF
QF
QF
QF
Js
"}
(15,1,1) = {"
Js
Js
QF
QF
QF
QF
QF
QF
QF
QF
Go
XC
vg
zv
eA
XC
dC
dC
dC
dC
dC
XC
dC
dC
dC
XC
XC
dC
dC
dC
dC
XC
dC
dC
XC
vg
zv
eA
XC
hV
QF
QF
QF
QF
Js
"}
(16,1,1) = {"
Js
Js
QF
QF
QF
QF
QF
QF
QF
QF
Go
dC
vg
zv
OM
XC
dC
dC
dC
XC
dC
XC
dC
dC
dC
XC
XC
dC
dC
dC
XC
XC
dC
dC
dC
Qk
zv
eA
dC
hV
QF
QF
QF
QF
Js
"}
(17,1,1) = {"
Js
QF
QF
QF
QF
QF
QF
QF
QF
QF
Go
dC
vg
zv
eA
XC
dC
dC
XC
XC
dC
dC
dC
XC
dC
dC
XC
dC
dC
dC
XC
XC
dC
dC
dC
vg
zv
eA
dC
hV
QF
QF
QF
QF
Js
"}
(18,1,1) = {"
Js
Js
QF
QF
QF
QF
QF
QF
QF
QF
Go
XC
vg
zv
eA
dC
dC
dC
dC
dC
dC
dC
dC
dC
dC
dC
dC
dC
dC
dC
dC
dC
dC
dC
dC
vg
zv
eA
XC
hV
QF
QF
QF
QF
Js
"}
(19,1,1) = {"
Js
Js
Js
QF
QF
QF
QF
QF
QF
QF
Go
XC
vg
zv
eA
FX
dC
dC
dC
dC
dC
dC
XC
dC
dC
dC
dC
XC
dC
dC
dC
dC
XC
dC
FX
vg
zv
eA
dC
hV
QF
QF
QF
Js
Js
"}
(20,1,1) = {"
Js
QF
QF
QF
QF
QF
QF
QF
QF
QF
Go
dC
vg
zv
eA
dC
dC
XC
dC
dC
dC
dC
dC
dC
dC
dC
dC
dC
XC
XC
dC
dC
dC
dC
dC
vg
zv
eA
dC
hV
QF
QF
Js
Js
Js
"}
(21,1,1) = {"
Js
QF
QF
QF
QF
QF
QF
QF
QF
QF
Go
XC
vg
zv
eA
dC
XC
dC
dC
XC
dC
dC
dC
dC
dC
XC
dC
dC
dC
XC
dC
dC
dC
dC
dC
vg
zv
eA
dC
hV
QF
QF
Js
Js
Js
"}
(22,1,1) = {"
Js
QF
QF
QF
QF
QF
QF
QF
QF
QF
Go
XC
vg
zv
eA
dC
dC
dC
dC
dC
dC
dC
dC
dC
XC
dC
dC
dC
dC
dC
dC
dC
dC
dC
dC
vg
zv
eA
dC
hV
QF
QF
Js
Js
Js
"}
(23,1,1) = {"
Js
Js
QF
QF
QF
QF
QF
QF
QF
QF
Go
XC
vg
zv
eA
dC
dC
dC
dC
dC
dC
XC
dC
dC
XC
dC
dC
dC
dC
dC
dC
XC
dC
dC
dC
vg
zv
eA
XC
hV
QF
Js
Js
Js
Js
"}
(24,1,1) = {"
Js
Js
Js
QF
QF
QF
QF
QF
QF
QF
Go
XC
vg
zv
OM
FX
dC
dC
dC
dC
dC
dC
dC
dC
dC
dC
dC
XC
dC
dC
dC
XC
XC
dC
FX
Qk
zv
eA
XC
hV
QF
QF
QF
Js
Js
"}
(25,1,1) = {"
Js
Js
QF
Js
QF
QF
QF
QF
QF
QF
Go
dC
vg
zv
eA
dC
dC
dC
dC
dC
dC
dC
dC
dC
dC
dC
dC
dC
dC
dC
dC
XC
XC
dC
XC
vg
zv
eA
dC
hV
QF
QF
QF
QF
Js
"}
(26,1,1) = {"
Js
Js
QF
QF
QF
QF
QF
QF
QF
QF
Go
dC
vg
zv
eA
XC
dC
dC
dC
XC
dC
dC
dC
XC
XC
XC
dC
dC
dC
dC
dC
XC
XC
dC
XC
vg
zv
eA
dC
hV
QF
QF
QF
QF
Js
"}
(27,1,1) = {"
Js
QF
QF
QF
QF
QF
QF
QF
QF
QF
Go
dC
vg
zv
eA
dC
dC
dC
dC
dC
XC
dC
XC
XC
XC
dC
dC
dC
dC
dC
dC
dC
dC
dC
XC
vg
zv
eA
XC
hV
QF
QF
QF
QF
Js
"}
(28,1,1) = {"
Js
QF
QF
QF
QF
QF
QF
QF
QF
QF
Go
dC
vg
zv
eA
XC
dC
dC
dC
XC
XC
dC
dC
XC
XC
dC
dC
dC
XC
dC
dC
dC
dC
dC
XC
vg
zv
eA
XC
hV
QF
QF
QF
QF
Js
"}
(29,1,1) = {"
Js
QF
QF
QF
QF
QF
QF
QF
QF
QF
Go
dC
vg
zv
eA
oI
dC
dC
dC
dC
dC
dC
dC
XC
dC
dC
dC
XC
XC
dC
dC
dC
dC
dC
FX
vg
zv
eA
XC
hV
QF
QF
QF
QF
Js
"}
(30,1,1) = {"
Js
QF
QF
QF
QF
QF
QF
QF
QF
QF
Go
dC
vg
zv
eA
XC
dC
dC
XC
dC
dC
dC
dC
dC
dC
dC
dC
XC
dC
dC
dC
dC
dC
dC
XC
vg
zv
eA
dC
hV
QF
QF
QF
QF
Js
"}
(31,1,1) = {"
Js
Js
QF
QF
QF
QF
QF
QF
QF
QF
Go
XC
vg
zv
eA
dC
dC
dC
dC
XC
dC
dC
dC
dC
dC
dC
dC
dC
dC
dC
XC
dC
dC
dC
dC
vg
zv
eA
dC
hV
QF
QF
QF
QF
Js
"}
(32,1,1) = {"
Js
Js
QF
QF
QF
QF
QF
QF
QF
QF
Go
XC
vg
zv
OM
dC
dC
XC
dC
dC
dC
dC
dC
dC
dC
dC
dC
dC
dC
dC
dC
dC
dC
dC
dC
Qk
zv
eA
dC
hV
QF
QF
QF
Js
Js
"}
(33,1,1) = {"
Js
Js
QF
QF
QF
QF
QF
QF
QF
QF
Go
XC
vg
zv
eA
dC
dC
dC
XC
dC
dC
dC
dC
dC
dC
dC
dC
dC
dC
dC
dC
dC
dC
dC
dC
vg
zv
eA
XC
hV
QF
QF
QF
Js
Js
"}
(34,1,1) = {"
Js
Js
QF
QF
QF
QF
QF
QF
QF
QF
Go
dC
vg
zv
eA
dC
XC
dC
dC
dC
XC
dC
dC
XC
XC
dC
dC
dC
dC
dC
XC
XC
dC
XC
dC
vg
zv
eA
XC
hV
QF
QF
Js
Js
Js
"}
(35,1,1) = {"
Js
Js
QF
QF
QF
QF
QF
QF
QF
QF
Go
dC
vg
zv
eA
dC
dC
dC
dC
dC
dC
XC
XC
dC
dC
dC
dC
dC
dC
dC
dC
XC
dC
dC
dC
vg
zv
eA
XC
hV
QF
QF
QF
Js
Js
"}
(36,1,1) = {"
Js
Js
QF
QF
QF
QF
QF
QF
QF
QF
Go
dC
vg
zv
eA
dC
XC
dC
dC
dC
dC
dC
dC
XC
XC
dC
dC
dC
dC
dC
dC
XC
dC
dC
XC
vg
zv
eA
dC
hV
QF
QF
Js
Js
Js
"}
(37,1,1) = {"
Js
Js
QF
QF
QF
QF
QF
QF
QF
QF
Go
dC
vg
zv
eA
XC
dC
dC
XC
dC
XC
dC
dC
dC
dC
XC
XC
dC
dC
dC
dC
dC
dC
dC
dC
vg
zv
eA
dC
hV
QF
Js
Js
Js
Js
"}
(38,1,1) = {"
Js
Js
Js
QF
QF
QF
QF
QF
QF
QF
Go
XC
vg
zv
eA
dC
dC
dC
dC
dC
dC
XC
dC
dC
dC
dC
dC
dC
XC
dC
dC
dC
dC
dC
dC
vg
zv
eA
XC
hV
QF
QF
QF
Js
Js
"}
(39,1,1) = {"
Js
Js
Js
QF
QF
QF
QF
QF
QF
QF
Go
XC
vg
zv
eA
dC
dC
dC
dC
dC
dC
dC
dC
dC
dC
dC
dC
dC
dC
dC
dC
dC
dC
dC
dC
vg
zv
eA
dC
hV
QF
QF
QF
Js
Js
"}
(40,1,1) = {"
Js
Js
Js
Js
QF
QF
QF
QF
QF
QF
Go
XC
vg
zv
OM
XC
dC
dC
dC
dC
XC
XC
XC
dC
dC
dC
dC
dC
XC
dC
dC
dC
dC
XC
dC
Qk
zv
eA
dC
hV
QF
QF
QF
QF
Js
"}
(41,1,1) = {"
Js
Js
Js
QF
QF
QF
QF
QF
QF
QF
Go
dC
vg
zv
eA
XC
dC
dC
XC
dC
dC
XC
dC
dC
dC
dC
dC
XC
XC
dC
dC
dC
dC
dC
XC
vg
zv
eA
XC
hV
QF
QF
QF
QF
Js
"}
(42,1,1) = {"
Js
Js
QF
QF
QF
QF
QF
QF
QF
QF
Go
dC
vg
zv
eA
dC
dC
dC
dC
XC
XC
dC
dC
dC
dC
XC
dC
dC
dC
dC
dC
XC
dC
dC
dC
vg
zv
eA
dC
hV
QF
QF
QF
Js
Js
"}
(43,1,1) = {"
Js
Js
QF
QF
QF
QF
QF
QF
QF
QF
Go
XC
vg
zv
eA
dC
dC
dC
dC
dC
XC
XC
dC
dC
dC
dC
dC
dC
dC
dC
XC
XC
dC
dC
dC
vg
zv
eA
dC
hV
QF
Js
Js
Js
Js
"}
(44,1,1) = {"
Js
Js
QF
QF
QF
QF
QF
QF
QF
QF
Go
dC
vg
zv
eA
dC
dC
dC
dC
XC
dC
dC
dC
dC
dC
dC
dC
dC
dC
XC
dC
dC
dC
dC
dC
vg
zv
eA
dC
hV
Js
Js
Js
Js
Js
"}
(45,1,1) = {"
Js
Js
QF
QF
QF
QF
QF
QF
QF
QF
Go
XC
vg
zv
eA
dC
XC
dC
dC
dC
dC
dC
XC
dC
dC
dC
dC
XC
dC
dC
dC
XC
dC
dC
dC
vg
zv
eA
dC
hV
QF
QF
Js
Js
Js
"}
(46,1,1) = {"
Js
Js
QF
QF
QF
QF
QF
QF
QF
QF
Go
XC
vg
zv
eA
dC
dC
dC
dC
dC
dC
dC
dC
dC
XC
XC
XC
dC
dC
dC
dC
dC
dC
dC
XC
vg
zv
eA
XC
hV
QF
QF
Js
Js
Js
"}
(47,1,1) = {"
Js
Js
QF
QF
QF
QF
QF
QF
QF
QF
Go
dC
vg
zv
eA
dC
dC
dC
dC
XC
dC
dC
dC
dC
dC
dC
dC
dC
dC
dC
dC
dC
dC
dC
dC
vg
zv
eA
dC
hV
QF
QF
Js
Js
Js
"}
(48,1,1) = {"
Js
QF
QF
QF
QF
QF
QF
QF
QF
QF
Go
dC
vg
zv
OM
dC
dC
dC
dC
dC
dC
dC
dC
dC
XC
dC
dC
dC
dC
XC
XC
XC
dC
dC
XC
Qk
zv
eA
dC
hV
QF
QF
QF
Js
Js
"}
(49,1,1) = {"
Js
QF
QF
QF
QF
QF
QF
QF
QF
QF
Go
dC
vg
zv
eA
dC
dC
dC
dC
XC
dC
dC
dC
dC
dC
dC
dC
dC
dC
dC
XC
XC
dC
dC
XC
vg
zv
eA
dC
hV
QF
QF
Js
Js
Js
"}
(50,1,1) = {"
Js
QF
QF
QF
QF
QF
QF
QF
QF
QF
Go
dC
vg
zv
eA
oI
dC
dC
XC
XC
XC
XC
dC
dC
dC
dC
dC
dC
dC
dC
dC
dC
dC
dC
oI
vg
zv
eA
dC
hV
QF
QF
Js
Js
Js
"}
(51,1,1) = {"
Js
QF
QF
QF
QF
QF
QF
QF
QF
QF
Go
dC
vg
zv
eA
dC
dC
dC
dC
dC
XC
dC
dC
dC
dC
XC
XC
XC
dC
dC
dC
dC
dC
dC
XC
vg
zv
eA
XC
hV
QF
QF
QF
Js
Js
"}
(52,1,1) = {"
Js
QF
QF
QF
QF
QF
QF
QF
QF
QF
Go
dC
vg
zv
eA
dC
dC
dC
dC
dC
dC
dC
dC
dC
XC
XC
XC
XC
dC
dC
dC
dC
dC
dC
dC
vg
zv
eA
XC
hV
QF
QF
QF
QF
Js
"}
(53,1,1) = {"
Js
QF
QF
QF
QF
QF
QF
QF
QF
QF
Go
XC
vg
zv
eA
dC
XC
dC
dC
dC
dC
dC
dC
dC
dC
dC
XC
dC
dC
dC
dC
XC
dC
dC
dC
vg
zv
eA
XC
hV
QF
QF
QF
QF
Js
"}
(54,1,1) = {"
Js
Js
QF
QF
QF
QF
QF
QF
QF
QF
Go
XC
vg
zv
eA
dC
dC
dC
dC
dC
dC
XC
XC
dC
dC
dC
dC
dC
dC
dC
XC
XC
dC
dC
XC
vg
zv
eA
dC
hV
QF
QF
QF
QF
Js
"}
(55,1,1) = {"
Js
Js
Js
Js
Js
QF
QF
QF
QF
QF
Go
dC
vg
zv
eA
oI
dC
dC
dC
dC
XC
dC
dC
dC
dC
dC
dC
dC
dC
XC
XC
dC
dC
dC
oI
vg
zv
eA
dC
hV
QF
QF
QF
QF
Js
"}
(56,1,1) = {"
Js
Js
Js
Js
QF
QF
QF
QF
QF
QF
Go
XC
vg
zv
OM
XC
dC
dC
dC
dC
dC
dC
dC
dC
XC
dC
dC
dC
dC
XC
XC
dC
dC
dC
dC
Qk
zv
eA
XC
hV
QF
QF
Js
Js
Js
"}
(57,1,1) = {"
Js
Js
QF
QF
QF
QF
QF
QF
QF
QF
Go
XC
vg
zv
eA
XC
dC
dC
dC
dC
dC
dC
dC
dC
dC
dC
dC
dC
dC
dC
XC
dC
dC
dC
dC
vg
zv
eA
XC
hV
QF
QF
Js
Js
Js
"}
(58,1,1) = {"
Js
QF
QF
QF
QF
QF
QF
QF
QF
QF
Go
dC
vg
zv
eA
dC
dC
dC
dC
XC
dC
dC
dC
dC
dC
XC
dC
dC
dC
dC
dC
dC
dC
dC
XC
vg
zv
eA
XC
hV
QF
QF
QF
Js
Js
"}
(59,1,1) = {"
Js
QF
QF
QF
QF
QF
QF
QF
QF
QF
Go
XC
vg
zv
eA
dC
dC
dC
dC
dC
dC
dC
XC
XC
XC
XC
XC
dC
dC
dC
dC
dC
dC
XC
dC
vg
zv
eA
dC
hV
QF
QF
QF
Js
Js
"}
(60,1,1) = {"
Js
QF
QF
QF
QF
QF
QF
QF
QF
QF
Go
XC
vg
zv
eA
FX
dC
dC
dC
dC
dC
dC
dC
XC
XC
XC
XC
dC
dC
dC
dC
dC
dC
XC
FX
vg
zv
eA
dC
hV
QF
QF
QF
Js
Js
"}
(61,1,1) = {"
Js
QF
QF
QF
QF
QF
QF
QF
QF
QF
Go
dC
vg
zv
eA
dC
dC
dC
dC
dC
XC
XC
XC
XC
dC
XC
XC
XC
dC
dC
dC
dC
dC
XC
XC
vg
zv
eA
XC
hV
QF
QF
QF
Js
Js
"}
(62,1,1) = {"
Js
Js
QF
QF
QF
QF
QF
QF
QF
QF
Go
dC
vg
zv
OM
dC
dC
dC
dC
dC
dC
dC
dC
dC
dC
dC
XC
dC
XC
dC
dC
dC
dC
dC
XC
Qk
zv
eA
dC
hV
QF
QF
QF
Js
Js
"}
(63,1,1) = {"
Js
QF
QF
QF
QF
QF
QF
QF
QF
QF
Go
XC
vg
zv
eA
XC
dC
dC
XC
dC
dC
dC
dC
dC
dC
dC
XC
XC
XC
dC
dC
dC
dC
dC
XC
vg
zv
eA
dC
hV
QF
QF
QF
Js
Js
"}
(64,1,1) = {"
Js
Js
QF
QF
QF
QF
QF
QF
QF
QF
Go
XC
vg
zv
eA
XC
XC
dC
dC
XC
XC
dC
dC
dC
dC
dC
dC
dC
dC
dC
dC
dC
XC
dC
dC
vg
HB
eA
XC
hV
QF
QF
QF
QF
Js
"}
(65,1,1) = {"
Js
Js
QF
QF
QF
QF
QF
QF
QF
QF
Go
dC
vg
zv
eA
oI
XC
dC
dC
dC
dC
dC
dC
dC
XC
XC
XC
dC
dC
dC
dC
XC
dC
dC
oI
vg
zv
eA
dC
hV
QF
QF
QF
QF
Js
"}
(66,1,1) = {"
Js
Js
QF
QF
QF
QF
QF
QF
QF
QF
Go
dC
vg
zv
eA
XC
XC
XC
XC
dC
dC
dC
dC
dC
dC
dC
dC
dC
dC
dC
dC
dC
dC
dC
XC
vg
zv
eA
dC
hV
QF
QF
QF
QF
Js
"}
(67,1,1) = {"
Js
Js
QF
QF
QF
QF
QF
QF
QF
QF
Go
XC
vg
zv
eA
XC
XC
XC
XC
XC
XC
XC
XC
dC
dC
XC
dC
dC
dC
dC
dC
dC
dC
XC
XC
vg
zv
eA
dC
hV
QF
QF
QF
QF
Js
"}
(68,1,1) = {"
Js
QF
QF
QF
QF
QF
QF
QF
QF
QF
Go
dC
vg
zv
sa
lu
lu
lu
lu
lu
lu
lu
lu
lu
lu
lu
lu
lu
lu
lu
lu
lu
lu
lu
lu
ov
zv
eA
dC
hV
QF
QF
QF
QF
Js
"}
(69,1,1) = {"
Js
Js
QF
QF
QF
QF
QF
QF
QF
QF
Go
uF
vg
zv
zv
zv
zv
zv
zv
zv
zv
zv
zv
Gs
qC
OH
zv
zv
zv
zv
zv
zv
zv
zv
zv
zv
zv
eA
uF
hV
QF
QF
QF
QF
Js
"}
(70,1,1) = {"
Js
QF
QF
QF
QF
QF
QF
QF
QF
uF
uF
uF
nb
No
No
No
bI
No
PA
iA
iA
iA
iA
wf
Sq
Lw
iA
iA
iA
iA
gA
No
No
bI
No
No
No
iD
uF
uF
uF
QF
QF
QF
Js
"}
(71,1,1) = {"
uF
uF
uF
QF
QF
QF
QF
QF
QF
QF
QF
uF
uF
uF
dC
dC
dC
XC
vg
iA
gR
iA
iA
iA
DS
iA
iA
iA
gR
iA
eA
dC
dC
XC
XC
dC
uF
uF
uF
QF
QF
QF
uF
uF
uF
"}
(72,1,1) = {"
tY
tY
uF
QF
QF
QF
QF
QF
QF
QF
QF
QF
uF
Iy
Iy
Iy
Iy
Iy
uF
Bb
Bb
Bb
uF
Bb
Bb
ZG
fu
Bb
Bb
Bb
uF
Iy
Iy
Iy
Iy
Iy
Iy
uF
QF
QF
QF
QF
uF
tY
tY
"}
(73,1,1) = {"
vP
vP
YA
vP
vP
vP
vP
vP
vP
vP
vP
vP
vP
vP
vP
vP
vP
vP
uF
Tw
Tw
ZB
uF
Qx
nf
nf
uF
ZB
Tw
Tw
uF
vP
vP
vP
vP
vP
vP
vP
vP
vP
vP
vP
YA
vP
vP
"}
(74,1,1) = {"
tY
tY
YA
QF
QF
QF
QF
QF
QF
QF
QF
QF
QF
QF
QF
QF
QF
QF
uF
tY
tY
tY
uF
tY
tY
dk
uF
tY
tY
tY
uF
QF
QF
QF
QF
QF
QF
QF
QF
QF
QF
QF
YA
tY
tY
"}
(75,1,1) = {"
tY
tY
YA
QF
QF
QF
QF
QF
QF
QF
QF
QF
QF
QF
QF
QF
QF
QF
uF
tY
tY
tY
uF
tY
tY
tY
uF
tY
tY
tY
uF
QF
QF
QF
QF
QF
QF
QF
QF
QF
QF
QF
YA
tY
tY
"}
(76,1,1) = {"
tY
tY
YA
QF
QF
QF
QF
QF
QF
QF
QF
QF
QF
QF
QF
QF
QF
QF
uF
tY
tY
tY
uF
tY
tY
tY
uF
tY
tY
tY
uF
QF
QF
QF
QF
QF
QF
QF
QF
QF
QF
QF
YA
tY
tY
"}
(77,1,1) = {"
vP
vP
YA
vP
vP
vP
vP
vP
vP
vP
vP
vP
vP
vP
vP
vP
vP
vP
uF
Ey
uF
Ey
uF
NQ
uF
NQ
uF
Ey
uF
Ey
uF
vP
vP
vP
vP
vP
vP
vP
vP
vP
vP
vP
YA
vP
vP
"}
(78,1,1) = {"
tY
tY
uF
QF
QF
QF
QF
QF
QF
QF
QF
QF
QF
QF
QF
QF
QF
LJ
uF
Qg
QF
QF
QF
QF
QF
QF
QF
QF
QF
LJ
uF
Qg
QF
QF
QF
QF
QF
QF
QF
QF
QF
QF
uF
tY
tY
"}
(79,1,1) = {"
uF
uF
uF
QF
QF
QF
QF
QF
QF
QF
QF
QF
QF
QF
QF
QF
QF
fS
hW
AZ
QF
QF
QF
QF
QF
QF
QF
QF
QF
fS
hW
AZ
QF
QF
QF
QF
QF
QF
QF
QF
QF
QF
uF
uF
uF
"}
(80,1,1) = {"
Js
Js
QF
QF
QF
QF
QF
QF
QF
QF
QF
QF
QF
QF
QF
QF
QF
QF
QF
QF
QF
QF
QF
QF
QF
QF
QF
QF
QF
QF
QF
QF
QF
QF
QF
QF
QF
QF
QF
QF
QF
QF
QF
QF
Js
"}
(81,1,1) = {"
Js
Js
Js
QF
QF
QF
Js
QF
QF
QF
QF
QF
QF
QF
QF
QF
QF
QF
QF
QF
QF
QF
QF
QF
QF
QF
QF
QF
QF
QF
QF
QF
QF
QF
QF
QF
QF
QF
QF
QF
QF
QF
QF
QF
Js
"}
(82,1,1) = {"
Js
Js
Js
Js
QF
Js
Js
QF
QF
QF
QF
QF
QF
QF
QF
QF
QF
QF
QF
QF
QF
QF
QF
QF
QF
QF
QF
QF
QF
QF
QF
QF
QF
QF
QF
QF
QF
QF
QF
Js
Js
QF
QF
Js
Js
"}
(83,1,1) = {"
Js
Js
Js
Js
Js
QF
QF
QF
QF
QF
QF
QF
QF
QF
QF
QF
QF
QF
QF
QF
QF
QF
QF
QF
QF
QF
QF
QF
QF
Js
QF
QF
QF
QF
QF
QF
QF
QF
QF
QF
Js
QF
QF
Js
Js
"}
(84,1,1) = {"
Js
Js
Js
Js
Js
Js
QF
QF
QF
QF
QF
QF
QF
QF
QF
QF
QF
Js
Js
Js
QF
QF
QF
QF
QF
QF
QF
QF
QF
Js
Js
QF
QF
QF
Js
QF
QF
QF
QF
QF
QF
QF
Js
Js
Js
"}
(85,1,1) = {"
Js
Js
Js
Js
Js
Js
Js
QF
QF
Js
Js
QF
QF
QF
QF
Js
Js
Js
Js
Js
Js
Js
QF
QF
QF
QF
QF
QF
Js
Js
Js
QF
QF
QF
Js
Js
QF
QF
Js
Js
Js
Js
Js
Js
Js
"}
(86,1,1) = {"
Js
Js
Js
Js
Js
Js
Js
Js
Js
Js
Js
Js
Js
Js
Js
Js
Js
Js
Js
Js
Js
Js
Js
Js
Js
Js
Js
Js
Js
Js
Js
Js
Js
Js
Js
Js
Js
Js
Js
Js
Js
Js
Js
Js
Js
"}
