//MAP CONVERTED BY dmm2tgm.py THIS HEADER COMMENT PREVENTS RECONVERSION, DO NOT REMOVE
"aM" = (
/obj/effect/turf_decal/techfloor{
	dir = 8
	},
/turf/open/floor/plasteel/tech{
	planetary_atmos = 1
	},
/area/hangar)
"bb" = (
/obj/machinery/light/floor/hangar,
/obj/effect/turf_decal/corner/opaque/brown{
	dir = 4
	},
/obj/effect/turf_decal/corner/opaque/yellow,
/turf/open/floor/plasteel/patterned/grid,
/area/hangar)
"bT" = (
/obj/effect/turf_decal/corner/opaque/brown{
	dir = 8
	},
/obj/effect/turf_decal/corner/opaque/yellow{
	dir = 1
	},
/turf/open/floor/plasteel/patterned/grid,
/area/hangar)
"ca" = (
/turf/open/floor/plasteel/patterned/grid,
/area/hangar)
"cS" = (
/obj/structure/catwalk/over/plated_catwalk/dark,
/turf/open/floor/plating/rust,
/area/hangar)
"eP" = (
/obj/machinery/elevator_call_button{
	dir = 8;
	pixel_x = 23
	},
/turf/closed/indestructible/reinforced,
/area/hangar)
"eY" = (
/obj/effect/turf_decal/corner/opaque/brown{
	dir = 8
	},
/obj/effect/turf_decal/corner/opaque/yellow,
/turf/open/floor/plasteel/patterned/grid,
/area/hangar)
"gF" = (
/obj/effect/turf_decal/corner/opaque/yellow{
	dir = 8
	},
/obj/effect/turf_decal/corner/opaque/yellow,
/turf/open/floor/plasteel/patterned/grid,
/area/hangar)
"hd" = (
/obj/effect/turf_decal/corner/opaque/brown{
	dir = 4
	},
/obj/machinery/light/floor/hangar,
/turf/open/floor/plasteel/patterned/grid,
/area/hangar)
"hn" = (
/obj/structure/platform/industrial_alt{
	dir = 1
	},
/turf/open/water/beach/deep,
/area/hangar)
"jN" = (
/obj/effect/turf_decal/corner/opaque/yellow{
	dir = 1
	},
/turf/open/floor/plasteel/patterned/grid,
/area/hangar)
"ma" = (
/turf/open/floor/plating{
	planetary_atmos = 1
	},
/area/hangar)
"mH" = (
/obj/effect/turf_decal/corner/opaque/yellow,
/obj/effect/turf_decal/corner/opaque/yellow{
	dir = 8
	},
/turf/open/floor/plasteel/patterned/grid,
/area/hangar)
"nf" = (
/obj/effect/forcefield/mime/advanced{
	name = "long fall";
	desc = "You don't want to jump off. You probably won't be saved.";
	timeleft = null
	},
/turf/open/water/beach/deep,
/area/hangar)
"nY" = (
/obj/structure/platform/industrial_alt{
	dir = 8
	},
/turf/open/water/beach/deep,
/area/hangar)
"ou" = (
/obj/machinery/elevator_call_button{
	dir = 1;
	pixel_y = -24
	},
/obj/effect/landmark/outpost/elevator_machine{
	shaft = "1"
	},
/obj/effect/turf_decal/techfloor{
	dir = 4
	},
/obj/effect/turf_decal/trimline/opaque/yellow/line{
	dir = 8
	},
/turf/open/floor/plasteel/patterned/grid,
/area/hangar)
"oy" = (
/obj/structure/marker_beacon{
	picked_color = "Teal"
	},
/turf/open/floor/plating{
	planetary_atmos = 1
	},
/area/hangar)
"oP" = (
/obj/effect/turf_decal/corner/opaque/brown{
	dir = 4
	},
/obj/effect/turf_decal/corner/opaque/yellow,
/turf/open/floor/plasteel/patterned/grid,
/area/hangar)
"oW" = (
/obj/effect/turf_decal/corner/opaque/yellow/full,
/obj/effect/landmark/outpost/hangar_numbers,
/turf/open/floor/plasteel/patterned/grid,
/area/hangar)
"pb" = (
/obj/structure/catwalk/over/plated_catwalk/dark,
/turf/open/floor/plating{
	planetary_atmos = 1
	},
/area/hangar)
"pl" = (
/obj/machinery/door/poddoor/shutters/indestructible{
	dir = 4
	},
/turf/closed/indestructible/fakeglass,
/area/hangar)
"qc" = (
/obj/structure/platform/industrial_alt{
	dir = 8
	},
/obj/effect/forcefield/mime/advanced{
	name = "long fall";
	desc = "You don't want to jump off. You probably won't be saved.";
	timeleft = null
	},
/turf/open/water/beach/deep,
/area/hangar)
"rw" = (
/obj/effect/turf_decal/corner/opaque/yellow{
	dir = 1
	},
/obj/effect/turf_decal/corner/opaque/yellow{
	dir = 4
	},
/turf/open/floor/plasteel/patterned/grid,
/area/hangar)
"rA" = (
/obj/effect/landmark/outpost/hangar_dock,
/turf/open/floor/plating{
	planetary_atmos = 1
	},
/area/hangar)
"sP" = (
/obj/effect/turf_decal/corner/opaque/brown{
	dir = 4
	},
/obj/effect/turf_decal/corner/opaque/yellow,
/obj/effect/turf_decal/corner/opaque/yellow{
	dir = 1
	},
/turf/open/floor/plasteel/patterned/grid,
/area/hangar)
"uz" = (
/obj/structure/catwalk/over/plated_catwalk,
/turf/open/floor/plating{
	planetary_atmos = 1
	},
/area/hangar)
"vH" = (
/turf/closed/indestructible/reinforced,
/area/hangar)
"wb" = (
/obj/effect/turf_decal/corner/opaque/brown{
	dir = 4
	},
/obj/effect/turf_decal/corner/opaque/brown{
	dir = 8
	},
/obj/effect/turf_decal/corner/opaque/yellow{
	dir = 1
	},
/turf/open/floor/plasteel/patterned/grid,
/area/hangar)
"wt" = (
/obj/structure/platform/industrial{
	dir = 4
	},
/obj/structure/platform/industrial{
	dir = 8
	},
/turf/open/floor/plasteel/elevatorshaft,
/area/hangar)
"xI" = (
/obj/effect/turf_decal/corner/opaque/brown{
	dir = 4
	},
/obj/effect/turf_decal/corner/opaque/yellow{
	dir = 1
	},
/turf/open/floor/plasteel/patterned/grid,
/area/hangar)
"yh" = (
/obj/structure/platform/industrial_alt{
	dir = 1
	},
/obj/effect/forcefield/mime/advanced{
	name = "long fall";
	desc = "You don't want to jump off. You probably won't be saved.";
	timeleft = null
	},
/turf/open/water/beach/deep,
/area/hangar)
"Bm" = (
/obj/effect/landmark/outpost/elevator{
	shaft = "1"
	},
/turf/open/floor/plasteel/elevatorshaft,
/area/hangar)
"BL" = (
/turf/closed/indestructible/rock,
/area/hangar)
"Cm" = (
/obj/structure/platform/industrial_alt,
/turf/open/water/beach/deep,
/area/hangar)
"Ct" = (
/obj/effect/landmark/outpost/elevator_machine{
	shaft = "1"
	},
/obj/machinery/door/airlock/hatch{
	dir = 4
	},
/turf/open/floor/plating{
	planetary_atmos = 1
	},
/area/hangar)
"Cw" = (
/obj/effect/turf_decal/corner/opaque/yellow{
	dir = 4
	},
/obj/effect/turf_decal/corner/opaque/yellow,
/turf/open/floor/plasteel/patterned/grid,
/area/hangar)
"CE" = (
/turf/open/floor/plasteel/elevatorshaft,
/area/hangar)
"Dd" = (
/obj/structure/platform/industrial_alt{
	dir = 4
	},
/obj/effect/forcefield/mime/advanced{
	name = "long fall";
	desc = "You don't want to jump off. You probably won't be saved.";
	timeleft = null
	},
/turf/open/water/beach/deep,
/area/hangar)
"Dy" = (
/obj/effect/landmark/outpost/hangar_numbers,
/turf/open/floor/plasteel/patterned/grid,
/area/hangar)
"DM" = (
/obj/machinery/door/poddoor/ert,
/turf/open/floor/plasteel/elevatorshaft,
/area/hangar)
"Ff" = (
/obj/structure/platform/industrial_alt,
/obj/effect/forcefield/mime/advanced{
	name = "long fall";
	desc = "You don't want to jump off. You probably won't be saved.";
	timeleft = null
	},
/turf/open/water/beach/deep,
/area/hangar)
"FG" = (
/obj/machinery/light/floor/hangar,
/obj/effect/turf_decal/corner/opaque/brown{
	dir = 4
	},
/obj/effect/turf_decal/corner/opaque/yellow{
	dir = 1
	},
/turf/open/floor/plasteel/patterned/grid,
/area/hangar)
"GK" = (
/turf/open/floor/plating/rust,
/area/hangar)
"IK" = (
/obj/effect/turf_decal/corner/opaque/brown{
	dir = 8
	},
/obj/effect/turf_decal/corner/opaque/brown{
	dir = 4
	},
/obj/effect/turf_decal/corner/opaque/yellow,
/turf/open/floor/plasteel/patterned/grid,
/area/hangar)
"JA" = (
/obj/machinery/door/poddoor/shutters/indestructible{
	dir = 4
	},
/turf/open/floor/plating/rust,
/area/hangar)
"Po" = (
/obj/effect/turf_decal/corner/opaque/brown{
	dir = 8
	},
/obj/effect/turf_decal/corner/opaque/yellow{
	dir = 1
	},
/obj/effect/turf_decal/corner/opaque/yellow,
/turf/open/floor/plasteel/patterned/grid,
/area/hangar)
"Rh" = (
/obj/effect/turf_decal/corner/opaque/yellow{
	dir = 4
	},
/obj/effect/turf_decal/corner/opaque/yellow{
	dir = 1
	},
/turf/open/floor/plasteel/patterned/grid,
/area/hangar)
"RE" = (
/obj/structure/platform/industrial_alt/corner{
	dir = 4
	},
/turf/open/water/beach/deep,
/area/hangar)
"RT" = (
/obj/effect/landmark/outpost/elevator_machine{
	shaft = "1"
	},
/obj/machinery/door/airlock/hatch{
	dir = 4
	},
/turf/open/floor/plating/rust,
/area/hangar)
"SK" = (
/obj/machinery/door/poddoor/shutters/indestructible{
	dir = 4
	},
/turf/open/floor/plating{
	planetary_atmos = 1
	},
/area/hangar)
"TB" = (
/obj/effect/turf_decal/techfloor{
	dir = 4
	},
/obj/effect/turf_decal/trimline/opaque/yellow/line{
	dir = 8
	},
/turf/open/floor/plasteel/patterned/grid,
/area/hangar)
"TL" = (
/obj/structure/platform/industrial_alt/corner{
	dir = 1
	},
/turf/open/water/beach/deep,
/area/hangar)
"TM" = (
/obj/effect/turf_decal/corner/opaque/brown{
	dir = 8
	},
/turf/open/floor/plasteel/patterned/grid,
/area/hangar)
"Ve" = (
/obj/machinery/light/floor/hangar,
/obj/effect/turf_decal/corner/opaque/brown{
	dir = 8
	},
/obj/effect/turf_decal/corner/opaque/yellow,
/turf/open/floor/plasteel/patterned/grid,
/area/hangar)
"VS" = (
/obj/effect/turf_decal/corner/opaque/yellow,
/obj/machinery/light/floor/hangar,
/turf/open/floor/plasteel/patterned/grid,
/area/hangar)
"Wv" = (
/turf/open/water/beach/deep,
/area/hangar)
"WH" = (
/obj/structure/marker_beacon{
	picked_color = "Teal"
	},
/turf/open/floor/plating/rust,
/area/hangar)
"WI" = (
/obj/effect/turf_decal/techfloor{
	dir = 4
	},
/turf/open/floor/plasteel/tech{
	planetary_atmos = 1
	},
/area/hangar)
"YF" = (
/obj/structure/catwalk/over/plated_catwalk,
/obj/machinery/atmospherics/pipe/manifold/orange/hidden,
/turf/open/floor/plating{
	planetary_atmos = 1
	},
/area/hangar)
"YP" = (
/obj/effect/turf_decal/corner/opaque/yellow{
	dir = 1
	},
/obj/effect/turf_decal/corner/opaque/yellow{
	dir = 8
	},
/turf/open/floor/plasteel/patterned/grid,
/area/hangar)

(1,1,1) = {"
BL
BL
BL
BL
BL
BL
BL
BL
BL
BL
BL
BL
BL
BL
BL
BL
BL
BL
Wv
Wv
Wv
Wv
Wv
Wv
Wv
Wv
Wv
Wv
BL
BL
BL
BL
BL
BL
BL
BL
BL
BL
BL
BL
BL
Wv
Wv
Wv
Wv
Wv
Wv
Wv
Wv
Wv
Wv
BL
BL
BL
BL
BL
BL
BL
BL
BL
BL
BL
BL
BL
BL
"}
(2,1,1) = {"
BL
BL
BL
BL
BL
BL
BL
Wv
Wv
Wv
BL
BL
BL
BL
BL
BL
BL
Wv
Wv
Wv
Wv
Wv
Wv
Wv
Wv
Wv
Wv
Wv
Wv
Wv
Wv
Wv
BL
BL
BL
BL
BL
Wv
Wv
BL
BL
Wv
Wv
Wv
Wv
Wv
Wv
Wv
Wv
Wv
Wv
BL
BL
Wv
Wv
Wv
Wv
Wv
Wv
BL
BL
BL
BL
BL
BL
"}
(3,1,1) = {"
BL
BL
BL
BL
BL
BL
Wv
Wv
Wv
Wv
Wv
Wv
Wv
Wv
Wv
Wv
Wv
Wv
Wv
Wv
Wv
Wv
Wv
Wv
Wv
Wv
Wv
Wv
Wv
Wv
Wv
Wv
Wv
BL
BL
BL
Wv
Wv
Wv
Wv
Wv
Wv
Wv
Wv
Wv
Wv
Wv
Wv
Wv
Wv
Wv
BL
Wv
Wv
Wv
Wv
Wv
Wv
Wv
Wv
Wv
BL
BL
BL
BL
"}
(4,1,1) = {"
BL
BL
BL
BL
Wv
Wv
Wv
Wv
Wv
Wv
Wv
Wv
Wv
Wv
Wv
Wv
Wv
Wv
Wv
Wv
Wv
Wv
Wv
Wv
Wv
Wv
Wv
Wv
Wv
Wv
Wv
Wv
Wv
BL
Wv
Wv
Wv
Wv
Wv
Wv
Wv
Wv
Wv
Wv
Wv
Wv
Wv
Wv
Wv
Wv
Wv
Wv
Wv
Wv
Wv
Wv
Wv
Wv
Wv
Wv
Wv
Wv
BL
BL
BL
"}
(5,1,1) = {"
BL
BL
BL
Wv
Wv
Wv
Wv
Wv
Wv
Wv
Wv
Wv
Wv
Wv
Wv
Wv
Wv
Wv
Wv
Wv
Wv
Wv
Wv
Wv
Wv
Wv
Wv
Wv
Wv
Wv
Wv
Wv
Wv
Wv
Wv
Wv
Wv
Wv
Wv
Wv
Wv
Wv
Wv
Wv
Wv
Wv
Wv
Wv
Wv
Wv
Wv
Wv
Wv
Wv
Wv
Wv
Wv
Wv
Wv
Wv
Wv
Wv
Wv
BL
BL
"}
(6,1,1) = {"
BL
BL
Wv
Wv
Wv
Wv
Wv
Wv
Wv
Wv
Wv
Wv
vH
nf
nf
nf
nf
nf
nf
nf
nf
nf
nf
nf
nf
nf
nf
nf
nf
nf
nf
nf
nf
nf
nf
nf
nf
nf
nf
nf
nf
nf
nf
nf
nf
nf
nf
nf
nf
nf
nf
nf
nf
nf
nf
nf
nf
vH
Wv
Wv
Wv
Wv
Wv
BL
BL
"}
(7,1,1) = {"
BL
Wv
Wv
Wv
Wv
Wv
Wv
Wv
Wv
Wv
Wv
Wv
vH
Dd
Dd
Dd
Dd
Dd
Dd
Dd
Dd
Dd
Dd
Dd
Dd
Dd
Dd
Dd
Dd
Dd
Dd
Dd
Dd
Dd
Dd
Dd
Dd
Dd
Dd
Dd
Dd
Dd
Dd
Dd
Dd
Dd
Dd
Dd
Dd
Dd
Dd
Dd
Dd
Dd
Dd
Dd
Dd
vH
Wv
Wv
Wv
Wv
Wv
BL
BL
"}
(8,1,1) = {"
BL
Wv
Wv
Wv
Wv
Wv
Wv
Wv
Wv
Wv
Wv
vH
vH
vH
ma
GK
GK
GK
ma
ma
GK
GK
GK
ma
ma
GK
ma
GK
ma
ma
GK
ma
ma
vH
vH
vH
vH
GK
GK
ma
GK
ma
GK
GK
ma
ma
ma
GK
GK
GK
ma
ma
GK
ma
GK
ma
vH
vH
vH
Wv
Wv
Wv
Wv
BL
BL
"}
(9,1,1) = {"
BL
Wv
Wv
Wv
Wv
Wv
Wv
Wv
Wv
vH
vH
vH
wb
bT
Po
aM
aM
aM
aM
aM
aM
aM
aM
aM
aM
aM
aM
aM
aM
aM
aM
aM
aM
aM
aM
aM
aM
aM
aM
aM
aM
aM
aM
aM
aM
aM
aM
aM
aM
aM
aM
aM
aM
aM
aM
wb
bT
Po
vH
vH
vH
Wv
Wv
BL
BL
"}
(10,1,1) = {"
BL
Wv
Wv
Wv
Wv
Wv
Wv
Wv
Wv
Wv
Ff
vH
xI
uz
eY
cS
pb
cS
pb
cS
pb
pb
pb
cS
pb
pb
pb
cS
pb
cS
pb
cS
pb
pb
pb
cS
cS
cS
pb
pb
pb
cS
pb
cS
pb
pb
pb
cS
pb
pb
cS
pb
pb
cS
pb
xI
uz
eY
vH
yh
Wv
Wv
Wv
Wv
BL
"}
(11,1,1) = {"
BL
Wv
Wv
Wv
Wv
Wv
Wv
Wv
Wv
Wv
Ff
GK
xI
uz
eY
WI
WI
WI
WI
WI
WI
WI
WI
WI
WI
WI
WI
WI
WI
WI
WI
WI
WI
WI
WI
WI
WI
WI
WI
WI
WI
WI
WI
WI
WI
WI
WI
WI
WI
WI
WI
WI
WI
WI
WI
xI
uz
eY
ma
yh
Wv
Wv
Wv
Wv
BL
"}
(12,1,1) = {"
BL
BL
Wv
Wv
Wv
Wv
Wv
Wv
Wv
Wv
Ff
GK
xI
uz
eY
GK
GK
GK
GK
GK
ma
ma
ma
ma
ma
ma
ma
ma
ma
ma
ma
ma
ma
ma
ma
ma
ma
ma
ma
ma
ma
ma
ma
ma
ma
ma
ma
ma
ma
ma
ma
ma
ma
GK
rA
xI
uz
eY
GK
yh
Wv
Wv
Wv
Wv
BL
"}
(13,1,1) = {"
BL
BL
BL
Wv
Wv
Wv
Wv
Wv
Wv
Wv
Ff
ma
xI
uz
eY
GK
GK
ma
ma
ma
ma
ma
ma
ma
GK
ma
ma
ma
ma
ma
ma
ma
ma
ma
ma
ma
ma
ma
ma
ma
ma
ma
ma
ma
ma
ma
GK
ma
ma
ma
ma
ma
ma
ma
GK
xI
uz
eY
GK
yh
Wv
Wv
Wv
Wv
BL
"}
(14,1,1) = {"
BL
BL
BL
BL
Wv
Wv
Wv
Wv
Wv
Wv
Ff
ma
xI
uz
eY
oy
GK
ma
ma
ma
ma
ma
ma
ma
GK
ma
ma
ma
GK
GK
ma
ma
ma
ma
ma
ma
ma
ma
ma
GK
GK
GK
GK
ma
ma
GK
GK
GK
GK
ma
ma
GK
ma
ma
WH
xI
uz
eY
GK
yh
Wv
Wv
Wv
Wv
BL
"}
(15,1,1) = {"
BL
BL
Wv
Wv
Wv
Wv
Wv
Wv
Wv
Wv
Ff
GK
xI
uz
eY
GK
ma
ma
ma
ma
ma
GK
ma
ma
ma
GK
GK
ma
ma
ma
ma
ma
ma
ma
ma
ma
GK
GK
GK
GK
ma
ma
GK
GK
GK
GK
GK
ma
ma
ma
ma
GK
ma
ma
GK
xI
uz
eY
GK
yh
Wv
Wv
Wv
Wv
BL
"}
(16,1,1) = {"
BL
BL
Wv
Wv
Wv
Wv
Wv
Wv
Wv
Wv
Ff
ma
xI
uz
Ve
GK
ma
ma
ma
GK
ma
GK
ma
ma
ma
ma
ma
ma
ma
ma
GK
ma
ma
GK
ma
ma
ma
ma
ma
GK
GK
ma
GK
GK
ma
GK
GK
ma
ma
ma
GK
GK
ma
ma
ma
FG
uz
eY
ma
yh
Wv
Wv
Wv
Wv
BL
"}
(17,1,1) = {"
BL
Wv
Wv
Wv
Wv
Wv
Wv
Wv
Wv
Wv
Ff
ma
xI
uz
eY
GK
ma
ma
GK
GK
ma
ma
ma
ma
ma
ma
ma
ma
ma
ma
GK
ma
ma
GK
GK
ma
ma
ma
ma
ma
ma
ma
GK
GK
ma
ma
GK
ma
ma
ma
GK
GK
ma
ma
ma
xI
uz
eY
ma
yh
Wv
Wv
Wv
Wv
BL
"}
(18,1,1) = {"
BL
BL
Wv
Wv
Wv
Wv
Wv
Wv
Wv
Wv
Ff
GK
xI
uz
eY
ma
ma
ma
ma
ma
ma
ma
ma
ma
ma
ma
ma
ma
ma
GK
ma
ma
ma
ma
ma
GK
GK
ma
ma
ma
ma
ma
ma
GK
ma
ma
ma
ma
ma
ma
ma
ma
ma
ma
ma
xI
uz
eY
GK
yh
Wv
Wv
Wv
Wv
BL
"}
(19,1,1) = {"
BL
BL
BL
Wv
Wv
Wv
Wv
Wv
Wv
Wv
Ff
GK
xI
uz
eY
oy
ma
ma
ma
ma
ma
ma
GK
ma
ma
ma
ma
ma
ma
ma
ma
ma
ma
ma
ma
ma
GK
GK
GK
ma
ma
ma
ma
ma
ma
ma
ma
GK
ma
ma
ma
ma
GK
ma
oy
xI
uz
eY
ma
yh
Wv
Wv
Wv
BL
BL
"}
(20,1,1) = {"
BL
Wv
Wv
Wv
Wv
Wv
Wv
Wv
Wv
Wv
Ff
ma
xI
uz
eY
ma
ma
GK
ma
ma
ma
ma
ma
GK
ma
GK
GK
ma
ma
ma
ma
ma
ma
ma
ma
ma
ma
ma
ma
ma
ma
ma
ma
ma
GK
ma
ma
ma
GK
GK
ma
ma
ma
ma
ma
xI
uz
eY
ma
yh
Wv
Wv
Wv
Wv
BL
"}
(21,1,1) = {"
BL
Wv
Wv
Wv
Wv
Wv
Wv
Wv
Wv
Wv
Ff
GK
xI
uz
eY
ma
GK
ma
ma
GK
ma
ma
ma
GK
ma
ma
ma
GK
ma
ma
ma
ma
ma
ma
ma
ma
ma
ma
ma
ma
ma
ma
GK
ma
ma
GK
ma
ma
ma
GK
ma
ma
ma
ma
ma
xI
uz
eY
ma
yh
Wv
Wv
Wv
Wv
BL
"}
(22,1,1) = {"
BL
Wv
Wv
Wv
Wv
Wv
Wv
Wv
Wv
Wv
Ff
GK
xI
uz
eY
ma
ma
ma
ma
ma
ma
ma
ma
ma
ma
ma
ma
ma
GK
ma
ma
ma
ma
ma
ma
GK
GK
ma
ma
ma
ma
ma
ma
ma
ma
ma
ma
ma
ma
ma
ma
ma
ma
ma
ma
xI
uz
eY
ma
yh
Wv
Wv
Wv
Wv
BL
"}
(23,1,1) = {"
BL
Wv
Wv
Wv
Wv
Wv
Wv
Wv
Wv
Wv
Ff
GK
xI
uz
eY
ma
ma
ma
ma
ma
ma
GK
ma
GK
ma
ma
ma
ma
ma
ma
ma
ma
GK
GK
ma
ma
GK
ma
ma
GK
ma
ma
ma
ma
ma
ma
ma
ma
ma
ma
ma
GK
ma
ma
ma
xI
uz
eY
GK
yh
Wv
Wv
Wv
Wv
BL
"}
(24,1,1) = {"
BL
Wv
Wv
Wv
Wv
Wv
Wv
Wv
Wv
Wv
Ff
GK
xI
uz
Ve
oy
ma
ma
ma
ma
ma
ma
ma
ma
ma
ma
GK
ma
ma
ma
ma
ma
ma
GK
GK
ma
ma
ma
ma
ma
ma
ma
ma
ma
ma
ma
ma
GK
ma
ma
ma
GK
GK
ma
oy
FG
uz
eY
GK
yh
Wv
Wv
Wv
BL
BL
"}
(25,1,1) = {"
BL
Wv
Wv
Wv
Wv
Wv
Wv
Wv
Wv
Wv
Ff
ma
xI
uz
eY
ma
ma
ma
ma
ma
ma
ma
ma
ma
ma
ma
GK
ma
ma
ma
ma
ma
ma
ma
GK
ma
ma
ma
ma
ma
ma
ma
ma
ma
GK
ma
ma
ma
ma
ma
ma
GK
GK
ma
GK
xI
uz
eY
ma
yh
Wv
Wv
Wv
BL
BL
"}
(26,1,1) = {"
BL
BL
Wv
Wv
Wv
Wv
Wv
Wv
Wv
Wv
Ff
ma
xI
uz
eY
GK
ma
ma
ma
GK
ma
ma
ma
ma
ma
ma
GK
ma
ma
ma
ma
ma
ma
ma
ma
ma
ma
ma
ma
GK
ma
ma
ma
ma
ma
GK
ma
ma
ma
ma
ma
GK
GK
ma
GK
xI
uz
eY
ma
yh
Wv
Wv
Wv
BL
BL
"}
(27,1,1) = {"
BL
BL
Wv
Wv
Wv
Wv
Wv
Wv
Wv
Wv
Ff
ma
xI
uz
eY
ma
ma
ma
ma
ma
GK
ma
GK
ma
ma
ma
GK
ma
ma
ma
ma
ma
ma
ma
ma
ma
ma
ma
GK
ma
ma
ma
GK
ma
ma
ma
ma
ma
ma
ma
ma
ma
ma
ma
GK
xI
uz
eY
GK
yh
Wv
Wv
Wv
BL
BL
"}
(28,1,1) = {"
BL
BL
Wv
Wv
Wv
Wv
Wv
Wv
Wv
Wv
Ff
ma
xI
uz
eY
GK
ma
ma
ma
GK
GK
ma
ma
GK
GK
ma
GK
GK
ma
ma
GK
ma
ma
ma
ma
ma
ma
ma
ma
ma
ma
ma
ma
ma
ma
ma
ma
ma
GK
ma
ma
ma
ma
ma
GK
xI
uz
eY
GK
yh
Wv
Wv
Wv
BL
BL
"}
(29,1,1) = {"
BL
BL
Wv
Wv
Wv
Wv
Wv
Wv
Wv
Wv
Ff
ma
xI
uz
eY
WH
ma
ma
ma
ma
ma
ma
ma
ma
GK
ma
ma
GK
ma
ma
GK
ma
ma
ma
ma
ma
ma
GK
ma
ma
ma
ma
ma
ma
ma
ma
ma
GK
GK
ma
ma
ma
ma
ma
oy
xI
uz
eY
GK
yh
Wv
Wv
Wv
BL
BL
"}
(30,1,1) = {"
BL
BL
Wv
Wv
Wv
Wv
Wv
Wv
Wv
Wv
Ff
ma
xI
uz
eY
GK
ma
ma
GK
ma
ma
ma
ma
ma
ma
ma
ma
ma
ma
ma
ma
ma
GK
ma
ma
ma
ma
GK
GK
ma
ma
ma
ma
ma
GK
ma
ma
GK
ma
ma
ma
ma
ma
ma
GK
xI
uz
eY
ma
yh
Wv
Wv
Wv
BL
BL
"}
(31,1,1) = {"
BL
BL
BL
Wv
Wv
Wv
Wv
Wv
Wv
Wv
Ff
GK
xI
uz
eY
ma
ma
ma
ma
GK
ma
ma
ma
ma
ma
ma
ma
ma
ma
ma
ma
ma
GK
GK
ma
ma
ma
ma
GK
ma
ma
ma
ma
ma
GK
ma
ma
ma
ma
ma
GK
ma
ma
ma
ma
xI
uz
eY
ma
yh
Wv
Wv
BL
BL
BL
"}
(32,1,1) = {"
BL
BL
BL
Wv
Wv
Wv
Wv
Wv
Wv
Wv
Ff
GK
xI
uz
Ve
ma
ma
GK
ma
ma
ma
ma
ma
ma
ma
ma
ma
ma
ma
ma
ma
ma
ma
GK
ma
ma
ma
ma
ma
ma
ma
ma
ma
ma
ma
ma
ma
ma
ma
ma
ma
ma
ma
ma
ma
FG
uz
eY
ma
yh
Wv
Wv
BL
BL
BL
"}
(33,1,1) = {"
BL
BL
BL
BL
Wv
Wv
Wv
Wv
Wv
Wv
Ff
GK
xI
uz
eY
ma
ma
ma
GK
ma
ma
ma
ma
ma
GK
ma
ma
ma
ma
GK
ma
ma
ma
GK
ma
ma
GK
GK
ma
ma
GK
ma
ma
ma
ma
ma
ma
ma
ma
ma
ma
ma
ma
ma
ma
xI
uz
eY
GK
yh
Wv
Wv
Wv
BL
BL
"}
(34,1,1) = {"
BL
BL
BL
Wv
Wv
Wv
Wv
Wv
Wv
Wv
Ff
ma
xI
uz
eY
ma
GK
ma
ma
ma
GK
ma
ma
ma
GK
ma
ma
ma
ma
ma
GK
ma
ma
ma
GK
GK
ma
ma
ma
ma
ma
ma
ma
ma
ma
ma
ma
ma
ma
ma
GK
GK
ma
GK
ma
xI
uz
eY
GK
yh
Wv
Wv
Wv
BL
BL
"}
(35,1,1) = {"
BL
BL
BL
Wv
Wv
Wv
Wv
Wv
Wv
Wv
Ff
ma
xI
uz
eY
ma
ma
ma
ma
ma
ma
GK
GK
ma
ma
GK
GK
ma
ma
GK
ma
ma
ma
ma
ma
ma
ma
ma
ma
GK
ma
ma
ma
ma
ma
ma
ma
ma
ma
ma
ma
GK
ma
ma
ma
xI
uz
eY
GK
yh
Wv
Wv
Wv
BL
BL
"}
(36,1,1) = {"
BL
BL
BL
Wv
Wv
Wv
Wv
Wv
Wv
Wv
Ff
ma
xI
uz
eY
ma
GK
ma
ma
ma
ma
ma
ma
ma
ma
GK
ma
ma
ma
GK
ma
ma
ma
ma
ma
ma
ma
ma
ma
GK
ma
ma
GK
GK
GK
ma
ma
ma
ma
ma
ma
GK
ma
ma
GK
xI
uz
eY
ma
yh
Wv
Wv
Wv
Wv
BL
"}
(37,1,1) = {"
BL
BL
BL
Wv
Wv
Wv
Wv
Wv
Wv
Wv
Ff
ma
xI
uz
eY
GK
ma
ma
GK
ma
GK
ma
ma
ma
GK
GK
ma
ma
ma
ma
ma
ma
ma
ma
ma
ma
ma
ma
GK
ma
ma
ma
GK
GK
GK
GK
GK
ma
ma
ma
ma
ma
ma
ma
ma
xI
uz
eY
ma
yh
Wv
Wv
Wv
Wv
BL
"}
(38,1,1) = {"
BL
BL
Wv
Wv
Wv
Wv
Wv
Wv
Wv
Wv
Ff
GK
xI
uz
eY
ma
ma
ma
ma
ma
ma
GK
ma
ma
GK
ma
ma
ma
ma
ma
ma
ma
ma
ma
ma
ma
ma
ma
ma
ma
ma
ma
ma
GK
ma
ma
ma
ma
GK
ma
ma
ma
ma
ma
ma
xI
uz
eY
GK
yh
Wv
Wv
Wv
Wv
BL
"}
(39,1,1) = {"
BL
BL
Wv
Wv
Wv
Wv
Wv
Wv
Wv
Wv
Ff
GK
xI
uz
eY
ma
ma
ma
ma
ma
ma
ma
ma
ma
GK
ma
ma
GK
ma
ma
ma
ma
ma
GK
GK
ma
ma
ma
ma
GK
GK
ma
ma
ma
ma
ma
ma
ma
ma
ma
ma
ma
ma
ma
ma
xI
uz
eY
ma
yh
Wv
Wv
Wv
Wv
BL
"}
(40,1,1) = {"
BL
BL
Wv
Wv
Wv
Wv
Wv
Wv
Wv
Wv
Ff
GK
xI
uz
Ve
GK
ma
ma
ma
ma
GK
GK
GK
ma
ma
ma
ma
ma
ma
ma
GK
ma
ma
ma
ma
ma
ma
ma
ma
GK
ma
ma
ma
ma
ma
ma
ma
ma
GK
ma
ma
ma
ma
GK
ma
FG
uz
eY
ma
yh
Wv
Wv
Wv
Wv
BL
"}
(41,1,1) = {"
BL
BL
Wv
Wv
Wv
Wv
Wv
Wv
Wv
Wv
Ff
ma
xI
uz
eY
GK
ma
ma
GK
ma
ma
GK
ma
ma
ma
ma
ma
ma
ma
ma
ma
GK
GK
GK
GK
GK
ma
ma
ma
ma
ma
ma
ma
ma
ma
ma
ma
GK
GK
ma
ma
ma
ma
ma
GK
xI
uz
eY
GK
yh
Wv
Wv
Wv
BL
BL
"}
(42,1,1) = {"
BL
BL
Wv
Wv
Wv
Wv
Wv
Wv
Wv
Wv
Ff
ma
xI
uz
eY
ma
ma
ma
ma
GK
GK
ma
ma
GK
ma
ma
ma
ma
ma
ma
ma
ma
ma
ma
ma
ma
ma
ma
ma
ma
ma
ma
ma
ma
ma
GK
ma
ma
ma
ma
ma
GK
ma
ma
ma
xI
uz
eY
ma
yh
Wv
Wv
BL
BL
BL
"}
(43,1,1) = {"
BL
BL
Wv
Wv
Wv
Wv
Wv
Wv
Wv
Wv
Ff
GK
xI
uz
eY
ma
ma
ma
ma
ma
GK
GK
ma
ma
ma
ma
GK
GK
GK
ma
ma
ma
ma
ma
ma
ma
ma
ma
GK
ma
ma
ma
GK
ma
ma
ma
ma
ma
ma
ma
GK
GK
ma
ma
ma
xI
uz
eY
ma
yh
Wv
BL
BL
BL
BL
"}
(44,1,1) = {"
BL
Wv
Wv
Wv
Wv
Wv
Wv
Wv
Wv
Wv
Ff
ma
xI
uz
eY
ma
ma
ma
ma
GK
ma
ma
ma
ma
ma
ma
GK
ma
ma
ma
ma
ma
ma
ma
ma
ma
ma
ma
GK
ma
ma
ma
GK
GK
ma
ma
ma
ma
ma
GK
ma
ma
ma
ma
ma
xI
uz
eY
ma
yh
Wv
Wv
Wv
BL
BL
"}
(45,1,1) = {"
BL
Wv
Wv
Wv
Wv
Wv
Wv
Wv
Wv
Wv
Ff
GK
xI
uz
eY
ma
GK
ma
ma
ma
ma
ma
GK
ma
ma
ma
ma
GK
ma
ma
ma
ma
ma
ma
ma
ma
GK
ma
GK
ma
ma
ma
GK
GK
ma
ma
ma
GK
ma
ma
ma
GK
ma
ma
ma
xI
uz
eY
ma
yh
Wv
Wv
Wv
BL
BL
"}
(46,1,1) = {"
BL
Wv
Wv
Wv
Wv
Wv
Wv
Wv
Wv
Wv
Ff
GK
xI
uz
eY
ma
ma
ma
ma
ma
ma
ma
ma
GK
ma
ma
ma
GK
ma
ma
ma
ma
GK
GK
ma
ma
ma
ma
ma
ma
ma
ma
GK
GK
GK
GK
GK
ma
ma
ma
ma
ma
ma
ma
GK
xI
uz
eY
GK
yh
Wv
Wv
BL
BL
BL
"}
(47,1,1) = {"
BL
Wv
Wv
Wv
Wv
Wv
Wv
Wv
Wv
Wv
Ff
ma
xI
uz
eY
ma
ma
ma
ma
GK
ma
ma
ma
ma
ma
ma
GK
ma
ma
ma
GK
GK
GK
GK
ma
GK
ma
ma
ma
ma
ma
ma
ma
GK
ma
ma
ma
ma
ma
ma
ma
ma
ma
ma
ma
xI
uz
eY
ma
yh
Wv
Wv
BL
BL
BL
"}
(48,1,1) = {"
BL
BL
Wv
Wv
Wv
Wv
Wv
Wv
Wv
Wv
Ff
ma
xI
uz
Ve
ma
ma
ma
ma
ma
ma
ma
ma
GK
ma
ma
GK
GK
ma
ma
GK
ma
ma
ma
ma
ma
ma
ma
ma
ma
GK
ma
ma
GK
GK
ma
ma
ma
ma
GK
GK
GK
ma
ma
GK
FG
uz
eY
ma
yh
Wv
Wv
Wv
BL
BL
"}
(49,1,1) = {"
BL
BL
Wv
Wv
Wv
Wv
Wv
Wv
Wv
Wv
Ff
ma
xI
uz
eY
ma
ma
ma
ma
GK
ma
ma
ma
ma
ma
ma
GK
ma
ma
ma
GK
ma
ma
ma
ma
ma
ma
ma
ma
ma
GK
ma
ma
ma
ma
ma
ma
ma
ma
ma
GK
GK
ma
ma
GK
xI
uz
eY
ma
yh
Wv
Wv
Wv
BL
BL
"}
(50,1,1) = {"
BL
BL
BL
Wv
Wv
Wv
Wv
Wv
Wv
Wv
Ff
ma
xI
uz
eY
WH
ma
ma
GK
GK
GK
ma
ma
ma
ma
GK
GK
ma
ma
ma
ma
ma
ma
ma
ma
ma
ma
ma
ma
ma
GK
ma
ma
ma
ma
ma
ma
ma
ma
ma
ma
ma
ma
ma
WH
xI
uz
eY
ma
yh
Wv
Wv
Wv
Wv
BL
"}
(51,1,1) = {"
BL
BL
BL
BL
Wv
Wv
Wv
Wv
Wv
Wv
Ff
ma
xI
uz
eY
ma
ma
ma
ma
ma
GK
GK
ma
ma
ma
GK
ma
ma
ma
ma
ma
ma
ma
ma
ma
ma
GK
ma
ma
ma
GK
ma
ma
ma
ma
GK
GK
GK
ma
ma
ma
ma
ma
ma
GK
xI
uz
eY
GK
yh
Wv
Wv
Wv
Wv
BL
"}
(52,1,1) = {"
BL
BL
Wv
Wv
Wv
Wv
Wv
Wv
Wv
Wv
Ff
ma
xI
uz
eY
ma
ma
ma
ma
ma
ma
GK
ma
ma
ma
GK
ma
ma
GK
ma
ma
ma
ma
ma
GK
ma
ma
GK
GK
ma
GK
GK
ma
ma
GK
GK
GK
GK
ma
ma
ma
ma
ma
ma
ma
xI
uz
eY
GK
yh
Wv
Wv
Wv
Wv
BL
"}
(53,1,1) = {"
BL
BL
BL
Wv
Wv
Wv
Wv
Wv
Wv
Wv
Ff
GK
xI
uz
eY
ma
GK
ma
ma
ma
ma
GK
ma
GK
ma
ma
ma
ma
ma
ma
ma
GK
ma
ma
ma
ma
ma
ma
GK
ma
ma
GK
ma
ma
GK
ma
GK
ma
ma
ma
ma
GK
ma
ma
ma
xI
uz
eY
GK
yh
Wv
Wv
Wv
Wv
BL
"}
(54,1,1) = {"
BL
BL
Wv
Wv
Wv
Wv
Wv
Wv
Wv
Wv
Ff
GK
xI
uz
eY
ma
ma
ma
ma
ma
ma
ma
GK
ma
ma
ma
ma
ma
ma
ma
ma
ma
GK
GK
GK
ma
ma
ma
ma
ma
ma
ma
ma
ma
ma
ma
ma
ma
ma
ma
GK
GK
ma
ma
GK
xI
uz
eY
ma
yh
Wv
Wv
Wv
Wv
BL
"}
(55,1,1) = {"
BL
BL
Wv
Wv
Wv
Wv
Wv
Wv
Wv
Wv
Ff
ma
xI
uz
eY
WH
ma
ma
ma
ma
GK
ma
ma
ma
GK
ma
ma
ma
ma
ma
ma
ma
GK
GK
ma
ma
GK
ma
ma
ma
ma
ma
ma
ma
GK
ma
GK
ma
ma
GK
GK
ma
ma
ma
WH
xI
uz
eY
ma
yh
Wv
Wv
Wv
Wv
BL
"}
(56,1,1) = {"
BL
Wv
Wv
Wv
Wv
Wv
Wv
Wv
Wv
Wv
Ff
GK
xI
uz
Ve
GK
ma
ma
ma
GK
GK
ma
ma
GK
ma
ma
ma
ma
ma
ma
ma
ma
ma
GK
ma
ma
GK
ma
ma
ma
ma
ma
GK
ma
GK
ma
GK
ma
ma
GK
GK
ma
ma
ma
ma
FG
uz
eY
GK
yh
Wv
Wv
BL
BL
BL
"}
(57,1,1) = {"
BL
Wv
Wv
Wv
Wv
Wv
Wv
Wv
Wv
Wv
Ff
GK
xI
uz
eY
GK
ma
ma
ma
GK
ma
ma
ma
GK
ma
ma
ma
ma
ma
ma
ma
ma
ma
GK
ma
ma
GK
ma
ma
ma
ma
ma
ma
ma
ma
ma
GK
ma
ma
ma
GK
ma
ma
ma
ma
xI
uz
eY
GK
yh
Wv
Wv
BL
BL
BL
"}
(58,1,1) = {"
BL
BL
Wv
Wv
Wv
Wv
Wv
Wv
Wv
Wv
Ff
ma
xI
uz
eY
ma
ma
ma
ma
GK
ma
ma
ma
ma
ma
ma
ma
ma
ma
ma
ma
ma
ma
GK
ma
ma
ma
ma
ma
ma
ma
GK
ma
ma
ma
ma
GK
ma
ma
ma
ma
ma
ma
ma
GK
xI
uz
eY
GK
yh
Wv
Wv
Wv
BL
BL
"}
(59,1,1) = {"
BL
BL
Wv
Wv
Wv
Wv
Wv
Wv
Wv
Wv
Ff
GK
xI
uz
eY
ma
ma
ma
ma
ma
ma
ma
ma
ma
ma
ma
ma
ma
ma
GK
ma
ma
ma
GK
ma
ma
ma
ma
ma
ma
ma
ma
GK
ma
ma
ma
GK
ma
ma
ma
ma
ma
ma
GK
ma
xI
uz
eY
ma
yh
Wv
Wv
Wv
BL
BL
"}
(60,1,1) = {"
BL
Wv
Wv
Wv
Wv
Wv
Wv
Wv
Wv
Wv
Ff
GK
xI
uz
eY
oy
ma
ma
ma
ma
ma
GK
ma
ma
ma
ma
ma
GK
ma
ma
GK
GK
ma
GK
GK
ma
ma
ma
ma
ma
GK
ma
ma
GK
GK
ma
GK
ma
ma
ma
ma
ma
ma
GK
oy
xI
uz
eY
ma
yh
Wv
Wv
Wv
BL
BL
"}
(61,1,1) = {"
BL
Wv
Wv
Wv
Wv
Wv
Wv
Wv
Wv
Wv
Ff
ma
xI
uz
eY
ma
ma
ma
ma
ma
ma
ma
ma
ma
GK
ma
ma
ma
ma
ma
ma
GK
ma
ma
ma
ma
ma
GK
ma
ma
ma
ma
ma
ma
GK
ma
ma
GK
ma
ma
ma
ma
ma
GK
GK
xI
uz
eY
GK
yh
Wv
Wv
Wv
BL
BL
"}
(62,1,1) = {"
BL
BL
Wv
Wv
Wv
Wv
Wv
Wv
Wv
Wv
Ff
ma
xI
uz
Ve
ma
ma
ma
ma
ma
ma
ma
ma
ma
ma
GK
GK
GK
ma
ma
ma
ma
ma
ma
ma
ma
ma
ma
GK
GK
GK
ma
ma
ma
ma
ma
ma
ma
GK
ma
ma
ma
ma
ma
GK
FG
uz
eY
ma
yh
Wv
Wv
Wv
BL
BL
"}
(63,1,1) = {"
BL
Wv
Wv
Wv
Wv
Wv
Wv
Wv
Wv
Wv
Ff
GK
xI
uz
eY
GK
ma
ma
GK
ma
ma
ma
ma
ma
ma
ma
ma
ma
ma
ma
ma
ma
ma
ma
ma
ma
ma
ma
ma
ma
ma
ma
ma
ma
ma
ma
ma
GK
GK
ma
ma
ma
ma
ma
GK
xI
uz
eY
ma
yh
Wv
Wv
Wv
BL
BL
"}
(64,1,1) = {"
BL
BL
Wv
Wv
Wv
Wv
Wv
Wv
Wv
Wv
Ff
GK
xI
uz
eY
GK
GK
ma
ma
ma
GK
GK
GK
ma
ma
ma
ma
ma
ma
ma
ma
ma
ma
ma
GK
GK
ma
ma
ma
ma
ma
ma
ma
ma
ma
ma
ma
ma
ma
ma
ma
ma
GK
ma
ma
xI
YF
eY
GK
yh
Wv
Wv
Wv
Wv
BL
"}
(65,1,1) = {"
BL
BL
Wv
Wv
Wv
Wv
Wv
Wv
Wv
Wv
Ff
ma
xI
uz
eY
WH
GK
ma
ma
GK
ma
ma
ma
GK
GK
GK
ma
ma
ma
ma
ma
GK
ma
ma
ma
ma
GK
GK
GK
ma
ma
ma
ma
ma
GK
ma
ma
ma
ma
ma
ma
GK
ma
ma
WH
xI
uz
eY
ma
yh
Wv
Wv
Wv
Wv
BL
"}
(66,1,1) = {"
BL
BL
Wv
Wv
Wv
Wv
Wv
Wv
Wv
Wv
Ff
ma
xI
uz
eY
GK
GK
GK
GK
ma
ma
ma
ma
ma
GK
ma
ma
GK
ma
ma
ma
GK
ma
ma
ma
ma
ma
GK
ma
ma
GK
ma
ma
ma
GK
ma
ma
ma
ma
ma
ma
ma
ma
ma
GK
xI
uz
eY
ma
yh
Wv
Wv
Wv
Wv
BL
"}
(67,1,1) = {"
BL
BL
Wv
Wv
Wv
Wv
Wv
Wv
Wv
Wv
Ff
GK
xI
uz
eY
GK
GK
GK
GK
ma
GK
GK
ma
ma
ma
ma
ma
ma
GK
GK
ma
ma
GK
GK
GK
ma
ma
ma
ma
ma
ma
GK
GK
ma
ma
GK
GK
ma
ma
ma
ma
ma
ma
GK
GK
xI
uz
eY
ma
yh
Wv
Wv
Wv
Wv
BL
"}
(68,1,1) = {"
BL
Wv
Wv
Wv
Wv
Wv
Wv
Wv
Wv
Wv
Ff
ma
xI
uz
TM
bT
bT
bT
bT
bT
bT
bT
bT
bT
bT
bT
bT
bT
bT
bT
bT
bT
bT
bT
bT
bT
bT
bT
bT
bT
bT
bT
bT
bT
bT
bT
bT
bT
bT
bT
bT
bT
bT
bT
bT
jN
uz
eY
ma
yh
Wv
Wv
Wv
Wv
BL
"}
(69,1,1) = {"
BL
BL
Wv
Wv
Wv
Wv
Wv
Wv
Wv
Wv
Ff
vH
xI
uz
uz
uz
uz
uz
uz
uz
uz
uz
uz
uz
uz
uz
uz
uz
uz
uz
uz
uz
uz
mH
Cw
Rh
uz
uz
uz
uz
uz
uz
uz
uz
uz
uz
uz
uz
uz
uz
uz
uz
uz
uz
uz
uz
uz
eY
vH
yh
Wv
Wv
Wv
Wv
BL
"}
(70,1,1) = {"
BL
Wv
Wv
Wv
Wv
Wv
Wv
Wv
Wv
vH
vH
vH
sP
oP
oP
oP
bb
oP
oP
oP
oP
oP
bb
oP
oP
oP
oP
oP
hd
ca
ca
ca
ca
gF
oW
rw
ca
ca
ca
ca
VS
oP
oP
oP
oP
oP
oP
bb
oP
oP
oP
oP
oP
bb
oP
oP
oP
IK
vH
vH
vH
Wv
Wv
Wv
BL
"}
(71,1,1) = {"
vH
vH
vH
Wv
Wv
Wv
Wv
Wv
Wv
Wv
Wv
vH
vH
vH
ma
ma
ma
GK
ma
ma
GK
GK
ma
GK
ma
ma
GK
GK
xI
ca
Dy
ca
ca
ca
YP
ca
ca
ca
Dy
ca
eY
ma
GK
ma
ma
ma
GK
ma
ma
GK
GK
ma
ma
GK
GK
ma
vH
vH
vH
Wv
Wv
Wv
vH
vH
vH
"}
(72,1,1) = {"
CE
CE
vH
Wv
Wv
Wv
Wv
Wv
Wv
Wv
Wv
Wv
vH
qc
qc
qc
qc
qc
qc
qc
qc
qc
qc
qc
qc
qc
qc
qc
vH
TB
TB
TB
vH
TB
TB
ou
eP
TB
TB
TB
vH
qc
qc
qc
qc
qc
qc
qc
qc
qc
qc
qc
qc
qc
qc
qc
qc
vH
Wv
Wv
Wv
Wv
vH
CE
CE
"}
(73,1,1) = {"
wt
wt
DM
wt
wt
wt
wt
wt
wt
wt
wt
wt
wt
wt
wt
wt
wt
wt
wt
wt
wt
wt
wt
wt
wt
wt
wt
wt
vH
SK
SK
JA
vH
Ct
RT
RT
vH
JA
SK
SK
vH
wt
wt
wt
wt
wt
wt
wt
wt
wt
wt
wt
wt
wt
wt
wt
wt
wt
wt
wt
wt
wt
DM
wt
wt
"}
(74,1,1) = {"
CE
CE
DM
Wv
Wv
Wv
Wv
Wv
Wv
Wv
Wv
Wv
Wv
Wv
Wv
Wv
Wv
Wv
Wv
Wv
Wv
Wv
Wv
Wv
Wv
Wv
Wv
Wv
vH
CE
CE
CE
vH
CE
CE
Bm
vH
CE
CE
CE
vH
Wv
Wv
Wv
Wv
Wv
Wv
Wv
Wv
Wv
Wv
Wv
Wv
Wv
Wv
Wv
Wv
Wv
Wv
Wv
Wv
Wv
DM
CE
CE
"}
(75,1,1) = {"
CE
CE
DM
Wv
Wv
Wv
Wv
Wv
Wv
Wv
Wv
Wv
Wv
Wv
Wv
Wv
Wv
Wv
Wv
Wv
Wv
Wv
Wv
Wv
Wv
Wv
Wv
Wv
vH
CE
CE
CE
vH
CE
CE
CE
vH
CE
CE
CE
vH
Wv
Wv
Wv
Wv
Wv
Wv
Wv
Wv
Wv
Wv
Wv
Wv
Wv
Wv
Wv
Wv
Wv
Wv
Wv
Wv
Wv
DM
CE
CE
"}
(76,1,1) = {"
CE
CE
DM
Wv
Wv
Wv
Wv
Wv
Wv
Wv
Wv
Wv
Wv
Wv
Wv
Wv
Wv
Wv
Wv
Wv
Wv
Wv
Wv
Wv
Wv
Wv
Wv
Wv
vH
CE
CE
CE
vH
CE
CE
CE
vH
CE
CE
CE
vH
Wv
Wv
Wv
Wv
Wv
Wv
Wv
Wv
Wv
Wv
Wv
Wv
Wv
Wv
Wv
Wv
Wv
Wv
Wv
Wv
Wv
DM
CE
CE
"}
(77,1,1) = {"
wt
wt
DM
wt
wt
wt
wt
wt
wt
wt
wt
wt
wt
wt
wt
wt
wt
wt
wt
wt
wt
wt
wt
wt
wt
wt
wt
wt
vH
pl
vH
pl
vH
pl
vH
pl
vH
pl
vH
pl
vH
wt
wt
wt
wt
wt
wt
wt
wt
wt
wt
wt
wt
wt
wt
wt
wt
wt
wt
wt
wt
wt
DM
wt
wt
"}
(78,1,1) = {"
CE
CE
vH
Wv
Wv
Wv
Wv
Wv
Wv
Wv
Wv
Wv
Wv
Wv
Wv
Wv
Wv
Wv
Wv
Wv
Wv
Wv
Wv
Wv
Wv
Wv
Wv
Cm
vH
hn
Wv
Wv
Wv
Wv
Wv
Wv
Wv
Wv
Wv
Cm
vH
hn
Wv
Wv
Wv
Wv
Wv
Wv
Wv
Wv
Wv
Wv
Wv
Wv
Wv
Wv
Wv
Wv
Wv
Wv
Wv
Wv
vH
CE
CE
"}
(79,1,1) = {"
vH
vH
vH
Wv
Wv
Wv
Wv
Wv
Wv
Wv
Wv
Wv
Wv
Wv
Wv
Wv
Wv
Wv
Wv
Wv
Wv
Wv
Wv
Wv
Wv
Wv
Wv
TL
nY
RE
Wv
Wv
Wv
Wv
Wv
Wv
Wv
Wv
Wv
TL
nY
RE
Wv
Wv
Wv
Wv
Wv
Wv
Wv
Wv
Wv
Wv
Wv
Wv
Wv
Wv
Wv
Wv
Wv
Wv
Wv
Wv
vH
vH
vH
"}
(80,1,1) = {"
BL
BL
Wv
Wv
Wv
Wv
Wv
Wv
Wv
Wv
Wv
Wv
Wv
Wv
Wv
Wv
Wv
Wv
Wv
Wv
Wv
Wv
Wv
Wv
Wv
Wv
Wv
Wv
Wv
Wv
Wv
Wv
Wv
Wv
Wv
Wv
Wv
Wv
Wv
Wv
Wv
Wv
Wv
Wv
Wv
Wv
Wv
Wv
Wv
Wv
Wv
Wv
Wv
Wv
Wv
Wv
Wv
Wv
Wv
Wv
Wv
Wv
Wv
Wv
BL
"}
(81,1,1) = {"
BL
BL
BL
Wv
Wv
Wv
BL
Wv
Wv
Wv
Wv
Wv
Wv
Wv
Wv
Wv
Wv
Wv
Wv
Wv
Wv
Wv
Wv
Wv
Wv
Wv
Wv
Wv
Wv
Wv
Wv
Wv
Wv
Wv
Wv
Wv
Wv
Wv
Wv
Wv
Wv
Wv
Wv
Wv
Wv
Wv
Wv
Wv
Wv
Wv
Wv
Wv
Wv
Wv
Wv
Wv
Wv
Wv
Wv
Wv
Wv
Wv
Wv
Wv
BL
"}
(82,1,1) = {"
BL
BL
BL
BL
Wv
BL
BL
Wv
Wv
Wv
Wv
Wv
Wv
Wv
Wv
Wv
Wv
Wv
Wv
Wv
Wv
Wv
Wv
Wv
Wv
Wv
Wv
Wv
Wv
Wv
Wv
Wv
Wv
Wv
Wv
Wv
Wv
Wv
Wv
Wv
Wv
Wv
Wv
Wv
Wv
Wv
Wv
Wv
Wv
Wv
Wv
Wv
Wv
Wv
Wv
Wv
Wv
Wv
Wv
BL
BL
Wv
Wv
BL
BL
"}
(83,1,1) = {"
BL
BL
BL
BL
BL
Wv
Wv
Wv
Wv
Wv
Wv
Wv
Wv
Wv
Wv
Wv
Wv
Wv
Wv
Wv
Wv
Wv
Wv
Wv
Wv
Wv
Wv
Wv
Wv
Wv
Wv
Wv
Wv
Wv
Wv
Wv
Wv
Wv
Wv
Wv
Wv
Wv
Wv
Wv
Wv
Wv
Wv
Wv
Wv
BL
Wv
Wv
Wv
Wv
Wv
Wv
Wv
Wv
Wv
Wv
BL
Wv
Wv
BL
BL
"}
(84,1,1) = {"
BL
BL
BL
BL
BL
BL
Wv
Wv
Wv
Wv
Wv
Wv
Wv
Wv
Wv
Wv
Wv
Wv
Wv
BL
BL
Wv
Wv
Wv
Wv
Wv
Wv
Wv
Wv
Wv
Wv
Wv
Wv
Wv
Wv
Wv
Wv
Wv
Wv
Wv
Wv
Wv
Wv
Wv
Wv
Wv
Wv
BL
BL
BL
BL
Wv
Wv
Wv
Wv
Wv
Wv
Wv
Wv
Wv
Wv
Wv
BL
BL
BL
"}
(85,1,1) = {"
BL
BL
BL
BL
BL
BL
BL
Wv
Wv
BL
BL
BL
Wv
Wv
Wv
Wv
Wv
Wv
BL
BL
BL
BL
BL
BL
Wv
BL
BL
Wv
BL
Wv
Wv
Wv
Wv
Wv
Wv
Wv
Wv
Wv
BL
BL
BL
Wv
Wv
Wv
BL
BL
BL
BL
BL
BL
BL
BL
BL
BL
Wv
Wv
Wv
Wv
BL
BL
BL
BL
BL
BL
BL
"}
(86,1,1) = {"
BL
BL
BL
BL
BL
BL
BL
BL
BL
BL
BL
BL
BL
BL
BL
BL
BL
BL
BL
BL
BL
BL
BL
BL
BL
BL
BL
BL
BL
BL
BL
BL
BL
BL
BL
BL
BL
BL
BL
BL
BL
BL
BL
BL
BL
BL
BL
BL
BL
BL
BL
BL
BL
BL
BL
BL
BL
BL
BL
BL
BL
BL
BL
BL
BL
"}
