//MAP CONVERTED BY dmm2tgm.py THIS HEADER COMMENT PREVENTS RECONVERSION, DO NOT REMOVE
"bI" = (
/obj/machinery/light/floor/hangar,
/obj/effect/turf_decal/corner/opaque/brown{
	dir = 4
	},
/obj/effect/turf_decal/corner/opaque/yellow,
/turf/open/floor/plasteel/patterned/grid,
/area/hangar)
"dk" = (
/obj/effect/landmark/outpost/elevator_machine{
	shaft = "1"
	},
/obj/machinery/door/airlock/hatch{
	dir = 4
	},
/turf/open/floor/plating{
	planetary_atmos = 1
	},
/area/hangar)
"dC" = (
/turf/open/floor/plating{
	planetary_atmos = 1
	},
/area/hangar)
"eA" = (
/obj/machinery/door/poddoor/shutters/indestructible{
	dir = 4
	},
/turf/open/floor/plating/rust,
/area/hangar)
"fu" = (
/obj/effect/turf_decal/corner/opaque/yellow{
	dir = 8
	},
/obj/effect/turf_decal/corner/opaque/yellow,
/turf/open/floor/plasteel/patterned/grid,
/area/hangar)
"fS" = (
/turf/open/floor/plasteel/elevatorshaft,
/area/hangar)
"hV" = (
/obj/structure/platform/industrial_alt{
	dir = 1
	},
/obj/effect/forcefield/mime/advanced{
	name = "long fall";
	desc = "You don't want to jump off. You probably won't be saved.";
	timeleft = null
	},
/turf/open/water/beach/deep,
/area/hangar)
"hW" = (
/obj/structure/platform/industrial_alt{
	dir = 8
	},
/turf/open/water/beach/deep,
/area/hangar)
"iA" = (
/obj/effect/turf_decal/corner/opaque/yellow{
	dir = 1
	},
/obj/effect/turf_decal/corner/opaque/yellow{
	dir = 8
	},
/turf/open/floor/plasteel/patterned/grid,
/area/hangar)
"iD" = (
/obj/effect/turf_decal/corner/opaque/brown{
	dir = 8
	},
/obj/effect/turf_decal/corner/opaque/brown{
	dir = 4
	},
/obj/effect/turf_decal/corner/opaque/yellow,
/turf/open/floor/plasteel/patterned/grid,
/area/hangar)
"jO" = (
/obj/effect/turf_decal/techfloor{
	dir = 4
	},
/turf/open/floor/plasteel/tech{
	planetary_atmos = 1
	},
/area/hangar)
"lc" = (
/obj/effect/landmark/outpost/elevator{
	shaft = "1"
	},
/turf/open/floor/plasteel/elevatorshaft,
/area/hangar)
"lu" = (
/obj/effect/turf_decal/corner/opaque/brown{
	dir = 8
	},
/obj/effect/turf_decal/corner/opaque/yellow{
	dir = 1
	},
/turf/open/floor/plasteel/patterned/grid,
/area/hangar)
"lY" = (
/obj/structure/catwalk/over/plated_catwalk/dark,
/turf/open/floor/plating{
	planetary_atmos = 1
	},
/area/hangar)
"mq" = (
/obj/structure/platform/industrial_alt/corner{
	dir = 1
	},
/turf/open/water/beach/deep,
/area/hangar)
"nb" = (
/obj/effect/turf_decal/corner/opaque/brown{
	dir = 4
	},
/obj/effect/turf_decal/corner/opaque/yellow,
/obj/effect/turf_decal/corner/opaque/yellow{
	dir = 1
	},
/turf/open/floor/plasteel/patterned/grid,
/area/hangar)
"nf" = (
/obj/effect/turf_decal/corner/opaque/yellow,
/obj/effect/turf_decal/corner/opaque/yellow{
	dir = 8
	},
/turf/open/floor/plasteel/patterned/grid,
/area/hangar)
"ov" = (
/obj/effect/turf_decal/corner/opaque/yellow{
	dir = 1
	},
/turf/open/floor/plasteel/patterned/grid,
/area/hangar)
"oI" = (
/obj/structure/marker_beacon{
	picked_color = "Teal"
	},
/turf/open/floor/plating/rust,
/area/hangar)
"sa" = (
/obj/effect/turf_decal/corner/opaque/brown{
	dir = 8
	},
/turf/open/floor/plasteel/patterned/grid,
/area/hangar)
"sb" = (
/obj/effect/turf_decal/corner/opaque/brown{
	dir = 4
	},
/obj/effect/turf_decal/corner/opaque/yellow{
	dir = 1
	},
/turf/open/floor/plasteel/patterned/grid,
/area/hangar)
"sh" = (
/obj/machinery/door/poddoor/shutters/indestructible{
	dir = 4
	},
/turf/open/floor/plating{
	planetary_atmos = 1
	},
/area/hangar)
"to" = (
/obj/effect/turf_decal/corner/opaque/yellow,
/turf/open/floor/plasteel/patterned/grid,
/area/hangar)
"uF" = (
/turf/closed/indestructible/reinforced,
/area/hangar)
"vg" = (
/obj/effect/landmark/outpost/hangar_numbers,
/turf/open/floor/plasteel/patterned/grid,
/area/hangar)
"vP" = (
/obj/structure/platform/industrial{
	dir = 4
	},
/obj/structure/platform/industrial{
	dir = 8
	},
/turf/open/floor/plasteel/elevatorshaft,
/area/hangar)
"zv" = (
/obj/structure/catwalk/over/plated_catwalk,
/turf/open/floor/plating{
	planetary_atmos = 1
	},
/area/hangar)
"AZ" = (
/obj/structure/platform/industrial_alt/corner{
	dir = 4
	},
/turf/open/water/beach/deep,
/area/hangar)
"Bb" = (
/obj/effect/turf_decal/corner/opaque/yellow/full,
/obj/effect/landmark/outpost/hangar_numbers,
/turf/open/floor/plasteel/patterned/grid,
/area/hangar)
"Dj" = (
/obj/structure/catwalk/over/plated_catwalk/dark,
/turf/open/floor/plating/rust,
/area/hangar)
"DS" = (
/obj/effect/turf_decal/corner/opaque/yellow{
	dir = 4
	},
/obj/effect/turf_decal/corner/opaque/yellow{
	dir = 1
	},
/turf/open/floor/plasteel/patterned/grid,
/area/hangar)
"Ey" = (
/obj/effect/turf_decal/techfloor{
	dir = 4
	},
/obj/effect/turf_decal/trimline/opaque/yellow/line{
	dir = 8
	},
/turf/open/floor/plasteel/patterned/grid,
/area/hangar)
"EU" = (
/obj/effect/turf_decal/corner/opaque/brown{
	dir = 4
	},
/obj/effect/turf_decal/corner/opaque/brown{
	dir = 8
	},
/obj/effect/turf_decal/corner/opaque/yellow{
	dir = 1
	},
/turf/open/floor/plasteel/patterned/grid,
/area/hangar)
"EX" = (
/obj/effect/landmark/outpost/hangar_dock,
/turf/open/floor/plating{
	planetary_atmos = 1
	},
/area/hangar)
"FX" = (
/obj/structure/marker_beacon{
	picked_color = "Teal"
	},
/turf/open/floor/plating{
	planetary_atmos = 1
	},
/area/hangar)
"Ge" = (
/obj/effect/turf_decal/corner/opaque/brown{
	dir = 8
	},
/obj/effect/turf_decal/corner/opaque/yellow,
/turf/open/floor/plasteel/patterned/grid,
/area/hangar)
"Go" = (
/obj/structure/platform/industrial_alt,
/obj/effect/forcefield/mime/advanced{
	name = "long fall";
	desc = "You don't want to jump off. You probably won't be saved.";
	timeleft = null
	},
/turf/open/water/beach/deep,
/area/hangar)
"HB" = (
/obj/structure/catwalk/over/plated_catwalk,
/obj/machinery/atmospherics/pipe/manifold/orange/hidden,
/turf/open/floor/plating{
	planetary_atmos = 1
	},
/area/hangar)
"It" = (
/obj/effect/turf_decal/corner/opaque/brown{
	dir = 4
	},
/obj/effect/turf_decal/corner/opaque/yellow,
/turf/open/floor/plasteel/patterned/grid,
/area/hangar)
"Iy" = (
/obj/structure/platform/industrial_alt{
	dir = 8
	},
/obj/effect/forcefield/mime/advanced{
	name = "long fall";
	desc = "You don't want to jump off. You probably won't be saved.";
	timeleft = null
	},
/turf/open/water/beach/deep,
/area/hangar)
"IT" = (
/obj/effect/turf_decal/corner/opaque/brown{
	dir = 8
	},
/obj/effect/turf_decal/corner/opaque/yellow{
	dir = 1
	},
/obj/effect/turf_decal/corner/opaque/yellow,
/turf/open/floor/plasteel/patterned/grid,
/area/hangar)
"Js" = (
/turf/closed/indestructible/rock,
/area/hangar)
"JI" = (
/obj/machinery/door/poddoor/ert,
/turf/open/floor/plasteel/elevatorshaft,
/area/hangar)
"Kp" = (
/obj/effect/turf_decal/corner/opaque/brown{
	dir = 4
	},
/turf/open/floor/plasteel/patterned/grid,
/area/hangar)
"LJ" = (
/obj/structure/platform/industrial_alt,
/turf/open/water/beach/deep,
/area/hangar)
"No" = (
/turf/open/floor/plasteel/patterned/grid,
/area/hangar)
"NQ" = (
/turf/closed/indestructible/fakeglass,
/area/hangar)
"OH" = (
/obj/effect/turf_decal/corner/opaque/yellow{
	dir = 4
	},
/obj/effect/turf_decal/corner/opaque/yellow,
/turf/open/floor/plasteel/patterned/grid,
/area/hangar)
"OM" = (
/obj/machinery/light/floor/hangar,
/obj/effect/turf_decal/corner/opaque/brown{
	dir = 8
	},
/obj/effect/turf_decal/corner/opaque/yellow,
/turf/open/floor/plasteel/patterned/grid,
/area/hangar)
"PA" = (
/obj/effect/turf_decal/corner/opaque/yellow{
	dir = 1
	},
/obj/effect/turf_decal/corner/opaque/yellow{
	dir = 4
	},
/turf/open/floor/plasteel/patterned/grid,
/area/hangar)
"Qg" = (
/obj/structure/platform/industrial_alt{
	dir = 1
	},
/turf/open/water/beach/deep,
/area/hangar)
"Qk" = (
/obj/machinery/light/floor/hangar,
/obj/effect/turf_decal/corner/opaque/brown{
	dir = 4
	},
/obj/effect/turf_decal/corner/opaque/yellow{
	dir = 1
	},
/turf/open/floor/plasteel/patterned/grid,
/area/hangar)
"QF" = (
/turf/open/water/beach/deep,
/area/hangar)
"UK" = (
/obj/machinery/elevator_call_button{
	dir = 1;
	pixel_y = -24
	},
/obj/effect/landmark/outpost/elevator_machine{
	shaft = "1"
	},
/obj/effect/turf_decal/techfloor{
	dir = 4
	},
/obj/effect/turf_decal/trimline/opaque/yellow/line{
	dir = 8
	},
/turf/open/floor/plasteel/patterned/grid,
/area/hangar)
"Vh" = (
/obj/machinery/door/poddoor/shutters/indestructible{
	dir = 4
	},
/turf/closed/indestructible/fakeglass,
/area/hangar)
"Xs" = (
/obj/effect/turf_decal/techfloor{
	dir = 8
	},
/turf/open/floor/plasteel/tech{
	planetary_atmos = 1
	},
/area/hangar)
"XC" = (
/turf/open/floor/plating/rust,
/area/hangar)
"YH" = (
/obj/structure/platform/industrial_alt{
	dir = 4
	},
/obj/effect/forcefield/mime/advanced{
	name = "long fall";
	desc = "You don't want to jump off. You probably won't be saved.";
	timeleft = null
	},
/turf/open/water/beach/deep,
/area/hangar)
"ZG" = (
/obj/effect/landmark/outpost/elevator_machine{
	shaft = "1"
	},
/obj/machinery/door/airlock/hatch{
	dir = 4
	},
/turf/open/floor/plating/rust,
/area/hangar)

(1,1,1) = {"
Js
Js
Js
Js
Js
Js
Js
Js
Js
Js
Js
Js
Js
Js
Js
Js
Js
Js
Js
Js
Js
Js
Js
Js
Js
Js
Js
Js
Js
Js
Js
Js
Js
Js
Js
Js
Js
Js
Js
Js
Js
Js
Js
Js
Js
"}
(2,1,1) = {"
Js
Js
Js
Js
Js
Js
Js
QF
QF
QF
Js
Js
Js
Js
Js
Js
Js
QF
QF
QF
QF
QF
Js
Js
Js
Js
Js
QF
QF
Js
Js
Js
Js
QF
QF
QF
QF
QF
QF
Js
Js
Js
Js
Js
Js
"}
(3,1,1) = {"
Js
Js
Js
Js
Js
Js
QF
QF
QF
QF
QF
QF
QF
QF
QF
QF
QF
QF
QF
QF
QF
QF
QF
Js
Js
Js
QF
QF
QF
QF
QF
Js
QF
QF
QF
QF
QF
QF
QF
QF
QF
Js
Js
Js
Js
"}
(4,1,1) = {"
Js
Js
Js
Js
QF
QF
QF
QF
QF
QF
QF
QF
QF
QF
QF
QF
QF
QF
QF
QF
QF
QF
QF
Js
QF
QF
QF
QF
QF
QF
QF
QF
QF
QF
QF
QF
QF
QF
QF
QF
QF
QF
Js
Js
Js
"}
(5,1,1) = {"
Js
Js
Js
QF
QF
QF
QF
QF
QF
QF
QF
QF
QF
QF
QF
QF
QF
QF
QF
QF
QF
QF
QF
QF
QF
QF
QF
QF
QF
QF
QF
QF
QF
QF
QF
QF
QF
QF
QF
QF
QF
QF
QF
Js
Js
"}
(6,1,1) = {"
Js
Js
QF
QF
QF
QF
QF
QF
QF
QF
QF
QF
uF
QF
QF
QF
QF
QF
QF
QF
QF
QF
QF
QF
QF
QF
QF
QF
QF
QF
QF
QF
QF
QF
QF
QF
QF
uF
QF
QF
QF
QF
QF
Js
Js
"}
(7,1,1) = {"
Js
QF
QF
QF
QF
QF
QF
QF
QF
QF
QF
QF
uF
YH
YH
YH
YH
YH
YH
YH
YH
YH
YH
YH
YH
YH
YH
YH
YH
YH
YH
YH
YH
YH
YH
YH
YH
uF
QF
QF
QF
QF
QF
Js
Js
"}
(8,1,1) = {"
Js
QF
QF
QF
QF
QF
QF
QF
QF
QF
QF
uF
uF
uF
dC
XC
XC
XC
dC
dC
XC
dC
dC
uF
uF
uF
uF
XC
XC
dC
dC
dC
dC
dC
XC
dC
uF
uF
uF
QF
QF
QF
QF
Js
Js
"}
(9,1,1) = {"
Js
QF
QF
QF
QF
QF
QF
QF
QF
uF
uF
uF
EU
lu
IT
Xs
Xs
Xs
Xs
Xs
Xs
Xs
Xs
Xs
Xs
Xs
Xs
Xs
Xs
Xs
Xs
Xs
Xs
Xs
Xs
EU
lu
IT
uF
uF
uF
QF
QF
Js
Js
"}
(10,1,1) = {"
Js
QF
QF
QF
QF
QF
QF
QF
QF
QF
Go
uF
sb
zv
Ge
Dj
lY
lY
lY
Dj
lY
Dj
lY
lY
lY
Dj
Dj
Dj
lY
lY
lY
lY
lY
Dj
lY
sb
zv
Ge
uF
hV
QF
QF
QF
QF
Js
"}
(11,1,1) = {"
Js
QF
QF
QF
QF
QF
QF
QF
QF
QF
Go
XC
sb
zv
Ge
jO
jO
jO
jO
jO
jO
jO
jO
jO
jO
jO
jO
jO
jO
jO
jO
jO
jO
jO
jO
sb
zv
Ge
dC
hV
QF
QF
QF
QF
Js
"}
(12,1,1) = {"
Js
Js
QF
QF
QF
QF
QF
QF
QF
QF
Go
XC
sb
zv
Ge
XC
XC
XC
XC
XC
dC
dC
dC
dC
dC
dC
dC
dC
dC
dC
dC
dC
dC
XC
EX
sb
zv
Ge
XC
hV
QF
QF
QF
QF
Js
"}
(13,1,1) = {"
Js
Js
Js
QF
QF
QF
QF
QF
QF
QF
Go
dC
sb
zv
Ge
XC
XC
dC
dC
dC
dC
dC
dC
dC
XC
dC
XC
dC
dC
dC
dC
dC
dC
dC
XC
sb
zv
Ge
XC
hV
QF
QF
QF
QF
Js
"}
(14,1,1) = {"
Js
Js
Js
Js
QF
QF
QF
QF
QF
QF
Go
dC
sb
zv
Ge
FX
XC
dC
dC
dC
dC
dC
dC
dC
XC
XC
XC
XC
XC
dC
dC
XC
dC
dC
oI
sb
zv
Ge
XC
hV
QF
QF
QF
QF
Js
"}
(15,1,1) = {"
Js
Js
QF
QF
QF
QF
QF
QF
QF
QF
Go
XC
sb
zv
Ge
XC
dC
dC
dC
dC
dC
XC
dC
dC
dC
XC
XC
dC
dC
dC
dC
XC
dC
dC
XC
sb
zv
Ge
XC
hV
QF
QF
QF
QF
Js
"}
(16,1,1) = {"
Js
Js
QF
QF
QF
QF
QF
QF
QF
QF
Go
dC
sb
zv
OM
XC
dC
dC
dC
XC
dC
XC
dC
dC
dC
XC
XC
dC
dC
dC
XC
XC
dC
dC
dC
Qk
zv
Ge
dC
hV
QF
QF
QF
QF
Js
"}
(17,1,1) = {"
Js
QF
QF
QF
QF
QF
QF
QF
QF
QF
Go
dC
sb
zv
Ge
XC
dC
dC
XC
XC
dC
dC
dC
XC
dC
dC
XC
dC
dC
dC
XC
XC
dC
dC
dC
sb
zv
Ge
dC
hV
QF
QF
QF
QF
Js
"}
(18,1,1) = {"
Js
Js
QF
QF
QF
QF
QF
QF
QF
QF
Go
XC
sb
zv
Ge
dC
dC
dC
dC
dC
dC
dC
dC
dC
dC
dC
dC
dC
dC
dC
dC
dC
dC
dC
dC
sb
zv
Ge
XC
hV
QF
QF
QF
QF
Js
"}
(19,1,1) = {"
Js
Js
Js
QF
QF
QF
QF
QF
QF
QF
Go
XC
sb
zv
Ge
FX
dC
dC
dC
dC
dC
dC
XC
dC
dC
dC
dC
XC
dC
dC
dC
dC
XC
dC
FX
sb
zv
Ge
dC
hV
QF
QF
QF
Js
Js
"}
(20,1,1) = {"
Js
QF
QF
QF
QF
QF
QF
QF
QF
QF
Go
dC
sb
zv
Ge
dC
dC
XC
dC
dC
dC
dC
dC
dC
dC
dC
dC
dC
XC
XC
dC
dC
dC
dC
dC
sb
zv
Ge
dC
hV
QF
QF
Js
Js
Js
"}
(21,1,1) = {"
Js
QF
QF
QF
QF
QF
QF
QF
QF
QF
Go
XC
sb
zv
Ge
dC
XC
dC
dC
XC
dC
dC
dC
dC
dC
XC
dC
dC
dC
XC
dC
dC
dC
dC
dC
sb
zv
Ge
dC
hV
QF
QF
Js
Js
Js
"}
(22,1,1) = {"
Js
QF
QF
QF
QF
QF
QF
QF
QF
QF
Go
XC
sb
zv
Ge
dC
dC
dC
dC
dC
dC
dC
dC
dC
XC
dC
dC
dC
dC
dC
dC
dC
dC
dC
dC
sb
zv
Ge
dC
hV
QF
QF
Js
Js
Js
"}
(23,1,1) = {"
Js
Js
QF
QF
QF
QF
QF
QF
QF
QF
Go
XC
sb
zv
Ge
dC
dC
dC
dC
dC
dC
XC
dC
dC
XC
dC
dC
dC
dC
dC
dC
XC
dC
dC
dC
sb
zv
Ge
XC
hV
QF
Js
Js
Js
Js
"}
(24,1,1) = {"
Js
Js
Js
QF
QF
QF
QF
QF
QF
QF
Go
XC
sb
zv
OM
FX
dC
dC
dC
dC
dC
dC
dC
dC
dC
dC
dC
XC
dC
dC
dC
XC
XC
dC
FX
Qk
zv
Ge
XC
hV
QF
QF
QF
Js
Js
"}
(25,1,1) = {"
Js
Js
QF
Js
QF
QF
QF
QF
QF
QF
Go
dC
sb
zv
Ge
dC
dC
dC
dC
dC
dC
dC
dC
dC
dC
dC
dC
dC
dC
dC
dC
XC
XC
dC
XC
sb
zv
Ge
dC
hV
QF
QF
QF
QF
Js
"}
(26,1,1) = {"
Js
Js
QF
QF
QF
QF
QF
QF
QF
QF
Go
dC
sb
zv
Ge
XC
dC
dC
dC
XC
dC
dC
dC
XC
XC
XC
dC
dC
dC
dC
dC
XC
XC
dC
XC
sb
zv
Ge
dC
hV
QF
QF
QF
QF
Js
"}
(27,1,1) = {"
Js
QF
QF
QF
QF
QF
QF
QF
QF
QF
Go
dC
sb
zv
Ge
dC
dC
dC
dC
dC
XC
dC
XC
XC
XC
dC
dC
dC
dC
dC
dC
dC
dC
dC
XC
sb
zv
Ge
XC
hV
QF
QF
QF
QF
Js
"}
(28,1,1) = {"
Js
QF
QF
QF
QF
QF
QF
QF
QF
QF
Go
dC
sb
zv
Ge
XC
dC
dC
dC
XC
XC
dC
dC
XC
XC
dC
dC
dC
XC
dC
dC
dC
dC
dC
XC
sb
zv
Ge
XC
hV
QF
QF
QF
QF
Js
"}
(29,1,1) = {"
Js
QF
QF
QF
QF
QF
QF
QF
QF
QF
Go
dC
sb
zv
Ge
oI
dC
dC
dC
dC
dC
dC
dC
XC
dC
dC
dC
XC
XC
dC
dC
dC
dC
dC
FX
sb
zv
Ge
XC
hV
QF
QF
QF
QF
Js
"}
(30,1,1) = {"
Js
QF
QF
QF
QF
QF
QF
QF
QF
QF
Go
dC
sb
zv
Ge
XC
dC
dC
XC
dC
dC
dC
dC
dC
dC
dC
dC
XC
dC
dC
dC
dC
dC
dC
XC
sb
zv
Ge
dC
hV
QF
QF
QF
QF
Js
"}
(31,1,1) = {"
Js
Js
QF
QF
QF
QF
QF
QF
QF
QF
Go
XC
sb
zv
Ge
dC
dC
dC
dC
XC
dC
dC
dC
dC
dC
dC
dC
dC
dC
dC
XC
dC
dC
dC
dC
sb
zv
Ge
dC
hV
QF
QF
QF
QF
Js
"}
(32,1,1) = {"
Js
Js
QF
QF
QF
QF
QF
QF
QF
QF
Go
XC
sb
zv
OM
dC
dC
XC
dC
dC
dC
dC
dC
dC
dC
dC
dC
dC
dC
dC
dC
dC
dC
dC
dC
Qk
zv
Ge
dC
hV
QF
QF
QF
Js
Js
"}
(33,1,1) = {"
Js
Js
QF
QF
QF
QF
QF
QF
QF
QF
Go
XC
sb
zv
Ge
dC
dC
dC
XC
dC
dC
dC
dC
dC
dC
dC
dC
dC
dC
dC
dC
dC
dC
dC
dC
sb
zv
Ge
XC
hV
QF
QF
QF
Js
Js
"}
(34,1,1) = {"
Js
Js
QF
QF
QF
QF
QF
QF
QF
QF
Go
dC
sb
zv
Ge
dC
XC
dC
dC
dC
XC
dC
dC
XC
XC
dC
dC
dC
dC
dC
XC
XC
dC
XC
dC
sb
zv
Ge
XC
hV
QF
QF
Js
Js
Js
"}
(35,1,1) = {"
Js
Js
QF
QF
QF
QF
QF
QF
QF
QF
Go
dC
sb
zv
Ge
dC
dC
dC
dC
dC
dC
XC
XC
dC
dC
dC
dC
dC
dC
dC
dC
XC
dC
dC
dC
sb
zv
Ge
XC
hV
QF
QF
QF
Js
Js
"}
(36,1,1) = {"
Js
Js
QF
QF
QF
QF
QF
QF
QF
QF
Go
dC
sb
zv
Ge
dC
XC
dC
dC
dC
dC
dC
dC
XC
XC
dC
dC
dC
dC
dC
dC
XC
dC
dC
XC
sb
zv
Ge
dC
hV
QF
QF
Js
Js
Js
"}
(37,1,1) = {"
Js
Js
QF
QF
QF
QF
QF
QF
QF
QF
Go
dC
sb
zv
Ge
XC
dC
dC
XC
dC
XC
dC
dC
dC
dC
XC
XC
dC
dC
dC
dC
dC
dC
dC
dC
sb
zv
Ge
dC
hV
QF
Js
Js
Js
Js
"}
(38,1,1) = {"
Js
Js
Js
QF
QF
QF
QF
QF
QF
QF
Go
XC
sb
zv
Ge
dC
dC
dC
dC
dC
dC
XC
dC
dC
dC
dC
dC
dC
XC
dC
dC
dC
dC
dC
dC
sb
zv
Ge
XC
hV
QF
QF
QF
Js
Js
"}
(39,1,1) = {"
Js
Js
Js
QF
QF
QF
QF
QF
QF
QF
Go
XC
sb
zv
Ge
dC
dC
dC
dC
dC
dC
dC
dC
dC
dC
dC
dC
dC
dC
dC
dC
dC
dC
dC
dC
sb
zv
Ge
dC
hV
QF
QF
QF
Js
Js
"}
(40,1,1) = {"
Js
Js
Js
Js
QF
QF
QF
QF
QF
QF
Go
XC
sb
zv
OM
XC
dC
dC
dC
dC
XC
XC
XC
dC
dC
dC
dC
dC
XC
dC
dC
dC
dC
XC
dC
Qk
zv
Ge
dC
hV
QF
QF
QF
QF
Js
"}
(41,1,1) = {"
Js
Js
Js
QF
QF
QF
QF
QF
QF
QF
Go
dC
sb
zv
Ge
XC
dC
dC
XC
dC
dC
XC
dC
dC
dC
dC
dC
XC
XC
dC
dC
dC
dC
dC
XC
sb
zv
Ge
XC
hV
QF
QF
QF
QF
Js
"}
(42,1,1) = {"
Js
Js
QF
QF
QF
QF
QF
QF
QF
QF
Go
dC
sb
zv
Ge
dC
dC
dC
dC
XC
XC
dC
dC
dC
dC
XC
dC
dC
dC
dC
dC
XC
dC
dC
dC
sb
zv
Ge
dC
hV
QF
QF
QF
Js
Js
"}
(43,1,1) = {"
Js
Js
QF
QF
QF
QF
QF
QF
QF
QF
Go
XC
sb
zv
Ge
dC
dC
dC
dC
dC
XC
XC
dC
dC
dC
dC
dC
dC
dC
dC
XC
XC
dC
dC
dC
sb
zv
Ge
dC
hV
QF
Js
Js
Js
Js
"}
(44,1,1) = {"
Js
Js
QF
QF
QF
QF
QF
QF
QF
QF
Go
dC
sb
zv
Ge
dC
dC
dC
dC
XC
dC
dC
dC
dC
dC
dC
dC
dC
dC
XC
dC
dC
dC
dC
dC
sb
zv
Ge
dC
hV
Js
Js
Js
Js
Js
"}
(45,1,1) = {"
Js
Js
QF
QF
QF
QF
QF
QF
QF
QF
Go
XC
sb
zv
Ge
dC
XC
dC
dC
dC
dC
dC
XC
dC
dC
dC
dC
XC
dC
dC
dC
XC
dC
dC
dC
sb
zv
Ge
dC
hV
QF
QF
Js
Js
Js
"}
(46,1,1) = {"
Js
Js
QF
QF
QF
QF
QF
QF
QF
QF
Go
XC
sb
zv
Ge
dC
dC
dC
dC
dC
dC
dC
dC
dC
XC
XC
XC
dC
dC
dC
dC
dC
dC
dC
XC
sb
zv
Ge
XC
hV
QF
QF
Js
Js
Js
"}
(47,1,1) = {"
Js
Js
QF
QF
QF
QF
QF
QF
QF
QF
Go
dC
sb
zv
Ge
dC
dC
dC
dC
XC
dC
dC
dC
dC
dC
dC
dC
dC
dC
dC
dC
dC
dC
dC
dC
sb
zv
Ge
dC
hV
QF
QF
Js
Js
Js
"}
(48,1,1) = {"
Js
QF
QF
QF
QF
QF
QF
QF
QF
QF
Go
dC
sb
zv
OM
dC
dC
dC
dC
dC
dC
dC
dC
dC
XC
dC
dC
dC
dC
XC
XC
XC
dC
dC
XC
Qk
zv
Ge
dC
hV
QF
QF
QF
Js
Js
"}
(49,1,1) = {"
Js
QF
QF
QF
QF
QF
QF
QF
QF
QF
Go
dC
sb
zv
Ge
dC
dC
dC
dC
XC
dC
dC
dC
dC
dC
dC
dC
dC
dC
dC
XC
XC
dC
dC
XC
sb
zv
Ge
dC
hV
QF
QF
Js
Js
Js
"}
(50,1,1) = {"
Js
QF
QF
QF
QF
QF
QF
QF
QF
QF
Go
dC
sb
zv
Ge
oI
dC
dC
XC
XC
XC
XC
dC
dC
dC
dC
dC
dC
dC
dC
dC
dC
dC
dC
oI
sb
zv
Ge
dC
hV
QF
QF
Js
Js
Js
"}
(51,1,1) = {"
Js
QF
QF
QF
QF
QF
QF
QF
QF
QF
Go
dC
sb
zv
Ge
dC
dC
dC
dC
dC
XC
dC
dC
dC
dC
XC
XC
XC
dC
dC
dC
dC
dC
dC
XC
sb
zv
Ge
XC
hV
QF
QF
QF
Js
Js
"}
(52,1,1) = {"
Js
QF
QF
QF
QF
QF
QF
QF
QF
QF
Go
dC
sb
zv
Ge
dC
dC
dC
dC
dC
dC
dC
dC
dC
XC
XC
XC
XC
dC
dC
dC
dC
dC
dC
dC
sb
zv
Ge
XC
hV
QF
QF
QF
QF
Js
"}
(53,1,1) = {"
Js
QF
QF
QF
QF
QF
QF
QF
QF
QF
Go
XC
sb
zv
Ge
dC
XC
dC
dC
dC
dC
dC
dC
dC
dC
dC
XC
dC
dC
dC
dC
XC
dC
dC
dC
sb
zv
Ge
XC
hV
QF
QF
QF
QF
Js
"}
(54,1,1) = {"
Js
Js
QF
QF
QF
QF
QF
QF
QF
QF
Go
XC
sb
zv
Ge
dC
dC
dC
dC
dC
dC
XC
XC
dC
dC
dC
dC
dC
dC
dC
XC
XC
dC
dC
XC
sb
zv
Ge
dC
hV
QF
QF
QF
QF
Js
"}
(55,1,1) = {"
Js
Js
Js
Js
Js
QF
QF
QF
QF
QF
Go
dC
sb
zv
Ge
oI
dC
dC
dC
dC
XC
dC
dC
dC
dC
dC
dC
dC
dC
XC
XC
dC
dC
dC
oI
sb
zv
Ge
dC
hV
QF
QF
QF
QF
Js
"}
(56,1,1) = {"
Js
Js
Js
Js
QF
QF
QF
QF
QF
QF
Go
XC
sb
zv
OM
XC
dC
dC
dC
dC
dC
dC
dC
dC
XC
dC
dC
dC
dC
XC
XC
dC
dC
dC
dC
Qk
zv
Ge
XC
hV
QF
QF
Js
Js
Js
"}
(57,1,1) = {"
Js
Js
QF
QF
QF
QF
QF
QF
QF
QF
Go
XC
sb
zv
Ge
XC
dC
dC
dC
dC
dC
dC
dC
dC
dC
dC
dC
dC
dC
dC
XC
dC
dC
dC
dC
sb
zv
Ge
XC
hV
QF
QF
Js
Js
Js
"}
(58,1,1) = {"
Js
QF
QF
QF
QF
QF
QF
QF
QF
QF
Go
dC
sb
zv
Ge
dC
dC
dC
dC
XC
dC
dC
dC
dC
dC
XC
dC
dC
dC
dC
dC
dC
dC
dC
XC
sb
zv
Ge
XC
hV
QF
QF
QF
Js
Js
"}
(59,1,1) = {"
Js
QF
QF
QF
QF
QF
QF
QF
QF
QF
Go
XC
sb
zv
Ge
dC
dC
dC
dC
dC
dC
dC
XC
XC
XC
XC
XC
dC
dC
dC
dC
dC
dC
XC
dC
sb
zv
Ge
dC
hV
QF
QF
QF
Js
Js
"}
(60,1,1) = {"
Js
QF
QF
QF
QF
QF
QF
QF
QF
QF
Go
XC
sb
zv
Ge
FX
dC
dC
dC
dC
dC
dC
dC
XC
XC
XC
XC
dC
dC
dC
dC
dC
dC
XC
FX
sb
zv
Ge
dC
hV
QF
QF
QF
Js
Js
"}
(61,1,1) = {"
Js
QF
QF
QF
QF
QF
QF
QF
QF
QF
Go
dC
sb
zv
Ge
dC
dC
dC
dC
dC
XC
XC
XC
XC
dC
XC
XC
XC
dC
dC
dC
dC
dC
XC
XC
sb
zv
Ge
XC
hV
QF
QF
QF
Js
Js
"}
(62,1,1) = {"
Js
Js
QF
QF
QF
QF
QF
QF
QF
QF
Go
dC
sb
zv
OM
dC
dC
dC
dC
dC
dC
dC
dC
dC
dC
dC
XC
dC
XC
dC
dC
dC
dC
dC
XC
Qk
zv
Ge
dC
hV
QF
QF
QF
Js
Js
"}
(63,1,1) = {"
Js
QF
QF
QF
QF
QF
QF
QF
QF
QF
Go
XC
sb
zv
Ge
XC
dC
dC
XC
dC
dC
dC
dC
dC
dC
dC
XC
XC
XC
dC
dC
dC
dC
dC
XC
sb
zv
Ge
dC
hV
QF
QF
QF
Js
Js
"}
(64,1,1) = {"
Js
Js
QF
QF
QF
QF
QF
QF
QF
QF
Go
XC
sb
zv
Ge
XC
XC
dC
dC
XC
XC
dC
dC
dC
dC
dC
dC
dC
dC
dC
dC
dC
XC
dC
dC
sb
HB
Ge
XC
hV
QF
QF
QF
QF
Js
"}
(65,1,1) = {"
Js
Js
QF
QF
QF
QF
QF
QF
QF
QF
Go
dC
sb
zv
Ge
oI
XC
dC
dC
dC
dC
dC
dC
dC
XC
XC
XC
dC
dC
dC
dC
XC
dC
dC
oI
sb
zv
Ge
dC
hV
QF
QF
QF
QF
Js
"}
(66,1,1) = {"
Js
Js
QF
QF
QF
QF
QF
QF
QF
QF
Go
dC
sb
zv
Ge
XC
XC
XC
XC
dC
dC
dC
dC
dC
dC
dC
dC
dC
dC
dC
dC
dC
dC
dC
XC
sb
zv
Ge
dC
hV
QF
QF
QF
QF
Js
"}
(67,1,1) = {"
Js
Js
QF
QF
QF
QF
QF
QF
QF
QF
Go
XC
sb
zv
Ge
XC
XC
XC
XC
XC
XC
XC
XC
dC
dC
XC
dC
dC
dC
dC
dC
dC
dC
XC
XC
sb
zv
Ge
dC
hV
QF
QF
QF
QF
Js
"}
(68,1,1) = {"
Js
QF
QF
QF
QF
QF
QF
QF
QF
QF
Go
dC
sb
zv
sa
lu
lu
lu
lu
lu
lu
lu
lu
lu
lu
lu
lu
lu
lu
lu
lu
lu
lu
lu
lu
ov
zv
Ge
dC
hV
QF
QF
QF
QF
Js
"}
(69,1,1) = {"
Js
Js
QF
QF
QF
QF
QF
QF
QF
QF
Go
uF
sb
zv
zv
zv
zv
zv
zv
zv
zv
zv
zv
nf
OH
DS
zv
zv
zv
zv
zv
zv
zv
zv
zv
zv
zv
Ge
uF
hV
QF
QF
QF
QF
Js
"}
(70,1,1) = {"
Js
QF
QF
QF
QF
QF
QF
QF
QF
uF
uF
uF
nb
It
It
It
bI
It
Kp
No
No
No
No
fu
Bb
PA
No
No
No
No
to
It
It
bI
It
It
It
iD
uF
uF
uF
QF
QF
QF
Js
"}
(71,1,1) = {"
uF
uF
uF
QF
QF
QF
QF
QF
QF
QF
QF
uF
uF
uF
dC
dC
dC
XC
sb
No
vg
No
No
No
iA
No
No
No
vg
No
Ge
dC
dC
XC
XC
dC
uF
uF
uF
QF
QF
QF
uF
uF
uF
"}
(72,1,1) = {"
fS
fS
uF
QF
QF
QF
QF
QF
QF
QF
QF
QF
uF
Iy
Iy
Iy
Iy
Iy
uF
Ey
Ey
Ey
uF
Ey
Ey
UK
uF
Ey
Ey
Ey
uF
Iy
Iy
Iy
Iy
Iy
Iy
uF
QF
QF
QF
QF
uF
fS
fS
"}
(73,1,1) = {"
vP
vP
JI
vP
vP
vP
vP
vP
vP
vP
vP
vP
vP
vP
vP
vP
vP
vP
uF
sh
sh
eA
uF
dk
ZG
ZG
uF
eA
sh
sh
uF
vP
vP
vP
vP
vP
vP
vP
vP
vP
vP
vP
JI
vP
vP
"}
(74,1,1) = {"
fS
fS
JI
QF
QF
QF
QF
QF
QF
QF
QF
QF
QF
QF
QF
QF
QF
QF
uF
fS
fS
fS
uF
fS
fS
lc
uF
fS
fS
fS
uF
QF
QF
QF
QF
QF
QF
QF
QF
QF
QF
QF
JI
fS
fS
"}
(75,1,1) = {"
fS
fS
JI
QF
QF
QF
QF
QF
QF
QF
QF
QF
QF
QF
QF
QF
QF
QF
uF
fS
fS
fS
uF
fS
fS
fS
uF
fS
fS
fS
uF
QF
QF
QF
QF
QF
QF
QF
QF
QF
QF
QF
JI
fS
fS
"}
(76,1,1) = {"
fS
fS
JI
QF
QF
QF
QF
QF
QF
QF
QF
QF
QF
QF
QF
QF
QF
QF
uF
fS
fS
fS
uF
fS
fS
fS
uF
fS
fS
fS
uF
QF
QF
QF
QF
QF
QF
QF
QF
QF
QF
QF
JI
fS
fS
"}
(77,1,1) = {"
vP
vP
JI
vP
vP
vP
vP
vP
vP
vP
vP
vP
vP
vP
vP
vP
vP
vP
uF
Vh
uF
Vh
uF
NQ
uF
NQ
uF
Vh
uF
Vh
uF
vP
vP
vP
vP
vP
vP
vP
vP
vP
vP
vP
JI
vP
vP
"}
(78,1,1) = {"
fS
fS
uF
QF
QF
QF
QF
QF
QF
QF
QF
QF
QF
QF
QF
QF
QF
LJ
uF
Qg
QF
QF
QF
QF
QF
QF
QF
QF
QF
LJ
uF
Qg
QF
QF
QF
QF
QF
QF
QF
QF
QF
QF
uF
fS
fS
"}
(79,1,1) = {"
uF
uF
uF
QF
QF
QF
QF
QF
QF
QF
QF
QF
QF
QF
QF
QF
QF
mq
hW
AZ
QF
QF
QF
QF
QF
QF
QF
QF
QF
mq
hW
AZ
QF
QF
QF
QF
QF
QF
QF
QF
QF
QF
uF
uF
uF
"}
(80,1,1) = {"
Js
Js
QF
QF
QF
QF
QF
QF
QF
QF
QF
QF
QF
QF
QF
QF
QF
QF
QF
QF
QF
QF
QF
QF
QF
QF
QF
QF
QF
QF
QF
QF
QF
QF
QF
QF
QF
QF
QF
QF
QF
QF
QF
QF
Js
"}
(81,1,1) = {"
Js
Js
Js
QF
QF
QF
Js
QF
QF
QF
QF
QF
QF
QF
QF
QF
QF
QF
QF
QF
QF
QF
QF
QF
QF
QF
QF
QF
QF
QF
QF
QF
QF
QF
QF
QF
QF
QF
QF
QF
QF
QF
QF
QF
Js
"}
(82,1,1) = {"
Js
Js
Js
Js
QF
Js
Js
QF
QF
QF
QF
QF
QF
QF
QF
QF
QF
QF
QF
QF
QF
QF
QF
QF
QF
QF
QF
QF
QF
QF
QF
QF
QF
QF
QF
QF
QF
QF
QF
Js
Js
QF
QF
Js
Js
"}
(83,1,1) = {"
Js
Js
Js
Js
Js
QF
QF
QF
QF
QF
QF
QF
QF
QF
QF
QF
QF
QF
QF
QF
QF
QF
QF
QF
QF
QF
QF
QF
QF
Js
QF
QF
QF
QF
QF
QF
QF
QF
QF
QF
Js
QF
QF
Js
Js
"}
(84,1,1) = {"
Js
Js
Js
Js
Js
Js
QF
QF
QF
QF
QF
QF
QF
QF
QF
QF
QF
Js
Js
Js
QF
QF
QF
QF
QF
QF
QF
QF
QF
Js
Js
QF
QF
QF
Js
QF
QF
QF
QF
QF
QF
QF
Js
Js
Js
"}
(85,1,1) = {"
Js
Js
Js
Js
Js
Js
Js
QF
QF
Js
Js
QF
QF
QF
QF
Js
Js
Js
Js
Js
Js
Js
QF
QF
QF
QF
QF
QF
Js
Js
Js
QF
QF
QF
Js
Js
QF
QF
Js
Js
Js
Js
Js
Js
Js
"}
(86,1,1) = {"
Js
Js
Js
Js
Js
Js
Js
Js
Js
Js
Js
Js
Js
Js
Js
Js
Js
Js
Js
Js
Js
Js
Js
Js
Js
Js
Js
Js
Js
Js
Js
Js
Js
Js
Js
Js
Js
Js
Js
Js
Js
Js
Js
Js
Js
"}
