//MAP CONVERTED BY dmm2tgm.py THIS HEADER COMMENT PREVENTS RECONVERSION, DO NOT REMOVE
"aU" = (
/obj/effect/turf_decal/corner/opaque/brown{
	dir = 4
	},
/turf/open/floor/plasteel/patterned/grid,
/area/hangar)
"bY" = (
/obj/effect/turf_decal/corner/opaque/brown{
	dir = 8
	},
/obj/effect/turf_decal/corner/opaque/brown{
	dir = 4
	},
/obj/effect/turf_decal/corner/opaque/yellow,
/turf/open/floor/plasteel/patterned/grid,
/area/hangar)
"dD" = (
/turf/closed/indestructible/reinforced,
/area/hangar)
"eI" = (
/obj/effect/turf_decal/corner/opaque/brown{
	dir = 4
	},
/obj/effect/turf_decal/corner/opaque/yellow{
	dir = 1
	},
/turf/open/floor/plasteel/patterned/grid,
/area/hangar)
"fw" = (
/obj/machinery/door/poddoor/shutters/indestructible{
	dir = 4
	},
/turf/open/floor/plating/rust,
/area/hangar)
"fH" = (
/obj/effect/turf_decal/corner/opaque/brown{
	dir = 8
	},
/turf/open/floor/plasteel/patterned/grid,
/area/hangar)
"fQ" = (
/obj/structure/platform/industrial_alt/corner{
	dir = 1
	},
/turf/open/water/beach/deep,
/area/hangar)
"fR" = (
/obj/machinery/light/floor/hangar,
/turf/open/floor/plasteel/patterned/grid,
/area/hangar)
"hF" = (
/obj/effect/turf_decal/corner/opaque/brown{
	dir = 4
	},
/obj/effect/turf_decal/corner/opaque/yellow,
/turf/open/floor/plasteel/patterned/grid,
/area/hangar)
"ji" = (
/obj/effect/landmark/outpost/elevator{
	shaft = "1"
	},
/turf/open/floor/plasteel/elevatorshaft,
/area/hangar)
"kA" = (
/obj/effect/turf_decal/corner/opaque/yellow{
	dir = 8
	},
/obj/effect/turf_decal/corner/opaque/yellow,
/turf/open/floor/plasteel/patterned/grid,
/area/hangar)
"nC" = (
/obj/structure/platform/industrial_alt{
	dir = 8
	},
/turf/open/water/beach/deep,
/area/hangar)
"oz" = (
/obj/effect/turf_decal/corner/opaque/brown{
	dir = 4
	},
/obj/effect/turf_decal/corner/opaque/yellow,
/obj/effect/turf_decal/corner/opaque/yellow{
	dir = 1
	},
/turf/open/floor/plasteel/patterned/grid,
/area/hangar)
"oB" = (
/obj/machinery/door/poddoor/ert,
/turf/open/floor/plasteel/elevatorshaft,
/area/hangar)
"oR" = (
/obj/effect/turf_decal/corner/opaque/yellow,
/turf/open/floor/plasteel/patterned/grid,
/area/hangar)
"oW" = (
/obj/machinery/light/floor/hangar,
/obj/effect/turf_decal/corner/opaque/brown{
	dir = 8
	},
/obj/effect/turf_decal/corner/opaque/yellow,
/turf/open/floor/plasteel/patterned/grid,
/area/hangar)
"pf" = (
/obj/effect/turf_decal/techfloor{
	dir = 8
	},
/turf/open/floor/plasteel/tech{
	planetary_atmos = 1
	},
/area/hangar)
"pt" = (
/obj/structure/catwalk/over/plated_catwalk/dark,
/turf/open/floor/plating/rust,
/area/hangar)
"pA" = (
/obj/effect/turf_decal/techfloor{
	dir = 4
	},
/turf/open/floor/plasteel/tech{
	planetary_atmos = 1
	},
/area/hangar)
"rJ" = (
/obj/structure/marker_beacon{
	picked_color = "Teal"
	},
/turf/open/floor/plating{
	planetary_atmos = 1
	},
/area/hangar)
"sG" = (
/obj/machinery/light/floor/hangar,
/obj/effect/turf_decal/corner/opaque/brown{
	dir = 4
	},
/obj/effect/turf_decal/corner/opaque/yellow,
/turf/open/floor/plasteel/patterned/grid,
/area/hangar)
"sH" = (
/obj/structure/catwalk/over/plated_catwalk,
/turf/open/floor/plating{
	planetary_atmos = 1
	},
/area/hangar)
"sI" = (
/turf/open/floor/plating{
	planetary_atmos = 1
	},
/area/hangar)
"vA" = (
/turf/closed/indestructible/rock,
/area/hangar)
"vE" = (
/obj/structure/platform/industrial_alt{
	dir = 8
	},
/obj/effect/forcefield/mime/advanced{
	name = "long fall";
	desc = "You don't want to jump off. You probably won't be saved.";
	timeleft = null
	},
/turf/open/water/beach/deep,
/area/hangar)
"vW" = (
/obj/effect/turf_decal/techfloor{
	dir = 4
	},
/obj/effect/turf_decal/trimline/opaque/yellow/line{
	dir = 8
	},
/turf/open/floor/plasteel/patterned/grid,
/area/hangar)
"xg" = (
/obj/structure/catwalk/over/plated_catwalk/dark,
/turf/open/floor/plating{
	planetary_atmos = 1
	},
/area/hangar)
"xO" = (
/obj/structure/platform/industrial_alt/corner{
	dir = 4
	},
/turf/open/water/beach/deep,
/area/hangar)
"yq" = (
/obj/effect/turf_decal/corner/opaque/brown{
	dir = 8
	},
/obj/effect/turf_decal/corner/opaque/yellow{
	dir = 1
	},
/obj/effect/turf_decal/corner/opaque/yellow,
/turf/open/floor/plasteel/patterned/grid,
/area/hangar)
"yL" = (
/obj/effect/turf_decal/corner/opaque/brown{
	dir = 8
	},
/obj/effect/turf_decal/corner/opaque/yellow{
	dir = 1
	},
/turf/open/floor/plasteel/patterned/grid,
/area/hangar)
"AH" = (
/obj/structure/platform/industrial_alt{
	dir = 4
	},
/obj/effect/forcefield/mime/advanced{
	name = "long fall";
	desc = "You don't want to jump off. You probably won't be saved.";
	timeleft = null
	},
/turf/open/water/beach/deep,
/area/hangar)
"Cu" = (
/obj/effect/turf_decal/corner/opaque/yellow{
	dir = 4
	},
/obj/effect/turf_decal/corner/opaque/yellow,
/turf/open/floor/plasteel/patterned/grid,
/area/hangar)
"El" = (
/obj/effect/turf_decal/corner/opaque/yellow{
	dir = 1
	},
/obj/effect/turf_decal/corner/opaque/yellow{
	dir = 4
	},
/turf/open/floor/plasteel/patterned/grid,
/area/hangar)
"Et" = (
/obj/effect/landmark/outpost/elevator_machine{
	shaft = "1"
	},
/obj/machinery/door/airlock/hatch{
	dir = 4
	},
/turf/open/floor/plating/rust,
/area/hangar)
"Fa" = (
/obj/structure/platform/industrial_alt{
	dir = 1
	},
/turf/open/water/beach/deep,
/area/hangar)
"Fj" = (
/turf/open/floor/plasteel/patterned/grid,
/area/hangar)
"GE" = (
/obj/effect/landmark/outpost/hangar_dock,
/turf/open/floor/plating{
	planetary_atmos = 1
	},
/area/hangar)
"HR" = (
/obj/machinery/door/poddoor/shutters/indestructible{
	dir = 4
	},
/turf/open/floor/plating{
	planetary_atmos = 1
	},
/area/hangar)
"HS" = (
/turf/closed/indestructible/fakeglass,
/area/hangar)
"HT" = (
/obj/structure/platform/industrial_alt{
	dir = 1
	},
/obj/effect/forcefield/mime/advanced{
	name = "long fall";
	desc = "You don't want to jump off. You probably won't be saved.";
	timeleft = null
	},
/turf/open/water/beach/deep,
/area/hangar)
"IT" = (
/obj/effect/landmark/outpost/hangar_numbers,
/turf/open/floor/plasteel/patterned/grid,
/area/hangar)
"Ld" = (
/turf/open/floor/plating/rust,
/area/hangar)
"Le" = (
/turf/open/water/beach/deep,
/area/hangar)
"Lu" = (
/obj/effect/turf_decal/corner/opaque/yellow/full,
/obj/effect/landmark/outpost/hangar_numbers,
/turf/open/floor/plasteel/patterned/grid,
/area/hangar)
"LB" = (
/obj/effect/turf_decal/corner/opaque/brown{
	dir = 4
	},
/obj/effect/turf_decal/corner/opaque/brown{
	dir = 8
	},
/obj/effect/turf_decal/corner/opaque/yellow{
	dir = 1
	},
/turf/open/floor/plasteel/patterned/grid,
/area/hangar)
"Me" = (
/obj/machinery/light/floor/hangar,
/obj/effect/turf_decal/corner/opaque/brown{
	dir = 4
	},
/obj/effect/turf_decal/corner/opaque/yellow{
	dir = 1
	},
/turf/open/floor/plasteel/patterned/grid,
/area/hangar)
"MF" = (
/obj/structure/platform/industrial_alt,
/turf/open/water/beach/deep,
/area/hangar)
"NM" = (
/obj/effect/turf_decal/corner/opaque/yellow{
	dir = 1
	},
/turf/open/floor/plasteel/patterned/grid,
/area/hangar)
"OA" = (
/obj/machinery/elevator_call_button{
	dir = 1;
	pixel_y = -24
	},
/obj/effect/landmark/outpost/elevator_machine{
	shaft = "1"
	},
/obj/effect/turf_decal/techfloor{
	dir = 4
	},
/obj/effect/turf_decal/trimline/opaque/yellow/line{
	dir = 8
	},
/turf/open/floor/plasteel/patterned/grid,
/area/hangar)
"PJ" = (
/obj/effect/landmark/outpost/elevator_machine{
	shaft = "1"
	},
/obj/machinery/door/airlock/hatch{
	dir = 4
	},
/turf/open/floor/plating{
	planetary_atmos = 1
	},
/area/hangar)
"SZ" = (
/obj/structure/catwalk/over/plated_catwalk,
/obj/machinery/atmospherics/pipe/manifold/orange/hidden,
/turf/open/floor/plating{
	planetary_atmos = 1
	},
/area/hangar)
"UD" = (
/obj/effect/turf_decal/corner/opaque/yellow{
	dir = 4
	},
/obj/effect/turf_decal/corner/opaque/yellow{
	dir = 1
	},
/turf/open/floor/plasteel/patterned/grid,
/area/hangar)
"VB" = (
/obj/machinery/door/poddoor/shutters/indestructible{
	dir = 4
	},
/turf/closed/indestructible/fakeglass,
/area/hangar)
"XX" = (
/turf/open/floor/plasteel/elevatorshaft,
/area/hangar)
"Yx" = (
/obj/effect/turf_decal/corner/opaque/yellow{
	dir = 1
	},
/obj/effect/turf_decal/corner/opaque/yellow{
	dir = 8
	},
/turf/open/floor/plasteel/patterned/grid,
/area/hangar)
"YK" = (
/obj/effect/turf_decal/corner/opaque/yellow,
/obj/effect/turf_decal/corner/opaque/yellow{
	dir = 8
	},
/turf/open/floor/plasteel/patterned/grid,
/area/hangar)
"YO" = (
/obj/effect/turf_decal/corner/opaque/brown{
	dir = 8
	},
/obj/effect/turf_decal/corner/opaque/yellow,
/turf/open/floor/plasteel/patterned/grid,
/area/hangar)
"YY" = (
/obj/structure/platform/industrial_alt,
/obj/effect/forcefield/mime/advanced{
	name = "long fall";
	desc = "You don't want to jump off. You probably won't be saved.";
	timeleft = null
	},
/turf/open/water/beach/deep,
/area/hangar)
"Zd" = (
/obj/structure/marker_beacon{
	picked_color = "Teal"
	},
/turf/open/floor/plating/rust,
/area/hangar)
"Zz" = (
/obj/structure/platform/industrial{
	dir = 4
	},
/obj/structure/platform/industrial{
	dir = 8
	},
/turf/open/floor/plasteel/elevatorshaft,
/area/hangar)

(1,1,1) = {"
vA
vA
vA
vA
vA
vA
vA
vA
vA
vA
vA
vA
vA
vA
vA
vA
vA
vA
vA
vA
vA
vA
vA
vA
vA
vA
vA
vA
vA
vA
vA
vA
vA
vA
vA
vA
vA
vA
vA
vA
vA
vA
vA
vA
vA
"}
(2,1,1) = {"
vA
vA
vA
vA
vA
vA
vA
Le
Le
Le
vA
vA
vA
vA
vA
vA
vA
Le
Le
Le
Le
Le
vA
vA
vA
vA
vA
Le
Le
vA
vA
vA
vA
Le
Le
Le
Le
Le
Le
vA
vA
vA
vA
vA
vA
"}
(3,1,1) = {"
vA
vA
vA
vA
vA
vA
Le
Le
Le
Le
Le
Le
Le
Le
Le
Le
Le
Le
Le
Le
Le
Le
Le
vA
vA
vA
Le
Le
Le
Le
Le
vA
Le
Le
Le
Le
Le
Le
Le
Le
Le
vA
vA
vA
vA
"}
(4,1,1) = {"
vA
vA
vA
vA
Le
Le
Le
Le
Le
Le
Le
Le
Le
Le
Le
Le
Le
Le
Le
Le
Le
Le
Le
vA
Le
Le
Le
Le
Le
Le
Le
Le
Le
Le
Le
Le
Le
Le
Le
Le
Le
Le
vA
vA
vA
"}
(5,1,1) = {"
vA
vA
vA
Le
Le
Le
Le
Le
Le
Le
Le
Le
Le
Le
Le
Le
Le
Le
Le
Le
Le
Le
Le
Le
Le
Le
Le
Le
Le
Le
Le
Le
Le
Le
Le
Le
Le
Le
Le
Le
Le
Le
Le
vA
vA
"}
(6,1,1) = {"
vA
vA
Le
Le
Le
Le
Le
Le
Le
Le
Le
Le
dD
Le
Le
Le
Le
Le
Le
Le
Le
Le
Le
Le
Le
Le
Le
Le
Le
Le
Le
Le
Le
Le
Le
Le
Le
dD
Le
Le
Le
Le
Le
vA
vA
"}
(7,1,1) = {"
vA
Le
Le
Le
Le
Le
Le
Le
Le
Le
Le
Le
dD
AH
AH
AH
AH
AH
AH
AH
AH
AH
AH
AH
AH
AH
AH
AH
AH
AH
AH
AH
AH
AH
AH
AH
AH
dD
Le
Le
Le
Le
Le
vA
vA
"}
(8,1,1) = {"
vA
Le
Le
Le
Le
Le
Le
Le
Le
Le
Le
dD
dD
dD
sI
Ld
Ld
Ld
sI
sI
Ld
sI
sI
dD
dD
dD
dD
Ld
Ld
sI
sI
sI
sI
sI
Ld
sI
dD
dD
dD
Le
Le
Le
Le
vA
vA
"}
(9,1,1) = {"
vA
Le
Le
Le
Le
Le
Le
Le
Le
dD
dD
dD
LB
yL
yq
pf
pf
pf
pf
pf
pf
pf
pf
pf
pf
pf
pf
pf
pf
pf
pf
pf
pf
pf
pf
LB
yL
yq
dD
dD
dD
Le
Le
vA
vA
"}
(10,1,1) = {"
vA
Le
Le
Le
Le
Le
Le
Le
Le
Le
YY
dD
eI
sH
YO
pt
xg
xg
xg
pt
xg
pt
xg
xg
xg
pt
pt
pt
xg
xg
xg
xg
xg
pt
xg
eI
sH
YO
dD
HT
Le
Le
Le
Le
vA
"}
(11,1,1) = {"
vA
Le
Le
Le
Le
Le
Le
Le
Le
Le
YY
Ld
eI
sH
YO
pA
pA
pA
pA
pA
pA
pA
pA
pA
pA
pA
pA
pA
pA
pA
pA
pA
pA
pA
pA
eI
sH
YO
sI
HT
Le
Le
Le
Le
vA
"}
(12,1,1) = {"
vA
vA
Le
Le
Le
Le
Le
Le
Le
Le
YY
Ld
eI
sH
YO
Ld
Ld
Ld
Ld
Ld
sI
sI
sI
sI
sI
sI
sI
sI
sI
sI
sI
sI
sI
Ld
GE
eI
sH
YO
Ld
HT
Le
Le
Le
Le
vA
"}
(13,1,1) = {"
vA
vA
vA
Le
Le
Le
Le
Le
Le
Le
YY
sI
eI
sH
YO
Ld
Ld
sI
sI
sI
sI
sI
sI
sI
Ld
sI
Ld
sI
sI
sI
sI
sI
sI
sI
Ld
eI
sH
YO
Ld
HT
Le
Le
Le
Le
vA
"}
(14,1,1) = {"
vA
vA
vA
vA
Le
Le
Le
Le
Le
Le
YY
sI
eI
sH
YO
rJ
Ld
sI
sI
sI
sI
sI
sI
sI
Ld
Ld
Ld
Ld
Ld
sI
sI
Ld
sI
sI
Zd
eI
sH
YO
Ld
HT
Le
Le
Le
Le
vA
"}
(15,1,1) = {"
vA
vA
Le
Le
Le
Le
Le
Le
Le
Le
YY
Ld
eI
sH
YO
Ld
sI
sI
sI
sI
sI
Ld
sI
sI
sI
Ld
Ld
sI
sI
sI
sI
Ld
sI
sI
Ld
eI
sH
YO
Ld
HT
Le
Le
Le
Le
vA
"}
(16,1,1) = {"
vA
vA
Le
Le
Le
Le
Le
Le
Le
Le
YY
sI
eI
sH
oW
Ld
sI
sI
sI
Ld
sI
Ld
sI
sI
sI
Ld
Ld
sI
sI
sI
Ld
Ld
sI
sI
sI
Me
sH
YO
sI
HT
Le
Le
Le
Le
vA
"}
(17,1,1) = {"
vA
Le
Le
Le
Le
Le
Le
Le
Le
Le
YY
sI
eI
sH
YO
Ld
sI
sI
Ld
Ld
sI
sI
sI
Ld
sI
sI
Ld
sI
sI
sI
Ld
Ld
sI
sI
sI
eI
sH
YO
sI
HT
Le
Le
Le
Le
vA
"}
(18,1,1) = {"
vA
vA
Le
Le
Le
Le
Le
Le
Le
Le
YY
Ld
eI
sH
YO
sI
sI
sI
sI
sI
sI
sI
sI
sI
sI
sI
sI
sI
sI
sI
sI
sI
sI
sI
sI
eI
sH
YO
Ld
HT
Le
Le
Le
Le
vA
"}
(19,1,1) = {"
vA
vA
vA
Le
Le
Le
Le
Le
Le
Le
YY
Ld
eI
sH
YO
rJ
sI
sI
sI
sI
sI
sI
Ld
sI
sI
sI
sI
Ld
sI
sI
sI
sI
Ld
sI
rJ
eI
sH
YO
sI
HT
Le
Le
Le
vA
vA
"}
(20,1,1) = {"
vA
Le
Le
Le
Le
Le
Le
Le
Le
Le
YY
Ld
eI
sH
YO
sI
sI
Ld
sI
sI
sI
sI
sI
sI
sI
sI
sI
sI
Ld
Ld
sI
sI
sI
sI
sI
eI
sH
YO
Ld
HT
Le
Le
vA
vA
vA
"}
(21,1,1) = {"
vA
Le
Le
Le
Le
Le
Le
Le
Le
Le
YY
Ld
eI
sH
YO
sI
Ld
sI
sI
sI
sI
sI
sI
sI
sI
sI
sI
sI
sI
Ld
sI
sI
sI
sI
sI
eI
sH
YO
Ld
HT
Le
Le
vA
vA
vA
"}
(22,1,1) = {"
vA
Le
Le
Le
Le
Le
Le
Le
Le
Le
YY
sI
eI
sH
YO
sI
sI
sI
sI
Ld
sI
sI
sI
sI
sI
Ld
sI
sI
sI
sI
sI
sI
sI
sI
sI
eI
sH
YO
Ld
HT
Le
Le
Le
vA
vA
"}
(23,1,1) = {"
vA
Le
Le
Le
Le
Le
Le
Le
Le
Le
YY
Ld
eI
sH
YO
sI
sI
sI
sI
sI
sI
sI
Ld
Ld
Ld
Ld
Ld
sI
sI
sI
sI
sI
sI
Ld
sI
eI
sH
YO
sI
HT
Le
Le
Le
vA
vA
"}
(24,1,1) = {"
vA
Le
Le
Le
Le
Le
Le
Le
Le
Le
YY
Ld
eI
sH
YO
rJ
sI
sI
sI
sI
sI
sI
sI
Ld
Ld
Ld
Ld
sI
sI
sI
sI
sI
sI
Ld
rJ
eI
sH
YO
sI
HT
Le
Le
Le
vA
vA
"}
(25,1,1) = {"
vA
Le
Le
Le
Le
Le
Le
Le
Le
Le
YY
sI
eI
sH
YO
sI
sI
sI
sI
sI
Ld
Ld
Ld
Ld
sI
Ld
Ld
Ld
sI
sI
sI
sI
sI
Ld
Ld
eI
sH
YO
Ld
HT
Le
Le
Le
vA
vA
"}
(26,1,1) = {"
vA
vA
Le
Le
Le
Le
Le
Le
Le
Le
YY
sI
eI
sH
oW
sI
sI
sI
sI
sI
sI
sI
sI
sI
sI
sI
Ld
sI
Ld
sI
sI
sI
sI
sI
Ld
Me
sH
YO
sI
HT
Le
Le
Le
vA
vA
"}
(27,1,1) = {"
vA
Le
Le
Le
Le
Le
Le
Le
Le
Le
YY
Ld
eI
sH
YO
Ld
sI
sI
Ld
sI
sI
sI
sI
sI
sI
sI
Ld
Ld
Ld
sI
sI
sI
sI
sI
Ld
eI
sH
YO
sI
HT
Le
Le
Le
vA
vA
"}
(28,1,1) = {"
vA
vA
Le
Le
Le
Le
Le
Le
Le
Le
YY
Ld
eI
sH
YO
Ld
Ld
sI
sI
Ld
Ld
sI
sI
sI
sI
sI
sI
sI
sI
sI
sI
sI
Ld
sI
sI
eI
SZ
YO
Ld
HT
Le
Le
Le
Le
vA
"}
(29,1,1) = {"
vA
vA
Le
Le
Le
Le
Le
Le
Le
Le
YY
sI
eI
sH
YO
Zd
Ld
sI
sI
sI
sI
sI
sI
sI
sI
sI
sI
sI
sI
sI
sI
Ld
sI
sI
Zd
eI
sH
YO
sI
HT
Le
Le
Le
Le
vA
"}
(30,1,1) = {"
vA
vA
Le
Le
Le
Le
Le
Le
Le
Le
YY
sI
eI
sH
YO
Ld
Ld
Ld
Ld
sI
sI
sI
sI
sI
sI
sI
sI
sI
sI
sI
sI
sI
sI
sI
Ld
eI
sH
YO
sI
HT
Le
Le
Le
Le
vA
"}
(31,1,1) = {"
vA
vA
Le
Le
Le
Le
Le
Le
Le
Le
YY
Ld
eI
sH
YO
Ld
Ld
Ld
Ld
Ld
Ld
Ld
Ld
sI
sI
Ld
sI
sI
sI
sI
sI
sI
sI
Ld
Ld
eI
sH
YO
sI
HT
Le
Le
Le
Le
vA
"}
(32,1,1) = {"
vA
Le
Le
Le
Le
Le
Le
Le
Le
Le
YY
sI
eI
sH
fH
yL
yL
yL
yL
yL
yL
yL
yL
yL
yL
yL
yL
yL
yL
yL
yL
yL
yL
yL
yL
NM
sH
YO
sI
HT
Le
Le
Le
Le
vA
"}
(33,1,1) = {"
vA
vA
Le
Le
Le
Le
Le
Le
Le
Le
YY
dD
eI
sH
sH
sH
sH
sH
sH
sH
sH
sH
sH
YK
Cu
UD
sH
sH
sH
sH
sH
sH
sH
sH
sH
sH
sH
YO
dD
HT
Le
Le
Le
Le
vA
"}
(34,1,1) = {"
vA
Le
Le
Le
Le
Le
Le
Le
Le
dD
dD
dD
oz
hF
hF
hF
sG
hF
aU
Fj
Fj
Fj
Fj
kA
Lu
El
Fj
Fj
Fj
Fj
oR
hF
hF
sG
hF
hF
hF
bY
dD
dD
dD
Le
Le
Le
vA
"}
(35,1,1) = {"
dD
dD
dD
Le
Le
Le
Le
Le
Le
Le
Le
dD
dD
dD
sI
sI
sI
Ld
eI
Fj
IT
Fj
fR
Fj
Yx
Fj
fR
Fj
IT
Fj
YO
sI
sI
Ld
Ld
sI
dD
dD
dD
Le
Le
Le
dD
dD
dD
"}
(36,1,1) = {"
XX
XX
dD
Le
Le
Le
Le
Le
Le
Le
Le
Le
dD
vE
vE
vE
vE
vE
dD
vW
vW
vW
dD
vW
vW
OA
dD
vW
vW
vW
dD
vE
vE
vE
vE
vE
vE
dD
Le
Le
Le
Le
dD
XX
XX
"}
(37,1,1) = {"
Zz
Zz
oB
Zz
Zz
Zz
Zz
Zz
Zz
Zz
Zz
Zz
Zz
Zz
Zz
Zz
Zz
Zz
dD
HR
HR
fw
dD
PJ
Et
Et
dD
fw
HR
HR
dD
Zz
Zz
Zz
Zz
Zz
Zz
Zz
Zz
Zz
Zz
Zz
oB
Zz
Zz
"}
(38,1,1) = {"
XX
XX
oB
Le
Le
Le
Le
Le
Le
Le
Le
Le
Le
Le
Le
Le
Le
Le
dD
XX
XX
XX
dD
XX
XX
ji
dD
XX
XX
XX
dD
Le
Le
Le
Le
Le
Le
Le
Le
Le
Le
Le
oB
XX
XX
"}
(39,1,1) = {"
XX
XX
oB
Le
Le
Le
Le
Le
Le
Le
Le
Le
Le
Le
Le
Le
Le
Le
dD
XX
XX
XX
dD
XX
XX
XX
dD
XX
XX
XX
dD
Le
Le
Le
Le
Le
Le
Le
Le
Le
Le
Le
oB
XX
XX
"}
(40,1,1) = {"
XX
XX
oB
Le
Le
Le
Le
Le
Le
Le
Le
Le
Le
Le
Le
Le
Le
Le
dD
XX
XX
XX
dD
XX
XX
XX
dD
XX
XX
XX
dD
Le
Le
Le
Le
Le
Le
Le
Le
Le
Le
Le
oB
XX
XX
"}
(41,1,1) = {"
Zz
Zz
oB
Zz
Zz
Zz
Zz
Zz
Zz
Zz
Zz
Zz
Zz
Zz
Zz
Zz
Zz
Zz
dD
VB
dD
VB
dD
HS
dD
HS
dD
VB
dD
VB
dD
Zz
Zz
Zz
Zz
Zz
Zz
Zz
Zz
Zz
Zz
Zz
oB
Zz
Zz
"}
(42,1,1) = {"
XX
XX
dD
Le
Le
Le
Le
Le
Le
Le
Le
Le
Le
Le
Le
Le
Le
MF
dD
Fa
Le
Le
Le
Le
Le
Le
Le
Le
Le
MF
dD
Fa
Le
Le
Le
Le
Le
Le
Le
Le
Le
Le
dD
XX
XX
"}
(43,1,1) = {"
dD
dD
dD
Le
Le
Le
Le
Le
Le
Le
Le
Le
Le
Le
Le
Le
Le
fQ
nC
xO
Le
Le
Le
Le
Le
Le
Le
Le
Le
fQ
nC
xO
Le
Le
Le
Le
Le
Le
Le
Le
Le
Le
dD
dD
dD
"}
(44,1,1) = {"
vA
vA
Le
Le
Le
Le
Le
Le
Le
Le
Le
Le
Le
Le
Le
Le
Le
Le
Le
Le
Le
Le
Le
Le
Le
Le
Le
Le
Le
Le
Le
Le
Le
Le
Le
Le
Le
Le
Le
Le
Le
Le
Le
Le
vA
"}
(45,1,1) = {"
vA
vA
vA
Le
Le
Le
vA
Le
Le
Le
Le
Le
Le
Le
Le
Le
Le
Le
Le
Le
Le
Le
Le
Le
Le
Le
Le
Le
Le
Le
Le
Le
Le
Le
Le
Le
Le
Le
Le
Le
Le
Le
Le
Le
vA
"}
(46,1,1) = {"
vA
vA
vA
vA
Le
vA
vA
Le
Le
Le
Le
Le
Le
Le
Le
Le
Le
Le
Le
Le
Le
Le
Le
Le
Le
Le
Le
Le
Le
Le
Le
Le
Le
Le
Le
Le
Le
Le
Le
vA
vA
Le
Le
vA
vA
"}
(47,1,1) = {"
vA
vA
vA
vA
vA
Le
Le
Le
Le
Le
Le
Le
Le
Le
Le
Le
Le
Le
Le
Le
Le
Le
Le
Le
Le
Le
Le
Le
Le
Le
Le
Le
Le
Le
Le
Le
Le
Le
Le
Le
vA
Le
Le
vA
vA
"}
(48,1,1) = {"
vA
vA
vA
vA
vA
vA
Le
Le
Le
Le
Le
Le
Le
Le
Le
Le
Le
Le
Le
Le
Le
Le
Le
Le
Le
Le
Le
Le
Le
Le
Le
Le
Le
Le
Le
Le
Le
Le
Le
Le
Le
Le
vA
vA
vA
"}
(49,1,1) = {"
vA
vA
vA
vA
vA
vA
vA
Le
Le
Le
Le
Le
Le
Le
Le
Le
Le
Le
Le
Le
Le
Le
Le
Le
Le
Le
Le
Le
vA
vA
vA
Le
Le
Le
Le
Le
Le
Le
vA
vA
vA
vA
vA
vA
vA
"}
(50,1,1) = {"
vA
vA
vA
vA
vA
vA
vA
vA
vA
vA
vA
vA
vA
vA
vA
vA
vA
vA
vA
vA
vA
vA
vA
vA
vA
vA
vA
vA
vA
vA
vA
vA
vA
vA
vA
vA
vA
vA
vA
vA
vA
vA
vA
vA
vA
"}
