//MAP CONVERTED BY dmm2tgm.py THIS HEADER COMMENT PREVENTS RECONVERSION, DO NOT REMOVE
"ac" = (
/obj/machinery/door/poddoor/ert,
/turf/open/floor/plasteel/elevatorshaft,
/area/hangar)
"al" = (
/obj/structure/catwalk/over/plated_catwalk,
/turf/open/floor/plating{
	planetary_atmos = 1
	},
/area/hangar)
"ar" = (
/obj/effect/turf_decal/corner/opaque/brown{
	dir = 8
	},
/obj/effect/turf_decal/corner/opaque/brown{
	dir = 4
	},
/obj/effect/turf_decal/corner/opaque/yellow,
/turf/open/floor/plasteel/patterned/grid,
/area/hangar)
"bv" = (
/obj/machinery/light/floor/hangar,
/obj/effect/turf_decal/corner/opaque/brown{
	dir = 4
	},
/obj/effect/turf_decal/corner/opaque/yellow{
	dir = 1
	},
/turf/open/floor/plasteel/patterned/grid,
/area/hangar)
"cI" = (
/obj/effect/landmark/outpost/elevator_machine{
	shaft = "1"
	},
/obj/machinery/door/airlock/hatch{
	dir = 4
	},
/turf/open/floor/plating{
	planetary_atmos = 1
	},
/area/hangar)
"dM" = (
/obj/effect/landmark/outpost/elevator_machine{
	shaft = "1"
	},
/obj/machinery/door/airlock/hatch{
	dir = 4
	},
/turf/open/floor/plating/rust,
/area/hangar)
"ec" = (
/obj/effect/turf_decal/corner/opaque/brown{
	dir = 4
	},
/obj/effect/turf_decal/corner/opaque/brown{
	dir = 8
	},
/obj/effect/turf_decal/corner/opaque/yellow{
	dir = 1
	},
/turf/open/floor/plasteel/patterned/grid,
/area/hangar)
"eM" = (
/obj/effect/turf_decal/corner/opaque/yellow{
	dir = 1
	},
/turf/open/floor/plasteel/patterned/grid,
/area/hangar)
"fC" = (
/obj/effect/turf_decal/corner/opaque/yellow,
/obj/effect/turf_decal/corner/opaque/yellow{
	dir = 8
	},
/turf/open/floor/plasteel/patterned/grid,
/area/hangar)
"fQ" = (
/obj/effect/turf_decal/techfloor{
	dir = 4
	},
/turf/open/floor/plasteel/tech{
	planetary_atmos = 1
	},
/area/hangar)
"ho" = (
/obj/structure/catwalk/over/plated_catwalk/dark,
/turf/open/floor/plating{
	planetary_atmos = 1
	},
/area/hangar)
"jB" = (
/obj/effect/landmark/outpost/hangar_dock,
/turf/open/floor/plating{
	planetary_atmos = 1
	},
/area/hangar)
"jC" = (
/turf/open/floor/plating{
	planetary_atmos = 1
	},
/area/hangar)
"kx" = (
/obj/machinery/light/floor/hangar,
/obj/effect/turf_decal/corner/opaque/brown{
	dir = 4
	},
/obj/effect/turf_decal/corner/opaque/yellow,
/turf/open/floor/plasteel/patterned/grid,
/area/hangar)
"kC" = (
/turf/open/floor/plating/rust,
/area/hangar)
"lR" = (
/obj/effect/landmark/outpost/elevator{
	shaft = "1"
	},
/turf/open/floor/plasteel/elevatorshaft,
/area/hangar)
"mv" = (
/obj/structure/marker_beacon{
	picked_color = "Teal"
	},
/turf/open/floor/plating/rust,
/area/hangar)
"mB" = (
/obj/effect/turf_decal/corner/opaque/yellow{
	dir = 8
	},
/obj/effect/turf_decal/corner/opaque/yellow,
/turf/open/floor/plasteel/patterned/grid,
/area/hangar)
"mJ" = (
/obj/effect/turf_decal/corner/opaque/brown{
	dir = 8
	},
/turf/open/floor/plasteel/patterned/grid,
/area/hangar)
"mN" = (
/obj/structure/platform/industrial_alt,
/obj/effect/forcefield/mime/advanced{
	name = "long fall";
	desc = "You don't want to jump off. You probably won't be saved.";
	timeleft = null
	},
/turf/open/water/beach/deep,
/area/hangar)
"mS" = (
/turf/open/water/beach/deep,
/area/hangar)
"oL" = (
/obj/effect/forcefield/mime/advanced{
	name = "long fall";
	desc = "You don't want to jump off. You probably won't be saved.";
	timeleft = null
	},
/turf/open/water/beach/deep,
/area/hangar)
"qh" = (
/obj/effect/turf_decal/corner/opaque/brown{
	dir = 4
	},
/obj/effect/turf_decal/corner/opaque/yellow,
/turf/open/floor/plasteel/patterned/grid,
/area/hangar)
"qk" = (
/obj/structure/platform/industrial_alt/corner{
	dir = 1
	},
/turf/open/water/beach/deep,
/area/hangar)
"qG" = (
/obj/structure/platform/industrial_alt{
	dir = 8
	},
/obj/effect/forcefield/mime/advanced{
	name = "long fall";
	desc = "You don't want to jump off. You probably won't be saved.";
	timeleft = null
	},
/turf/open/water/beach/deep,
/area/hangar)
"qW" = (
/turf/open/floor/plasteel/elevatorshaft,
/area/hangar)
"rT" = (
/obj/structure/marker_beacon{
	picked_color = "Teal"
	},
/turf/open/floor/plating{
	planetary_atmos = 1
	},
/area/hangar)
"ur" = (
/obj/machinery/door/poddoor/shutters/indestructible{
	dir = 4
	},
/turf/closed/indestructible/fakeglass,
/area/hangar)
"uB" = (
/obj/effect/turf_decal/techfloor{
	dir = 4
	},
/obj/effect/turf_decal/trimline/opaque/yellow/line{
	dir = 8
	},
/turf/open/floor/plasteel/patterned/grid,
/area/hangar)
"vw" = (
/turf/open/floor/plasteel/patterned/grid,
/area/hangar)
"wk" = (
/obj/effect/turf_decal/techfloor{
	dir = 8
	},
/turf/open/floor/plasteel/tech{
	planetary_atmos = 1
	},
/area/hangar)
"yh" = (
/turf/closed/indestructible/reinforced,
/area/hangar)
"yA" = (
/obj/machinery/elevator_call_button{
	dir = 1;
	pixel_y = -24
	},
/obj/effect/landmark/outpost/elevator_machine{
	shaft = "1"
	},
/obj/effect/turf_decal/techfloor{
	dir = 4
	},
/obj/effect/turf_decal/trimline/opaque/yellow/line{
	dir = 8
	},
/turf/open/floor/plasteel/patterned/grid,
/area/hangar)
"yH" = (
/obj/effect/turf_decal/corner/opaque/yellow{
	dir = 4
	},
/obj/effect/turf_decal/corner/opaque/yellow{
	dir = 1
	},
/turf/open/floor/plasteel/patterned/grid,
/area/hangar)
"zh" = (
/obj/effect/turf_decal/corner/opaque/brown{
	dir = 8
	},
/obj/effect/turf_decal/corner/opaque/yellow,
/turf/open/floor/plasteel/patterned/grid,
/area/hangar)
"AL" = (
/turf/closed/indestructible/fakeglass,
/area/hangar)
"CD" = (
/obj/effect/turf_decal/corner/opaque/yellow{
	dir = 1
	},
/obj/effect/turf_decal/corner/opaque/yellow{
	dir = 8
	},
/turf/open/floor/plasteel/patterned/grid,
/area/hangar)
"CG" = (
/obj/structure/platform/industrial{
	dir = 4
	},
/obj/structure/platform/industrial{
	dir = 8
	},
/turf/open/floor/plasteel/elevatorshaft,
/area/hangar)
"EW" = (
/obj/effect/turf_decal/corner/opaque/brown{
	dir = 4
	},
/obj/effect/turf_decal/corner/opaque/yellow{
	dir = 1
	},
/turf/open/floor/plasteel/patterned/grid,
/area/hangar)
"Fj" = (
/obj/structure/platform/industrial_alt,
/turf/open/water/beach/deep,
/area/hangar)
"Gq" = (
/turf/closed/indestructible/rock,
/area/hangar)
"Hd" = (
/obj/effect/turf_decal/corner/opaque/yellow,
/obj/machinery/light/floor/hangar,
/turf/open/floor/plasteel/patterned/grid,
/area/hangar)
"HC" = (
/obj/effect/turf_decal/corner/opaque/yellow{
	dir = 1
	},
/obj/effect/turf_decal/corner/opaque/yellow{
	dir = 4
	},
/turf/open/floor/plasteel/patterned/grid,
/area/hangar)
"Iu" = (
/obj/effect/turf_decal/corner/opaque/brown{
	dir = 4
	},
/obj/machinery/light/floor/hangar,
/turf/open/floor/plasteel/patterned/grid,
/area/hangar)
"IP" = (
/obj/structure/platform/industrial_alt{
	dir = 1
	},
/turf/open/water/beach/deep,
/area/hangar)
"Mp" = (
/obj/effect/turf_decal/corner/opaque/yellow{
	dir = 4
	},
/obj/effect/turf_decal/corner/opaque/yellow,
/turf/open/floor/plasteel/patterned/grid,
/area/hangar)
"OB" = (
/obj/effect/turf_decal/corner/opaque/brown{
	dir = 8
	},
/obj/effect/turf_decal/corner/opaque/yellow{
	dir = 1
	},
/obj/effect/turf_decal/corner/opaque/yellow,
/turf/open/floor/plasteel/patterned/grid,
/area/hangar)
"Py" = (
/obj/effect/turf_decal/corner/opaque/brown{
	dir = 4
	},
/obj/effect/turf_decal/corner/opaque/yellow,
/obj/effect/turf_decal/corner/opaque/yellow{
	dir = 1
	},
/turf/open/floor/plasteel/patterned/grid,
/area/hangar)
"Qv" = (
/obj/structure/platform/industrial_alt{
	dir = 1
	},
/obj/effect/forcefield/mime/advanced{
	name = "long fall";
	desc = "You don't want to jump off. You probably won't be saved.";
	timeleft = null
	},
/turf/open/water/beach/deep,
/area/hangar)
"QJ" = (
/obj/structure/platform/industrial_alt/corner{
	dir = 4
	},
/turf/open/water/beach/deep,
/area/hangar)
"QN" = (
/obj/machinery/door/poddoor/shutters/indestructible{
	dir = 4
	},
/turf/open/floor/plating/rust,
/area/hangar)
"Rz" = (
/obj/structure/platform/industrial_alt{
	dir = 8
	},
/turf/open/water/beach/deep,
/area/hangar)
"Ti" = (
/obj/structure/catwalk/over/plated_catwalk,
/obj/machinery/atmospherics/pipe/manifold/orange/hidden,
/turf/open/floor/plating{
	planetary_atmos = 1
	},
/area/hangar)
"VB" = (
/obj/effect/landmark/outpost/hangar_numbers,
/turf/open/floor/plasteel/patterned/grid,
/area/hangar)
"We" = (
/obj/machinery/door/poddoor/shutters/indestructible{
	dir = 4
	},
/turf/open/floor/plating{
	planetary_atmos = 1
	},
/area/hangar)
"Xz" = (
/obj/machinery/light/floor/hangar,
/obj/effect/turf_decal/corner/opaque/brown{
	dir = 8
	},
/obj/effect/turf_decal/corner/opaque/yellow,
/turf/open/floor/plasteel/patterned/grid,
/area/hangar)
"XS" = (
/obj/structure/platform/industrial_alt{
	dir = 4
	},
/obj/effect/forcefield/mime/advanced{
	name = "long fall";
	desc = "You don't want to jump off. You probably won't be saved.";
	timeleft = null
	},
/turf/open/water/beach/deep,
/area/hangar)
"XW" = (
/obj/effect/turf_decal/corner/opaque/brown{
	dir = 8
	},
/obj/effect/turf_decal/corner/opaque/yellow{
	dir = 1
	},
/turf/open/floor/plasteel/patterned/grid,
/area/hangar)
"YG" = (
/obj/effect/turf_decal/corner/opaque/yellow/full,
/obj/effect/landmark/outpost/hangar_numbers,
/turf/open/floor/plasteel/patterned/grid,
/area/hangar)
"Zz" = (
/obj/structure/catwalk/over/plated_catwalk/dark,
/turf/open/floor/plating/rust,
/area/hangar)

(1,1,1) = {"
Gq
Gq
Gq
Gq
Gq
Gq
Gq
Gq
Gq
Gq
Gq
Gq
Gq
Gq
Gq
Gq
Gq
Gq
Gq
Gq
Gq
Gq
Gq
Gq
Gq
Gq
Gq
Gq
Gq
Gq
Gq
Gq
Gq
Gq
Gq
Gq
Gq
Gq
Gq
Gq
Gq
Gq
Gq
Gq
Gq
Gq
Gq
Gq
Gq
Gq
Gq
Gq
Gq
Gq
Gq
Gq
Gq
Gq
Gq
Gq
Gq
Gq
Gq
Gq
Gq
"}
(2,1,1) = {"
Gq
Gq
Gq
Gq
Gq
Gq
Gq
mS
mS
mS
Gq
Gq
Gq
Gq
Gq
Gq
Gq
mS
mS
mS
mS
mS
mS
Gq
Gq
mS
mS
Gq
mS
mS
mS
mS
Gq
Gq
Gq
Gq
Gq
mS
mS
Gq
Gq
mS
mS
mS
Gq
Gq
Gq
mS
Gq
mS
mS
Gq
Gq
mS
mS
mS
mS
mS
mS
Gq
Gq
Gq
Gq
Gq
Gq
"}
(3,1,1) = {"
Gq
Gq
Gq
Gq
Gq
Gq
mS
mS
mS
mS
mS
mS
mS
mS
mS
mS
mS
mS
mS
mS
mS
mS
mS
mS
Gq
mS
mS
mS
mS
mS
mS
mS
mS
Gq
Gq
Gq
mS
mS
mS
mS
mS
mS
mS
mS
mS
Gq
mS
mS
mS
mS
mS
Gq
mS
mS
mS
mS
mS
mS
mS
mS
mS
Gq
Gq
Gq
Gq
"}
(4,1,1) = {"
Gq
Gq
Gq
Gq
mS
mS
mS
mS
mS
mS
mS
mS
mS
mS
mS
mS
mS
mS
mS
mS
mS
mS
mS
mS
mS
mS
mS
mS
mS
mS
mS
mS
mS
Gq
mS
mS
mS
mS
mS
mS
mS
mS
mS
mS
mS
mS
mS
mS
mS
mS
mS
mS
mS
mS
mS
mS
mS
mS
mS
mS
mS
mS
Gq
Gq
Gq
"}
(5,1,1) = {"
Gq
Gq
Gq
mS
mS
mS
mS
mS
mS
mS
mS
mS
mS
mS
mS
mS
mS
mS
mS
mS
mS
mS
mS
mS
mS
mS
mS
mS
mS
mS
mS
mS
mS
mS
mS
mS
mS
mS
mS
mS
mS
mS
mS
mS
mS
mS
mS
mS
mS
mS
mS
mS
mS
mS
mS
mS
mS
mS
mS
mS
mS
mS
mS
Gq
Gq
"}
(6,1,1) = {"
Gq
Gq
mS
mS
mS
mS
mS
mS
mS
mS
mS
mS
yh
mS
mS
mS
mS
mS
mS
mS
mS
mS
mS
mS
mS
mS
mS
mS
mS
mS
mS
mS
mS
mS
mS
mS
mS
mS
mS
mS
mS
mS
mS
mS
mS
mS
mS
mS
mS
mS
mS
mS
mS
mS
mS
mS
mS
yh
mS
mS
mS
mS
mS
Gq
Gq
"}
(7,1,1) = {"
Gq
mS
mS
mS
mS
mS
mS
mS
mS
mS
mS
mS
yh
XS
XS
XS
XS
XS
XS
XS
XS
XS
XS
XS
XS
XS
XS
XS
XS
XS
XS
XS
XS
XS
XS
XS
XS
XS
XS
XS
XS
XS
XS
XS
XS
XS
XS
XS
XS
XS
XS
XS
XS
XS
XS
XS
XS
yh
mS
mS
mS
mS
mS
Gq
Gq
"}
(8,1,1) = {"
Gq
mS
mS
mS
mS
mS
mS
mS
mS
mS
mS
yh
yh
yh
jC
kC
kC
kC
jC
jC
kC
kC
kC
jC
jC
kC
jC
kC
jC
jC
kC
jC
jC
yh
yh
yh
yh
kC
kC
jC
kC
jC
kC
kC
jC
jC
jC
kC
kC
kC
jC
jC
kC
jC
kC
jC
yh
yh
yh
mS
mS
mS
mS
Gq
Gq
"}
(9,1,1) = {"
Gq
mS
mS
mS
mS
mS
mS
mS
mS
yh
yh
yh
ec
XW
OB
wk
wk
wk
wk
wk
wk
wk
wk
wk
wk
wk
wk
wk
wk
wk
wk
wk
wk
wk
wk
wk
wk
wk
wk
wk
wk
wk
wk
wk
wk
wk
wk
wk
wk
wk
wk
wk
wk
wk
wk
ec
XW
OB
yh
yh
yh
mS
mS
Gq
Gq
"}
(10,1,1) = {"
Gq
mS
mS
mS
mS
mS
mS
mS
mS
mS
mN
yh
EW
al
zh
Zz
ho
Zz
ho
Zz
ho
ho
ho
Zz
ho
ho
ho
Zz
ho
Zz
ho
Zz
ho
ho
ho
Zz
Zz
Zz
ho
ho
ho
Zz
ho
Zz
ho
ho
ho
Zz
ho
ho
Zz
ho
ho
Zz
ho
EW
al
zh
yh
Qv
mS
mS
mS
mS
Gq
"}
(11,1,1) = {"
Gq
mS
mS
mS
mS
mS
mS
mS
mS
mS
mN
kC
EW
al
zh
fQ
fQ
fQ
fQ
fQ
fQ
fQ
fQ
fQ
fQ
fQ
fQ
fQ
fQ
fQ
fQ
fQ
fQ
fQ
fQ
fQ
fQ
fQ
fQ
fQ
fQ
fQ
fQ
fQ
fQ
fQ
fQ
fQ
fQ
fQ
fQ
fQ
fQ
fQ
fQ
EW
al
zh
jC
Qv
mS
mS
mS
mS
Gq
"}
(12,1,1) = {"
Gq
Gq
mS
mS
mS
mS
mS
mS
mS
mS
mN
kC
EW
al
zh
kC
kC
kC
kC
kC
jC
jC
jC
jC
jC
jC
jC
jC
jC
jC
jC
jC
jC
jC
jC
jC
jC
jC
jC
jC
jC
jC
jC
jC
jC
jC
jC
jC
jC
jC
jC
jC
jC
kC
jB
EW
al
zh
kC
Qv
mS
mS
mS
mS
Gq
"}
(13,1,1) = {"
Gq
Gq
Gq
mS
mS
mS
mS
mS
mS
mS
mN
jC
EW
al
zh
kC
kC
jC
jC
jC
jC
jC
jC
jC
kC
jC
jC
jC
jC
jC
jC
jC
jC
jC
jC
jC
jC
jC
jC
jC
jC
jC
jC
jC
jC
jC
kC
jC
jC
jC
jC
jC
jC
jC
kC
EW
al
zh
kC
Qv
mS
mS
mS
mS
Gq
"}
(14,1,1) = {"
Gq
Gq
Gq
Gq
mS
mS
mS
mS
mS
mS
mN
jC
EW
al
zh
rT
kC
jC
jC
jC
jC
jC
jC
jC
kC
jC
jC
jC
kC
kC
jC
jC
jC
jC
jC
jC
jC
jC
jC
kC
kC
kC
kC
jC
jC
kC
kC
kC
kC
jC
jC
kC
jC
jC
mv
EW
al
zh
kC
Qv
mS
mS
mS
mS
Gq
"}
(15,1,1) = {"
Gq
Gq
mS
mS
mS
mS
mS
mS
mS
mS
mN
kC
EW
al
zh
kC
jC
jC
jC
jC
jC
kC
jC
jC
jC
jC
jC
jC
jC
jC
jC
jC
jC
kC
jC
jC
kC
jC
jC
jC
jC
jC
kC
kC
jC
kC
kC
jC
jC
jC
jC
kC
jC
jC
kC
EW
al
zh
jC
Qv
mS
mS
mS
mS
Gq
"}
(16,1,1) = {"
Gq
Gq
mS
mS
mS
mS
mS
mS
mS
mS
mN
jC
EW
al
Xz
kC
jC
jC
jC
kC
jC
kC
jC
jC
jC
jC
jC
jC
jC
jC
jC
jC
jC
kC
jC
jC
kC
kC
jC
jC
jC
jC
jC
jC
jC
kC
kC
jC
jC
jC
kC
kC
jC
jC
jC
bv
al
zh
jC
Qv
mS
mS
mS
mS
Gq
"}
(17,1,1) = {"
Gq
mS
mS
mS
mS
mS
mS
mS
mS
mS
mN
jC
EW
al
zh
kC
jC
jC
kC
kC
jC
jC
jC
kC
jC
jC
jC
jC
jC
jC
jC
jC
kC
jC
jC
jC
jC
jC
kC
kC
jC
jC
jC
jC
jC
jC
kC
jC
jC
jC
kC
kC
jC
jC
jC
EW
al
zh
jC
Qv
mS
mS
mS
mS
Gq
"}
(18,1,1) = {"
Gq
Gq
mS
mS
mS
mS
mS
mS
mS
mS
mN
kC
EW
al
zh
jC
jC
jC
jC
jC
jC
jC
jC
jC
jC
jC
jC
jC
jC
jC
jC
jC
jC
jC
jC
jC
jC
jC
jC
kC
kC
kC
jC
jC
jC
jC
jC
jC
jC
jC
jC
jC
jC
jC
jC
EW
al
zh
jC
Qv
mS
mS
mS
mS
Gq
"}
(19,1,1) = {"
Gq
Gq
Gq
mS
mS
mS
mS
mS
mS
mS
mN
kC
EW
al
zh
rT
jC
jC
jC
jC
jC
jC
kC
jC
jC
jC
kC
jC
kC
kC
jC
jC
jC
jC
jC
jC
jC
jC
jC
jC
jC
jC
jC
jC
jC
jC
jC
kC
jC
jC
jC
jC
kC
jC
rT
EW
al
zh
kC
Qv
mS
mS
mS
Gq
Gq
"}
(20,1,1) = {"
Gq
mS
mS
mS
mS
mS
mS
mS
mS
mS
oL
jC
EW
al
zh
jC
jC
kC
jC
jC
jC
jC
jC
jC
jC
jC
kC
jC
jC
jC
kC
jC
jC
jC
jC
jC
jC
jC
jC
jC
jC
jC
jC
jC
jC
kC
jC
jC
kC
kC
jC
jC
jC
jC
jC
EW
al
zh
kC
Qv
mS
mS
mS
Gq
Gq
"}
(21,1,1) = {"
Gq
Gq
mS
mS
mS
mS
mS
mS
mS
mS
oL
jC
EW
al
zh
jC
kC
jC
jC
jC
jC
jC
jC
jC
jC
kC
jC
jC
jC
jC
jC
kC
jC
jC
jC
jC
jC
jC
kC
kC
jC
jC
jC
jC
jC
jC
jC
jC
jC
kC
jC
jC
jC
jC
jC
EW
al
zh
jC
Qv
mS
mS
mS
mS
Gq
"}
(22,1,1) = {"
Gq
Gq
mS
mS
mS
mS
mS
mS
mS
mS
oL
kC
EW
al
zh
jC
jC
jC
jC
jC
jC
jC
jC
jC
jC
jC
kC
jC
jC
jC
jC
jC
jC
jC
jC
kC
kC
jC
jC
kC
jC
jC
kC
jC
jC
jC
jC
jC
jC
jC
jC
jC
jC
jC
jC
EW
al
zh
jC
Qv
mS
mS
mS
mS
Gq
"}
(23,1,1) = {"
Gq
Gq
mS
mS
mS
mS
mS
mS
mS
mS
oL
jC
EW
al
zh
jC
jC
jC
jC
jC
jC
kC
jC
jC
jC
jC
jC
jC
jC
kC
jC
jC
jC
jC
jC
jC
kC
kC
jC
jC
jC
jC
jC
jC
jC
jC
jC
jC
jC
jC
jC
kC
jC
jC
jC
EW
al
zh
kC
Qv
mS
mS
mS
mS
Gq
"}
(24,1,1) = {"
Gq
mS
mS
mS
mS
mS
mS
mS
mS
mS
oL
jC
EW
al
Xz
rT
jC
jC
jC
jC
jC
jC
jC
jC
jC
jC
jC
jC
jC
kC
jC
jC
jC
jC
jC
jC
jC
kC
jC
jC
jC
jC
jC
jC
jC
jC
jC
kC
jC
jC
jC
kC
kC
jC
rT
bv
al
zh
kC
Qv
mS
mS
mS
Gq
Gq
"}
(25,1,1) = {"
Gq
mS
mS
mS
mS
mS
mS
mS
mS
mS
oL
kC
EW
al
zh
jC
jC
jC
jC
jC
jC
jC
jC
jC
jC
jC
jC
jC
jC
kC
jC
jC
jC
jC
jC
jC
jC
jC
jC
jC
jC
jC
kC
jC
jC
jC
jC
jC
jC
jC
jC
kC
kC
jC
kC
EW
al
zh
kC
Qv
mS
mS
Gq
Gq
Gq
"}
(26,1,1) = {"
Gq
mS
mS
mS
mS
mS
mS
mS
mS
mS
oL
kC
EW
al
zh
kC
jC
jC
jC
kC
jC
jC
jC
kC
kC
jC
jC
jC
jC
kC
jC
jC
jC
jC
jC
jC
jC
jC
jC
jC
jC
kC
jC
jC
jC
kC
jC
jC
jC
jC
jC
kC
kC
jC
kC
EW
al
zh
jC
Qv
Gq
Gq
Gq
Gq
Gq
"}
(27,1,1) = {"
Gq
mS
mS
mS
mS
mS
mS
mS
mS
mS
oL
jC
EW
al
zh
jC
jC
jC
jC
jC
kC
jC
kC
kC
kC
jC
kC
kC
jC
kC
kC
jC
jC
kC
jC
jC
jC
jC
jC
jC
jC
jC
jC
jC
jC
jC
jC
jC
jC
jC
jC
jC
jC
jC
kC
EW
al
zh
jC
Qv
mS
Gq
Gq
Gq
Gq
"}
(28,1,1) = {"
Gq
Gq
mS
mS
mS
mS
mS
mS
mS
mS
oL
jC
EW
al
zh
kC
jC
jC
jC
kC
kC
jC
jC
kC
kC
jC
jC
kC
jC
jC
kC
jC
jC
kC
jC
jC
jC
jC
jC
jC
kC
jC
jC
jC
jC
jC
jC
jC
kC
jC
jC
jC
jC
jC
kC
EW
al
zh
jC
Qv
mS
mS
Gq
Gq
Gq
"}
(29,1,1) = {"
Gq
mS
mS
mS
mS
mS
mS
mS
mS
mS
oL
kC
EW
al
zh
mv
jC
jC
jC
jC
jC
jC
jC
kC
jC
jC
jC
jC
jC
jC
jC
jC
jC
jC
jC
kC
jC
jC
jC
jC
kC
kC
jC
jC
jC
jC
jC
kC
kC
jC
jC
jC
jC
jC
rT
EW
al
zh
kC
Qv
mS
mS
mS
Gq
Gq
"}
(30,1,1) = {"
Gq
mS
mS
mS
mS
mS
mS
mS
mS
mS
oL
kC
EW
al
zh
kC
jC
jC
kC
jC
jC
jC
jC
jC
jC
jC
jC
jC
jC
jC
jC
jC
jC
jC
jC
kC
kC
jC
jC
jC
jC
kC
jC
jC
jC
jC
jC
kC
jC
jC
jC
jC
jC
jC
kC
EW
al
zh
kC
Qv
mS
mS
mS
Gq
Gq
"}
(31,1,1) = {"
Gq
Gq
mS
mS
mS
mS
mS
mS
mS
mS
oL
jC
EW
al
zh
jC
jC
jC
jC
kC
jC
jC
jC
jC
jC
jC
jC
jC
jC
jC
jC
jC
jC
jC
jC
jC
kC
jC
jC
jC
jC
jC
jC
jC
jC
jC
jC
jC
jC
jC
kC
jC
jC
jC
jC
EW
al
zh
kC
Qv
mS
mS
mS
Gq
Gq
"}
(32,1,1) = {"
Gq
Gq
mS
mS
mS
mS
mS
mS
mS
mS
oL
jC
EW
al
Xz
jC
jC
jC
jC
jC
jC
jC
jC
jC
kC
jC
jC
kC
jC
jC
jC
jC
kC
jC
jC
jC
kC
jC
jC
kC
kC
jC
jC
kC
jC
jC
jC
jC
jC
kC
kC
kC
jC
jC
kC
bv
al
zh
jC
Qv
mS
mS
mS
Gq
Gq
"}
(33,1,1) = {"
Gq
Gq
mS
mS
mS
mS
mS
mS
mS
mS
oL
jC
EW
al
zh
jC
jC
jC
jC
kC
jC
jC
jC
jC
jC
jC
jC
kC
jC
jC
jC
jC
jC
kC
jC
jC
jC
kC
kC
jC
jC
jC
jC
jC
jC
jC
jC
jC
jC
jC
kC
kC
jC
jC
kC
EW
al
zh
jC
Qv
mS
mS
mS
mS
Gq
"}
(34,1,1) = {"
Gq
mS
mS
mS
mS
mS
mS
mS
mS
mS
oL
kC
EW
al
zh
mv
jC
jC
kC
kC
kC
kC
jC
jC
jC
jC
jC
jC
kC
kC
jC
jC
kC
jC
jC
jC
jC
jC
jC
jC
jC
jC
kC
jC
jC
jC
jC
jC
jC
jC
jC
jC
jC
jC
mv
EW
al
zh
kC
Qv
mS
mS
mS
Gq
Gq
"}
(35,1,1) = {"
Gq
Gq
Gq
mS
mS
mS
mS
mS
mS
mS
oL
kC
EW
al
zh
jC
jC
jC
jC
jC
kC
jC
jC
jC
jC
jC
jC
jC
kC
jC
jC
jC
kC
jC
jC
jC
jC
jC
jC
jC
jC
jC
kC
jC
jC
kC
kC
kC
jC
jC
jC
jC
jC
jC
kC
EW
al
zh
jC
Qv
mS
mS
mS
Gq
Gq
"}
(36,1,1) = {"
Gq
Gq
Gq
Gq
mS
mS
mS
mS
mS
mS
oL
kC
EW
al
zh
jC
jC
jC
jC
jC
jC
jC
jC
jC
kC
jC
jC
kC
kC
jC
jC
jC
jC
jC
jC
jC
jC
jC
jC
jC
jC
kC
jC
jC
jC
kC
kC
kC
jC
jC
jC
jC
jC
jC
jC
EW
al
zh
jC
Qv
mS
mS
mS
Gq
Gq
"}
(37,1,1) = {"
Gq
Gq
mS
mS
mS
mS
mS
mS
mS
mS
oL
jC
EW
al
zh
jC
kC
jC
jC
jC
jC
jC
jC
jC
jC
jC
jC
kC
jC
jC
jC
jC
jC
jC
jC
jC
jC
jC
jC
jC
jC
jC
jC
jC
jC
jC
kC
jC
jC
jC
jC
kC
jC
jC
jC
EW
al
zh
kC
Qv
mS
mS
mS
Gq
Gq
"}
(38,1,1) = {"
Gq
Gq
mS
mS
mS
mS
mS
mS
mS
mS
oL
kC
EW
al
zh
jC
jC
jC
jC
jC
jC
kC
kC
jC
jC
jC
jC
kC
jC
jC
kC
jC
jC
jC
jC
jC
kC
kC
jC
jC
jC
jC
kC
kC
jC
jC
jC
jC
jC
jC
kC
kC
jC
jC
kC
EW
al
zh
jC
Qv
mS
mS
mS
Gq
Gq
"}
(39,1,1) = {"
Gq
mS
mS
mS
mS
mS
mS
mS
mS
mS
oL
jC
EW
al
zh
mv
jC
jC
jC
jC
kC
jC
jC
jC
jC
jC
jC
jC
jC
jC
jC
jC
jC
kC
jC
jC
jC
jC
jC
jC
jC
jC
kC
jC
jC
jC
jC
jC
jC
kC
kC
jC
jC
jC
mv
EW
al
zh
jC
Qv
mS
mS
mS
mS
Gq
"}
(40,1,1) = {"
Gq
mS
mS
mS
mS
mS
mS
mS
mS
mS
mN
kC
EW
al
Xz
kC
jC
jC
jC
jC
jC
jC
jC
jC
jC
kC
jC
jC
jC
jC
jC
jC
jC
jC
kC
kC
kC
kC
kC
jC
jC
jC
jC
jC
jC
jC
jC
jC
jC
kC
kC
jC
jC
jC
jC
bv
al
zh
jC
Qv
mS
mS
Gq
Gq
Gq
"}
(41,1,1) = {"
Gq
Gq
mS
mS
mS
mS
mS
mS
mS
mS
mN
kC
EW
al
zh
kC
jC
jC
jC
jC
jC
jC
jC
jC
jC
jC
kC
jC
jC
jC
jC
jC
jC
jC
jC
jC
jC
jC
jC
jC
jC
jC
jC
jC
jC
jC
jC
jC
jC
jC
kC
jC
jC
jC
jC
EW
al
zh
jC
Qv
mS
mS
Gq
Gq
Gq
"}
(42,1,1) = {"
Gq
Gq
mS
mS
mS
mS
mS
mS
mS
mS
mN
jC
EW
al
zh
jC
jC
jC
jC
kC
jC
jC
jC
jC
jC
jC
jC
jC
jC
kC
kC
kC
jC
jC
jC
jC
jC
jC
jC
jC
jC
kC
jC
jC
jC
kC
jC
jC
jC
jC
jC
jC
jC
jC
kC
EW
al
zh
kC
Qv
mS
mS
mS
Gq
Gq
"}
(43,1,1) = {"
Gq
mS
mS
mS
mS
mS
mS
mS
mS
mS
mN
kC
EW
al
zh
jC
jC
jC
jC
jC
jC
jC
kC
kC
kC
jC
jC
jC
jC
kC
jC
jC
jC
jC
jC
jC
jC
jC
jC
jC
jC
kC
jC
jC
jC
kC
kC
jC
jC
jC
jC
jC
jC
kC
jC
EW
al
zh
jC
Qv
mS
mS
mS
Gq
Gq
"}
(44,1,1) = {"
Gq
mS
mS
mS
mS
mS
mS
mS
mS
mS
mN
kC
EW
al
zh
rT
jC
jC
jC
jC
jC
jC
jC
kC
kC
jC
jC
jC
jC
jC
kC
jC
jC
jC
jC
jC
jC
jC
jC
kC
jC
kC
jC
jC
jC
kC
kC
jC
jC
jC
jC
jC
jC
kC
rT
EW
al
zh
jC
Qv
mS
mS
mS
Gq
Gq
"}
(45,1,1) = {"
Gq
mS
mS
mS
mS
mS
mS
mS
mS
mS
mN
jC
EW
al
zh
jC
jC
jC
jC
jC
kC
kC
kC
kC
jC
jC
kC
jC
jC
jC
kC
jC
jC
jC
jC
kC
kC
jC
jC
jC
jC
jC
jC
jC
jC
kC
kC
kC
jC
jC
jC
jC
jC
kC
kC
EW
al
zh
jC
Qv
mS
mS
mS
Gq
Gq
"}
(46,1,1) = {"
Gq
Gq
mS
mS
mS
mS
mS
mS
mS
mS
mN
jC
EW
al
Xz
jC
jC
jC
jC
jC
jC
jC
jC
jC
jC
jC
jC
jC
jC
kC
jC
jC
jC
kC
kC
kC
kC
jC
kC
jC
jC
jC
jC
jC
jC
jC
kC
jC
kC
jC
jC
jC
jC
jC
kC
bv
al
zh
jC
Qv
mS
mS
mS
Gq
Gq
"}
(47,1,1) = {"
Gq
mS
mS
mS
mS
mS
mS
mS
mS
mS
mN
kC
EW
al
zh
kC
jC
jC
kC
jC
jC
jC
jC
jC
jC
jC
jC
jC
kC
jC
jC
jC
jC
jC
kC
jC
jC
jC
jC
jC
jC
jC
jC
kC
jC
jC
kC
kC
kC
jC
jC
jC
jC
jC
kC
EW
al
zh
kC
Qv
mS
mS
mS
Gq
Gq
"}
(48,1,1) = {"
Gq
Gq
mS
mS
mS
mS
mS
mS
mS
mS
mN
kC
EW
al
zh
kC
kC
jC
jC
kC
kC
jC
jC
jC
jC
jC
jC
jC
kC
jC
jC
jC
jC
jC
jC
jC
jC
jC
jC
jC
jC
jC
kC
kC
jC
jC
jC
jC
jC
jC
jC
jC
kC
jC
jC
EW
Ti
zh
kC
Qv
mS
mS
mS
mS
Gq
"}
(49,1,1) = {"
Gq
Gq
mS
mS
mS
mS
mS
mS
mS
mS
mN
jC
EW
al
zh
mv
kC
jC
jC
jC
jC
jC
jC
jC
jC
jC
jC
jC
jC
jC
jC
jC
jC
jC
jC
jC
jC
kC
kC
jC
kC
jC
jC
jC
jC
jC
jC
jC
jC
jC
jC
kC
jC
jC
mv
EW
al
zh
kC
Qv
mS
mS
mS
mS
Gq
"}
(50,1,1) = {"
Gq
Gq
mS
mS
mS
mS
mS
mS
mS
mS
mN
jC
EW
al
zh
kC
kC
kC
kC
jC
jC
jC
jC
jC
jC
jC
jC
jC
jC
jC
kC
jC
jC
jC
jC
jC
kC
kC
jC
jC
jC
jC
jC
jC
jC
jC
jC
jC
jC
jC
jC
jC
jC
jC
kC
EW
al
zh
jC
Qv
mS
mS
mS
mS
Gq
"}
(51,1,1) = {"
Gq
Gq
mS
mS
mS
mS
mS
mS
mS
mS
mN
kC
EW
al
zh
kC
kC
kC
kC
kC
kC
kC
kC
jC
jC
jC
jC
jC
jC
jC
jC
jC
jC
jC
jC
jC
jC
jC
jC
jC
jC
jC
jC
jC
jC
kC
jC
jC
jC
jC
jC
jC
jC
kC
kC
EW
al
zh
jC
Qv
mS
mS
mS
mS
Gq
"}
(52,1,1) = {"
Gq
mS
mS
mS
mS
mS
mS
mS
mS
mS
mN
jC
EW
al
mJ
XW
XW
XW
XW
XW
XW
XW
XW
XW
XW
XW
XW
XW
XW
XW
XW
XW
XW
XW
XW
XW
XW
XW
XW
XW
XW
XW
XW
XW
XW
XW
XW
XW
XW
XW
XW
XW
XW
XW
XW
eM
al
zh
jC
Qv
mS
mS
mS
mS
Gq
"}
(53,1,1) = {"
Gq
Gq
mS
mS
mS
mS
mS
mS
mS
mS
mN
yh
EW
al
al
al
al
al
al
al
al
al
al
al
al
al
al
al
al
al
al
al
al
fC
Mp
yH
al
al
al
al
al
al
al
al
al
al
al
al
al
al
al
al
al
al
al
al
al
zh
yh
Qv
mS
mS
mS
mS
Gq
"}
(54,1,1) = {"
Gq
mS
mS
mS
mS
mS
mS
mS
mS
yh
yh
yh
Py
qh
qh
qh
kx
qh
qh
qh
qh
qh
kx
qh
qh
qh
qh
qh
Iu
vw
vw
vw
vw
mB
YG
HC
vw
vw
vw
vw
Hd
qh
qh
qh
qh
qh
qh
kx
qh
qh
qh
qh
qh
kx
qh
qh
qh
ar
yh
yh
yh
mS
mS
mS
Gq
"}
(55,1,1) = {"
yh
yh
yh
mS
mS
mS
mS
mS
mS
mS
mS
yh
yh
yh
jC
jC
jC
kC
jC
jC
kC
kC
jC
kC
jC
jC
kC
kC
EW
vw
VB
vw
vw
vw
CD
vw
vw
vw
VB
vw
zh
jC
kC
jC
jC
jC
kC
jC
jC
kC
kC
jC
jC
kC
kC
jC
yh
yh
yh
mS
mS
mS
yh
yh
yh
"}
(56,1,1) = {"
qW
qW
yh
mS
mS
mS
mS
mS
mS
mS
mS
mS
yh
qG
qG
qG
qG
qG
qG
qG
qG
qG
qG
qG
qG
qG
qG
qG
yh
uB
uB
uB
yh
uB
uB
yA
yh
uB
uB
uB
yh
qG
qG
qG
qG
qG
qG
qG
qG
qG
qG
qG
qG
qG
qG
qG
qG
yh
mS
mS
mS
mS
yh
qW
qW
"}
(57,1,1) = {"
CG
CG
ac
CG
CG
CG
CG
CG
CG
CG
CG
CG
CG
CG
CG
CG
CG
CG
CG
CG
CG
CG
CG
CG
CG
CG
CG
CG
yh
We
We
QN
yh
cI
dM
dM
yh
QN
We
We
yh
CG
CG
CG
CG
CG
CG
CG
CG
CG
CG
CG
CG
CG
CG
CG
CG
CG
CG
CG
CG
CG
ac
CG
CG
"}
(58,1,1) = {"
qW
qW
ac
mS
mS
mS
mS
mS
mS
mS
mS
mS
mS
mS
mS
mS
mS
mS
mS
mS
mS
mS
mS
mS
mS
mS
mS
mS
yh
qW
qW
qW
yh
qW
qW
lR
yh
qW
qW
qW
yh
mS
mS
mS
mS
mS
mS
mS
mS
mS
mS
mS
mS
mS
mS
mS
mS
mS
mS
mS
mS
mS
ac
qW
qW
"}
(59,1,1) = {"
qW
qW
ac
mS
mS
mS
mS
mS
mS
mS
mS
mS
mS
mS
mS
mS
mS
mS
mS
mS
mS
mS
mS
mS
mS
mS
mS
mS
yh
qW
qW
qW
yh
qW
qW
qW
yh
qW
qW
qW
yh
mS
mS
mS
mS
mS
mS
mS
mS
mS
mS
mS
mS
mS
mS
mS
mS
mS
mS
mS
mS
mS
ac
qW
qW
"}
(60,1,1) = {"
qW
qW
ac
mS
mS
mS
mS
mS
mS
mS
mS
mS
mS
mS
mS
mS
mS
mS
mS
mS
mS
mS
mS
mS
mS
mS
mS
mS
yh
qW
qW
qW
yh
qW
qW
qW
yh
qW
qW
qW
yh
mS
mS
mS
mS
mS
mS
mS
mS
mS
mS
mS
mS
mS
mS
mS
mS
mS
mS
mS
mS
mS
ac
qW
qW
"}
(61,1,1) = {"
CG
CG
ac
CG
CG
CG
CG
CG
CG
CG
CG
CG
CG
CG
CG
CG
CG
CG
CG
CG
CG
CG
CG
CG
CG
CG
CG
CG
yh
ur
yh
ur
yh
AL
yh
AL
yh
ur
yh
ur
yh
CG
CG
CG
CG
CG
CG
CG
CG
CG
CG
CG
CG
CG
CG
CG
CG
CG
CG
CG
CG
CG
ac
CG
CG
"}
(62,1,1) = {"
qW
qW
yh
mS
mS
mS
mS
mS
mS
mS
mS
mS
mS
mS
mS
mS
mS
mS
mS
mS
mS
mS
mS
mS
mS
mS
mS
Fj
yh
IP
mS
mS
mS
mS
mS
mS
mS
mS
mS
Fj
yh
IP
mS
mS
mS
mS
mS
mS
mS
mS
mS
mS
mS
mS
mS
mS
mS
mS
mS
mS
mS
mS
yh
qW
qW
"}
(63,1,1) = {"
yh
yh
yh
mS
mS
mS
mS
mS
mS
mS
mS
mS
mS
mS
mS
mS
mS
mS
mS
mS
mS
mS
mS
mS
mS
mS
mS
qk
Rz
QJ
mS
mS
mS
mS
mS
mS
mS
mS
mS
qk
Rz
QJ
mS
mS
mS
mS
mS
mS
mS
mS
mS
mS
mS
mS
mS
mS
mS
mS
mS
mS
mS
mS
yh
yh
yh
"}
(64,1,1) = {"
Gq
Gq
mS
mS
mS
mS
mS
mS
mS
mS
mS
mS
mS
mS
mS
mS
mS
mS
mS
mS
mS
mS
mS
mS
mS
mS
mS
mS
mS
mS
mS
mS
mS
mS
mS
mS
mS
mS
mS
mS
mS
mS
mS
mS
mS
mS
mS
mS
mS
mS
mS
mS
mS
mS
mS
mS
mS
mS
mS
mS
mS
mS
mS
mS
Gq
"}
(65,1,1) = {"
Gq
Gq
Gq
mS
mS
mS
Gq
mS
mS
mS
mS
mS
mS
mS
mS
mS
mS
mS
mS
mS
mS
mS
mS
mS
mS
mS
mS
mS
mS
mS
mS
mS
mS
mS
mS
mS
mS
mS
mS
mS
mS
mS
mS
mS
mS
mS
mS
mS
mS
mS
mS
mS
mS
mS
mS
mS
mS
mS
mS
mS
mS
mS
mS
mS
Gq
"}
(66,1,1) = {"
Gq
Gq
Gq
Gq
mS
Gq
Gq
mS
mS
mS
mS
mS
mS
mS
mS
mS
mS
mS
mS
mS
mS
mS
mS
mS
mS
mS
mS
mS
mS
mS
mS
mS
mS
mS
mS
mS
mS
mS
mS
mS
mS
mS
mS
mS
mS
mS
mS
mS
mS
mS
mS
mS
mS
mS
mS
mS
mS
mS
mS
Gq
Gq
mS
mS
Gq
Gq
"}
(67,1,1) = {"
Gq
Gq
Gq
Gq
Gq
mS
mS
mS
mS
mS
mS
mS
mS
mS
mS
mS
mS
mS
mS
mS
mS
mS
mS
mS
mS
mS
mS
mS
mS
mS
mS
mS
mS
mS
mS
mS
mS
mS
mS
mS
mS
mS
mS
mS
mS
mS
mS
mS
mS
Gq
mS
mS
mS
mS
mS
mS
mS
mS
mS
mS
Gq
mS
mS
Gq
Gq
"}
(68,1,1) = {"
Gq
Gq
Gq
Gq
Gq
Gq
mS
mS
mS
mS
mS
mS
mS
mS
mS
mS
mS
mS
mS
Gq
Gq
mS
mS
mS
mS
mS
mS
mS
mS
mS
mS
mS
mS
mS
mS
mS
mS
mS
mS
mS
mS
mS
mS
mS
mS
mS
mS
Gq
Gq
Gq
Gq
mS
mS
mS
mS
mS
mS
mS
mS
mS
mS
mS
Gq
Gq
Gq
"}
(69,1,1) = {"
Gq
Gq
Gq
Gq
Gq
Gq
Gq
mS
mS
Gq
Gq
Gq
mS
mS
mS
mS
mS
mS
Gq
Gq
Gq
Gq
Gq
Gq
mS
Gq
Gq
mS
Gq
mS
mS
mS
mS
mS
mS
mS
mS
mS
Gq
Gq
Gq
mS
mS
mS
Gq
Gq
Gq
Gq
Gq
Gq
Gq
Gq
Gq
Gq
mS
mS
mS
mS
Gq
Gq
Gq
Gq
Gq
Gq
Gq
"}
(70,1,1) = {"
Gq
Gq
Gq
Gq
Gq
Gq
Gq
Gq
Gq
Gq
Gq
Gq
Gq
Gq
Gq
Gq
Gq
Gq
Gq
Gq
Gq
Gq
Gq
Gq
Gq
Gq
Gq
Gq
Gq
Gq
Gq
Gq
Gq
Gq
Gq
Gq
Gq
Gq
Gq
Gq
Gq
Gq
Gq
Gq
Gq
Gq
Gq
Gq
Gq
Gq
Gq
Gq
Gq
Gq
Gq
Gq
Gq
Gq
Gq
Gq
Gq
Gq
Gq
Gq
Gq
"}
