//MAP CONVERTED BY dmm2tgm.py THIS HEADER COMMENT PREVENTS RECONVERSION, DO NOT REMOVE
"bb" = (
/obj/effect/turf_decal/corner/opaque/tan{
	dir = 10
	},
/obj/effect/turf_decal/trimline/opaque/bar/line,
/obj/effect/landmark/outpost/shaft_number,
/turf/open/floor/plasteel/tech/ngr_outpost_outside,
/area/hangar)
"bD" = (
/obj/machinery/light/dim/directional/north,
/obj/machinery/conveyor/auto/outpost{
	dir = 8
	},
/obj/structure/railing/thin/corner,
/turf/open/floor/plasteel/tech/ngr_outpost_outside,
/area/hangar)
"cL" = (
/obj/structure/disposalpipe/trunk{
	dir = 4
	},
/obj/machinery/conveyor/auto/outpost{
	dir = 1
	},
/obj/structure/disposaloutlet{
	dir = 1
	},
/turf/open/floor/plasteel/tech/ngr_outpost_outside,
/area/hangar)
"ee" = (
/obj/structure/plasticflaps/outpost,
/obj/machinery/conveyor/auto/outpost{
	dir = 8
	},
/turf/open/floor/plasteel/tech/ngr_outpost_outside,
/area/hangar)
"fv" = (
/obj/effect/turf_decal/corner/opaque/tan{
	dir = 8
	},
/obj/effect/turf_decal/trimline/opaque/bar/corner{
	dir = 8
	},
/turf/open/floor/plasteel/tech/ngr_outpost_outside,
/area/hangar)
"gg" = (
/obj/effect/turf_decal/corner/opaque/tan{
	dir = 1
	},
/obj/effect/turf_decal/trimline/opaque/bar/corner{
	dir = 1
	},
/turf/open/floor/plasteel/tech/ngr_outpost_outside,
/area/hangar)
"gq" = (
/obj/structure/sign/departments/cargo,
/turf/closed/indestructible/plastitanium/nodiagnonal,
/area/hangar)
"gu" = (
/obj/machinery/conveyor/auto/outpost{
	dir = 6;
	verted = -1
	},
/turf/open/floor/plasteel/tech/ngr_outpost_outside,
/area/hangar)
"gD" = (
/obj/effect/turf_decal/techfloor{
	dir = 8
	},
/obj/effect/turf_decal/borderfloorblack{
	dir = 4
	},
/turf/open/floor/plasteel/tech/ngr_outpost_outside,
/area/hangar)
"hg" = (
/obj/machinery/disposal/deliveryChute{
	dir = 1
	},
/obj/structure/disposalpipe/trunk{
	dir = 8
	},
/turf/open/floor/plasteel/tech/ngr_outpost_outside,
/area/hangar)
"hv" = (
/obj/effect/turf_decal/corner/opaque/tan{
	dir = 5
	},
/obj/effect/turf_decal/trimline/opaque/bar/line{
	dir = 1
	},
/obj/machinery/light/floor/hangar,
/turf/open/floor/plasteel/tech/ngr_outpost_outside,
/area/hangar)
"iC" = (
/obj/effect/turf_decal/corner/opaque/tan{
	dir = 5
	},
/obj/effect/turf_decal/trimline/opaque/bar/line{
	dir = 1
	},
/turf/open/floor/plasteel/tech/ngr_outpost_outside,
/area/hangar)
"jA" = (
/obj/structure/catwalk/over/plated_catwalk/dark,
/turf/open/floor/hangar,
/area/hangar)
"kE" = (
/obj/structure/flora/rock/pile/rockplanet,
/turf/open/floor/plating/asteroid/rockplanet/cracked/safe/lit/ngr_outpost_outside,
/area/hangar)
"lf" = (
/obj/structure/flora/grass/rockplanet/dead,
/turf/open/floor/plating/asteroid/rockplanet/cracked/safe/lit/ngr_outpost_outside,
/area/hangar)
"lp" = (
/obj/machinery/door/poddoor/ert,
/turf/open/floor/plasteel/elevatorshaft{
	planetary_atmos = 1
	},
/area/hangar)
"lG" = (
/obj/effect/turf_decal/techfloor{
	dir = 8
	},
/obj/structure/rack,
/obj/item/clothing/suit/hooded/wintercoat,
/obj/item/clothing/suit/hooded/wintercoat,
/obj/item/clothing/suit/hooded/wintercoat,
/obj/item/clothing/suit/hooded/wintercoat,
/obj/item/clothing/suit/hooded/wintercoat,
/obj/effect/turf_decal/borderfloorblack{
	dir = 4
	},
/turf/open/floor/plasteel/tech/ngr_outpost_outside,
/area/hangar)
"nF" = (
/obj/machinery/conveyor/auto/outpost{
	dir = 10
	},
/obj/structure/railing/thin,
/turf/open/floor/plasteel/tech/ngr_outpost_outside,
/area/hangar)
"oA" = (
/obj/effect/turf_decal/trimline/opaque/yellow/warning{
	dir = 8
	},
/turf/open/floor/plasteel/tech/ngr_outpost_outside,
/area/hangar)
"pu" = (
/obj/effect/landmark/outpost/hangar_dock,
/turf/open/floor/hangar,
/area/hangar)
"qq" = (
/turf/open/floor/plasteel/elevatorshaft{
	planetary_atmos = 1
	},
/area/hangar)
"rk" = (
/obj/effect/turf_decal/industrial/loading/stripes/red,
/turf/open/floor/plasteel/tech/ngr_outpost_outside,
/area/hangar)
"rA" = (
/turf/closed/indestructible/rock/rockplanet,
/area/hangar)
"sr" = (
/obj/structure/flora/rock/rockplanet,
/turf/open/floor/plating/asteroid/rockplanet/safe/lit/ngr_outpost_outside,
/area/hangar)
"sE" = (
/turf/open/floor/plating/asteroid/rockplanet/safe/lit/ngr_outpost_outside,
/area/hangar)
"sP" = (
/turf/open/floor/plasteel/tech/ngr_outpost_outside,
/area/hangar)
"tA" = (
/obj/effect/landmark/outpost/elevator_machine,
/obj/machinery/elevator_call_button{
	pixel_y = 25
	},
/obj/effect/turf_decal/techfloor{
	dir = 4
	},
/obj/effect/turf_decal/borderfloorblack{
	layer = 2.030;
	dir = 8
	},
/turf/open/floor/plasteel/tech/ngr_outpost_outside,
/area/hangar)
"uV" = (
/obj/structure/disposalpipe/segment{
	dir = 4
	},
/turf/closed/indestructible/plastitanium/nodiagnonal,
/area/hangar)
"vQ" = (
/obj/structure/flora/rock/pile/rockplanet,
/turf/open/floor/plating/asteroid/rockplanet/safe/lit/ngr_outpost_outside,
/area/hangar)
"wA" = (
/obj/structure/chair/bench/red/directional/south,
/turf/open/floor/plasteel/tech/ngr_outpost_outside,
/area/hangar)
"xj" = (
/obj/effect/turf_decal/borderfloorblack,
/turf/open/floor/plasteel/tech/ngr_outpost_outside,
/area/hangar)
"xL" = (
/turf/open/floor/plating/asteroid/rockplanet/cracked/safe/lit/ngr_outpost_outside,
/area/hangar)
"yh" = (
/obj/effect/turf_decal/industrial/outline/red,
/turf/open/floor/plasteel/tech/ngr_outpost_outside,
/area/hangar)
"zN" = (
/obj/structure/flora/grass/rockplanet/dead,
/turf/open/floor/plating/asteroid/rockplanet/safe/lit/ngr_outpost_outside,
/area/hangar)
"zT" = (
/obj/effect/turf_decal/corner/opaque/tan{
	dir = 10
	},
/obj/effect/turf_decal/trimline/opaque/bar/line,
/obj/effect/landmark/outpost/hangar_numbers{
	pixel_x = 0;
	pixel_y = 0
	},
/turf/open/floor/plasteel/tech/ngr_outpost_outside,
/area/hangar)
"Ab" = (
/obj/effect/turf_decal/arrows{
	dir = 1
	},
/turf/open/floor/plasteel/tech/ngr_outpost_outside,
/area/hangar)
"Ad" = (
/obj/machinery/door/poddoor/ert,
/turf/closed/indestructible/plastitanium/nodiagnonal,
/area/hangar)
"Aw" = (
/obj/machinery/conveyor/auto/outpost{
	dir = 8
	},
/obj/structure/railing/thin,
/turf/open/floor/plasteel/tech/ngr_outpost_outside,
/area/hangar)
"AF" = (
/obj/effect/turf_decal/corner/opaque/tan/three_quarters,
/obj/effect/turf_decal/trimline/opaque/bar/line{
	dir = 6
	},
/turf/open/floor/plasteel/tech/ngr_outpost_outside,
/area/hangar)
"AS" = (
/obj/structure/chair/bench/red/directional/south,
/obj/structure/sign/poster/contraband/random{
	pixel_y = 32
	},
/turf/open/floor/plasteel/tech/ngr_outpost_outside,
/area/hangar)
"DF" = (
/obj/structure/plasticflaps/outpost,
/obj/machinery/conveyor/auto/outpost{
	dir = 5;
	verted = -1
	},
/turf/open/floor/plasteel/tech/ngr_outpost_outside,
/area/hangar)
"DR" = (
/obj/effect/turf_decal/corner/opaque/tan{
	dir = 9
	},
/turf/open/floor/plasteel/tech/ngr_outpost_outside,
/area/hangar)
"DU" = (
/obj/effect/turf_decal/corner/opaque/tan{
	dir = 6
	},
/obj/effect/turf_decal/trimline/opaque/bar/line{
	dir = 4
	},
/turf/open/floor/plasteel/tech/ngr_outpost_outside,
/area/hangar)
"Ef" = (
/obj/effect/turf_decal/corner/opaque/tan/three_quarters{
	dir = 8
	},
/obj/effect/turf_decal/trimline/opaque/bar/line{
	dir = 5
	},
/turf/open/floor/plasteel/tech/ngr_outpost_outside,
/area/hangar)
"EA" = (
/obj/effect/turf_decal/corner/opaque/tan{
	dir = 9
	},
/obj/effect/turf_decal/trimline/opaque/bar/line{
	dir = 8
	},
/turf/open/floor/plasteel/tech/ngr_outpost_outside,
/area/hangar)
"Fl" = (
/obj/effect/turf_decal/corner/opaque/tan{
	dir = 4
	},
/obj/effect/turf_decal/trimline/opaque/bar/corner{
	dir = 4
	},
/turf/open/floor/plasteel/tech/ngr_outpost_outside,
/area/hangar)
"Fo" = (
/obj/effect/turf_decal/corner/opaque/tan/three_quarters{
	dir = 4
	},
/obj/effect/turf_decal/trimline/opaque/bar/filled/shrink_ccw{
	dir = 1
	},
/turf/open/floor/plasteel/tech/ngr_outpost_outside,
/area/hangar)
"Fy" = (
/obj/effect/turf_decal/industrial/hatch/red,
/turf/open/floor/plasteel/tech/ngr_outpost_outside,
/area/hangar)
"He" = (
/obj/machinery/conveyor/auto/outpost,
/obj/effect/landmark/outpost/hangar_crate_spawner,
/turf/open/floor/plasteel/tech/ngr_outpost_outside,
/area/hangar)
"Hy" = (
/obj/structure/flora/tree/cactus,
/turf/open/floor/plating/asteroid/rockplanet/cracked/safe/lit/ngr_outpost_outside,
/area/hangar)
"HK" = (
/obj/effect/turf_decal/corner/opaque/tan/three_quarters{
	dir = 1
	},
/obj/effect/turf_decal/trimline/opaque/bar/line{
	dir = 10
	},
/turf/open/floor/plasteel/tech/ngr_outpost_outside,
/area/hangar)
"Kt" = (
/obj/effect/turf_decal/borderfloorblack{
	layer = 2.030
	},
/turf/open/floor/plasteel/tech/ngr_outpost_outside,
/area/hangar)
"Mf" = (
/turf/open/floor/plasteel/stairs/mid{
	dir = 1;
	color = "#2e2e2e"
	},
/area/hangar)
"Mh" = (
/turf/open/floor/hangar,
/area/hangar)
"MT" = (
/obj/structure/flora/tree/cactus,
/turf/open/floor/plating/asteroid/rockplanet/safe/lit/ngr_outpost_outside,
/area/hangar)
"Nt" = (
/obj/effect/turf_decal/trimline/opaque/yellow/warning{
	dir = 4
	},
/turf/open/floor/plasteel/tech/ngr_outpost_outside,
/area/hangar)
"OM" = (
/obj/machinery/conveyor/auto/outpost{
	dir = 8
	},
/turf/open/floor/plasteel/tech/ngr_outpost_outside,
/area/hangar)
"Ps" = (
/obj/machinery/conveyor/auto/outpost,
/obj/structure/plasticflaps/outpost,
/turf/open/floor/plasteel/tech/ngr_outpost_outside,
/area/hangar)
"Qx" = (
/obj/machinery/light/floor/hangar,
/turf/open/floor/plasteel/tech/ngr_outpost_outside,
/area/hangar)
"Qz" = (
/obj/effect/turf_decal/corner/opaque/tan{
	dir = 6
	},
/obj/effect/turf_decal/trimline/opaque/bar/line{
	dir = 4
	},
/obj/structure/sign/directions/supply{
	dir = 1;
	pixel_x = 32;
	pixel_y = -5;
	desc = "A direction sign, pointing out which way the Cargo Delivery Chute is."
	},
/turf/open/floor/plasteel/tech/ngr_outpost_outside,
/area/hangar)
"Ry" = (
/obj/machinery/light/floor/hangar,
/obj/effect/turf_decal/corner/opaque/tan{
	dir = 6
	},
/obj/effect/turf_decal/trimline/opaque/bar/line{
	dir = 4
	},
/turf/open/floor/plasteel/tech/ngr_outpost_outside,
/area/hangar)
"Se" = (
/obj/effect/landmark/outpost/elevator,
/turf/open/floor/plasteel/elevatorshaft{
	planetary_atmos = 1
	},
/area/hangar)
"Sm" = (
/obj/effect/turf_decal/corner/opaque/tan/three_quarters{
	dir = 4
	},
/obj/effect/turf_decal/trimline/opaque/bar/line{
	dir = 9
	},
/turf/open/floor/plasteel/tech/ngr_outpost_outside,
/area/hangar)
"Vk" = (
/obj/effect/turf_decal/techfloor{
	dir = 1
	},
/obj/effect/turf_decal/borderfloorblack,
/turf/open/floor/plasteel/tech/ngr_outpost_outside,
/area/hangar)
"VT" = (
/obj/effect/turf_decal/techfloor{
	dir = 4
	},
/obj/effect/turf_decal/borderfloorblack{
	layer = 2.030;
	dir = 8
	},
/turf/open/floor/plasteel/tech/ngr_outpost_outside,
/area/hangar)
"VW" = (
/obj/structure/flora/rock/rockplanet,
/turf/open/floor/plating/asteroid/rockplanet/cracked/safe/lit/ngr_outpost_outside,
/area/hangar)
"Xb" = (
/obj/structure/marker_beacon{
	picked_color = "Teal"
	},
/turf/open/floor/hangar,
/area/hangar)
"Xp" = (
/obj/effect/turf_decal/techfloor{
	dir = 1;
	layer = 2.04
	},
/obj/effect/turf_decal/techfloor,
/obj/machinery/door/airlock/grunge,
/obj/effect/landmark/outpost/elevator_machine,
/turf/open/floor/plasteel/tech/grid,
/area/hangar)
"Yb" = (
/obj/machinery/light/floor/hangar,
/obj/effect/turf_decal/corner/opaque/tan{
	dir = 10
	},
/obj/effect/turf_decal/trimline/opaque/bar/line,
/turf/open/floor/plasteel/tech/ngr_outpost_outside,
/area/hangar)
"YM" = (
/obj/effect/turf_decal/corner/opaque/tan/three_quarters{
	dir = 1
	},
/obj/effect/turf_decal/trimline/opaque/bar/filled/shrink_cw{
	layer = 2.032
	},
/turf/open/floor/plasteel/tech/ngr_outpost_outside,
/area/hangar)
"YS" = (
/turf/closed/indestructible/plastitanium/nodiagnonal,
/area/hangar)
"YZ" = (
/obj/structure/catwalk/over/plated_catwalk/dark,
/obj/machinery/light/floor/hangar,
/turf/open/floor/hangar,
/area/hangar)
"Zh" = (
/obj/effect/turf_decal/corner/opaque/tan{
	dir = 10
	},
/obj/effect/turf_decal/trimline/opaque/bar/line,
/turf/open/floor/plasteel/tech/ngr_outpost_outside,
/area/hangar)

(1,1,1) = {"
rA
rA
rA
rA
rA
rA
rA
rA
rA
rA
rA
rA
rA
rA
rA
rA
rA
rA
rA
rA
rA
rA
rA
rA
rA
rA
rA
rA
rA
rA
rA
rA
rA
rA
rA
rA
rA
rA
rA
"}
(2,1,1) = {"
rA
rA
rA
rA
rA
rA
rA
rA
rA
rA
rA
rA
rA
rA
rA
rA
rA
rA
rA
rA
rA
rA
rA
rA
rA
rA
rA
rA
rA
rA
rA
rA
rA
rA
rA
rA
rA
rA
rA
"}
(3,1,1) = {"
rA
rA
rA
rA
rA
rA
rA
rA
rA
rA
rA
rA
rA
rA
rA
rA
rA
rA
rA
rA
rA
rA
rA
rA
rA
rA
rA
rA
rA
rA
rA
rA
rA
rA
rA
rA
rA
rA
rA
"}
(4,1,1) = {"
rA
rA
rA
rA
rA
rA
rA
rA
rA
Fo
DR
YM
oA
oA
oA
oA
oA
oA
oA
oA
oA
oA
oA
oA
oA
oA
oA
oA
oA
oA
oA
oA
Fo
DR
YM
rA
rA
rA
rA
"}
(5,1,1) = {"
rA
rA
rA
rA
rA
rA
rA
rA
rA
iC
jA
Zh
sP
sP
Ab
sP
Qx
sP
sP
Ab
sP
sP
sP
sP
Ab
sP
Qx
sP
sP
Ab
sP
sP
iC
jA
Zh
xL
rA
rA
rA
"}
(6,1,1) = {"
rA
rA
rA
rA
rA
rA
rA
rA
rA
iC
jA
Zh
Nt
Nt
Nt
Nt
Nt
Nt
Nt
Nt
Nt
Nt
Nt
Nt
Nt
Nt
Nt
Nt
Nt
Nt
Nt
Nt
iC
jA
Zh
lf
rA
rA
rA
"}
(7,1,1) = {"
rA
rA
rA
rA
rA
rA
rA
rA
kE
iC
jA
Zh
Mh
Mh
Mh
Mh
Mh
Mh
Mh
Mh
Mh
Mh
Mh
Mh
Mh
Mh
Mh
Mh
Mh
Mh
Mh
pu
iC
jA
Zh
xL
rA
rA
rA
"}
(8,1,1) = {"
rA
rA
rA
rA
rA
rA
rA
rA
xL
iC
jA
Zh
Mh
Mh
Mh
Mh
Mh
Mh
Mh
Mh
Mh
Mh
Mh
Mh
Mh
Mh
Mh
Mh
Mh
Mh
Mh
Mh
iC
jA
Zh
sr
rA
rA
rA
"}
(9,1,1) = {"
rA
rA
rA
rA
rA
rA
rA
rA
lf
iC
jA
Zh
Xb
Mh
Mh
Mh
Mh
Mh
Mh
Mh
Mh
Mh
Mh
Mh
Mh
Mh
Mh
Mh
Mh
Mh
Mh
Xb
iC
jA
Zh
xL
rA
rA
rA
"}
(10,1,1) = {"
rA
rA
rA
rA
rA
rA
rA
rA
xL
iC
jA
Zh
Mh
Mh
Mh
Mh
Mh
Mh
Mh
Mh
Mh
Mh
Mh
Mh
Mh
Mh
Mh
Mh
Mh
Mh
Mh
Mh
iC
jA
Zh
xL
xL
rA
rA
"}
(11,1,1) = {"
rA
rA
rA
rA
rA
rA
rA
xL
sE
iC
jA
Yb
Mh
Mh
Mh
Mh
Mh
Mh
Mh
Mh
Mh
Mh
Mh
Mh
Mh
Mh
Mh
Mh
Mh
Mh
Mh
Mh
hv
jA
Zh
sE
xL
rA
rA
"}
(12,1,1) = {"
rA
rA
rA
rA
rA
rA
rA
xL
sE
iC
jA
Zh
Mh
Mh
Mh
Mh
Mh
Mh
Mh
Mh
Mh
Mh
Mh
Mh
Mh
Mh
Mh
Mh
Mh
Mh
Mh
Mh
iC
jA
Zh
sE
xL
rA
rA
"}
(13,1,1) = {"
rA
rA
rA
rA
rA
rA
rA
xL
MT
iC
jA
Zh
Mh
Mh
Mh
Mh
Mh
Mh
Mh
Mh
Mh
Mh
Mh
Mh
Mh
Mh
Mh
Mh
Mh
Mh
Mh
Mh
iC
jA
Zh
zN
vQ
rA
rA
"}
(14,1,1) = {"
rA
rA
rA
rA
rA
rA
xL
lf
xL
iC
jA
Zh
Xb
Mh
Mh
Mh
Mh
Mh
Mh
Mh
Mh
Mh
Mh
Mh
Mh
Mh
Mh
Mh
Mh
Mh
Mh
Xb
iC
jA
Zh
sE
xL
xL
rA
"}
(15,1,1) = {"
rA
rA
rA
rA
rA
rA
kE
sE
xL
iC
jA
Zh
Mh
Mh
Mh
Mh
Mh
Mh
Mh
Mh
Mh
Mh
Mh
Mh
Mh
Mh
Mh
Mh
Mh
Mh
Mh
Mh
iC
jA
Zh
sE
MT
xL
rA
"}
(16,1,1) = {"
rA
rA
rA
rA
rA
rA
rA
rA
VW
iC
jA
Zh
Mh
Mh
Mh
Mh
Mh
Mh
Mh
Mh
Mh
Mh
Mh
Mh
Mh
Mh
Mh
Mh
Mh
Mh
Mh
Mh
iC
jA
Zh
sE
xL
VW
rA
"}
(17,1,1) = {"
rA
rA
rA
rA
rA
rA
rA
rA
sE
iC
jA
Zh
Mh
Mh
Mh
Mh
Mh
Mh
Mh
Mh
Mh
Mh
Mh
Mh
Mh
Mh
Mh
Mh
Mh
Mh
Mh
Mh
iC
jA
Zh
sE
sE
sE
rA
"}
(18,1,1) = {"
rA
rA
rA
rA
rA
rA
rA
rA
sE
iC
jA
Zh
Mh
Mh
Mh
Mh
Mh
Mh
Mh
Mh
Mh
Mh
Mh
Mh
Mh
Mh
Mh
Mh
Mh
Mh
Mh
Mh
iC
jA
Zh
xL
lf
xL
rA
"}
(19,1,1) = {"
rA
rA
rA
rA
rA
rA
rA
rA
zN
iC
jA
Zh
Xb
Mh
Mh
Mh
Mh
Mh
Mh
Mh
Mh
Mh
Mh
Mh
Mh
Mh
Mh
Mh
Mh
Mh
Mh
Xb
iC
jA
Zh
sE
xL
xL
rA
"}
(20,1,1) = {"
rA
rA
rA
rA
rA
rA
rA
rA
sE
iC
jA
Zh
Mh
Mh
Mh
Mh
Mh
Mh
Mh
Mh
Mh
Mh
Mh
Mh
Mh
Mh
Mh
Mh
Mh
Mh
Mh
Mh
iC
jA
Zh
sE
xL
rA
rA
"}
(21,1,1) = {"
rA
rA
rA
rA
rA
rA
rA
rA
rA
iC
jA
Yb
Mh
Mh
Mh
Mh
Mh
Mh
Mh
Mh
Mh
Mh
Mh
Mh
Mh
Mh
Mh
Mh
Mh
Mh
Mh
Mh
iC
jA
Zh
xL
xL
rA
rA
"}
(22,1,1) = {"
rA
rA
rA
rA
rA
rA
rA
rA
rA
iC
jA
Zh
Mh
Mh
Mh
Mh
Mh
Mh
Mh
Mh
Mh
Mh
Mh
Mh
Mh
Mh
Mh
Mh
Mh
Mh
Mh
Mh
iC
jA
Zh
xL
xL
rA
rA
"}
(23,1,1) = {"
rA
rA
rA
rA
rA
rA
rA
rA
rA
iC
jA
Zh
Mh
Mh
Mh
Mh
Mh
Mh
Mh
Mh
Mh
Mh
Mh
Mh
Mh
Mh
Mh
Mh
Mh
Mh
Mh
Mh
iC
jA
Zh
sE
kE
rA
rA
"}
(24,1,1) = {"
rA
rA
rA
rA
rA
rA
rA
rA
rA
iC
jA
Zh
Xb
Mh
Mh
Mh
Mh
Mh
Mh
Mh
Mh
Mh
Mh
Mh
Mh
Mh
Mh
Mh
Mh
Mh
Mh
Xb
iC
jA
Zh
zN
xL
rA
rA
"}
(25,1,1) = {"
rA
rA
rA
rA
rA
rA
rA
rA
sr
iC
jA
Zh
Mh
Mh
Mh
Mh
Mh
Mh
Mh
Mh
Mh
Mh
Mh
Mh
Mh
Mh
Mh
Mh
Mh
Mh
Mh
Mh
iC
jA
Zh
sE
sE
rA
rA
"}
(26,1,1) = {"
rA
rA
rA
rA
rA
rA
rA
rA
zN
iC
jA
Zh
Mh
Mh
Mh
Mh
Mh
Mh
Mh
Mh
Mh
Mh
Mh
Mh
Mh
Mh
Mh
Mh
Mh
Mh
Mh
Mh
iC
jA
Zh
MT
zN
rA
rA
"}
(27,1,1) = {"
rA
rA
rA
rA
rA
rA
rA
rA
MT
iC
jA
Zh
Mh
Mh
Mh
Mh
Mh
Mh
Mh
Mh
Mh
Mh
Mh
Mh
Mh
Mh
Mh
Mh
Mh
Mh
Mh
Mh
hv
jA
Zh
sE
VW
rA
rA
"}
(28,1,1) = {"
rA
rA
rA
rA
rA
rA
rA
rA
rA
iC
jA
Zh
Mh
Mh
Mh
Mh
Mh
Mh
Mh
Mh
Mh
Mh
Mh
Mh
Mh
Mh
Mh
Mh
Mh
Mh
Mh
Mh
iC
jA
Zh
sE
rA
rA
rA
"}
(29,1,1) = {"
rA
rA
rA
rA
rA
rA
rA
rA
rA
iC
jA
Zh
Mh
Mh
Mh
Mh
Mh
Mh
Mh
Mh
Mh
Mh
Mh
Mh
Mh
Mh
Mh
Mh
Mh
Mh
Mh
Mh
iC
jA
Zh
xL
rA
rA
rA
"}
(30,1,1) = {"
rA
rA
rA
rA
rA
rA
rA
rA
rA
iC
jA
Zh
Xb
Mh
Mh
Mh
Mh
Mh
Mh
Mh
Mh
Mh
Mh
Mh
Mh
Mh
Mh
Mh
Mh
Mh
Mh
Xb
iC
jA
Zh
lf
rA
rA
rA
"}
(31,1,1) = {"
rA
rA
rA
rA
rA
rA
rA
rA
zN
iC
jA
Yb
Mh
Mh
Mh
Mh
Mh
Mh
Mh
Mh
Mh
Mh
Mh
Mh
Mh
Mh
Mh
Mh
Mh
Mh
Mh
Mh
iC
jA
Zh
xL
rA
rA
rA
"}
(32,1,1) = {"
rA
rA
rA
rA
rA
rA
rA
rA
xL
iC
jA
Zh
Mh
Mh
Mh
Mh
Mh
Mh
Mh
Mh
Mh
Mh
Mh
Mh
Mh
Mh
Mh
Mh
Mh
Mh
Mh
Mh
iC
jA
Zh
xL
rA
rA
rA
"}
(33,1,1) = {"
rA
rA
rA
rA
rA
rA
rA
rA
kE
iC
jA
Zh
Mh
Mh
Mh
Mh
Mh
Mh
Mh
Mh
Mh
Mh
Mh
Mh
Mh
Mh
Mh
Mh
Mh
Mh
Mh
Mh
iC
jA
Zh
sE
rA
rA
rA
"}
(34,1,1) = {"
rA
rA
rA
rA
rA
rA
rA
rA
xL
iC
jA
Zh
Mh
Mh
Mh
Mh
Mh
Mh
Mh
Mh
Mh
Mh
Mh
Mh
Mh
Mh
Mh
Mh
Mh
Mh
Mh
Mh
iC
jA
Zh
MT
rA
rA
rA
"}
(35,1,1) = {"
rA
rA
rA
rA
rA
rA
rA
rA
sE
iC
jA
Zh
Xb
Mh
Mh
Mh
Mh
Mh
Mh
Mh
Mh
Mh
Mh
Mh
Mh
Mh
Mh
Mh
Mh
Mh
Mh
Xb
iC
jA
Zh
vQ
rA
rA
rA
"}
(36,1,1) = {"
rA
rA
rA
rA
rA
rA
rA
xL
sE
iC
jA
Zh
Mh
Mh
Mh
Mh
Mh
Mh
Mh
Mh
Mh
Mh
Mh
Mh
Mh
Mh
Mh
Mh
Mh
Mh
Mh
Mh
iC
jA
Zh
zN
rA
rA
rA
"}
(37,1,1) = {"
rA
rA
rA
rA
rA
rA
rA
lf
sE
iC
jA
Zh
Mh
Mh
Mh
Mh
Mh
Mh
Mh
Mh
Mh
Mh
Mh
Mh
Mh
Mh
Mh
Mh
Mh
Mh
Mh
Mh
hv
jA
Zh
rA
rA
rA
rA
"}
(38,1,1) = {"
rA
rA
rA
rA
rA
rA
rA
xL
MT
iC
jA
Zh
Mh
Mh
Mh
Mh
Mh
Mh
Mh
Mh
Mh
Mh
Mh
Mh
Mh
Mh
Mh
Mh
Mh
Mh
Mh
Mh
iC
jA
Zh
rA
rA
rA
rA
"}
(39,1,1) = {"
rA
rA
rA
rA
rA
rA
rA
rA
xL
iC
jA
Zh
Mh
Mh
Mh
Mh
Mh
Mh
Mh
Mh
Mh
Mh
Mh
Mh
Mh
Mh
Mh
Mh
Mh
Mh
Mh
Mh
iC
jA
Zh
rA
rA
rA
rA
"}
(40,1,1) = {"
rA
rA
rA
rA
rA
rA
rA
rA
xL
iC
jA
Zh
Xb
Mh
Mh
Mh
Mh
Mh
Mh
Mh
Mh
Mh
Mh
Mh
Mh
Mh
Mh
Mh
Mh
Mh
Mh
Xb
iC
jA
Zh
xL
rA
rA
rA
"}
(41,1,1) = {"
rA
rA
rA
rA
rA
rA
rA
rA
lf
iC
jA
Yb
Mh
Mh
Mh
Mh
Mh
Mh
Mh
Mh
Mh
Mh
Mh
Mh
Mh
Mh
Mh
Mh
Mh
Mh
Mh
Mh
iC
jA
Zh
lf
rA
rA
rA
"}
(42,1,1) = {"
rA
rA
rA
rA
rA
rA
rA
rA
rA
iC
jA
Zh
Mh
Mh
Mh
Mh
Mh
Mh
Mh
Mh
Mh
Mh
Mh
Mh
Mh
Mh
Mh
Mh
Mh
Mh
Mh
Mh
iC
jA
Zh
sE
sE
rA
rA
"}
(43,1,1) = {"
rA
rA
rA
rA
rA
rA
rA
rA
rA
iC
jA
Zh
Mh
Mh
Mh
Mh
Mh
Mh
Mh
Mh
Mh
Mh
Mh
Mh
Mh
Mh
Mh
Mh
Mh
Mh
Mh
Mh
iC
jA
Zh
sE
sE
rA
rA
"}
(44,1,1) = {"
rA
rA
rA
rA
rA
rA
rA
rA
rA
iC
jA
Zh
Mh
Mh
Mh
Mh
Mh
Mh
Mh
Mh
Mh
Mh
Mh
Mh
Mh
Mh
Mh
Mh
Mh
Mh
Mh
Mh
iC
jA
Zh
sE
xL
rA
rA
"}
(45,1,1) = {"
rA
rA
rA
rA
rA
rA
rA
rA
rA
iC
jA
Zh
Xb
Mh
Mh
Mh
Mh
Mh
Mh
Mh
Mh
Mh
Mh
Mh
Mh
Mh
Mh
Mh
Mh
Mh
Mh
Xb
iC
jA
Zh
sE
xL
rA
rA
"}
(46,1,1) = {"
rA
rA
rA
rA
rA
rA
rA
rA
rA
iC
jA
Zh
Mh
Mh
Mh
Mh
Mh
Mh
Mh
Mh
Mh
Mh
Mh
Mh
Mh
Mh
Mh
Mh
Mh
Mh
Mh
Mh
iC
jA
Zh
zN
xL
rA
rA
"}
(47,1,1) = {"
rA
rA
rA
rA
rA
rA
rA
rA
rA
iC
jA
Zh
Mh
Mh
Mh
Mh
Mh
Mh
Mh
Mh
Mh
Mh
Mh
Mh
Mh
Mh
Mh
Mh
Mh
Mh
Mh
Mh
hv
jA
Zh
sE
zN
kE
rA
"}
(48,1,1) = {"
rA
rA
rA
rA
rA
rA
rA
rA
rA
iC
jA
Zh
Mh
Mh
Mh
Mh
Mh
Mh
Mh
Mh
Mh
Mh
Mh
Mh
Mh
Mh
Mh
Mh
Mh
Mh
Mh
Mh
iC
jA
Zh
sE
xL
xL
rA
"}
(49,1,1) = {"
rA
rA
rA
rA
rA
rA
rA
rA
rA
iC
jA
Zh
Mh
Mh
Mh
Mh
Mh
Mh
Mh
Mh
Mh
Mh
Mh
Mh
Mh
Mh
Mh
Mh
Mh
Mh
Mh
Mh
iC
jA
Zh
xL
sE
xL
rA
"}
(50,1,1) = {"
rA
rA
rA
rA
rA
rA
rA
rA
rA
iC
jA
Zh
Xb
Mh
Mh
Mh
Mh
Mh
Mh
Mh
Mh
Mh
Mh
Mh
Mh
Mh
Mh
Mh
Mh
Mh
Mh
Xb
iC
jA
Zh
sE
Hy
sE
rA
"}
(51,1,1) = {"
rA
rA
rA
rA
rA
rA
rA
rA
kE
iC
jA
Yb
Mh
Mh
Mh
Mh
Mh
Mh
Mh
Mh
Mh
Mh
Mh
Mh
Mh
Mh
Mh
Mh
Mh
Mh
Mh
Mh
iC
jA
Zh
zN
xL
sE
rA
"}
(52,1,1) = {"
rA
rA
rA
rA
rA
rA
rA
rA
lf
iC
jA
Zh
Mh
Mh
Mh
Mh
Mh
Mh
Mh
Mh
Mh
Mh
Mh
Mh
Mh
Mh
Mh
Mh
Mh
Mh
Mh
Mh
iC
jA
Zh
sE
sE
xL
rA
"}
(53,1,1) = {"
rA
rA
rA
rA
rA
rA
rA
rA
xL
iC
jA
Zh
Mh
Mh
Mh
Mh
Mh
Mh
Mh
Mh
Mh
Mh
Mh
Mh
Mh
Mh
Mh
Mh
Mh
Mh
Mh
Mh
iC
jA
Zh
sE
lf
kE
rA
"}
(54,1,1) = {"
rA
rA
rA
rA
rA
rA
rA
rA
rA
iC
jA
Zh
Mh
Mh
Mh
Mh
Mh
Mh
Mh
Mh
Mh
Mh
Mh
Mh
Mh
Mh
Mh
Mh
Mh
Mh
Mh
Mh
iC
jA
Zh
xL
xL
rA
rA
"}
(55,1,1) = {"
rA
rA
rA
rA
rA
rA
rA
YS
gq
gg
jA
Zh
Xb
Mh
Mh
Mh
Mh
Mh
Mh
Mh
Mh
Mh
Mh
Mh
Mh
Mh
Mh
Mh
Mh
Mh
Mh
Xb
iC
jA
Zh
lf
rA
rA
rA
"}
(56,1,1) = {"
rA
rA
rA
rA
rA
rA
rA
YS
Fy
rk
jA
Zh
Mh
Mh
Mh
Mh
Mh
Mh
Mh
Mh
Mh
Mh
Mh
Mh
Mh
Mh
Mh
Mh
Mh
Mh
Mh
Mh
iC
jA
Zh
zN
rA
rA
rA
"}
(57,1,1) = {"
rA
rA
rA
rA
rA
rA
rA
YS
OM
sP
jA
Zh
Mh
Mh
Mh
Mh
Mh
Mh
Mh
Mh
Mh
Mh
Mh
Mh
Mh
Mh
Mh
Mh
Mh
Mh
Mh
Mh
hv
jA
Zh
xL
rA
rA
rA
"}
(58,1,1) = {"
rA
rA
rA
rA
rA
rA
rA
YS
bD
sP
jA
Zh
Mh
Mh
Mh
Mh
Mh
Mh
Mh
Mh
Mh
Mh
Mh
Mh
Mh
Mh
Mh
Mh
Mh
Mh
Mh
Mh
iC
jA
Zh
xL
rA
rA
rA
"}
(59,1,1) = {"
rA
rA
rA
rA
rA
YS
YS
YS
Aw
yh
jA
Zh
Mh
Mh
Mh
Mh
Mh
Mh
Mh
Mh
Mh
Mh
Mh
Mh
Mh
Mh
Mh
Mh
Mh
Mh
Mh
Mh
iC
jA
Zh
rA
rA
rA
rA
"}
(60,1,1) = {"
rA
rA
rA
rA
rA
YS
DF
Ps
nF
yh
jA
Zh
Xb
Mh
Mh
Mh
Mh
Mh
Mh
Mh
Mh
Mh
Mh
Mh
Mh
Mh
Mh
Mh
Mh
Mh
Mh
Xb
iC
jA
Zh
rA
rA
rA
rA
"}
(61,1,1) = {"
rA
rA
rA
rA
rA
YS
ee
YS
gq
sP
jA
Zh
Mh
Mh
Mh
Mh
Mh
Mh
Mh
Mh
Mh
Mh
Mh
Mh
Mh
Mh
Mh
Mh
Mh
Mh
Mh
Mh
iC
jA
Zh
rA
rA
rA
rA
"}
(62,1,1) = {"
rA
rA
rA
rA
rA
YS
gu
cL
YS
wA
jA
Zh
Mh
Mh
Mh
Mh
Mh
Mh
Mh
Mh
Mh
Mh
Mh
Mh
Mh
Mh
Mh
Mh
Mh
Mh
Mh
Mh
iC
jA
Zh
rA
rA
rA
rA
"}
(63,1,1) = {"
rA
rA
rA
rA
rA
YS
YS
uV
YS
AS
sP
fv
EA
EA
EA
EA
EA
EA
EA
EA
EA
EA
EA
EA
EA
EA
EA
EA
EA
EA
EA
EA
gg
jA
Zh
rA
rA
rA
rA
"}
(64,1,1) = {"
rA
rA
rA
rA
rA
YS
He
hg
YS
Fl
sP
jA
jA
jA
jA
jA
jA
jA
jA
jA
jA
jA
jA
jA
jA
jA
jA
jA
jA
jA
jA
jA
jA
jA
Zh
xL
rA
rA
rA
"}
(65,1,1) = {"
rA
rA
rA
rA
rA
YS
YS
YS
YS
Ef
DU
DU
DU
Ry
DU
Qz
DU
DU
DU
DU
DU
DU
DU
DU
DU
DU
DU
DU
DU
DU
Ry
DU
DU
DU
AF
zN
rA
rA
rA
"}
(66,1,1) = {"
rA
rA
rA
rA
rA
rA
rA
rA
rA
rA
rA
rA
rA
rA
rA
YS
rA
xL
xL
xL
xL
xj
jA
Kt
xL
xL
sE
sE
sE
sE
lf
sE
sE
sE
xL
kE
xL
rA
rA
"}
(67,1,1) = {"
rA
rA
rA
rA
rA
rA
rA
rA
rA
rA
rA
rA
rA
rA
rA
rA
rA
rA
xL
xL
sE
xj
jA
Kt
xL
xL
xL
xL
rA
xL
xL
Hy
VW
zN
xL
rA
rA
rA
rA
"}
(68,1,1) = {"
rA
rA
rA
YS
YS
YS
YS
YS
YS
YS
YS
YS
YS
YS
YS
YS
YS
YS
YS
YS
tA
VT
VT
VT
VT
xL
xL
sE
rA
rA
xL
xL
xL
xL
rA
rA
rA
rA
rA
"}
(69,1,1) = {"
rA
rA
rA
Ad
qq
qq
Mf
qq
qq
Mf
qq
qq
Mf
YS
qq
qq
qq
qq
Se
YS
Sm
EA
EA
EA
HK
Vk
sE
rA
rA
rA
rA
xL
rA
rA
rA
rA
rA
rA
rA
"}
(70,1,1) = {"
rA
rA
rA
lp
qq
qq
Mf
qq
qq
Mf
qq
qq
Mf
YS
qq
qq
qq
qq
qq
Xp
iC
jA
jA
jA
bb
Vk
sE
rA
rA
rA
rA
rA
rA
rA
rA
rA
rA
rA
rA
"}
(71,1,1) = {"
rA
rA
rA
lp
qq
qq
Mf
qq
qq
Mf
qq
qq
Mf
YS
qq
qq
qq
qq
qq
Xp
iC
YZ
jA
YZ
Zh
Vk
MT
rA
rA
rA
rA
rA
rA
rA
rA
rA
rA
rA
rA
"}
(72,1,1) = {"
rA
rA
rA
lp
qq
qq
Mf
qq
qq
Mf
qq
qq
Mf
YS
qq
qq
qq
qq
qq
Xp
iC
jA
jA
jA
zT
Vk
xL
rA
rA
rA
rA
rA
rA
rA
rA
rA
rA
rA
rA
"}
(73,1,1) = {"
rA
rA
rA
Ad
qq
qq
Mf
qq
qq
Mf
qq
qq
Mf
YS
qq
qq
qq
qq
qq
YS
Ef
DU
DU
DU
AF
Vk
rA
rA
rA
rA
rA
rA
rA
rA
rA
rA
rA
rA
rA
"}
(74,1,1) = {"
rA
rA
rA
YS
YS
YS
YS
YS
YS
YS
YS
YS
YS
YS
YS
YS
YS
YS
YS
YS
lG
lG
gD
gD
gD
xL
rA
rA
rA
rA
rA
rA
rA
rA
rA
rA
rA
rA
rA
"}
(75,1,1) = {"
rA
rA
rA
rA
rA
rA
rA
rA
rA
rA
rA
rA
rA
rA
rA
rA
rA
rA
rA
rA
rA
rA
rA
sr
kE
rA
rA
rA
rA
rA
rA
rA
rA
rA
rA
rA
rA
rA
rA
"}
(76,1,1) = {"
rA
rA
rA
rA
rA
rA
rA
rA
rA
rA
rA
rA
rA
rA
rA
rA
rA
rA
rA
rA
rA
rA
rA
rA
rA
rA
rA
rA
rA
rA
rA
rA
rA
rA
rA
rA
rA
rA
rA
"}
(77,1,1) = {"
rA
rA
rA
rA
rA
rA
rA
rA
rA
rA
rA
rA
rA
rA
rA
rA
rA
rA
rA
rA
rA
rA
rA
rA
rA
rA
rA
rA
rA
rA
rA
rA
rA
rA
rA
rA
rA
rA
rA
"}
(78,1,1) = {"
rA
rA
rA
rA
rA
rA
rA
rA
rA
rA
rA
rA
rA
rA
rA
rA
rA
rA
rA
rA
rA
rA
rA
rA
rA
rA
rA
rA
rA
rA
rA
rA
rA
rA
rA
rA
rA
rA
rA
"}
