//MAP CONVERTED BY dmm2tgm.py THIS HEADER COMMENT PREVENTS RECONVERSION, DO NOT REMOVE
"fv" = (
/obj/effect/turf_decal/corner/opaque/bar{
	dir = 8
	},
/turf/open/floor/plasteel/dark,
/area/hangar)
"gg" = (
/obj/effect/turf_decal/corner/opaque/bar{
	dir = 1
	},
/turf/open/floor/plasteel/dark,
/area/hangar)
"gD" = (
/obj/effect/landmark/outpost/elevator_machine,
/obj/machinery/elevator_call_button{
	pixel_y = 25
	},
/obj/effect/turf_decal/techfloor{
	dir = 4
	},
/turf/open/floor/plasteel/dark,
/area/hangar)
"hv" = (
/obj/effect/turf_decal/corner/opaque/bar/half{
	dir = 1
	},
/turf/open/floor/plasteel/dark,
/area/hangar)
"iC" = (
/obj/effect/turf_decal/corner/opaque/bar/half{
	dir = 1
	},
/obj/machinery/light/floor/hangar,
/turf/open/floor/plasteel/dark,
/area/hangar)
"jq" = (
/obj/effect/turf_decal/corner/opaque/tan{
	dir = 6
	},
/obj/effect/turf_decal/trimline/opaque/bar/line{
	dir = 4
	},
/obj/effect/turf_decal/siding/wideplating/dark{
	dir = 4
	},
/turf/open/floor/plasteel/tech,
/area/hangar)
"jA" = (
/obj/structure/catwalk/over/plated_catwalk/dark,
/turf/open/floor/plating{
	planetary_atmos = 1
	},
/area/hangar)
"kE" = (
/obj/structure/flora/rock/pile/rockplanet,
/turf/open/floor/plating/asteroid/rockplanet/cracked/safe/lit,
/area/hangar)
"lf" = (
/obj/structure/flora/grass/rockplanet/dead,
/turf/open/floor/plating/asteroid/rockplanet/cracked/safe/lit,
/area/hangar)
"lp" = (
/obj/machinery/door/poddoor/ert,
/turf/open/floor/plasteel/elevatorshaft{
	planetary_atmos = 1
	},
/area/hangar)
"lG" = (
/obj/effect/turf_decal/techfloor{
	dir = 1
	},
/turf/open/floor/plasteel/dark,
/area/hangar)
"mm" = (
/obj/effect/turf_decal/corner/opaque/bar/three_quarters,
/turf/open/floor/plasteel/dark,
/area/hangar)
"oA" = (
/obj/effect/turf_decal/trimline/opaque/yellow/warning{
	dir = 8
	},
/turf/open/floor/plasteel/tech{
	planetary_atmos = 1
	},
/area/hangar)
"pu" = (
/obj/effect/landmark/outpost/hangar_dock,
/turf/open/floor/plating{
	planetary_atmos = 1
	},
/area/hangar)
"qc" = (
/obj/effect/turf_decal/corner/opaque/tan/three_quarters{
	dir = 8
	},
/obj/effect/turf_decal/trimline/opaque/bar/line{
	dir = 5
	},
/obj/effect/turf_decal/siding/wideplating/dark{
	dir = 4
	},
/turf/open/floor/plasteel/tech,
/area/hangar)
"qq" = (
/turf/open/floor/plasteel/elevatorshaft{
	planetary_atmos = 1
	},
/area/hangar)
"rA" = (
/turf/closed/indestructible/rock/rockplanet,
/area/hangar)
"sr" = (
/obj/structure/flora/rock/rockplanet,
/turf/open/floor/plating/asteroid/rockplanet/safe/lit,
/area/hangar)
"sE" = (
/turf/open/floor/plating/asteroid/rockplanet/safe/lit,
/area/hangar)
"sP" = (
/turf/open/floor/plasteel/tech{
	planetary_atmos = 1
	},
/area/hangar)
"tA" = (
/obj/effect/decal/fakelattice,
/turf/open/floor/plasteel/elevatorshaft{
	planetary_atmos = 1
	},
/area/hangar)
"tK" = (
/turf/open/floor/plating/asteroid/snow/safe/lit,
/area/hangar)
"vQ" = (
/obj/structure/flora/rock/pile/rockplanet,
/turf/open/floor/plating/asteroid/rockplanet/safe/lit,
/area/hangar)
"xj" = (
/obj/effect/turf_decal/techfloor{
	dir = 4
	},
/turf/open/floor/plasteel/dark,
/area/hangar)
"xL" = (
/turf/open/floor/plating/asteroid/rockplanet/cracked/safe/lit,
/area/hangar)
"yI" = (
/obj/effect/turf_decal/corner/opaque/bar/half,
/obj/machinery/light/floor/hangar,
/turf/open/floor/plasteel/dark,
/area/hangar)
"zN" = (
/obj/structure/flora/grass/rockplanet/dead,
/turf/open/floor/plating/asteroid/rockplanet/safe/lit,
/area/hangar)
"zT" = (
/obj/effect/decal/fakelattice,
/turf/open/floor/plasteel/stairs/mid{
	dir = 1;
	color = "#2e2e2e"
	},
/area/hangar)
"Ab" = (
/obj/effect/turf_decal/arrows{
	dir = 1
	},
/turf/open/floor/plasteel/tech{
	planetary_atmos = 1
	},
/area/hangar)
"Ad" = (
/obj/effect/turf_decal/techfloor{
	dir = 8
	},
/obj/structure/rack,
/obj/item/clothing/suit/hooded/wintercoat,
/obj/item/clothing/suit/hooded/wintercoat,
/obj/item/clothing/suit/hooded/wintercoat,
/obj/item/clothing/suit/hooded/wintercoat,
/obj/item/clothing/suit/hooded/wintercoat,
/turf/open/floor/plasteel/dark,
/area/hangar)
"AF" = (
/obj/effect/turf_decal/corner/opaque/tan/three_quarters,
/obj/effect/turf_decal/trimline/opaque/bar/line{
	dir = 6
	},
/obj/effect/turf_decal/siding/wideplating/dark{
	dir = 4
	},
/turf/open/floor/plasteel/tech,
/area/hangar)
"DR" = (
/obj/effect/turf_decal/corner/opaque/bar/half{
	dir = 8
	},
/turf/open/floor/plasteel/dark,
/area/hangar)
"DU" = (
/obj/effect/turf_decal/corner/opaque/bar/half{
	dir = 4
	},
/turf/open/floor/plasteel/dark,
/area/hangar)
"EA" = (
/obj/effect/turf_decal/corner/opaque/tan{
	dir = 9
	},
/obj/effect/turf_decal/trimline/opaque/bar/line{
	dir = 8
	},
/obj/effect/turf_decal/siding/wideplating/dark{
	dir = 8
	},
/turf/open/floor/plasteel/tech,
/area/hangar)
"Fo" = (
/obj/effect/turf_decal/corner/opaque/bar/three_quarters{
	dir = 4
	},
/turf/open/floor/plasteel/dark,
/area/hangar)
"Go" = (
/turf/open/floor/plasteel/dark,
/area/hangar)
"Hk" = (
/obj/structure/flora/grass/rockplanet/dead,
/turf/open/floor/plating/asteroid/snow/safe/lit,
/area/hangar)
"Hy" = (
/obj/structure/flora/tree/cactus,
/turf/open/floor/plating/asteroid/rockplanet/cracked/safe/lit,
/area/hangar)
"HK" = (
/obj/effect/turf_decal/techfloor{
	dir = 8
	},
/turf/open/floor/plasteel/dark,
/area/hangar)
"JO" = (
/obj/effect/landmark/outpost/hangar_numbers,
/obj/effect/turf_decal/corner/opaque/tan{
	dir = 5
	},
/obj/effect/turf_decal/trimline/opaque/bar/line{
	dir = 1
	},
/turf/open/floor/plasteel/tech,
/area/hangar)
"Kt" = (
/obj/effect/turf_decal/techfloor/corner{
	dir = 4
	},
/turf/open/floor/plasteel/dark,
/area/hangar)
"KX" = (
/obj/effect/turf_decal/corner/opaque/bar/half,
/turf/open/floor/plasteel/dark,
/area/hangar)
"Mf" = (
/turf/open/floor/plasteel/stairs/mid{
	dir = 1;
	color = "#2e2e2e"
	},
/area/hangar)
"Mh" = (
/turf/open/floor/plating{
	planetary_atmos = 1
	},
/area/hangar)
"MT" = (
/obj/structure/flora/tree/cactus,
/turf/open/floor/plating/asteroid/rockplanet/safe/lit,
/area/hangar)
"Nt" = (
/obj/effect/turf_decal/trimline/opaque/yellow/warning{
	dir = 4
	},
/turf/open/floor/plasteel/tech{
	planetary_atmos = 1
	},
/area/hangar)
"PR" = (
/obj/structure/flora/rock/rockplanet,
/turf/open/floor/plating/asteroid/snow/safe/lit,
/area/hangar)
"Qx" = (
/obj/machinery/light/floor/hangar,
/turf/open/floor/plasteel/tech{
	planetary_atmos = 1
	},
/area/hangar)
"Ry" = (
/obj/machinery/light/floor/hangar,
/obj/effect/turf_decal/corner/opaque/bar/half{
	dir = 4
	},
/turf/open/floor/plasteel/dark,
/area/hangar)
"RG" = (
/obj/machinery/light/floor/hangar,
/obj/effect/turf_decal/corner/opaque/bar/half{
	dir = 1
	},
/turf/open/floor/plasteel/dark,
/area/hangar)
"Se" = (
/obj/effect/landmark/outpost/elevator,
/turf/open/floor/plasteel/elevatorshaft{
	planetary_atmos = 1
	},
/area/hangar)
"Sm" = (
/obj/effect/turf_decal/corner/opaque/tan/three_quarters{
	dir = 4
	},
/obj/effect/turf_decal/trimline/opaque/bar/line{
	dir = 9
	},
/obj/effect/turf_decal/siding/wideplating/dark{
	dir = 8
	},
/turf/open/floor/plasteel/tech,
/area/hangar)
"TY" = (
/obj/structure/flora/rock/pile/rockplanet,
/turf/open/floor/plating/asteroid/snow/safe/lit,
/area/hangar)
"Vk" = (
/obj/effect/turf_decal/techfloor/corner{
	dir = 1
	},
/turf/open/floor/plasteel/dark,
/area/hangar)
"VT" = (
/obj/effect/turf_decal/corner/opaque/tan/three_quarters{
	dir = 1
	},
/obj/effect/turf_decal/trimline/opaque/bar/line{
	dir = 10
	},
/obj/effect/turf_decal/siding/wideplating/dark{
	dir = 8
	},
/turf/open/floor/plasteel/tech,
/area/hangar)
"VW" = (
/obj/structure/flora/rock/rockplanet,
/turf/open/floor/plating/asteroid/rockplanet/cracked/safe/lit,
/area/hangar)
"Xb" = (
/obj/structure/marker_beacon{
	picked_color = "Teal"
	},
/turf/open/floor/plating{
	planetary_atmos = 1
	},
/area/hangar)
"Xp" = (
/obj/effect/landmark/outpost/elevator_machine,
/obj/structure/lattice/catwalk,
/obj/machinery/door/airlock/grunge,
/turf/open/floor/engine,
/area/hangar)
"Yb" = (
/obj/machinery/light/floor/hangar,
/obj/effect/turf_decal/corner/opaque/bar/half,
/turf/open/floor/plasteel/dark,
/area/hangar)
"YM" = (
/obj/effect/turf_decal/corner/opaque/bar/three_quarters{
	dir = 1
	},
/turf/open/floor/plasteel/dark,
/area/hangar)
"YS" = (
/turf/closed/indestructible/plastitanium/nodiagnonal,
/area/hangar)
"YZ" = (
/obj/structure/catwalk/over/plated_catwalk/dark,
/obj/machinery/light/floor/hangar,
/turf/open/floor/plating{
	planetary_atmos = 1
	},
/area/hangar)
"Zh" = (
/obj/effect/turf_decal/corner/opaque/tan{
	dir = 10
	},
/obj/effect/turf_decal/trimline/opaque/bar/line,
/turf/open/floor/plasteel/tech,
/area/hangar)

(1,1,1) = {"
rA
rA
rA
rA
rA
rA
rA
rA
rA
rA
rA
rA
rA
rA
rA
rA
rA
rA
rA
rA
rA
rA
rA
rA
rA
rA
rA
rA
rA
rA
rA
rA
rA
rA
rA
rA
rA
rA
rA
"}
(2,1,1) = {"
rA
rA
rA
rA
rA
rA
rA
rA
rA
rA
rA
rA
rA
rA
rA
rA
rA
rA
rA
rA
rA
rA
rA
rA
rA
rA
rA
rA
rA
rA
rA
rA
rA
rA
rA
rA
rA
rA
rA
"}
(3,1,1) = {"
rA
rA
rA
rA
rA
rA
rA
rA
rA
rA
rA
rA
rA
rA
rA
rA
rA
rA
rA
rA
rA
rA
rA
rA
rA
rA
rA
rA
rA
rA
rA
rA
rA
rA
rA
rA
rA
rA
rA
"}
(4,1,1) = {"
rA
rA
rA
rA
rA
rA
rA
rA
rA
Fo
DR
YM
oA
oA
oA
oA
oA
oA
oA
oA
oA
oA
oA
oA
oA
oA
oA
oA
oA
oA
oA
oA
Fo
DR
YM
rA
rA
rA
rA
"}
(5,1,1) = {"
rA
rA
rA
rA
rA
rA
rA
rA
rA
hv
jA
KX
sP
sP
Ab
sP
Qx
sP
sP
Ab
sP
sP
sP
sP
Ab
sP
Qx
sP
sP
Ab
sP
sP
hv
jA
KX
tK
rA
rA
rA
"}
(6,1,1) = {"
rA
rA
rA
rA
rA
rA
rA
rA
rA
hv
jA
KX
Nt
Nt
Nt
Nt
Nt
Nt
Nt
Nt
Nt
Nt
Nt
Nt
Nt
Nt
Nt
Nt
Nt
Nt
Nt
Nt
hv
jA
KX
lf
rA
rA
rA
"}
(7,1,1) = {"
rA
rA
rA
rA
rA
rA
rA
rA
TY
hv
jA
KX
Mh
Mh
Mh
Mh
Mh
Mh
Mh
Mh
Mh
Mh
Mh
Mh
Mh
Mh
Mh
Mh
Mh
Mh
Mh
pu
hv
jA
KX
xL
rA
rA
rA
"}
(8,1,1) = {"
rA
rA
rA
rA
rA
rA
rA
rA
xL
hv
jA
KX
Mh
Mh
Mh
Mh
Mh
Mh
Mh
Mh
Mh
Mh
Mh
Mh
Mh
Mh
Mh
Mh
Mh
Mh
Mh
Mh
hv
jA
KX
sr
rA
rA
rA
"}
(9,1,1) = {"
rA
rA
rA
rA
rA
rA
rA
rA
lf
hv
jA
KX
Xb
Mh
Mh
Mh
Mh
Mh
Mh
Mh
Mh
Mh
Mh
Mh
Mh
Mh
Mh
Mh
Mh
Mh
Mh
Xb
hv
jA
KX
tK
rA
rA
rA
"}
(10,1,1) = {"
rA
rA
rA
rA
rA
rA
rA
rA
xL
hv
jA
KX
Mh
Mh
Mh
Mh
Mh
Mh
Mh
Mh
Mh
Mh
Mh
Mh
Mh
Mh
Mh
Mh
Mh
Mh
Mh
Mh
hv
jA
KX
tK
tK
rA
rA
"}
(11,1,1) = {"
rA
rA
rA
rA
rA
rA
rA
tK
sE
hv
jA
Yb
Mh
Mh
Mh
Mh
Mh
Mh
Mh
Mh
Mh
Mh
Mh
Mh
Mh
Mh
Mh
Mh
Mh
Mh
Mh
Mh
RG
jA
KX
sE
tK
rA
rA
"}
(12,1,1) = {"
rA
rA
rA
rA
rA
rA
rA
tK
sE
hv
jA
KX
Mh
Mh
Mh
Mh
Mh
Mh
Mh
Mh
Mh
Mh
Mh
Mh
Mh
Mh
Mh
Mh
Mh
Mh
Mh
Mh
hv
jA
KX
sE
tK
rA
rA
"}
(13,1,1) = {"
rA
rA
rA
rA
rA
rA
rA
tK
MT
hv
jA
KX
Mh
Mh
Mh
Mh
Mh
Mh
Mh
Mh
Mh
Mh
Mh
Mh
Mh
Mh
Mh
Mh
Mh
Mh
Mh
Mh
hv
jA
KX
zN
vQ
rA
rA
"}
(14,1,1) = {"
rA
rA
rA
rA
rA
rA
tK
lf
xL
hv
jA
KX
Xb
Mh
Mh
Mh
Mh
Mh
Mh
Mh
Mh
Mh
Mh
Mh
Mh
Mh
Mh
Mh
Mh
Mh
Mh
Xb
hv
jA
KX
sE
xL
tK
rA
"}
(15,1,1) = {"
rA
rA
rA
rA
rA
rA
TY
sE
xL
hv
jA
KX
Mh
Mh
Mh
Mh
Mh
Mh
Mh
Mh
Mh
Mh
Mh
Mh
Mh
Mh
Mh
Mh
Mh
Mh
Mh
Mh
hv
jA
KX
sE
MT
tK
rA
"}
(16,1,1) = {"
rA
rA
rA
rA
rA
rA
rA
rA
VW
hv
jA
KX
Mh
Mh
Mh
Mh
Mh
Mh
Mh
Mh
Mh
Mh
Mh
Mh
Mh
Mh
Mh
Mh
Mh
Mh
Mh
Mh
hv
jA
KX
sE
xL
PR
rA
"}
(17,1,1) = {"
rA
rA
rA
rA
rA
rA
rA
rA
sE
hv
jA
KX
Mh
Mh
Mh
Mh
Mh
Mh
Mh
Mh
Mh
Mh
Mh
Mh
Mh
Mh
Mh
Mh
Mh
Mh
Mh
Mh
hv
jA
KX
sE
sE
sE
rA
"}
(18,1,1) = {"
rA
rA
rA
rA
rA
rA
rA
rA
sE
hv
jA
KX
Mh
Mh
Mh
Mh
Mh
Mh
Mh
Mh
Mh
Mh
Mh
Mh
Mh
Mh
Mh
Mh
Mh
Mh
Mh
Mh
hv
jA
KX
xL
lf
tK
rA
"}
(19,1,1) = {"
rA
rA
rA
rA
rA
rA
rA
rA
zN
hv
jA
KX
Xb
Mh
Mh
Mh
Mh
Mh
Mh
Mh
Mh
Mh
Mh
Mh
Mh
Mh
Mh
Mh
Mh
Mh
Mh
Xb
hv
jA
KX
sE
xL
tK
rA
"}
(20,1,1) = {"
rA
rA
rA
rA
rA
rA
rA
rA
sE
hv
jA
KX
Mh
Mh
Mh
Mh
Mh
Mh
Mh
Mh
Mh
Mh
Mh
Mh
Mh
Mh
Mh
Mh
Mh
Mh
Mh
Mh
hv
jA
KX
sE
xL
rA
rA
"}
(21,1,1) = {"
rA
rA
rA
rA
rA
rA
rA
rA
rA
hv
jA
yI
Mh
Mh
Mh
Mh
Mh
Mh
Mh
Mh
Mh
Mh
Mh
Mh
Mh
Mh
Mh
Mh
Mh
Mh
Mh
Mh
iC
jA
KX
xL
tK
rA
rA
"}
(22,1,1) = {"
rA
rA
rA
rA
rA
rA
rA
rA
rA
hv
jA
KX
Mh
Mh
Mh
Mh
Mh
Mh
Mh
Mh
Mh
Mh
Mh
Mh
Mh
Mh
Mh
Mh
Mh
Mh
Mh
Mh
hv
jA
KX
xL
tK
rA
rA
"}
(23,1,1) = {"
rA
rA
rA
rA
rA
rA
rA
rA
rA
hv
jA
KX
Mh
Mh
Mh
Mh
Mh
Mh
Mh
Mh
Mh
Mh
Mh
Mh
Mh
Mh
Mh
Mh
Mh
Mh
Mh
Mh
hv
jA
KX
sE
TY
rA
rA
"}
(24,1,1) = {"
rA
rA
rA
rA
rA
rA
rA
rA
rA
hv
jA
KX
Xb
Mh
Mh
Mh
Mh
Mh
Mh
Mh
Mh
Mh
Mh
Mh
Mh
Mh
Mh
Mh
Mh
Mh
Mh
Xb
hv
jA
KX
zN
tK
rA
rA
"}
(25,1,1) = {"
rA
rA
rA
rA
rA
rA
rA
rA
sr
hv
jA
KX
Mh
Mh
Mh
Mh
Mh
Mh
Mh
Mh
Mh
Mh
Mh
Mh
Mh
Mh
Mh
Mh
Mh
Mh
Mh
Mh
hv
jA
KX
sE
sE
rA
rA
"}
(26,1,1) = {"
rA
rA
rA
rA
rA
rA
rA
rA
zN
hv
jA
KX
Mh
Mh
Mh
Mh
Mh
Mh
Mh
Mh
Mh
Mh
Mh
Mh
Mh
Mh
Mh
Mh
Mh
Mh
Mh
Mh
hv
jA
KX
MT
zN
rA
rA
"}
(27,1,1) = {"
rA
rA
rA
rA
rA
rA
rA
rA
MT
hv
jA
KX
Mh
Mh
Mh
Mh
Mh
Mh
Mh
Mh
Mh
Mh
Mh
Mh
Mh
Mh
Mh
Mh
Mh
Mh
Mh
Mh
hv
jA
KX
sE
PR
rA
rA
"}
(28,1,1) = {"
rA
rA
rA
rA
rA
rA
rA
rA
rA
hv
jA
KX
Mh
Mh
Mh
Mh
Mh
Mh
Mh
Mh
Mh
Mh
Mh
Mh
Mh
Mh
Mh
Mh
Mh
Mh
Mh
Mh
hv
jA
KX
sE
rA
rA
rA
"}
(29,1,1) = {"
rA
rA
rA
rA
rA
rA
rA
rA
rA
hv
jA
KX
Mh
Mh
Mh
Mh
Mh
Mh
Mh
Mh
Mh
Mh
Mh
Mh
Mh
Mh
Mh
Mh
Mh
Mh
Mh
Mh
hv
jA
KX
xL
rA
rA
rA
"}
(30,1,1) = {"
rA
rA
rA
rA
rA
rA
rA
rA
rA
hv
jA
KX
Xb
Mh
Mh
Mh
Mh
Mh
Mh
Mh
Mh
Mh
Mh
Mh
Mh
Mh
Mh
Mh
Mh
Mh
Mh
Xb
hv
jA
KX
lf
rA
rA
rA
"}
(31,1,1) = {"
rA
rA
rA
rA
rA
rA
rA
rA
zN
hv
jA
Yb
Mh
Mh
Mh
Mh
Mh
Mh
Mh
Mh
Mh
Mh
Mh
Mh
Mh
Mh
Mh
Mh
Mh
Mh
Mh
Mh
iC
jA
KX
xL
rA
rA
rA
"}
(32,1,1) = {"
rA
rA
rA
rA
rA
rA
rA
rA
xL
hv
jA
KX
Mh
Mh
Mh
Mh
Mh
Mh
Mh
Mh
Mh
Mh
Mh
Mh
Mh
Mh
Mh
Mh
Mh
Mh
Mh
Mh
hv
jA
KX
xL
rA
rA
rA
"}
(33,1,1) = {"
rA
rA
rA
rA
rA
rA
rA
rA
kE
hv
jA
KX
Mh
Mh
Mh
Mh
Mh
Mh
Mh
Mh
Mh
Mh
Mh
Mh
Mh
Mh
Mh
Mh
Mh
Mh
Mh
Mh
hv
jA
KX
sE
rA
rA
rA
"}
(34,1,1) = {"
rA
rA
rA
rA
rA
rA
rA
rA
xL
hv
jA
KX
Mh
Mh
Mh
Mh
Mh
Mh
Mh
Mh
Mh
Mh
Mh
Mh
Mh
Mh
Mh
Mh
Mh
Mh
Mh
Mh
hv
jA
KX
MT
rA
rA
rA
"}
(35,1,1) = {"
rA
rA
rA
rA
rA
rA
rA
rA
sE
hv
jA
KX
Xb
Mh
Mh
Mh
Mh
Mh
Mh
Mh
Mh
Mh
Mh
Mh
Mh
Mh
Mh
Mh
Mh
Mh
Mh
Xb
hv
jA
KX
vQ
rA
rA
rA
"}
(36,1,1) = {"
rA
rA
rA
rA
rA
rA
rA
tK
sE
hv
jA
KX
Mh
Mh
Mh
Mh
Mh
Mh
Mh
Mh
Mh
Mh
Mh
Mh
Mh
Mh
Mh
Mh
Mh
Mh
Mh
Mh
hv
jA
KX
zN
rA
rA
rA
"}
(37,1,1) = {"
rA
rA
rA
rA
rA
rA
rA
Hk
sE
hv
jA
KX
Mh
Mh
Mh
Mh
Mh
Mh
Mh
Mh
Mh
Mh
Mh
Mh
Mh
Mh
Mh
Mh
Mh
Mh
Mh
Mh
hv
jA
KX
rA
rA
rA
rA
"}
(38,1,1) = {"
rA
rA
rA
rA
rA
rA
rA
tK
MT
hv
jA
KX
Mh
Mh
Mh
Mh
Mh
Mh
Mh
Mh
Mh
Mh
Mh
Mh
Mh
Mh
Mh
Mh
Mh
Mh
Mh
Mh
hv
jA
KX
rA
rA
rA
rA
"}
(39,1,1) = {"
rA
rA
rA
rA
rA
rA
rA
rA
tK
hv
jA
KX
Mh
Mh
Mh
Mh
Mh
Mh
Mh
Mh
Mh
Mh
Mh
Mh
Mh
Mh
Mh
Mh
Mh
Mh
Mh
Mh
hv
jA
KX
rA
rA
rA
rA
"}
(40,1,1) = {"
rA
rA
rA
rA
rA
rA
rA
rA
xL
hv
jA
KX
Xb
Mh
Mh
Mh
Mh
Mh
Mh
Mh
Mh
Mh
Mh
Mh
Mh
Mh
Mh
Mh
Mh
Mh
Mh
Xb
hv
jA
KX
xL
rA
rA
rA
"}
(41,1,1) = {"
rA
rA
rA
rA
rA
rA
rA
rA
lf
hv
jA
yI
Mh
Mh
Mh
Mh
Mh
Mh
Mh
Mh
Mh
Mh
Mh
Mh
Mh
Mh
Mh
Mh
Mh
Mh
Mh
Mh
iC
jA
KX
lf
rA
rA
rA
"}
(42,1,1) = {"
rA
rA
rA
rA
rA
rA
rA
rA
rA
hv
jA
KX
Mh
Mh
Mh
Mh
Mh
Mh
Mh
Mh
Mh
Mh
Mh
Mh
Mh
Mh
Mh
Mh
Mh
Mh
Mh
Mh
hv
jA
KX
sE
sE
rA
rA
"}
(43,1,1) = {"
rA
rA
rA
rA
rA
rA
rA
rA
rA
hv
jA
KX
Mh
Mh
Mh
Mh
Mh
Mh
Mh
Mh
Mh
Mh
Mh
Mh
Mh
Mh
Mh
Mh
Mh
Mh
Mh
Mh
hv
jA
KX
sE
sE
rA
rA
"}
(44,1,1) = {"
rA
rA
rA
rA
rA
rA
rA
rA
rA
hv
jA
KX
Mh
Mh
Mh
Mh
Mh
Mh
Mh
Mh
Mh
Mh
Mh
Mh
Mh
Mh
Mh
Mh
Mh
Mh
Mh
Mh
hv
jA
KX
sE
tK
rA
rA
"}
(45,1,1) = {"
rA
rA
rA
rA
rA
rA
rA
rA
rA
hv
jA
KX
Xb
Mh
Mh
Mh
Mh
Mh
Mh
Mh
Mh
Mh
Mh
Mh
Mh
Mh
Mh
Mh
Mh
Mh
Mh
Xb
hv
jA
KX
sE
tK
rA
rA
"}
(46,1,1) = {"
rA
rA
rA
rA
rA
rA
rA
rA
rA
hv
jA
KX
Mh
Mh
Mh
Mh
Mh
Mh
Mh
Mh
Mh
Mh
Mh
Mh
Mh
Mh
Mh
Mh
Mh
Mh
Mh
Mh
hv
jA
KX
zN
tK
rA
rA
"}
(47,1,1) = {"
rA
rA
rA
rA
rA
rA
rA
rA
rA
hv
jA
yI
Mh
Mh
Mh
Mh
Mh
Mh
Mh
Mh
Mh
Mh
Mh
Mh
Mh
Mh
Mh
Mh
Mh
Mh
Mh
Mh
iC
jA
KX
sE
zN
TY
rA
"}
(48,1,1) = {"
rA
rA
rA
rA
rA
rA
rA
rA
rA
hv
jA
KX
Mh
Mh
Mh
Mh
Mh
Mh
Mh
Mh
Mh
Mh
Mh
Mh
Mh
Mh
Mh
Mh
Mh
Mh
Mh
Mh
hv
jA
KX
sE
xL
tK
rA
"}
(49,1,1) = {"
rA
rA
rA
rA
rA
rA
rA
rA
rA
hv
jA
KX
Mh
Mh
Mh
Mh
Mh
Mh
Mh
Mh
Mh
Mh
Mh
Mh
Mh
Mh
Mh
Mh
Mh
Mh
Mh
Mh
hv
jA
KX
xL
sE
tK
rA
"}
(50,1,1) = {"
rA
rA
rA
rA
rA
rA
rA
rA
rA
hv
jA
KX
Xb
Mh
Mh
Mh
Mh
Mh
Mh
Mh
Mh
Mh
Mh
Mh
Mh
Mh
Mh
Mh
Mh
Mh
Mh
Xb
hv
jA
KX
sE
Hy
sE
rA
"}
(51,1,1) = {"
rA
rA
rA
rA
rA
rA
rA
rA
TY
hv
jA
KX
Mh
Mh
Mh
Mh
Mh
Mh
Mh
Mh
Mh
Mh
Mh
Mh
Mh
Mh
Mh
Mh
Mh
Mh
Mh
Mh
hv
jA
KX
zN
xL
sE
rA
"}
(52,1,1) = {"
rA
rA
rA
rA
rA
rA
rA
rA
Hk
hv
jA
KX
Mh
Mh
Mh
Mh
Mh
Mh
Mh
Mh
Mh
Mh
Mh
Mh
Mh
Mh
Mh
Mh
Mh
Mh
Mh
Mh
hv
jA
KX
sE
sE
xL
rA
"}
(53,1,1) = {"
rA
rA
rA
rA
rA
rA
rA
rA
tK
hv
jA
KX
Mh
Mh
Mh
Mh
Mh
Mh
Mh
Mh
Mh
Mh
Mh
Mh
Mh
Mh
Mh
Mh
Mh
Mh
Mh
Mh
hv
jA
KX
sE
lf
TY
rA
"}
(54,1,1) = {"
rA
rA
rA
rA
rA
rA
rA
rA
rA
hv
jA
KX
Mh
Mh
Mh
Mh
Mh
Mh
Mh
Mh
Mh
Mh
Mh
Mh
Mh
Mh
Mh
Mh
Mh
Mh
Mh
Mh
hv
jA
KX
xL
tK
rA
rA
"}
(55,1,1) = {"
rA
rA
rA
rA
rA
rA
rA
rA
rA
hv
jA
KX
Xb
Mh
Mh
Mh
Mh
Mh
Mh
Mh
Mh
Mh
Mh
Mh
Mh
Mh
Mh
Mh
Mh
Mh
Mh
Xb
hv
jA
KX
lf
rA
rA
rA
"}
(56,1,1) = {"
rA
rA
rA
rA
rA
rA
rA
rA
rA
hv
jA
KX
Mh
Mh
Mh
Mh
Mh
Mh
Mh
Mh
Mh
Mh
Mh
Mh
Mh
Mh
Mh
Mh
Mh
Mh
Mh
Mh
hv
jA
KX
zN
rA
rA
rA
"}
(57,1,1) = {"
rA
rA
rA
rA
rA
rA
rA
rA
rA
hv
jA
Yb
Mh
Mh
Mh
Mh
Mh
Mh
Mh
Mh
Mh
Mh
Mh
Mh
Mh
Mh
Mh
Mh
Mh
Mh
Mh
Mh
RG
jA
KX
tK
rA
rA
rA
"}
(58,1,1) = {"
rA
rA
rA
rA
rA
rA
rA
rA
rA
hv
jA
KX
Mh
Mh
Mh
Mh
Mh
Mh
Mh
Mh
Mh
Mh
Mh
Mh
Mh
Mh
Mh
Mh
Mh
Mh
Mh
Mh
hv
jA
KX
tK
rA
rA
rA
"}
(59,1,1) = {"
rA
rA
rA
rA
rA
rA
rA
rA
rA
hv
jA
KX
Mh
Mh
Mh
Mh
Mh
Mh
Mh
Mh
Mh
Mh
Mh
Mh
Mh
Mh
Mh
Mh
Mh
Mh
Mh
Mh
hv
jA
KX
rA
rA
rA
rA
"}
(60,1,1) = {"
rA
rA
rA
rA
rA
rA
rA
rA
rA
hv
jA
KX
Xb
Mh
Mh
Mh
Mh
Mh
Mh
Mh
Mh
Mh
Mh
Mh
Mh
Mh
Mh
Mh
Mh
Mh
Mh
Xb
hv
jA
KX
rA
rA
rA
rA
"}
(61,1,1) = {"
rA
rA
rA
rA
rA
rA
rA
rA
rA
hv
jA
KX
Mh
Mh
Mh
Mh
Mh
Mh
Mh
Mh
Mh
Mh
Mh
Mh
Mh
Mh
Mh
Mh
Mh
Mh
Mh
Mh
hv
jA
KX
rA
rA
rA
rA
"}
(62,1,1) = {"
rA
rA
rA
rA
rA
rA
rA
rA
rA
rA
jA
KX
Mh
Mh
Mh
Mh
Mh
Mh
Mh
Mh
Mh
Mh
Mh
Mh
Mh
Mh
Mh
Mh
Mh
Mh
Mh
Mh
hv
jA
KX
rA
rA
rA
rA
"}
(63,1,1) = {"
rA
rA
rA
rA
rA
rA
rA
rA
rA
sE
Go
fv
DR
DR
DR
DR
DR
DR
DR
DR
DR
DR
DR
DR
DR
DR
DR
DR
DR
DR
DR
DR
gg
jA
KX
rA
rA
rA
rA
"}
(64,1,1) = {"
rA
rA
rA
rA
rA
rA
rA
rA
zN
sE
Go
jA
jA
jA
jA
jA
jA
jA
jA
jA
jA
jA
jA
jA
jA
jA
jA
jA
jA
jA
jA
jA
jA
jA
KX
tK
rA
rA
rA
"}
(65,1,1) = {"
rA
rA
rA
rA
rA
rA
rA
rA
rA
sr
DU
DU
DU
Ry
DU
DU
DU
DU
DU
DU
DU
DU
DU
DU
DU
DU
DU
DU
DU
DU
Ry
DU
DU
DU
mm
zN
rA
rA
rA
"}
(66,1,1) = {"
rA
rA
rA
rA
rA
rA
rA
rA
rA
rA
rA
rA
rA
rA
rA
rA
rA
rA
lf
xL
sE
sE
zN
xL
xL
rA
rA
rA
rA
tK
lf
sE
sE
sE
xL
kE
tK
rA
rA
"}
(67,1,1) = {"
rA
rA
rA
YS
rA
rA
YS
rA
rA
YS
rA
rA
YS
rA
rA
YS
YS
YS
YS
YS
gD
xj
xj
Kt
xL
rA
rA
rA
rA
tK
tK
Hy
VW
zN
tK
rA
rA
rA
rA
"}
(68,1,1) = {"
rA
rA
rA
lp
qq
qq
Mf
qq
qq
Mf
qq
qq
Mf
qq
qq
lp
qq
qq
Se
Xp
Sm
EA
VT
lG
lf
sE
rA
rA
rA
rA
tK
tK
tK
tK
rA
rA
rA
rA
rA
"}
(69,1,1) = {"
rA
rA
rA
lp
tA
tA
zT
tA
tA
zT
tA
tA
zT
tA
tA
YS
qq
qq
qq
Xp
JO
YZ
Zh
lG
sE
MT
rA
rA
rA
rA
rA
tK
rA
rA
rA
rA
rA
rA
rA
"}
(70,1,1) = {"
rA
rA
rA
lp
qq
qq
Mf
qq
qq
Mf
qq
qq
Mf
qq
qq
lp
qq
qq
qq
Xp
qc
jq
AF
lG
sE
rA
rA
rA
rA
rA
rA
rA
rA
rA
rA
rA
rA
rA
rA
"}
(71,1,1) = {"
rA
rA
rA
YS
rA
rA
YS
rA
rA
YS
rA
rA
YS
rA
rA
YS
YS
YS
YS
YS
Ad
Ad
HK
Vk
xL
rA
rA
rA
rA
rA
rA
rA
rA
rA
rA
rA
rA
rA
rA
"}
(72,1,1) = {"
rA
rA
rA
rA
rA
rA
rA
rA
rA
rA
rA
rA
rA
rA
rA
rA
rA
rA
rA
rA
rA
rA
rA
sr
kE
rA
rA
rA
rA
rA
rA
rA
rA
rA
rA
rA
rA
rA
rA
"}
(73,1,1) = {"
rA
rA
rA
rA
rA
rA
rA
rA
rA
rA
rA
rA
rA
rA
rA
rA
rA
rA
rA
rA
rA
rA
rA
rA
rA
rA
rA
rA
rA
rA
rA
rA
rA
rA
rA
rA
rA
rA
rA
"}
(74,1,1) = {"
rA
rA
rA
rA
rA
rA
rA
rA
rA
rA
rA
rA
rA
rA
rA
rA
rA
rA
rA
rA
rA
rA
rA
rA
rA
rA
rA
rA
rA
rA
rA
rA
rA
rA
rA
rA
rA
rA
rA
"}
(75,1,1) = {"
rA
rA
rA
rA
rA
rA
rA
rA
rA
rA
rA
rA
rA
rA
rA
rA
rA
rA
rA
rA
rA
rA
rA
rA
rA
rA
rA
rA
rA
rA
rA
rA
rA
rA
rA
rA
rA
rA
rA
"}
(76,1,1) = {"
rA
rA
rA
rA
rA
rA
rA
rA
rA
rA
rA
rA
rA
rA
rA
rA
rA
rA
rA
rA
rA
rA
rA
rA
rA
rA
rA
rA
rA
rA
rA
rA
rA
rA
rA
rA
rA
rA
rA
"}
