//MAP CONVERTED BY dmm2tgm.py THIS HEADER COMMENT PREVENTS RECONVERSION, DO NOT REMOVE
"bB" = (
/obj/effect/turf_decal/corner/opaque/tan/three_quarters{
	dir = 4
	},
/obj/effect/turf_decal/trimline/opaque/bar/filled/shrink_ccw{
	dir = 1
	},
/turf/open/floor/plasteel/tech/ngr_outpost_outside,
/area/hangar/agni)
"dr" = (
/obj/machinery/conveyor/auto/outpost,
/obj/structure/plasticflaps/outpost,
/turf/open/floor/plasteel/tech/ngr_outpost_outside,
/area/hangar)
"ea" = (
/obj/effect/turf_decal/corner/opaque/tan{
	dir = 4
	},
/obj/effect/turf_decal/trimline/opaque/bar/corner{
	dir = 4
	},
/turf/open/floor/plasteel/tech/ngr_outpost_outside,
/area/hangar)
"em" = (
/obj/effect/turf_decal/techfloor{
	dir = 1;
	layer = 2.04
	},
/obj/effect/turf_decal/techfloor,
/obj/machinery/door/airlock/grunge,
/obj/effect/landmark/outpost/elevator_machine,
/turf/open/floor/plasteel/tech/grid,
/area/hangar)
"hh" = (
/obj/structure/chair/bench/red/directional/south,
/obj/structure/sign/poster/contraband/random{
	pixel_y = 32
	},
/turf/open/floor/plasteel/tech/ngr_outpost_outside,
/area/hangar)
"iA" = (
/obj/structure/catwalk/over/plated_catwalk/dark,
/obj/machinery/light/floor/hangar,
/turf/open/floor/hangar,
/area/hangar/agni)
"jp" = (
/obj/machinery/conveyor/auto/outpost{
	dir = 8
	},
/turf/open/floor/plasteel/tech/ngr_outpost_outside,
/area/hangar)
"jJ" = (
/obj/effect/turf_decal/corner/opaque/tan{
	dir = 10
	},
/obj/effect/turf_decal/trimline/opaque/bar/line,
/turf/open/floor/plasteel/tech/ngr_outpost_outside,
/area/hangar/agni)
"kr" = (
/obj/structure/flora/grass/rockplanet/dead,
/turf/open/floor/plating/asteroid/rockplanet/safe/lit/ngr_outpost_outside,
/area/hangar/agni)
"kT" = (
/obj/structure/marker_beacon{
	picked_color = "Teal"
	},
/turf/open/floor/hangar,
/area/hangar/agni)
"mt" = (
/turf/open/floor/plasteel/tech/ngr_outpost_outside,
/area/hangar)
"nA" = (
/obj/structure/plasticflaps/outpost,
/obj/machinery/conveyor/auto/outpost{
	dir = 8
	},
/turf/open/floor/plasteel/tech/ngr_outpost_outside,
/area/hangar)
"nQ" = (
/obj/effect/turf_decal/corner/opaque/tan{
	dir = 8
	},
/obj/effect/turf_decal/trimline/opaque/bar/corner{
	dir = 8
	},
/turf/open/floor/plasteel/tech/ngr_outpost_outside,
/area/hangar/agni)
"pg" = (
/turf/closed/indestructible/plastitanium/nodiagnonal,
/area/hangar/agni)
"pI" = (
/obj/structure/flora/rock/pile/rockplanet,
/turf/open/floor/plating/asteroid/rockplanet/safe/lit/ngr_outpost_outside,
/area/hangar/agni)
"pZ" = (
/obj/structure/chair/bench/red/directional/south,
/turf/open/floor/plasteel/tech/ngr_outpost_outside,
/area/hangar)
"qb" = (
/obj/effect/turf_decal/corner/opaque/tan{
	dir = 1
	},
/obj/effect/turf_decal/trimline/opaque/bar/corner{
	dir = 1
	},
/turf/open/floor/plasteel/tech/ngr_outpost_outside,
/area/hangar)
"qn" = (
/obj/effect/turf_decal/corner/opaque/tan{
	dir = 9
	},
/turf/open/floor/plasteel/tech/ngr_outpost_outside,
/area/hangar/agni)
"rv" = (
/obj/effect/turf_decal/corner/opaque/tan/three_quarters{
	dir = 8
	},
/obj/effect/turf_decal/trimline/opaque/bar/line{
	dir = 5
	},
/turf/open/floor/plasteel/tech/ngr_outpost_outside,
/area/hangar)
"rC" = (
/obj/structure/sign/departments/cargo,
/turf/closed/indestructible/plastitanium/nodiagnonal,
/area/hangar)
"rT" = (
/obj/structure/disposalpipe/segment{
	dir = 4
	},
/turf/closed/indestructible/plastitanium/nodiagnonal,
/area/hangar)
"sl" = (
/obj/structure/flora/tree/cactus,
/turf/open/floor/plating/asteroid/rockplanet/cracked/safe/lit/ngr_outpost_outside,
/area/hangar/agni)
"sq" = (
/obj/effect/turf_decal/techfloor{
	dir = 8
	},
/obj/structure/rack,
/obj/item/clothing/suit/hooded/wintercoat,
/obj/item/clothing/suit/hooded/wintercoat,
/obj/item/clothing/suit/hooded/wintercoat,
/obj/item/clothing/suit/hooded/wintercoat,
/obj/item/clothing/suit/hooded/wintercoat,
/obj/effect/turf_decal/borderfloorblack{
	dir = 4
	},
/turf/open/floor/plasteel/tech/ngr_outpost_outside,
/area/hangar)
"sz" = (
/obj/machinery/disposal/deliveryChute{
	dir = 1
	},
/obj/structure/disposalpipe/trunk{
	dir = 8
	},
/turf/open/floor/plasteel/tech/ngr_outpost_outside,
/area/hangar)
"sD" = (
/obj/structure/disposalpipe/trunk{
	dir = 4
	},
/obj/machinery/conveyor/auto/outpost{
	dir = 1
	},
/obj/structure/disposaloutlet{
	dir = 1
	},
/turf/open/floor/plasteel/tech/ngr_outpost_outside,
/area/hangar)
"sT" = (
/turf/open/floor/plasteel/stairs/mid{
	dir = 1;
	color = "#2e2e2e"
	},
/area/hangar)
"tF" = (
/obj/effect/turf_decal/corner/opaque/tan{
	dir = 5
	},
/obj/effect/turf_decal/trimline/opaque/bar/line{
	dir = 1
	},
/obj/machinery/light/floor/hangar,
/turf/open/floor/plasteel/tech/ngr_outpost_outside,
/area/hangar/agni)
"tH" = (
/obj/machinery/light/floor/hangar,
/obj/effect/turf_decal/corner/opaque/tan{
	dir = 6
	},
/obj/effect/turf_decal/trimline/opaque/bar/line{
	dir = 4
	},
/turf/open/floor/plasteel/tech/ngr_outpost_outside,
/area/hangar/agni)
"tZ" = (
/obj/effect/turf_decal/corner/opaque/tan{
	dir = 5
	},
/obj/effect/turf_decal/trimline/opaque/bar/line{
	dir = 1
	},
/turf/open/floor/plasteel/tech/ngr_outpost_outside,
/area/hangar)
"uT" = (
/obj/structure/flora/rock/rockplanet,
/turf/open/floor/plating/asteroid/rockplanet/cracked/safe/lit/ngr_outpost_outside,
/area/hangar/agni)
"vm" = (
/obj/effect/turf_decal/corner/opaque/tan/three_quarters{
	dir = 4
	},
/obj/effect/turf_decal/trimline/opaque/bar/line{
	dir = 9
	},
/turf/open/floor/plasteel/tech/ngr_outpost_outside,
/area/hangar)
"vq" = (
/obj/effect/landmark/outpost/elevator,
/turf/open/floor/plasteel/elevatorshaft{
	planetary_atmos = 1
	},
/area/hangar)
"vO" = (
/obj/effect/turf_decal/corner/opaque/tan{
	dir = 10
	},
/obj/effect/turf_decal/trimline/opaque/bar/line,
/obj/effect/landmark/outpost/hangar_numbers{
	pixel_x = 0;
	pixel_y = 0
	},
/turf/open/floor/plasteel/tech/ngr_outpost_outside,
/area/hangar/agni)
"vZ" = (
/obj/effect/turf_decal/corner/opaque/tan{
	dir = 6
	},
/obj/effect/turf_decal/trimline/opaque/bar/line{
	dir = 4
	},
/turf/open/floor/plasteel/tech/ngr_outpost_outside,
/area/hangar/agni)
"wV" = (
/obj/structure/flora/grass/rockplanet/dead,
/turf/open/floor/plating/asteroid/rockplanet/cracked/safe/lit/ngr_outpost_outside,
/area/hangar/agni)
"wY" = (
/obj/effect/turf_decal/corner/opaque/tan{
	dir = 9
	},
/obj/effect/turf_decal/trimline/opaque/bar/line{
	dir = 8
	},
/turf/open/floor/plasteel/tech/ngr_outpost_outside,
/area/hangar/agni)
"xh" = (
/obj/effect/turf_decal/corner/opaque/tan/three_quarters{
	dir = 1
	},
/obj/effect/turf_decal/trimline/opaque/bar/filled/shrink_cw{
	layer = 2.032
	},
/turf/open/floor/plasteel/tech/ngr_outpost_outside,
/area/hangar/agni)
"xs" = (
/turf/open/floor/plasteel/tech/ngr_outpost_outside,
/area/hangar/agni)
"xx" = (
/obj/machinery/conveyor/auto/outpost{
	dir = 6;
	verted = -1
	},
/turf/open/floor/plasteel/tech/ngr_outpost_outside,
/area/hangar)
"xD" = (
/turf/open/floor/plating/asteroid/rockplanet/cracked/safe/lit/ngr_outpost_outside,
/area/hangar/agni)
"yo" = (
/obj/effect/landmark/outpost/hangar_dock,
/turf/open/floor/hangar,
/area/hangar/agni)
"yG" = (
/obj/machinery/conveyor/auto/outpost{
	dir = 10
	},
/obj/structure/railing/thin,
/turf/open/floor/plasteel/tech/ngr_outpost_outside,
/area/hangar)
"AZ" = (
/obj/effect/turf_decal/borderfloorblack{
	layer = 2.030
	},
/turf/open/floor/plasteel/tech/ngr_outpost_outside,
/area/hangar/agni)
"Ba" = (
/obj/structure/plasticflaps/outpost,
/obj/machinery/conveyor/auto/outpost{
	dir = 5;
	verted = -1
	},
/turf/open/floor/plasteel/tech/ngr_outpost_outside,
/area/hangar)
"Bq" = (
/obj/effect/turf_decal/techfloor{
	dir = 1
	},
/obj/effect/turf_decal/borderfloorblack,
/turf/open/floor/plasteel/tech/ngr_outpost_outside,
/area/hangar/agni)
"BO" = (
/obj/effect/turf_decal/industrial/loading/stripes/red,
/turf/open/floor/plasteel/tech/ngr_outpost_outside,
/area/hangar)
"Cz" = (
/obj/effect/turf_decal/corner/opaque/tan/three_quarters,
/obj/effect/turf_decal/trimline/opaque/bar/line{
	dir = 6
	},
/turf/open/floor/plasteel/tech/ngr_outpost_outside,
/area/hangar/agni)
"CN" = (
/obj/effect/turf_decal/corner/opaque/tan{
	dir = 1
	},
/obj/effect/turf_decal/trimline/opaque/bar/corner{
	dir = 1
	},
/turf/open/floor/plasteel/tech/ngr_outpost_outside,
/area/hangar/agni)
"Dz" = (
/obj/structure/flora/tree/cactus,
/turf/open/floor/plating/asteroid/rockplanet/safe/lit/ngr_outpost_outside,
/area/hangar/agni)
"DC" = (
/obj/machinery/light/floor/hangar,
/turf/open/floor/plasteel/tech/ngr_outpost_outside,
/area/hangar/agni)
"Gn" = (
/obj/effect/landmark/outpost/elevator_machine,
/obj/machinery/elevator_call_button{
	pixel_y = 25
	},
/obj/effect/turf_decal/techfloor{
	dir = 4
	},
/obj/effect/turf_decal/borderfloorblack{
	layer = 2.030;
	dir = 8
	},
/turf/open/floor/plasteel/tech/ngr_outpost_outside,
/area/hangar)
"GX" = (
/obj/effect/turf_decal/techfloor{
	dir = 8
	},
/obj/structure/rack,
/obj/item/clothing/suit/hooded/wintercoat,
/obj/item/clothing/suit/hooded/wintercoat,
/obj/item/clothing/suit/hooded/wintercoat,
/obj/item/clothing/suit/hooded/wintercoat,
/obj/item/clothing/suit/hooded/wintercoat,
/obj/effect/turf_decal/borderfloorblack{
	dir = 4
	},
/turf/open/floor/plasteel/tech/ngr_outpost_outside,
/area/hangar/agni)
"HX" = (
/turf/open/floor/plasteel/elevatorshaft{
	planetary_atmos = 1
	},
/area/hangar)
"Il" = (
/obj/effect/turf_decal/techfloor{
	dir = 4
	},
/obj/effect/turf_decal/borderfloorblack{
	layer = 2.030;
	dir = 8
	},
/turf/open/floor/plasteel/tech/ngr_outpost_outside,
/area/hangar/agni)
"Jj" = (
/obj/machinery/door/poddoor/ert,
/turf/open/floor/plasteel/elevatorshaft{
	planetary_atmos = 1
	},
/area/hangar)
"Jw" = (
/obj/machinery/light/floor/hangar,
/obj/effect/turf_decal/corner/opaque/tan{
	dir = 10
	},
/obj/effect/turf_decal/trimline/opaque/bar/line,
/turf/open/floor/plasteel/tech/ngr_outpost_outside,
/area/hangar/agni)
"Jz" = (
/obj/machinery/conveyor/auto/outpost{
	dir = 8
	},
/obj/structure/railing/thin,
/turf/open/floor/plasteel/tech/ngr_outpost_outside,
/area/hangar)
"JI" = (
/turf/closed/indestructible/plastitanium/nodiagnonal,
/area/hangar)
"JK" = (
/obj/structure/flora/rock/pile/rockplanet,
/turf/open/floor/plating/asteroid/rockplanet/cracked/safe/lit/ngr_outpost_outside,
/area/hangar/agni)
"Ks" = (
/obj/machinery/door/poddoor/ert,
/turf/closed/indestructible/plastitanium/nodiagnonal,
/area/hangar)
"KV" = (
/turf/closed/indestructible/rock/rockplanet,
/area/hangar)
"Ld" = (
/obj/effect/turf_decal/trimline/opaque/yellow/warning{
	dir = 8
	},
/turf/open/floor/plasteel/tech/ngr_outpost_outside,
/area/hangar/agni)
"Lt" = (
/obj/structure/catwalk/over/plated_catwalk/dark,
/turf/open/floor/hangar,
/area/hangar/agni)
"Mf" = (
/obj/effect/turf_decal/corner/opaque/tan{
	dir = 6
	},
/obj/effect/turf_decal/trimline/opaque/bar/line{
	dir = 4
	},
/obj/structure/sign/directions/supply{
	dir = 1;
	pixel_x = 32;
	pixel_y = -5;
	desc = "A direction sign, pointing out which way the Cargo Delivery Chute is."
	},
/turf/open/floor/plasteel/tech/ngr_outpost_outside,
/area/hangar/agni)
"Op" = (
/obj/effect/turf_decal/borderfloorblack,
/turf/open/floor/plasteel/tech/ngr_outpost_outside,
/area/hangar/agni)
"ON" = (
/obj/machinery/conveyor/auto/outpost,
/obj/effect/landmark/outpost/hangar_crate_spawner,
/turf/open/floor/plasteel/tech/ngr_outpost_outside,
/area/hangar)
"PD" = (
/obj/effect/turf_decal/trimline/opaque/yellow/warning{
	dir = 4
	},
/turf/open/floor/plasteel/tech/ngr_outpost_outside,
/area/hangar/agni)
"Qn" = (
/turf/closed/indestructible/rock/rockplanet,
/area/hangar/agni)
"Ra" = (
/obj/effect/turf_decal/corner/opaque/tan{
	dir = 10
	},
/obj/effect/turf_decal/trimline/opaque/bar/line,
/obj/effect/landmark/outpost/shaft_number,
/turf/open/floor/plasteel/tech/ngr_outpost_outside,
/area/hangar/agni)
"Rr" = (
/obj/effect/turf_decal/industrial/outline/red,
/turf/open/floor/plasteel/tech/ngr_outpost_outside,
/area/hangar)
"Si" = (
/obj/structure/flora/rock/rockplanet,
/turf/open/floor/plating/asteroid/rockplanet/safe/lit/ngr_outpost_outside,
/area/hangar/agni)
"Sk" = (
/turf/open/floor/plating/asteroid/rockplanet/safe/lit/ngr_outpost_outside,
/area/hangar/agni)
"Ss" = (
/obj/machinery/light/dim/directional/north,
/obj/machinery/conveyor/auto/outpost{
	dir = 8
	},
/obj/structure/railing/thin/corner,
/turf/open/floor/plasteel/tech/ngr_outpost_outside,
/area/hangar)
"Th" = (
/obj/effect/turf_decal/corner/opaque/tan{
	dir = 5
	},
/obj/effect/turf_decal/trimline/opaque/bar/line{
	dir = 1
	},
/turf/open/floor/plasteel/tech/ngr_outpost_outside,
/area/hangar/agni)
"TO" = (
/obj/effect/turf_decal/industrial/hatch/red,
/turf/open/floor/plasteel/tech/ngr_outpost_outside,
/area/hangar)
"Vm" = (
/obj/effect/turf_decal/arrows{
	dir = 1
	},
/turf/open/floor/plasteel/tech/ngr_outpost_outside,
/area/hangar/agni)
"Yv" = (
/obj/effect/turf_decal/corner/opaque/tan/three_quarters{
	dir = 1
	},
/obj/effect/turf_decal/trimline/opaque/bar/line{
	dir = 10
	},
/turf/open/floor/plasteel/tech/ngr_outpost_outside,
/area/hangar/agni)
"YB" = (
/obj/effect/turf_decal/techfloor{
	dir = 8
	},
/obj/effect/turf_decal/borderfloorblack{
	dir = 4
	},
/turf/open/floor/plasteel/tech/ngr_outpost_outside,
/area/hangar/agni)
"Zd" = (
/turf/open/floor/hangar,
/area/hangar/agni)

(1,1,1) = {"
Qn
Qn
Qn
Qn
Qn
Qn
Qn
Qn
Qn
Qn
Qn
Qn
Qn
Qn
Qn
Qn
Qn
Qn
Qn
Qn
Qn
Qn
Qn
Qn
Qn
Qn
Qn
Qn
Qn
Qn
Qn
Qn
Qn
Qn
Qn
Qn
Qn
Qn
Qn
"}
(2,1,1) = {"
Qn
Qn
Qn
Qn
Qn
Qn
Qn
Qn
Qn
Qn
Qn
Qn
Qn
Qn
Qn
Qn
Qn
Qn
Qn
Qn
Qn
Qn
Qn
Qn
Qn
Qn
Qn
Qn
Qn
Qn
Qn
Qn
Qn
Qn
Qn
Qn
Qn
Qn
Qn
"}
(3,1,1) = {"
Qn
Qn
Qn
Qn
Qn
Qn
Qn
Qn
Qn
Qn
Qn
Qn
Qn
Qn
Qn
Qn
Qn
Qn
Qn
Qn
Qn
Qn
Qn
Qn
Qn
Qn
Qn
Qn
Qn
Qn
Qn
Qn
Qn
Qn
Qn
Qn
Qn
Qn
Qn
"}
(4,1,1) = {"
Qn
Qn
Qn
Qn
Qn
Qn
Qn
Qn
Qn
bB
qn
xh
Ld
Ld
Ld
Ld
Ld
Ld
Ld
Ld
Ld
Ld
Ld
Ld
Ld
Ld
Ld
Ld
Ld
Ld
Ld
Ld
bB
qn
xh
Qn
Qn
Qn
Qn
"}
(5,1,1) = {"
Qn
Qn
Qn
Qn
Qn
Qn
Qn
Qn
Qn
Th
Lt
jJ
xs
xs
Vm
xs
DC
xs
xs
Vm
xs
xs
xs
xs
Vm
xs
DC
xs
xs
Vm
xs
xs
Th
Lt
jJ
xD
Qn
Qn
Qn
"}
(6,1,1) = {"
Qn
Qn
Qn
Qn
Qn
Qn
Qn
Qn
Qn
Th
Lt
jJ
PD
PD
PD
PD
PD
PD
PD
PD
PD
PD
PD
PD
PD
PD
PD
PD
PD
PD
PD
PD
Th
Lt
jJ
wV
Qn
Qn
Qn
"}
(7,1,1) = {"
Qn
Qn
Qn
Qn
Qn
Qn
Qn
Qn
JK
Th
Lt
jJ
Zd
Zd
Zd
Zd
Zd
Zd
Zd
Zd
Zd
Zd
Zd
Zd
Zd
Zd
Zd
Zd
Zd
Zd
Zd
yo
Th
Lt
jJ
xD
Qn
Qn
Qn
"}
(8,1,1) = {"
Qn
Qn
Qn
Qn
Qn
Qn
Qn
Qn
xD
Th
Lt
jJ
Zd
Zd
Zd
Zd
Zd
Zd
Zd
Zd
Zd
Zd
Zd
Zd
Zd
Zd
Zd
Zd
Zd
Zd
Zd
Zd
Th
Lt
jJ
Si
Qn
Qn
Qn
"}
(9,1,1) = {"
Qn
Qn
Qn
Qn
Qn
Qn
Qn
Qn
wV
Th
Lt
jJ
kT
Zd
Zd
Zd
Zd
Zd
Zd
Zd
Zd
Zd
Zd
Zd
Zd
Zd
Zd
Zd
Zd
Zd
Zd
kT
Th
Lt
jJ
xD
Qn
Qn
Qn
"}
(10,1,1) = {"
Qn
Qn
Qn
Qn
Qn
Qn
Qn
Qn
xD
Th
Lt
jJ
Zd
Zd
Zd
Zd
Zd
Zd
Zd
Zd
Zd
Zd
Zd
Zd
Zd
Zd
Zd
Zd
Zd
Zd
Zd
Zd
Th
Lt
jJ
xD
xD
Qn
Qn
"}
(11,1,1) = {"
Qn
Qn
Qn
Qn
Qn
Qn
Qn
xD
Sk
Th
Lt
Jw
Zd
Zd
Zd
Zd
Zd
Zd
Zd
Zd
Zd
Zd
Zd
Zd
Zd
Zd
Zd
Zd
Zd
Zd
Zd
Zd
tF
Lt
jJ
Sk
xD
Qn
Qn
"}
(12,1,1) = {"
Qn
Qn
Qn
Qn
Qn
Qn
Qn
xD
Sk
Th
Lt
jJ
Zd
Zd
Zd
Zd
Zd
Zd
Zd
Zd
Zd
Zd
Zd
Zd
Zd
Zd
Zd
Zd
Zd
Zd
Zd
Zd
Th
Lt
jJ
Sk
xD
Qn
Qn
"}
(13,1,1) = {"
Qn
Qn
Qn
Qn
Qn
Qn
Qn
xD
Dz
Th
Lt
jJ
Zd
Zd
Zd
Zd
Zd
Zd
Zd
Zd
Zd
Zd
Zd
Zd
Zd
Zd
Zd
Zd
Zd
Zd
Zd
Zd
Th
Lt
jJ
kr
pI
Qn
Qn
"}
(14,1,1) = {"
Qn
Qn
Qn
Qn
Qn
Qn
xD
wV
xD
Th
Lt
jJ
kT
Zd
Zd
Zd
Zd
Zd
Zd
Zd
Zd
Zd
Zd
Zd
Zd
Zd
Zd
Zd
Zd
Zd
Zd
kT
Th
Lt
jJ
Sk
xD
xD
Qn
"}
(15,1,1) = {"
Qn
Qn
Qn
Qn
Qn
Qn
JK
Sk
xD
Th
Lt
jJ
Zd
Zd
Zd
Zd
Zd
Zd
Zd
Zd
Zd
Zd
Zd
Zd
Zd
Zd
Zd
Zd
Zd
Zd
Zd
Zd
Th
Lt
jJ
Sk
Dz
xD
Qn
"}
(16,1,1) = {"
Qn
Qn
Qn
Qn
Qn
Qn
Qn
Qn
uT
Th
Lt
jJ
Zd
Zd
Zd
Zd
Zd
Zd
Zd
Zd
Zd
Zd
Zd
Zd
Zd
Zd
Zd
Zd
Zd
Zd
Zd
Zd
Th
Lt
jJ
Sk
xD
uT
Qn
"}
(17,1,1) = {"
Qn
Qn
Qn
Qn
Qn
Qn
Qn
Qn
Sk
Th
Lt
jJ
Zd
Zd
Zd
Zd
Zd
Zd
Zd
Zd
Zd
Zd
Zd
Zd
Zd
Zd
Zd
Zd
Zd
Zd
Zd
Zd
Th
Lt
jJ
Sk
Sk
Sk
Qn
"}
(18,1,1) = {"
Qn
Qn
Qn
Qn
Qn
Qn
Qn
Qn
Sk
Th
Lt
jJ
Zd
Zd
Zd
Zd
Zd
Zd
Zd
Zd
Zd
Zd
Zd
Zd
Zd
Zd
Zd
Zd
Zd
Zd
Zd
Zd
Th
Lt
jJ
xD
wV
xD
Qn
"}
(19,1,1) = {"
Qn
Qn
Qn
Qn
Qn
Qn
Qn
Qn
kr
Th
Lt
jJ
kT
Zd
Zd
Zd
Zd
Zd
Zd
Zd
Zd
Zd
Zd
Zd
Zd
Zd
Zd
Zd
Zd
Zd
Zd
kT
Th
Lt
jJ
Sk
xD
xD
Qn
"}
(20,1,1) = {"
Qn
Qn
Qn
Qn
Qn
Qn
Qn
Qn
Sk
Th
Lt
jJ
Zd
Zd
Zd
Zd
Zd
Zd
Zd
Zd
Zd
Zd
Zd
Zd
Zd
Zd
Zd
Zd
Zd
Zd
Zd
Zd
Th
Lt
jJ
Sk
xD
Qn
Qn
"}
(21,1,1) = {"
Qn
Qn
Qn
Qn
Qn
Qn
Qn
Qn
Qn
Th
Lt
Jw
Zd
Zd
Zd
Zd
Zd
Zd
Zd
Zd
Zd
Zd
Zd
Zd
Zd
Zd
Zd
Zd
Zd
Zd
Zd
Zd
tF
Lt
jJ
xD
xD
Qn
Qn
"}
(22,1,1) = {"
Qn
Qn
Qn
Qn
Qn
Qn
Qn
Qn
Qn
Th
Lt
jJ
Zd
Zd
Zd
Zd
Zd
Zd
Zd
Zd
Zd
Zd
Zd
Zd
Zd
Zd
Zd
Zd
Zd
Zd
Zd
Zd
Th
Lt
jJ
xD
xD
Qn
Qn
"}
(23,1,1) = {"
Qn
Qn
Qn
Qn
Qn
Qn
Qn
Qn
Qn
Th
Lt
jJ
Zd
Zd
Zd
Zd
Zd
Zd
Zd
Zd
Zd
Zd
Zd
Zd
Zd
Zd
Zd
Zd
Zd
Zd
Zd
Zd
Th
Lt
jJ
Sk
JK
Qn
Qn
"}
(24,1,1) = {"
Qn
Qn
Qn
Qn
Qn
Qn
Qn
Qn
Qn
Th
Lt
jJ
kT
Zd
Zd
Zd
Zd
Zd
Zd
Zd
Zd
Zd
Zd
Zd
Zd
Zd
Zd
Zd
Zd
Zd
Zd
kT
Th
Lt
jJ
kr
xD
Qn
Qn
"}
(25,1,1) = {"
Qn
Qn
Qn
Qn
Qn
Qn
Qn
Qn
Si
Th
Lt
jJ
Zd
Zd
Zd
Zd
Zd
Zd
Zd
Zd
Zd
Zd
Zd
Zd
Zd
Zd
Zd
Zd
Zd
Zd
Zd
Zd
Th
Lt
jJ
Sk
Sk
Qn
Qn
"}
(26,1,1) = {"
Qn
Qn
Qn
Qn
Qn
Qn
Qn
Qn
kr
Th
Lt
jJ
Zd
Zd
Zd
Zd
Zd
Zd
Zd
Zd
Zd
Zd
Zd
Zd
Zd
Zd
Zd
Zd
Zd
Zd
Zd
Zd
Th
Lt
jJ
Dz
kr
Qn
Qn
"}
(27,1,1) = {"
Qn
Qn
Qn
Qn
Qn
Qn
Qn
Qn
Dz
Th
Lt
jJ
Zd
Zd
Zd
Zd
Zd
Zd
Zd
Zd
Zd
Zd
Zd
Zd
Zd
Zd
Zd
Zd
Zd
Zd
Zd
Zd
Th
Lt
jJ
Sk
uT
Qn
Qn
"}
(28,1,1) = {"
Qn
Qn
Qn
Qn
Qn
Qn
Qn
Qn
Qn
Th
Lt
jJ
Zd
Zd
Zd
Zd
Zd
Zd
Zd
Zd
Zd
Zd
Zd
Zd
Zd
Zd
Zd
Zd
Zd
Zd
Zd
Zd
Th
Lt
jJ
Sk
xD
Qn
Qn
"}
(29,1,1) = {"
Qn
Qn
Qn
Qn
Qn
Qn
Qn
Qn
Qn
Th
Lt
jJ
kT
Zd
Zd
Zd
Zd
Zd
Zd
Zd
Zd
Zd
Zd
Zd
Zd
Zd
Zd
Zd
Zd
Zd
Zd
kT
Th
Lt
jJ
Sk
xD
Qn
Qn
"}
(30,1,1) = {"
Qn
Qn
Qn
Qn
Qn
Qn
Qn
Qn
Qn
Th
Lt
jJ
Zd
Zd
Zd
Zd
Zd
Zd
Zd
Zd
Zd
Zd
Zd
Zd
Zd
Zd
Zd
Zd
Zd
Zd
Zd
Zd
Th
Lt
jJ
kr
xD
Qn
Qn
"}
(31,1,1) = {"
Qn
Qn
Qn
Qn
Qn
Qn
Qn
Qn
Qn
Th
Lt
Jw
Zd
Zd
Zd
Zd
Zd
Zd
Zd
Zd
Zd
Zd
Zd
Zd
Zd
Zd
Zd
Zd
Zd
Zd
Zd
Zd
tF
Lt
jJ
Sk
kr
JK
Qn
"}
(32,1,1) = {"
Qn
Qn
Qn
Qn
Qn
Qn
Qn
Qn
Qn
Th
Lt
jJ
Zd
Zd
Zd
Zd
Zd
Zd
Zd
Zd
Zd
Zd
Zd
Zd
Zd
Zd
Zd
Zd
Zd
Zd
Zd
Zd
Th
Lt
jJ
Sk
xD
xD
Qn
"}
(33,1,1) = {"
Qn
Qn
Qn
Qn
Qn
Qn
Qn
Qn
Qn
Th
Lt
jJ
Zd
Zd
Zd
Zd
Zd
Zd
Zd
Zd
Zd
Zd
Zd
Zd
Zd
Zd
Zd
Zd
Zd
Zd
Zd
Zd
Th
Lt
jJ
xD
Sk
xD
Qn
"}
(34,1,1) = {"
Qn
Qn
Qn
Qn
Qn
Qn
Qn
Qn
Qn
Th
Lt
jJ
kT
Zd
Zd
Zd
Zd
Zd
Zd
Zd
Zd
Zd
Zd
Zd
Zd
Zd
Zd
Zd
Zd
Zd
Zd
kT
Th
Lt
jJ
Sk
sl
Sk
Qn
"}
(35,1,1) = {"
Qn
Qn
Qn
Qn
Qn
Qn
Qn
Qn
JK
Th
Lt
jJ
Zd
Zd
Zd
Zd
Zd
Zd
Zd
Zd
Zd
Zd
Zd
Zd
Zd
Zd
Zd
Zd
Zd
Zd
Zd
Zd
Th
Lt
jJ
kr
xD
Sk
Qn
"}
(36,1,1) = {"
Qn
Qn
Qn
Qn
Qn
Qn
Qn
Qn
wV
Th
Lt
jJ
Zd
Zd
Zd
Zd
Zd
Zd
Zd
Zd
Zd
Zd
Zd
Zd
Zd
Zd
Zd
Zd
Zd
Zd
Zd
Zd
Th
Lt
jJ
Sk
Sk
xD
Qn
"}
(37,1,1) = {"
Qn
Qn
Qn
Qn
Qn
Qn
Qn
Qn
xD
Th
Lt
jJ
Zd
Zd
Zd
Zd
Zd
Zd
Zd
Zd
Zd
Zd
Zd
Zd
Zd
Zd
Zd
Zd
Zd
Zd
Zd
Zd
Th
Lt
jJ
Sk
wV
JK
Qn
"}
(38,1,1) = {"
Qn
Qn
Qn
Qn
Qn
Qn
Qn
Qn
Qn
Th
Lt
jJ
Zd
Zd
Zd
Zd
Zd
Zd
Zd
Zd
Zd
Zd
Zd
Zd
Zd
Zd
Zd
Zd
Zd
Zd
Zd
Zd
Th
Lt
jJ
xD
xD
Qn
Qn
"}
(39,1,1) = {"
Qn
Qn
Qn
Qn
Qn
KV
KV
JI
rC
qb
Lt
jJ
kT
Zd
Zd
Zd
Zd
Zd
Zd
Zd
Zd
Zd
Zd
Zd
Zd
Zd
Zd
Zd
Zd
Zd
Zd
kT
Th
Lt
jJ
wV
Qn
Qn
Qn
"}
(40,1,1) = {"
Qn
Qn
Qn
Qn
Qn
KV
KV
JI
TO
BO
Lt
jJ
Zd
Zd
Zd
Zd
Zd
Zd
Zd
Zd
Zd
Zd
Zd
Zd
Zd
Zd
Zd
Zd
Zd
Zd
Zd
Zd
Th
Lt
jJ
kr
Qn
Qn
Qn
"}
(41,1,1) = {"
Qn
Qn
Qn
Qn
Qn
KV
KV
JI
jp
mt
Lt
Jw
Zd
Zd
Zd
Zd
Zd
Zd
Zd
Zd
Zd
Zd
Zd
Zd
Zd
Zd
Zd
Zd
Zd
Zd
Zd
Zd
tF
Lt
jJ
xD
Qn
Qn
Qn
"}
(42,1,1) = {"
Qn
Qn
Qn
Qn
Qn
KV
KV
JI
Ss
mt
Lt
jJ
Zd
Zd
Zd
Zd
Zd
Zd
Zd
Zd
Zd
Zd
Zd
Zd
Zd
Zd
Zd
Zd
Zd
Zd
Zd
Zd
Th
Lt
jJ
xD
Qn
Qn
Qn
"}
(43,1,1) = {"
Qn
Qn
Qn
Qn
Qn
JI
JI
JI
Jz
Rr
Lt
jJ
Zd
Zd
Zd
Zd
Zd
Zd
Zd
Zd
Zd
Zd
Zd
Zd
Zd
Zd
Zd
Zd
Zd
Zd
Zd
Zd
Th
Lt
jJ
Qn
Qn
Qn
Qn
"}
(44,1,1) = {"
Qn
Qn
Qn
Qn
Qn
JI
Ba
dr
yG
Rr
Lt
jJ
kT
Zd
Zd
Zd
Zd
Zd
Zd
Zd
Zd
Zd
Zd
Zd
Zd
Zd
Zd
Zd
Zd
Zd
Zd
kT
Th
Lt
jJ
Qn
Qn
Qn
Qn
"}
(45,1,1) = {"
Qn
Qn
Qn
Qn
Qn
JI
nA
JI
rC
mt
Lt
jJ
Zd
Zd
Zd
Zd
Zd
Zd
Zd
Zd
Zd
Zd
Zd
Zd
Zd
Zd
Zd
Zd
Zd
Zd
Zd
Zd
Th
Lt
jJ
Qn
Qn
Qn
Qn
"}
(46,1,1) = {"
Qn
Qn
Qn
Qn
Qn
JI
xx
sD
JI
pZ
Lt
jJ
Zd
Zd
Zd
Zd
Zd
Zd
Zd
Zd
Zd
Zd
Zd
Zd
Zd
Zd
Zd
Zd
Zd
Zd
Zd
Zd
Th
Lt
jJ
Qn
Qn
Qn
Qn
"}
(47,1,1) = {"
Qn
Qn
Qn
Qn
Qn
JI
JI
rT
JI
hh
xs
nQ
wY
wY
wY
wY
wY
wY
wY
wY
wY
wY
wY
wY
wY
wY
wY
wY
wY
wY
wY
wY
CN
Lt
jJ
Qn
Qn
Qn
Qn
"}
(48,1,1) = {"
Qn
Qn
Qn
Qn
Qn
JI
ON
sz
JI
ea
xs
Lt
Lt
Lt
Lt
Lt
Lt
Lt
Lt
Lt
Lt
Lt
Lt
Lt
Lt
Lt
Lt
Lt
Lt
Lt
Lt
Lt
Lt
Lt
jJ
xD
Qn
Qn
Qn
"}
(49,1,1) = {"
Qn
Qn
Qn
Qn
Qn
JI
JI
JI
JI
rv
vZ
vZ
vZ
tH
vZ
Mf
vZ
vZ
vZ
vZ
vZ
vZ
vZ
vZ
vZ
vZ
vZ
vZ
vZ
vZ
tH
vZ
vZ
vZ
Cz
wV
Qn
Qn
Qn
"}
(50,1,1) = {"
Qn
Qn
Qn
Qn
Qn
Qn
Qn
Qn
Qn
Qn
Qn
Qn
Qn
Qn
Qn
pg
Qn
xD
xD
xD
xD
Op
Lt
AZ
xD
xD
Sk
Sk
Sk
Sk
wV
Sk
Sk
Sk
xD
JK
xD
Qn
Qn
"}
(51,1,1) = {"
Qn
Qn
Qn
Qn
Qn
Qn
Qn
Qn
Qn
Qn
Qn
Qn
Qn
Qn
Qn
Qn
Qn
Qn
xD
xD
Sk
Op
Lt
AZ
xD
xD
xD
xD
Qn
xD
xD
sl
uT
kr
xD
Qn
Qn
Qn
Qn
"}
(52,1,1) = {"
KV
KV
KV
JI
JI
JI
JI
JI
JI
JI
JI
JI
JI
JI
JI
JI
JI
JI
JI
JI
Gn
Il
Il
Il
Il
xD
xD
Sk
Qn
Qn
xD
xD
xD
xD
Qn
Qn
Qn
Qn
Qn
"}
(53,1,1) = {"
KV
KV
KV
Ks
HX
HX
sT
HX
HX
sT
HX
HX
sT
JI
HX
HX
HX
HX
vq
JI
vm
wY
wY
wY
Yv
Bq
Sk
Qn
Qn
Qn
Qn
xD
Qn
Qn
Qn
Qn
Qn
Qn
Qn
"}
(54,1,1) = {"
KV
KV
KV
Jj
HX
HX
sT
HX
HX
sT
HX
HX
sT
JI
HX
HX
HX
HX
HX
em
tZ
Lt
Lt
Lt
Ra
Bq
Sk
Qn
Qn
Qn
Qn
Qn
Qn
Qn
Qn
Qn
Qn
Qn
Qn
"}
(55,1,1) = {"
KV
KV
KV
Jj
HX
HX
sT
HX
HX
sT
HX
HX
sT
JI
HX
HX
HX
HX
HX
em
tZ
iA
Lt
iA
jJ
Bq
Dz
Qn
Qn
Qn
Qn
Qn
Qn
Qn
Qn
Qn
Qn
Qn
Qn
"}
(56,1,1) = {"
KV
KV
KV
Jj
HX
HX
sT
HX
HX
sT
HX
HX
sT
JI
HX
HX
HX
HX
HX
em
tZ
Lt
Lt
Lt
vO
Bq
xD
Qn
Qn
Qn
Qn
Qn
Qn
Qn
Qn
Qn
Qn
Qn
Qn
"}
(57,1,1) = {"
KV
KV
KV
Ks
HX
HX
sT
HX
HX
sT
HX
HX
sT
JI
HX
HX
HX
HX
HX
JI
rv
vZ
vZ
vZ
Cz
Bq
Qn
Qn
Qn
Qn
Qn
Qn
Qn
Qn
Qn
Qn
Qn
Qn
Qn
"}
(58,1,1) = {"
KV
KV
KV
JI
JI
JI
JI
JI
JI
JI
JI
JI
JI
JI
JI
JI
JI
JI
JI
JI
sq
GX
YB
YB
YB
xD
Qn
Qn
Qn
Qn
Qn
Qn
Qn
Qn
Qn
Qn
Qn
Qn
Qn
"}
(59,1,1) = {"
Qn
Qn
Qn
Qn
Qn
Qn
Qn
Qn
Qn
Qn
Qn
Qn
Qn
Qn
Qn
Qn
Qn
Qn
Qn
Qn
Qn
Qn
Qn
Si
JK
Qn
Qn
Qn
Qn
Qn
Qn
Qn
Qn
Qn
Qn
Qn
Qn
Qn
Qn
"}
(60,1,1) = {"
Qn
Qn
Qn
Qn
Qn
Qn
Qn
Qn
Qn
Qn
Qn
Qn
Qn
Qn
Qn
Qn
Qn
Qn
Qn
Qn
Qn
Qn
Qn
Qn
Qn
Qn
Qn
Qn
Qn
Qn
Qn
Qn
Qn
Qn
Qn
Qn
Qn
Qn
Qn
"}
(61,1,1) = {"
Qn
Qn
Qn
Qn
Qn
Qn
Qn
Qn
Qn
Qn
Qn
Qn
Qn
Qn
Qn
Qn
Qn
Qn
Qn
Qn
Qn
Qn
Qn
Qn
Qn
Qn
Qn
Qn
Qn
Qn
Qn
Qn
Qn
Qn
Qn
Qn
Qn
Qn
Qn
"}
(62,1,1) = {"
Qn
Qn
Qn
Qn
Qn
Qn
Qn
Qn
Qn
Qn
Qn
Qn
Qn
Qn
Qn
Qn
Qn
Qn
Qn
Qn
Qn
Qn
Qn
Qn
Qn
Qn
Qn
Qn
Qn
Qn
Qn
Qn
Qn
Qn
Qn
Qn
Qn
Qn
Qn
"}
