//MAP CONVERTED BY dmm2tgm.py THIS HEADER COMMENT PREVENTS RECONVERSION, DO NOT REMOVE
"aW" = (
/obj/effect/turf_decal/corner/opaque/tan/three_quarters{
	dir = 8
	},
/obj/effect/turf_decal/trimline/opaque/bar/line{
	dir = 5
	},
/turf/open/floor/plasteel/tech/ngr_outpost_outside,
/area/hangar)
"bV" = (
/obj/effect/turf_decal/trimline/opaque/yellow/warning{
	dir = 8
	},
/turf/open/floor/plasteel/tech/ngr_outpost_outside,
/area/hangar)
"ci" = (
/obj/structure/disposalpipe/segment{
	dir = 4
	},
/turf/closed/indestructible/plastitanium/nodiagnonal,
/area/hangar)
"cX" = (
/turf/open/floor/plating/asteroid/rockplanet/safe/lit/ngr_outpost_outside,
/area/hangar)
"dz" = (
/obj/machinery/conveyor/auto/outpost,
/obj/structure/plasticflaps/outpost,
/turf/open/floor/plasteel/tech/ngr_outpost_outside,
/area/hangar)
"dA" = (
/obj/structure/chair/bench/red/directional/south,
/obj/structure/sign/poster/contraband/random{
	pixel_y = 32
	},
/turf/open/floor/plasteel/tech/ngr_outpost_outside,
/area/hangar)
"eh" = (
/obj/structure/flora/rock/rockplanet,
/turf/open/floor/plating/asteroid/rockplanet/safe/lit/ngr_outpost_outside,
/area/hangar)
"ei" = (
/obj/effect/landmark/outpost/elevator_machine,
/obj/machinery/elevator_call_button{
	pixel_y = 25
	},
/obj/effect/turf_decal/techfloor{
	dir = 4
	},
/obj/effect/turf_decal/borderfloorblack{
	layer = 2.030;
	dir = 8
	},
/turf/open/floor/plasteel/tech/ngr_outpost_outside,
/area/hangar)
"ew" = (
/obj/effect/turf_decal/corner/opaque/tan{
	dir = 4
	},
/obj/effect/turf_decal/trimline/opaque/bar/corner{
	dir = 4
	},
/turf/open/floor/plasteel/tech/ngr_outpost_outside,
/area/hangar)
"ez" = (
/obj/effect/turf_decal/trimline/opaque/yellow/warning{
	dir = 4
	},
/turf/open/floor/plasteel/tech/ngr_outpost_outside,
/area/hangar)
"eU" = (
/obj/effect/landmark/outpost/elevator,
/turf/open/floor/plasteel/elevatorshaft{
	planetary_atmos = 1
	},
/area/hangar)
"fl" = (
/obj/structure/flora/tree/cactus,
/turf/open/floor/plating/asteroid/rockplanet/safe/lit/ngr_outpost_outside,
/area/hangar)
"ho" = (
/obj/effect/turf_decal/corner/opaque/tan{
	dir = 5
	},
/obj/effect/turf_decal/trimline/opaque/bar/line{
	dir = 1
	},
/turf/open/floor/plasteel/tech/ngr_outpost_outside,
/area/hangar)
"hs" = (
/obj/machinery/door/poddoor/ert,
/turf/open/floor/plasteel/elevatorshaft{
	planetary_atmos = 1
	},
/area/hangar)
"hO" = (
/obj/effect/turf_decal/industrial/hatch/red,
/turf/open/floor/plasteel/tech/ngr_outpost_outside,
/area/hangar)
"jA" = (
/obj/effect/turf_decal/techfloor{
	dir = 8
	},
/obj/effect/turf_decal/borderfloorblack{
	dir = 4
	},
/turf/open/floor/plasteel/tech/ngr_outpost_outside,
/area/hangar)
"ks" = (
/obj/effect/turf_decal/techfloor{
	dir = 8
	},
/obj/structure/rack,
/obj/item/clothing/suit/hooded/wintercoat,
/obj/item/clothing/suit/hooded/wintercoat,
/obj/item/clothing/suit/hooded/wintercoat,
/obj/item/clothing/suit/hooded/wintercoat,
/obj/item/clothing/suit/hooded/wintercoat,
/obj/effect/turf_decal/borderfloorblack{
	dir = 4
	},
/turf/open/floor/plasteel/tech/ngr_outpost_outside,
/area/hangar)
"kB" = (
/turf/open/floor/plasteel/stairs/mid{
	dir = 1;
	color = "#2e2e2e"
	},
/area/hangar)
"lh" = (
/obj/structure/flora/grass/rockplanet/dead,
/turf/open/floor/plating/asteroid/rockplanet/safe/lit/ngr_outpost_outside,
/area/hangar)
"nx" = (
/obj/effect/turf_decal/borderfloorblack{
	layer = 2.030
	},
/turf/open/floor/plasteel/tech/ngr_outpost_outside,
/area/hangar)
"rH" = (
/turf/open/floor/plasteel/tech/ngr_outpost_outside,
/area/hangar)
"rS" = (
/obj/structure/chair/bench/red/directional/south,
/turf/open/floor/plasteel/tech/ngr_outpost_outside,
/area/hangar)
"sk" = (
/turf/closed/indestructible/plastitanium/nodiagnonal,
/area/hangar)
"sy" = (
/obj/machinery/conveyor/auto/outpost{
	dir = 8
	},
/turf/open/floor/plasteel/tech/ngr_outpost_outside,
/area/hangar)
"td" = (
/obj/effect/turf_decal/industrial/loading/stripes/red,
/turf/open/floor/plasteel/tech/ngr_outpost_outside,
/area/hangar)
"tB" = (
/obj/effect/turf_decal/corner/opaque/tan{
	dir = 5
	},
/obj/effect/turf_decal/trimline/opaque/bar/line{
	dir = 1
	},
/obj/machinery/light/floor/hangar,
/turf/open/floor/plasteel/tech/ngr_outpost_outside,
/area/hangar)
"tU" = (
/turf/open/floor/plasteel/elevatorshaft{
	planetary_atmos = 1
	},
/area/hangar)
"uk" = (
/obj/effect/turf_decal/corner/opaque/tan{
	dir = 9
	},
/turf/open/floor/plasteel/tech/ngr_outpost_outside,
/area/hangar)
"uO" = (
/turf/open/floor/plating/asteroid/rockplanet/cracked/safe/lit/ngr_outpost_outside,
/area/hangar)
"vo" = (
/obj/machinery/conveyor/auto/outpost{
	dir = 8
	},
/obj/structure/railing/thin,
/turf/open/floor/plasteel/tech/ngr_outpost_outside,
/area/hangar)
"vS" = (
/obj/effect/turf_decal/industrial/outline/red,
/turf/open/floor/plasteel/tech/ngr_outpost_outside,
/area/hangar)
"wr" = (
/obj/effect/turf_decal/corner/opaque/tan{
	dir = 6
	},
/obj/effect/turf_decal/trimline/opaque/bar/line{
	dir = 4
	},
/obj/structure/sign/directions/supply{
	dir = 1;
	pixel_x = 32;
	pixel_y = -5;
	desc = "A direction sign, pointing out which way the Cargo Delivery Chute is."
	},
/turf/open/floor/plasteel/tech/ngr_outpost_outside,
/area/hangar)
"wG" = (
/obj/effect/turf_decal/arrows{
	dir = 1
	},
/turf/open/floor/plasteel/tech/ngr_outpost_outside,
/area/hangar)
"zl" = (
/turf/closed/indestructible/rock/rockplanet,
/area/hangar)
"zr" = (
/obj/structure/marker_beacon{
	picked_color = "Teal"
	},
/turf/open/floor/hangar,
/area/hangar)
"zM" = (
/obj/effect/turf_decal/techfloor{
	dir = 4
	},
/obj/effect/turf_decal/borderfloorblack{
	layer = 2.030;
	dir = 8
	},
/turf/open/floor/plasteel/tech/ngr_outpost_outside,
/area/hangar)
"zN" = (
/obj/effect/turf_decal/corner/opaque/tan/three_quarters{
	dir = 4
	},
/obj/effect/turf_decal/trimline/opaque/bar/line{
	dir = 9
	},
/turf/open/floor/plasteel/tech/ngr_outpost_outside,
/area/hangar)
"BC" = (
/obj/effect/turf_decal/techfloor{
	dir = 1
	},
/obj/effect/turf_decal/borderfloorblack,
/turf/open/floor/plasteel/tech/ngr_outpost_outside,
/area/hangar)
"BD" = (
/obj/machinery/light/floor/hangar,
/obj/effect/turf_decal/corner/opaque/tan{
	dir = 10
	},
/obj/effect/turf_decal/trimline/opaque/bar/line,
/turf/open/floor/plasteel/tech/ngr_outpost_outside,
/area/hangar)
"De" = (
/obj/structure/flora/rock/rockplanet,
/turf/open/floor/plating/asteroid/rockplanet/cracked/safe/lit/ngr_outpost_outside,
/area/hangar)
"DX" = (
/obj/machinery/disposal/deliveryChute{
	dir = 1
	},
/obj/structure/disposalpipe/trunk{
	dir = 8
	},
/turf/open/floor/plasteel/tech/ngr_outpost_outside,
/area/hangar)
"Eu" = (
/obj/machinery/conveyor/auto/outpost{
	dir = 10
	},
/obj/structure/railing/thin,
/turf/open/floor/plasteel/tech/ngr_outpost_outside,
/area/hangar)
"ED" = (
/obj/effect/turf_decal/corner/opaque/tan/three_quarters{
	dir = 4
	},
/obj/effect/turf_decal/trimline/opaque/bar/filled/shrink_ccw{
	dir = 1
	},
/turf/open/floor/plasteel/tech/ngr_outpost_outside,
/area/hangar)
"FP" = (
/obj/structure/plasticflaps/outpost,
/obj/machinery/conveyor/auto/outpost{
	dir = 5;
	verted = -1
	},
/turf/open/floor/plasteel/tech/ngr_outpost_outside,
/area/hangar)
"Hi" = (
/obj/structure/flora/rock/pile/rockplanet,
/turf/open/floor/plating/asteroid/rockplanet/safe/lit/ngr_outpost_outside,
/area/hangar)
"Hs" = (
/obj/effect/turf_decal/techfloor{
	dir = 1;
	layer = 2.04
	},
/obj/effect/turf_decal/techfloor,
/obj/machinery/door/airlock/grunge,
/obj/effect/landmark/outpost/elevator_machine,
/turf/open/floor/plasteel/tech/grid,
/area/hangar)
"Id" = (
/obj/effect/turf_decal/corner/opaque/tan{
	dir = 6
	},
/obj/effect/turf_decal/trimline/opaque/bar/line{
	dir = 4
	},
/turf/open/floor/plasteel/tech/ngr_outpost_outside,
/area/hangar)
"IB" = (
/turf/open/floor/hangar,
/area/hangar)
"II" = (
/obj/structure/flora/tree/cactus,
/turf/open/floor/plating/asteroid/rockplanet/cracked/safe/lit/ngr_outpost_outside,
/area/hangar)
"Jc" = (
/obj/machinery/conveyor/auto/outpost{
	dir = 6;
	verted = -1
	},
/turf/open/floor/plasteel/tech/ngr_outpost_outside,
/area/hangar)
"Jl" = (
/obj/effect/turf_decal/corner/opaque/tan/three_quarters,
/obj/effect/turf_decal/trimline/opaque/bar/line{
	dir = 6
	},
/turf/open/floor/plasteel/tech/ngr_outpost_outside,
/area/hangar)
"Kr" = (
/obj/machinery/light/floor/hangar,
/turf/open/floor/plasteel/tech/ngr_outpost_outside,
/area/hangar)
"KE" = (
/obj/effect/turf_decal/corner/opaque/tan{
	dir = 10
	},
/obj/effect/turf_decal/trimline/opaque/bar/line,
/obj/effect/landmark/outpost/shaft_number,
/turf/open/floor/plasteel/tech/ngr_outpost_outside,
/area/hangar)
"Mg" = (
/obj/effect/turf_decal/corner/opaque/tan/three_quarters{
	dir = 1
	},
/obj/effect/turf_decal/trimline/opaque/bar/filled/shrink_cw{
	layer = 2.032
	},
/turf/open/floor/plasteel/tech/ngr_outpost_outside,
/area/hangar)
"Nr" = (
/obj/effect/turf_decal/corner/opaque/tan{
	dir = 10
	},
/obj/effect/turf_decal/trimline/opaque/bar/line,
/turf/open/floor/plasteel/tech/ngr_outpost_outside,
/area/hangar)
"Nx" = (
/obj/structure/disposalpipe/trunk{
	dir = 4
	},
/obj/machinery/conveyor/auto/outpost{
	dir = 1
	},
/obj/structure/disposaloutlet{
	dir = 1
	},
/turf/open/floor/plasteel/tech/ngr_outpost_outside,
/area/hangar)
"NP" = (
/obj/machinery/light/dim/directional/north,
/obj/machinery/conveyor/auto/outpost{
	dir = 8
	},
/obj/structure/railing/thin/corner,
/turf/open/floor/plasteel/tech/ngr_outpost_outside,
/area/hangar)
"Og" = (
/obj/effect/turf_decal/corner/opaque/tan{
	dir = 9
	},
/obj/effect/turf_decal/trimline/opaque/bar/line{
	dir = 8
	},
/turf/open/floor/plasteel/tech/ngr_outpost_outside,
/area/hangar)
"Op" = (
/obj/structure/catwalk/over/plated_catwalk/dark,
/obj/machinery/light/floor/hangar,
/turf/open/floor/hangar,
/area/hangar)
"PD" = (
/obj/effect/turf_decal/corner/opaque/tan{
	dir = 1
	},
/obj/effect/turf_decal/trimline/opaque/bar/corner{
	dir = 1
	},
/turf/open/floor/plasteel/tech/ngr_outpost_outside,
/area/hangar)
"RA" = (
/obj/machinery/light/floor/hangar,
/obj/effect/turf_decal/corner/opaque/tan{
	dir = 6
	},
/obj/effect/turf_decal/trimline/opaque/bar/line{
	dir = 4
	},
/turf/open/floor/plasteel/tech/ngr_outpost_outside,
/area/hangar)
"Sv" = (
/obj/effect/turf_decal/corner/opaque/tan{
	dir = 10
	},
/obj/effect/turf_decal/trimline/opaque/bar/line,
/obj/effect/landmark/outpost/hangar_numbers{
	pixel_x = 0;
	pixel_y = 0
	},
/turf/open/floor/plasteel/tech/ngr_outpost_outside,
/area/hangar)
"SV" = (
/obj/structure/plasticflaps/outpost,
/obj/machinery/conveyor/auto/outpost{
	dir = 8
	},
/turf/open/floor/plasteel/tech/ngr_outpost_outside,
/area/hangar)
"SY" = (
/obj/machinery/door/poddoor/ert,
/turf/closed/indestructible/plastitanium/nodiagnonal,
/area/hangar)
"Tv" = (
/obj/effect/landmark/outpost/hangar_dock,
/turf/open/floor/hangar,
/area/hangar)
"TB" = (
/obj/structure/catwalk/over/plated_catwalk/dark,
/turf/open/floor/hangar,
/area/hangar)
"TE" = (
/obj/machinery/conveyor/auto/outpost,
/obj/effect/landmark/outpost/hangar_crate_spawner,
/turf/open/floor/plasteel/tech/ngr_outpost_outside,
/area/hangar)
"VK" = (
/obj/effect/turf_decal/borderfloorblack,
/turf/open/floor/plasteel/tech/ngr_outpost_outside,
/area/hangar)
"Xg" = (
/obj/effect/turf_decal/corner/opaque/tan{
	dir = 8
	},
/obj/effect/turf_decal/trimline/opaque/bar/corner{
	dir = 8
	},
/turf/open/floor/plasteel/tech/ngr_outpost_outside,
/area/hangar)
"XF" = (
/obj/structure/flora/grass/rockplanet/dead,
/turf/open/floor/plating/asteroid/rockplanet/cracked/safe/lit/ngr_outpost_outside,
/area/hangar)
"Ye" = (
/obj/structure/sign/departments/cargo,
/turf/closed/indestructible/plastitanium/nodiagnonal,
/area/hangar)
"Yu" = (
/obj/structure/flora/rock/pile/rockplanet,
/turf/open/floor/plating/asteroid/rockplanet/cracked/safe/lit/ngr_outpost_outside,
/area/hangar)
"Zw" = (
/obj/effect/turf_decal/corner/opaque/tan/three_quarters{
	dir = 1
	},
/obj/effect/turf_decal/trimline/opaque/bar/line{
	dir = 10
	},
/turf/open/floor/plasteel/tech/ngr_outpost_outside,
/area/hangar)

(1,1,1) = {"
zl
zl
zl
zl
zl
zl
zl
zl
zl
zl
zl
zl
zl
zl
zl
zl
zl
zl
zl
zl
zl
zl
zl
zl
zl
zl
zl
zl
zl
zl
zl
zl
zl
zl
zl
zl
zl
zl
zl
zl
zl
zl
zl
zl
zl
zl
zl
zl
zl
zl
zl
zl
zl
zl
zl
zl
zl
zl
zl
"}
(2,1,1) = {"
zl
zl
zl
zl
zl
zl
zl
zl
zl
zl
zl
zl
zl
zl
zl
zl
zl
zl
zl
zl
zl
zl
zl
zl
zl
zl
zl
zl
zl
zl
zl
zl
zl
zl
zl
zl
zl
zl
zl
zl
zl
zl
zl
zl
zl
zl
zl
zl
zl
zl
zl
zl
zl
zl
zl
zl
zl
zl
zl
"}
(3,1,1) = {"
zl
zl
zl
zl
zl
zl
zl
zl
zl
zl
zl
zl
zl
zl
zl
zl
zl
zl
zl
zl
zl
zl
zl
zl
zl
zl
zl
zl
zl
zl
zl
zl
zl
zl
zl
zl
zl
zl
zl
zl
zl
zl
zl
zl
zl
zl
zl
zl
zl
zl
zl
zl
zl
zl
zl
zl
zl
zl
zl
"}
(4,1,1) = {"
zl
zl
zl
zl
zl
zl
zl
zl
zl
ED
uk
Mg
bV
bV
bV
bV
bV
bV
bV
bV
bV
bV
bV
bV
bV
bV
bV
bV
bV
bV
bV
bV
bV
bV
bV
bV
bV
bV
bV
bV
bV
bV
bV
bV
bV
bV
bV
bV
bV
bV
bV
bV
ED
uk
Mg
zl
zl
zl
zl
"}
(5,1,1) = {"
zl
zl
zl
zl
zl
zl
zl
zl
zl
ho
TB
Nr
rH
rH
wG
rH
Kr
rH
rH
wG
rH
rH
rH
rH
wG
rH
Kr
rH
rH
wG
rH
rH
rH
rH
wG
rH
Kr
rH
rH
wG
rH
rH
rH
rH
wG
rH
Kr
rH
rH
wG
rH
rH
ho
TB
Nr
uO
zl
zl
zl
"}
(6,1,1) = {"
zl
zl
zl
zl
zl
zl
zl
zl
zl
ho
TB
Nr
ez
ez
ez
ez
ez
ez
ez
ez
ez
ez
ez
ez
ez
ez
ez
ez
ez
ez
ez
ez
ez
ez
ez
ez
ez
ez
ez
ez
ez
ez
ez
ez
ez
ez
ez
ez
ez
ez
ez
ez
ho
TB
Nr
XF
zl
zl
zl
"}
(7,1,1) = {"
zl
zl
zl
zl
zl
zl
zl
zl
Yu
ho
TB
Nr
IB
IB
IB
IB
IB
IB
IB
IB
IB
IB
IB
IB
IB
IB
IB
IB
IB
IB
IB
IB
IB
IB
IB
IB
IB
IB
IB
IB
IB
IB
IB
IB
IB
IB
IB
IB
IB
IB
IB
Tv
ho
TB
Nr
uO
zl
zl
zl
"}
(8,1,1) = {"
zl
zl
zl
zl
zl
zl
zl
zl
uO
ho
TB
Nr
IB
IB
IB
IB
IB
IB
IB
IB
IB
IB
IB
IB
IB
IB
IB
IB
IB
IB
IB
IB
IB
IB
IB
IB
IB
IB
IB
IB
IB
IB
IB
IB
IB
IB
IB
IB
IB
IB
IB
IB
ho
TB
Nr
eh
zl
zl
zl
"}
(9,1,1) = {"
zl
zl
zl
zl
zl
zl
zl
zl
XF
ho
TB
Nr
zr
IB
IB
IB
IB
IB
IB
IB
IB
IB
IB
IB
IB
IB
IB
IB
IB
IB
IB
IB
IB
IB
IB
IB
IB
IB
IB
IB
IB
IB
IB
IB
IB
IB
IB
IB
IB
IB
IB
zr
ho
TB
Nr
uO
zl
zl
zl
"}
(10,1,1) = {"
zl
zl
zl
zl
zl
zl
zl
zl
uO
ho
TB
Nr
IB
IB
IB
IB
IB
IB
IB
IB
IB
IB
IB
IB
IB
IB
IB
IB
IB
IB
IB
IB
IB
IB
IB
IB
IB
IB
IB
IB
IB
IB
IB
IB
IB
IB
IB
IB
IB
IB
IB
IB
ho
TB
Nr
uO
uO
zl
zl
"}
(11,1,1) = {"
zl
zl
zl
zl
zl
zl
zl
uO
cX
ho
TB
BD
IB
IB
IB
IB
IB
IB
IB
IB
IB
IB
IB
IB
IB
IB
IB
IB
IB
IB
IB
IB
IB
IB
IB
IB
IB
IB
IB
IB
IB
IB
IB
IB
IB
IB
IB
IB
IB
IB
IB
IB
tB
TB
Nr
cX
uO
zl
zl
"}
(12,1,1) = {"
zl
zl
zl
zl
zl
zl
zl
uO
cX
ho
TB
Nr
IB
IB
IB
IB
IB
IB
IB
IB
IB
IB
IB
IB
IB
IB
IB
IB
IB
IB
IB
IB
IB
IB
IB
IB
IB
IB
IB
IB
IB
IB
IB
IB
IB
IB
IB
IB
IB
IB
IB
IB
ho
TB
Nr
cX
uO
zl
zl
"}
(13,1,1) = {"
zl
zl
zl
zl
zl
zl
zl
uO
fl
ho
TB
Nr
IB
IB
IB
IB
IB
IB
IB
IB
IB
IB
IB
IB
IB
IB
IB
IB
IB
IB
IB
IB
IB
IB
IB
IB
IB
IB
IB
IB
IB
IB
IB
IB
IB
IB
IB
IB
IB
IB
IB
IB
ho
TB
Nr
lh
Hi
zl
zl
"}
(14,1,1) = {"
zl
zl
zl
zl
zl
zl
uO
XF
uO
ho
TB
Nr
zr
IB
IB
IB
IB
IB
IB
IB
IB
IB
IB
IB
IB
IB
IB
IB
IB
IB
IB
IB
IB
IB
IB
IB
IB
IB
IB
IB
IB
IB
IB
IB
IB
IB
IB
IB
IB
IB
IB
zr
ho
TB
Nr
cX
uO
uO
zl
"}
(15,1,1) = {"
zl
zl
zl
zl
zl
zl
Yu
cX
uO
ho
TB
Nr
IB
IB
IB
IB
IB
IB
IB
IB
IB
IB
IB
IB
IB
IB
IB
IB
IB
IB
IB
IB
IB
IB
IB
IB
IB
IB
IB
IB
IB
IB
IB
IB
IB
IB
IB
IB
IB
IB
IB
IB
ho
TB
Nr
cX
fl
uO
zl
"}
(16,1,1) = {"
zl
zl
zl
zl
zl
zl
zl
zl
De
ho
TB
Nr
IB
IB
IB
IB
IB
IB
IB
IB
IB
IB
IB
IB
IB
IB
IB
IB
IB
IB
IB
IB
IB
IB
IB
IB
IB
IB
IB
IB
IB
IB
IB
IB
IB
IB
IB
IB
IB
IB
IB
IB
ho
TB
Nr
cX
uO
De
zl
"}
(17,1,1) = {"
zl
zl
zl
zl
zl
zl
zl
zl
cX
ho
TB
Nr
IB
IB
IB
IB
IB
IB
IB
IB
IB
IB
IB
IB
IB
IB
IB
IB
IB
IB
IB
IB
IB
IB
IB
IB
IB
IB
IB
IB
IB
IB
IB
IB
IB
IB
IB
IB
IB
IB
IB
IB
ho
TB
Nr
cX
cX
cX
zl
"}
(18,1,1) = {"
zl
zl
zl
zl
zl
zl
zl
zl
cX
ho
TB
Nr
IB
IB
IB
IB
IB
IB
IB
IB
IB
IB
IB
IB
IB
IB
IB
IB
IB
IB
IB
IB
IB
IB
IB
IB
IB
IB
IB
IB
IB
IB
IB
IB
IB
IB
IB
IB
IB
IB
IB
IB
ho
TB
Nr
uO
XF
uO
zl
"}
(19,1,1) = {"
zl
zl
zl
zl
zl
zl
zl
zl
lh
ho
TB
Nr
zr
IB
IB
IB
IB
IB
IB
IB
IB
IB
IB
IB
IB
IB
IB
IB
IB
IB
IB
IB
IB
IB
IB
IB
IB
IB
IB
IB
IB
IB
IB
IB
IB
IB
IB
IB
IB
IB
IB
zr
ho
TB
Nr
cX
uO
uO
zl
"}
(20,1,1) = {"
zl
zl
zl
zl
zl
zl
zl
zl
cX
ho
TB
Nr
IB
IB
IB
IB
IB
IB
IB
IB
IB
IB
IB
IB
IB
IB
IB
IB
IB
IB
IB
IB
IB
IB
IB
IB
IB
IB
IB
IB
IB
IB
IB
IB
IB
IB
IB
IB
IB
IB
IB
IB
ho
TB
Nr
cX
uO
zl
zl
"}
(21,1,1) = {"
zl
zl
zl
zl
zl
zl
zl
zl
zl
ho
TB
BD
IB
IB
IB
IB
IB
IB
IB
IB
IB
IB
IB
IB
IB
IB
IB
IB
IB
IB
IB
IB
IB
IB
IB
IB
IB
IB
IB
IB
IB
IB
IB
IB
IB
IB
IB
IB
IB
IB
IB
IB
tB
TB
Nr
uO
uO
zl
zl
"}
(22,1,1) = {"
zl
zl
zl
zl
zl
zl
zl
zl
zl
ho
TB
Nr
IB
IB
IB
IB
IB
IB
IB
IB
IB
IB
IB
IB
IB
IB
IB
IB
IB
IB
IB
IB
IB
IB
IB
IB
IB
IB
IB
IB
IB
IB
IB
IB
IB
IB
IB
IB
IB
IB
IB
IB
ho
TB
Nr
uO
uO
zl
zl
"}
(23,1,1) = {"
zl
zl
zl
zl
zl
zl
zl
zl
zl
ho
TB
Nr
IB
IB
IB
IB
IB
IB
IB
IB
IB
IB
IB
IB
IB
IB
IB
IB
IB
IB
IB
IB
IB
IB
IB
IB
IB
IB
IB
IB
IB
IB
IB
IB
IB
IB
IB
IB
IB
IB
IB
IB
ho
TB
Nr
cX
Yu
zl
zl
"}
(24,1,1) = {"
zl
zl
zl
zl
zl
zl
zl
zl
zl
ho
TB
Nr
zr
IB
IB
IB
IB
IB
IB
IB
IB
IB
IB
IB
IB
IB
IB
IB
IB
IB
IB
IB
IB
IB
IB
IB
IB
IB
IB
IB
IB
IB
IB
IB
IB
IB
IB
IB
IB
IB
IB
zr
ho
TB
Nr
lh
uO
zl
zl
"}
(25,1,1) = {"
zl
zl
zl
zl
zl
zl
zl
zl
eh
ho
TB
Nr
IB
IB
IB
IB
IB
IB
IB
IB
IB
IB
IB
IB
IB
IB
IB
IB
IB
IB
IB
IB
IB
IB
IB
IB
IB
IB
IB
IB
IB
IB
IB
IB
IB
IB
IB
IB
IB
IB
IB
IB
ho
TB
Nr
cX
cX
zl
zl
"}
(26,1,1) = {"
zl
zl
zl
zl
zl
zl
zl
zl
lh
ho
TB
Nr
IB
IB
IB
IB
IB
IB
IB
IB
IB
IB
IB
IB
IB
IB
IB
IB
IB
IB
IB
IB
IB
IB
IB
IB
IB
IB
IB
IB
IB
IB
IB
IB
IB
IB
IB
IB
IB
IB
IB
IB
ho
TB
Nr
fl
lh
zl
zl
"}
(27,1,1) = {"
zl
zl
zl
zl
zl
zl
zl
zl
fl
ho
TB
Nr
IB
IB
IB
IB
IB
IB
IB
IB
IB
IB
IB
IB
IB
IB
IB
IB
IB
IB
IB
IB
IB
IB
IB
IB
IB
IB
IB
IB
IB
IB
IB
IB
IB
IB
IB
IB
IB
IB
IB
IB
ho
TB
Nr
cX
De
zl
zl
"}
(28,1,1) = {"
zl
zl
zl
zl
zl
zl
zl
zl
zl
ho
TB
Nr
IB
IB
IB
IB
IB
IB
IB
IB
IB
IB
IB
IB
IB
IB
IB
IB
IB
IB
IB
IB
IB
IB
IB
IB
IB
IB
IB
IB
IB
IB
IB
IB
IB
IB
IB
IB
IB
IB
IB
IB
ho
TB
Nr
cX
uO
zl
zl
"}
(29,1,1) = {"
zl
zl
zl
zl
zl
zl
zl
zl
zl
ho
TB
Nr
zr
IB
IB
IB
IB
IB
IB
IB
IB
IB
IB
IB
IB
IB
IB
IB
IB
IB
IB
IB
IB
IB
IB
IB
IB
IB
IB
IB
IB
IB
IB
IB
IB
IB
IB
IB
IB
IB
IB
zr
ho
TB
Nr
cX
uO
zl
zl
"}
(30,1,1) = {"
zl
zl
zl
zl
zl
zl
zl
zl
zl
ho
TB
Nr
IB
IB
IB
IB
IB
IB
IB
IB
IB
IB
IB
IB
IB
IB
IB
IB
IB
IB
IB
IB
IB
IB
IB
IB
IB
IB
IB
IB
IB
IB
IB
IB
IB
IB
IB
IB
IB
IB
IB
IB
ho
TB
Nr
lh
uO
zl
zl
"}
(31,1,1) = {"
zl
zl
zl
zl
zl
zl
zl
zl
zl
ho
TB
BD
IB
IB
IB
IB
IB
IB
IB
IB
IB
IB
IB
IB
IB
IB
IB
IB
IB
IB
IB
IB
IB
IB
IB
IB
IB
IB
IB
IB
IB
IB
IB
IB
IB
IB
IB
IB
IB
IB
IB
IB
tB
TB
Nr
cX
lh
Yu
zl
"}
(32,1,1) = {"
zl
zl
zl
zl
zl
zl
zl
zl
zl
ho
TB
Nr
IB
IB
IB
IB
IB
IB
IB
IB
IB
IB
IB
IB
IB
IB
IB
IB
IB
IB
IB
IB
IB
IB
IB
IB
IB
IB
IB
IB
IB
IB
IB
IB
IB
IB
IB
IB
IB
IB
IB
IB
ho
TB
Nr
cX
uO
uO
zl
"}
(33,1,1) = {"
zl
zl
zl
zl
zl
zl
zl
zl
zl
ho
TB
Nr
IB
IB
IB
IB
IB
IB
IB
IB
IB
IB
IB
IB
IB
IB
IB
IB
IB
IB
IB
IB
IB
IB
IB
IB
IB
IB
IB
IB
IB
IB
IB
IB
IB
IB
IB
IB
IB
IB
IB
IB
ho
TB
Nr
uO
cX
uO
zl
"}
(34,1,1) = {"
zl
zl
zl
zl
zl
zl
zl
zl
zl
ho
TB
Nr
zr
IB
IB
IB
IB
IB
IB
IB
IB
IB
IB
IB
IB
IB
IB
IB
IB
IB
IB
IB
IB
IB
IB
IB
IB
IB
IB
IB
IB
IB
IB
IB
IB
IB
IB
IB
IB
IB
IB
zr
ho
TB
Nr
cX
II
cX
zl
"}
(35,1,1) = {"
zl
zl
zl
zl
zl
zl
zl
zl
Yu
ho
TB
Nr
IB
IB
IB
IB
IB
IB
IB
IB
IB
IB
IB
IB
IB
IB
IB
IB
IB
IB
IB
IB
IB
IB
IB
IB
IB
IB
IB
IB
IB
IB
IB
IB
IB
IB
IB
IB
IB
IB
IB
IB
ho
TB
Nr
lh
uO
cX
zl
"}
(36,1,1) = {"
zl
zl
zl
zl
zl
zl
zl
zl
XF
ho
TB
Nr
IB
IB
IB
IB
IB
IB
IB
IB
IB
IB
IB
IB
IB
IB
IB
IB
IB
IB
IB
IB
IB
IB
IB
IB
IB
IB
IB
IB
IB
IB
IB
IB
IB
IB
IB
IB
IB
IB
IB
IB
ho
TB
Nr
cX
cX
uO
zl
"}
(37,1,1) = {"
zl
zl
zl
zl
zl
zl
zl
zl
uO
ho
TB
Nr
IB
IB
IB
IB
IB
IB
IB
IB
IB
IB
IB
IB
IB
IB
IB
IB
IB
IB
IB
IB
IB
IB
IB
IB
IB
IB
IB
IB
IB
IB
IB
IB
IB
IB
IB
IB
IB
IB
IB
IB
ho
TB
Nr
cX
XF
Yu
zl
"}
(38,1,1) = {"
zl
zl
zl
zl
zl
zl
zl
zl
zl
ho
TB
Nr
IB
IB
IB
IB
IB
IB
IB
IB
IB
IB
IB
IB
IB
IB
IB
IB
IB
IB
IB
IB
IB
IB
IB
IB
IB
IB
IB
IB
IB
IB
IB
IB
IB
IB
IB
IB
IB
IB
IB
IB
ho
TB
Nr
uO
uO
zl
zl
"}
(39,1,1) = {"
zl
zl
zl
zl
zl
zl
zl
sk
Ye
PD
TB
Nr
zr
IB
IB
IB
IB
IB
IB
IB
IB
IB
IB
IB
IB
IB
IB
IB
IB
IB
IB
IB
IB
IB
IB
IB
IB
IB
IB
IB
IB
IB
IB
IB
IB
IB
IB
IB
IB
IB
IB
zr
ho
TB
Nr
XF
zl
zl
zl
"}
(40,1,1) = {"
zl
zl
zl
zl
zl
zl
zl
sk
hO
td
TB
Nr
IB
IB
IB
IB
IB
IB
IB
IB
IB
IB
IB
IB
IB
IB
IB
IB
IB
IB
IB
IB
IB
IB
IB
IB
IB
IB
IB
IB
IB
IB
IB
IB
IB
IB
IB
IB
IB
IB
IB
IB
ho
TB
Nr
lh
zl
zl
zl
"}
(41,1,1) = {"
zl
zl
zl
zl
zl
zl
zl
sk
sy
rH
TB
BD
IB
IB
IB
IB
IB
IB
IB
IB
IB
IB
IB
IB
IB
IB
IB
IB
IB
IB
IB
IB
IB
IB
IB
IB
IB
IB
IB
IB
IB
IB
IB
IB
IB
IB
IB
IB
IB
IB
IB
IB
tB
TB
Nr
uO
zl
zl
zl
"}
(42,1,1) = {"
zl
zl
zl
zl
zl
zl
zl
sk
NP
rH
TB
Nr
IB
IB
IB
IB
IB
IB
IB
IB
IB
IB
IB
IB
IB
IB
IB
IB
IB
IB
IB
IB
IB
IB
IB
IB
IB
IB
IB
IB
IB
IB
IB
IB
IB
IB
IB
IB
IB
IB
IB
IB
ho
TB
Nr
uO
zl
zl
zl
"}
(43,1,1) = {"
zl
zl
zl
zl
zl
sk
sk
sk
vo
vS
TB
Nr
IB
IB
IB
IB
IB
IB
IB
IB
IB
IB
IB
IB
IB
IB
IB
IB
IB
IB
IB
IB
IB
IB
IB
IB
IB
IB
IB
IB
IB
IB
IB
IB
IB
IB
IB
IB
IB
IB
IB
IB
ho
TB
Nr
zl
zl
zl
zl
"}
(44,1,1) = {"
zl
zl
zl
zl
zl
sk
FP
dz
Eu
vS
TB
Nr
zr
IB
IB
IB
IB
IB
IB
IB
IB
IB
IB
IB
IB
IB
IB
IB
IB
IB
IB
IB
IB
IB
IB
IB
IB
IB
IB
IB
IB
IB
IB
IB
IB
IB
IB
IB
IB
IB
IB
zr
ho
TB
Nr
zl
zl
zl
zl
"}
(45,1,1) = {"
zl
zl
zl
zl
zl
sk
SV
sk
Ye
rH
TB
Nr
IB
IB
IB
IB
IB
IB
IB
IB
IB
IB
IB
IB
IB
IB
IB
IB
IB
IB
IB
IB
IB
IB
IB
IB
IB
IB
IB
IB
IB
IB
IB
IB
IB
IB
IB
IB
IB
IB
IB
IB
ho
TB
Nr
zl
zl
zl
zl
"}
(46,1,1) = {"
zl
zl
zl
zl
zl
sk
Jc
Nx
sk
rS
TB
Nr
IB
IB
IB
IB
IB
IB
IB
IB
IB
IB
IB
IB
IB
IB
IB
IB
IB
IB
IB
IB
IB
IB
IB
IB
IB
IB
IB
IB
IB
IB
IB
IB
IB
IB
IB
IB
IB
IB
IB
IB
ho
TB
Nr
zl
zl
zl
zl
"}
(47,1,1) = {"
zl
zl
zl
zl
zl
sk
sk
ci
sk
dA
rH
Xg
Og
Og
Og
Og
Og
Og
Og
Og
Og
Og
Og
Og
Og
Og
Og
Og
Og
Og
Og
Og
Og
Og
Og
Og
Og
Og
Og
Og
Og
Og
Og
Og
Og
Og
Og
Og
Og
Og
Og
Og
PD
TB
Nr
zl
zl
zl
zl
"}
(48,1,1) = {"
zl
zl
zl
zl
zl
sk
TE
DX
sk
ew
rH
TB
TB
TB
TB
TB
TB
TB
TB
TB
TB
TB
TB
TB
TB
TB
TB
TB
TB
TB
TB
TB
TB
TB
TB
TB
TB
TB
TB
TB
TB
TB
TB
TB
TB
TB
TB
TB
TB
TB
TB
TB
TB
TB
Nr
uO
zl
zl
zl
"}
(49,1,1) = {"
zl
zl
zl
zl
zl
sk
sk
sk
sk
aW
Id
Id
Id
RA
Id
wr
Id
Id
Id
Id
Id
Id
Id
Id
Id
Id
Id
Id
Id
Id
RA
Id
Id
RA
Id
Id
Id
Id
Id
Id
Id
Id
Id
Id
Id
Id
Id
Id
Id
Id
RA
Id
Id
Id
Jl
lh
zl
zl
zl
"}
(50,1,1) = {"
zl
zl
zl
zl
zl
zl
zl
zl
zl
zl
zl
zl
zl
zl
zl
sk
zl
uO
uO
uO
uO
VK
TB
nx
uO
uO
cX
cX
cX
cX
lh
cX
cX
cX
uO
Yu
uO
zl
zl
zl
zl
cX
cX
fl
cX
zl
zl
zl
zl
uO
XF
cX
cX
cX
uO
Yu
uO
zl
zl
"}
(51,1,1) = {"
zl
zl
zl
zl
zl
zl
zl
zl
zl
zl
zl
zl
zl
zl
zl
zl
zl
zl
uO
uO
cX
VK
TB
nx
uO
uO
uO
uO
zl
uO
uO
cX
uO
lh
uO
zl
zl
zl
zl
zl
zl
cX
uO
zl
zl
zl
zl
zl
zl
uO
uO
II
De
lh
uO
zl
zl
zl
zl
"}
(52,1,1) = {"
zl
zl
zl
sk
sk
sk
sk
sk
sk
sk
sk
sk
sk
sk
sk
sk
sk
sk
sk
sk
ei
zM
zM
zM
zM
uO
uO
cX
zl
zl
uO
uO
uO
uO
zl
zl
zl
zl
zl
zl
cX
cX
XF
zl
zl
zl
zl
zl
zl
zl
uO
uO
uO
uO
zl
zl
zl
zl
zl
"}
(53,1,1) = {"
zl
zl
zl
SY
tU
tU
kB
tU
tU
kB
tU
tU
kB
sk
tU
tU
tU
tU
eU
sk
zN
Og
Og
Og
Zw
BC
cX
zl
zl
zl
zl
zl
zl
zl
zl
zl
zl
zl
zl
uO
cX
uO
zl
zl
zl
zl
zl
zl
zl
zl
zl
uO
zl
zl
zl
zl
zl
zl
zl
"}
(54,1,1) = {"
zl
zl
zl
hs
tU
tU
kB
tU
tU
kB
tU
tU
kB
sk
tU
tU
tU
tU
tU
Hs
ho
TB
TB
TB
KE
BC
cX
zl
zl
zl
zl
zl
zl
zl
zl
zl
zl
zl
zl
zl
zl
zl
zl
zl
zl
zl
zl
zl
zl
zl
zl
zl
zl
zl
zl
zl
zl
zl
zl
"}
(55,1,1) = {"
zl
zl
zl
hs
tU
tU
kB
tU
tU
kB
tU
tU
kB
sk
tU
tU
tU
tU
tU
Hs
ho
Op
TB
Op
Nr
BC
fl
zl
zl
zl
zl
zl
zl
zl
zl
zl
zl
zl
zl
zl
zl
zl
zl
zl
zl
zl
zl
zl
zl
zl
zl
zl
zl
zl
zl
zl
zl
zl
zl
"}
(56,1,1) = {"
zl
zl
zl
hs
tU
tU
kB
tU
tU
kB
tU
tU
kB
sk
tU
tU
tU
tU
tU
Hs
ho
TB
TB
TB
Sv
BC
uO
zl
zl
zl
zl
zl
zl
zl
zl
zl
zl
zl
zl
zl
zl
zl
zl
zl
zl
zl
zl
zl
zl
zl
zl
zl
zl
zl
zl
zl
zl
zl
zl
"}
(57,1,1) = {"
zl
zl
zl
SY
tU
tU
kB
tU
tU
kB
tU
tU
kB
sk
tU
tU
tU
tU
tU
sk
aW
Id
Id
Id
Jl
BC
zl
zl
zl
zl
zl
zl
zl
zl
zl
zl
zl
zl
zl
zl
zl
zl
zl
zl
zl
zl
zl
zl
zl
zl
zl
zl
zl
zl
zl
zl
zl
zl
zl
"}
(58,1,1) = {"
zl
zl
zl
sk
sk
sk
sk
sk
sk
sk
sk
sk
sk
sk
sk
sk
sk
sk
sk
sk
ks
ks
jA
jA
jA
uO
zl
zl
zl
zl
zl
zl
zl
zl
zl
zl
zl
zl
zl
zl
zl
zl
zl
zl
zl
zl
zl
zl
zl
zl
zl
zl
zl
zl
zl
zl
zl
zl
zl
"}
(59,1,1) = {"
zl
zl
zl
zl
zl
zl
zl
zl
zl
zl
zl
zl
zl
zl
zl
zl
zl
zl
zl
zl
zl
zl
zl
eh
Yu
zl
zl
zl
zl
zl
zl
zl
zl
zl
zl
zl
zl
zl
zl
zl
zl
zl
zl
zl
zl
zl
zl
zl
zl
zl
zl
zl
zl
zl
zl
zl
zl
zl
zl
"}
(60,1,1) = {"
zl
zl
zl
zl
zl
zl
zl
zl
zl
zl
zl
zl
zl
zl
zl
zl
zl
zl
zl
zl
zl
zl
zl
zl
zl
zl
zl
zl
zl
zl
zl
zl
zl
zl
zl
zl
zl
zl
zl
zl
zl
zl
zl
zl
zl
zl
zl
zl
zl
zl
zl
zl
zl
zl
zl
zl
zl
zl
zl
"}
(61,1,1) = {"
zl
zl
zl
zl
zl
zl
zl
zl
zl
zl
zl
zl
zl
zl
zl
zl
zl
zl
zl
zl
zl
zl
zl
zl
zl
zl
zl
zl
zl
zl
zl
zl
zl
zl
zl
zl
zl
zl
zl
zl
zl
zl
zl
zl
zl
zl
zl
zl
zl
zl
zl
zl
zl
zl
zl
zl
zl
zl
zl
"}
(62,1,1) = {"
zl
zl
zl
zl
zl
zl
zl
zl
zl
zl
zl
zl
zl
zl
zl
zl
zl
zl
zl
zl
zl
zl
zl
zl
zl
zl
zl
zl
zl
zl
zl
zl
zl
zl
zl
zl
zl
zl
zl
zl
zl
zl
zl
zl
zl
zl
zl
zl
zl
zl
zl
zl
zl
zl
zl
zl
zl
zl
zl
"}
