//MAP CONVERTED BY dmm2tgm.py THIS HEADER COMMENT PREVENTS RECONVERSION, DO NOT REMOVE
"aq" = (
/obj/structure/catwalk/over/plated_catwalk/dark,
/obj/machinery/atmospherics/pipe/manifold/orange/hidden,
/turf/open/floor/plating{
	planetary_atmos = 1
	},
/area/hangar)
"aF" = (
/obj/structure/flora/rock/pile/rockplanet,
/turf/open/floor/plating/asteroid/snow/lit,
/area/hangar)
"bJ" = (
/obj/structure/catwalk/over/plated_catwalk/dark,
/obj/machinery/light/floor/hangar,
/turf/open/floor/plating{
	planetary_atmos = 1
	},
/area/hangar)
"cR" = (
/obj/effect/turf_decal/corner/opaque/bar/half,
/obj/effect/turf_decal/weather/rock,
/turf/open/floor/plasteel/dark,
/area/hangar)
"df" = (
/obj/effect/turf_decal/corner/opaque/bar/three_quarters{
	dir = 4
	},
/obj/effect/turf_decal/weather/rock{
	dir = 8
	},
/turf/open/floor/plasteel/dark,
/area/hangar)
"dl" = (
/obj/effect/turf_decal/corner/opaque/bar/half{
	dir = 4
	},
/obj/effect/turf_decal/weather/rock{
	dir = 5
	},
/turf/open/floor/plasteel/dark,
/area/hangar)
"eR" = (
/obj/effect/landmark/outpost/elevator_machine,
/obj/structure/lattice/catwalk,
/obj/machinery/door/airlock/grunge,
/turf/open/floor/engine,
/area/hangar)
"eV" = (
/obj/effect/landmark/outpost/elevator,
/turf/open/floor/plasteel/elevatorshaft{
	planetary_atmos = 1
	},
/area/hangar)
"fs" = (
/obj/effect/turf_decal/corner/opaque/bar/half{
	dir = 4
	},
/turf/open/floor/plasteel/tech,
/area/hangar)
"fB" = (
/obj/effect/turf_decal/corner/opaque/bar/three_quarters,
/turf/open/floor/plasteel/tech,
/area/hangar)
"fH" = (
/obj/effect/turf_decal/corner/opaque/bar/half{
	dir = 1
	},
/turf/open/floor/plasteel/dark,
/area/hangar)
"fI" = (
/obj/effect/turf_decal/corner/opaque/bar{
	dir = 8
	},
/turf/open/floor/plasteel/dark,
/area/hangar)
"gS" = (
/obj/structure/flora/grass/rockplanet/dead,
/turf/open/floor/plating/asteroid/rockplanet/safe/lit,
/area/hangar)
"hp" = (
/obj/structure/catwalk/over/plated_catwalk/dark,
/obj/machinery/atmospherics/pipe/simple/orange/hidden{
	dir = 6
	},
/turf/open/floor/plating{
	planetary_atmos = 1
	},
/area/hangar)
"hz" = (
/obj/structure/flora/rock/rockplanet,
/turf/open/floor/plating/asteroid/rockplanet/safe/cracked/lit,
/area/hangar)
"hC" = (
/obj/machinery/door/airlock/maintenance{
	req_access_txt = "101"
	},
/turf/open/floor/plating{
	planetary_atmos = 1
	},
/area/hangar)
"hT" = (
/obj/structure/marker_beacon{
	picked_color = "Teal"
	},
/turf/open/floor/plating{
	planetary_atmos = 1
	},
/area/hangar)
"if" = (
/turf/closed/indestructible/plastitanium/nodiagnonal,
/area/hangar)
"iN" = (
/obj/structure/railing{
	dir = 1
	},
/obj/effect/turf_decal/corner/opaque/bar/half{
	dir = 1
	},
/turf/open/floor/plasteel/tech/grid,
/area/hangar)
"jC" = (
/obj/structure/table/reinforced,
/turf/open/floor/plasteel/tech,
/area/hangar)
"jL" = (
/obj/machinery/atmospherics/pipe/simple/orange/hidden{
	dir = 4
	},
/obj/structure/catwalk/over/plated_catwalk/dark,
/turf/open/floor/plating{
	planetary_atmos = 1
	},
/area/hangar)
"lx" = (
/obj/effect/turf_decal/arrows{
	dir = 1
	},
/turf/open/floor/plasteel/tech{
	planetary_atmos = 1
	},
/area/hangar)
"mz" = (
/obj/effect/turf_decal/corner/opaque/bar/half{
	dir = 1
	},
/obj/structure/railing{
	dir = 1
	},
/turf/open/floor/plasteel/tech/grid,
/area/hangar)
"mR" = (
/obj/effect/turf_decal/corner/opaque/bar/half{
	dir = 8
	},
/turf/open/floor/plasteel/tech,
/area/hangar)
"nO" = (
/obj/structure/flora/tree/cactus,
/turf/open/floor/plating/asteroid/rockplanet/safe/cracked/lit,
/area/hangar)
"oh" = (
/obj/effect/turf_decal/corner/opaque/bar/half,
/obj/machinery/atmospherics/components/binary/valve/digital,
/turf/open/floor/plasteel/dark,
/area/hangar)
"ov" = (
/obj/structure/catwalk/over/plated_catwalk/dark,
/obj/machinery/atmospherics/pipe/simple/orange/hidden{
	dir = 5
	},
/turf/open/floor/plating{
	planetary_atmos = 1
	},
/area/hangar)
"oW" = (
/obj/effect/turf_decal/corner/opaque/bar/half{
	dir = 1
	},
/obj/effect/turf_decal/weather/rock{
	dir = 5
	},
/turf/open/floor/plasteel/tech/grid,
/area/hangar)
"pT" = (
/turf/open/floor/plasteel/elevatorshaft{
	planetary_atmos = 1
	},
/area/hangar)
"qh" = (
/obj/effect/turf_decal/trimline/opaque/yellow/warning{
	dir = 8
	},
/obj/effect/turf_decal/weather/rock{
	dir = 8
	},
/turf/open/floor/plasteel/tech{
	planetary_atmos = 1
	},
/area/hangar)
"qx" = (
/obj/effect/turf_decal/corner/opaque/bar/half,
/turf/open/floor/plasteel/dark,
/area/hangar)
"ra" = (
/obj/effect/turf_decal/corner/opaque/bar/half{
	dir = 8
	},
/obj/effect/turf_decal/weather/rock{
	dir = 8
	},
/turf/open/floor/plasteel/dark,
/area/hangar)
"rc" = (
/obj/machinery/atmospherics/components/binary/valve/digital,
/obj/effect/turf_decal/corner/opaque/bar/half{
	dir = 1
	},
/turf/open/floor/plasteel/dark,
/area/hangar)
"rN" = (
/obj/machinery/atmospherics/pipe/manifold/orange/hidden{
	dir = 1
	},
/obj/structure/catwalk/over/plated_catwalk/dark,
/turf/open/floor/plating{
	planetary_atmos = 1
	},
/area/hangar)
"sc" = (
/turf/open/floor/plating/asteroid/snow/lit,
/area/hangar)
"sF" = (
/obj/machinery/door/poddoor/shutters/indestructible,
/turf/open/floor/plasteel/elevatorshaft{
	planetary_atmos = 1
	},
/area/hangar)
"sM" = (
/turf/open/floor/plasteel/tech{
	planetary_atmos = 1
	},
/area/hangar)
"sZ" = (
/obj/effect/turf_decal/corner/opaque/bar/half{
	dir = 1
	},
/obj/effect/turf_decal/weather/rock{
	dir = 1
	},
/turf/open/floor/plasteel/dark,
/area/hangar)
"tc" = (
/obj/structure/flora/tree/cactus,
/turf/open/floor/plating/asteroid/rockplanet/safe/lit,
/area/hangar)
"te" = (
/obj/effect/landmark/outpost/hangar_dock,
/turf/open/floor/plating{
	planetary_atmos = 1
	},
/area/hangar)
"ts" = (
/obj/structure/flora/rock/pile/rockplanet,
/turf/open/floor/plating/asteroid/rockplanet/safe/lit,
/area/hangar)
"tv" = (
/obj/machinery/atmospherics/pipe/simple/orange/hidden{
	dir = 10
	},
/obj/effect/turf_decal/weather/rock{
	dir = 1
	},
/turf/open/floor/plasteel/dark,
/area/hangar)
"uc" = (
/obj/effect/turf_decal/corner/opaque/bar/half,
/turf/open/floor/plasteel/tech,
/area/hangar)
"ue" = (
/obj/item/toy/plush/moth/deadhead,
/turf/open/floor/plasteel/tech,
/area/hangar)
"uo" = (
/obj/machinery/atmospherics/components/unary/portables_connector{
	dir = 8
	},
/obj/effect/turf_decal/industrial/outline/yellow,
/obj/effect/turf_decal/weather/rock{
	dir = 4
	},
/turf/open/floor/plasteel/tech/grid,
/area/hangar)
"uD" = (
/obj/effect/turf_decal/weather/rock{
	dir = 6
	},
/turf/open/floor/plasteel/dark,
/area/hangar)
"vm" = (
/obj/machinery/atmospherics/pipe/manifold/orange/hidden{
	dir = 1
	},
/turf/open/floor/plasteel/tech,
/area/hangar)
"vR" = (
/obj/machinery/light/floor/hangar,
/obj/effect/turf_decal/corner/opaque/bar/half{
	dir = 1
	},
/turf/open/floor/plasteel/dark,
/area/hangar)
"wx" = (
/obj/effect/turf_decal/weather/rock{
	dir = 8
	},
/turf/open/floor/plasteel/dark,
/area/hangar)
"wz" = (
/obj/structure/flora/rock/rockplanet,
/turf/open/floor/plating/asteroid/rockplanet/safe/lit,
/area/hangar)
"wC" = (
/obj/effect/turf_decal/trimline/opaque/yellow/warning{
	dir = 4
	},
/turf/open/floor/plasteel/tech{
	planetary_atmos = 1
	},
/area/hangar)
"wD" = (
/obj/machinery/atmospherics/components/binary/valve/digital,
/obj/effect/turf_decal/corner/opaque/bar/half,
/turf/open/floor/plasteel/dark,
/area/hangar)
"ye" = (
/turf/open/floor/plating{
	planetary_atmos = 1
	},
/area/hangar)
"yy" = (
/obj/structure/catwalk/over/plated_catwalk/dark,
/obj/machinery/atmospherics/pipe/simple/orange/hidden{
	dir = 4
	},
/turf/open/floor/plating{
	planetary_atmos = 1
	},
/area/hangar)
"zC" = (
/obj/effect/turf_decal/corner/opaque/bar/three_quarters,
/obj/effect/turf_decal/weather/rock{
	dir = 6
	},
/turf/open/floor/plasteel/dark,
/area/hangar)
"zD" = (
/turf/closed/indestructible/rock/rockplanet,
/area/hangar)
"Ak" = (
/obj/machinery/atmospherics/pipe/simple/orange/hidden{
	dir = 4
	},
/obj/structure/catwalk/over/plated_catwalk/dark,
/obj/effect/turf_decal/weather/rock{
	dir = 1
	},
/turf/open/floor/plating{
	planetary_atmos = 1
	},
/area/hangar)
"AZ" = (
/obj/effect/turf_decal/corner/opaque/bar/half{
	dir = 8
	},
/obj/machinery/light/floor/hangar,
/turf/open/floor/plasteel/dark,
/area/hangar)
"Bw" = (
/obj/machinery/door/poddoor/shutters/indestructible,
/turf/open/space/basic,
/area/hangar)
"BD" = (
/obj/effect/turf_decal/industrial/outline/yellow,
/obj/machinery/atmospherics/components/unary/hydrogen_pump{
	dir = 4
	},
/turf/open/floor/plasteel/tech/grid,
/area/hangar)
"BQ" = (
/obj/machinery/atmospherics/pipe/manifold/orange/hidden,
/obj/structure/catwalk/over/plated_catwalk/dark,
/turf/open/floor/plating{
	planetary_atmos = 1
	},
/area/hangar)
"BZ" = (
/obj/effect/turf_decal/corner/opaque/bar/three_quarters{
	dir = 8
	},
/turf/open/floor/plasteel/tech,
/area/hangar)
"Co" = (
/turf/open/floor/plasteel/stairs/mid{
	dir = 1;
	color = "#2e2e2e"
	},
/area/hangar)
"Da" = (
/obj/structure/sign/warning/nosmoking/burnt{
	pixel_y = 28
	},
/obj/machinery/computer/hydrogen_exchange,
/turf/open/floor/plasteel/tech,
/area/hangar)
"DR" = (
/obj/effect/turf_decal/corner/opaque/bar/three_quarters{
	dir = 1
	},
/turf/open/floor/plasteel/tech,
/area/hangar)
"El" = (
/obj/effect/turf_decal/corner/opaque/bar/half{
	dir = 1
	},
/turf/open/floor/plasteel/tech/grid,
/area/hangar)
"Eo" = (
/obj/effect/turf_decal/weather/rock,
/turf/open/floor/plasteel/dark,
/area/hangar)
"EG" = (
/obj/effect/turf_decal/corner/opaque/bar/three_quarters{
	dir = 4
	},
/turf/open/floor/plasteel/tech,
/area/hangar)
"Fv" = (
/obj/effect/turf_decal/corner/opaque/bar/half{
	dir = 1
	},
/obj/effect/turf_decal/weather/rock{
	dir = 1
	},
/obj/structure/railing/corner{
	dir = 4
	},
/turf/open/floor/plasteel/dark,
/area/hangar)
"Gh" = (
/obj/machinery/atmospherics/components/binary/volume_pump{
	dir = 4
	},
/turf/open/floor/plasteel/tech,
/area/hangar)
"HD" = (
/obj/structure/flora/grass/rockplanet/dead,
/turf/open/floor/plating/asteroid/rockplanet/safe/cracked/lit,
/area/hangar)
"JQ" = (
/obj/machinery/light/floor/hangar,
/obj/effect/turf_decal/corner/opaque/bar/half,
/turf/open/floor/plasteel/dark,
/area/hangar)
"KC" = (
/turf/open/floor/plating/asteroid/rockplanet/safe/lit,
/area/hangar)
"KH" = (
/obj/machinery/atmospherics/pipe/simple/orange/hidden,
/obj/structure/catwalk/over/plated_catwalk/dark,
/turf/open/floor/plating{
	planetary_atmos = 1
	},
/area/hangar)
"LG" = (
/obj/structure/catwalk/over/plated_catwalk/dark,
/obj/machinery/atmospherics/pipe/simple/orange/hidden,
/turf/open/floor/plating{
	planetary_atmos = 1
	},
/area/hangar)
"Mj" = (
/obj/effect/turf_decal/corner/opaque/bar/half{
	dir = 4
	},
/obj/effect/turf_decal/weather/rock{
	dir = 4
	},
/turf/open/floor/plasteel/dark,
/area/hangar)
"Mv" = (
/obj/effect/decal/fakelattice,
/turf/open/floor/plasteel/elevatorshaft{
	planetary_atmos = 1
	},
/area/hangar)
"MA" = (
/obj/effect/turf_decal/corner/opaque/bar/half{
	dir = 1
	},
/obj/machinery/light/floor/hangar,
/turf/open/floor/plasteel/dark,
/area/hangar)
"Ne" = (
/obj/effect/turf_decal/weather/rock{
	dir = 4
	},
/turf/open/floor/plasteel/dark,
/area/hangar)
"NL" = (
/obj/effect/turf_decal/corner/opaque/bar/three_quarters{
	dir = 1
	},
/obj/effect/turf_decal/weather/rock{
	dir = 8
	},
/turf/open/floor/plasteel/dark,
/area/hangar)
"Ox" = (
/obj/effect/decal/fakelattice,
/turf/open/floor/plasteel/stairs/mid{
	dir = 1;
	color = "#2e2e2e"
	},
/area/hangar)
"Pk" = (
/turf/open/floor/plating/asteroid/rockplanet/safe/cracked/lit,
/area/hangar)
"Pu" = (
/obj/effect/landmark/outpost/hangar_numbers,
/obj/effect/turf_decal/corner/opaque/bar/half{
	dir = 1
	},
/turf/open/floor/plasteel/tech,
/area/hangar)
"Qb" = (
/obj/structure/catwalk/over/plated_catwalk/dark,
/obj/machinery/atmospherics/pipe/simple/orange/hidden{
	dir = 8
	},
/turf/open/floor/plating{
	planetary_atmos = 1
	},
/area/hangar)
"Qf" = (
/obj/effect/turf_decal/corner/opaque/bar/three_quarters{
	dir = 4
	},
/obj/effect/turf_decal/weather/rock{
	dir = 9
	},
/turf/open/floor/plasteel/dark,
/area/hangar)
"Rc" = (
/obj/structure/catwalk/over/plated_catwalk/dark,
/obj/machinery/atmospherics/pipe/simple/orange/hidden{
	dir = 9
	},
/turf/open/floor/plating{
	planetary_atmos = 1
	},
/area/hangar)
"Rf" = (
/obj/effect/turf_decal/corner/opaque/bar/half{
	dir = 8
	},
/turf/open/floor/plasteel/dark,
/area/hangar)
"Si" = (
/obj/effect/turf_decal/corner/opaque/bar{
	dir = 1
	},
/turf/open/floor/plasteel/dark,
/area/hangar)
"SB" = (
/obj/effect/turf_decal/weather/rock{
	dir = 10
	},
/turf/open/floor/plasteel/dark,
/area/hangar)
"Tv" = (
/obj/machinery/light/floor/hangar,
/turf/open/floor/plasteel/tech{
	planetary_atmos = 1
	},
/area/hangar)
"Uu" = (
/obj/structure/flora/grass/rockplanet/dead,
/turf/open/floor/plating/asteroid/snow/lit,
/area/hangar)
"UL" = (
/turf/open/floor/plasteel/tech,
/area/hangar)
"Vt" = (
/obj/structure/railing/corner{
	dir = 1;
	layer = 4.1
	},
/obj/effect/turf_decal/corner/opaque/bar/half{
	dir = 1
	},
/obj/machinery/atmospherics/pipe/simple/orange/hidden,
/turf/open/floor/plasteel/tech/grid,
/area/hangar)
"VK" = (
/obj/effect/landmark/outpost/elevator_machine,
/obj/machinery/elevator_call_button{
	pixel_y = 25
	},
/obj/effect/turf_decal/weather/rock{
	dir = 8
	},
/turf/open/floor/plasteel/dark,
/area/hangar)
"WX" = (
/obj/structure/flora/rock/pile/rockplanet,
/turf/open/floor/plating/asteroid/rockplanet/safe/cracked/lit,
/area/hangar)
"Xf" = (
/obj/effect/turf_decal/industrial/shutoff{
	dir = 8
	},
/obj/machinery/atmospherics/components/binary/volume_pump{
	dir = 4
	},
/turf/open/floor/plasteel/tech/grid,
/area/hangar)
"XG" = (
/obj/machinery/atmospherics/pipe/simple/orange/hidden{
	dir = 4
	},
/obj/effect/turf_decal/weather/rock{
	dir = 1
	},
/turf/open/floor/plasteel/dark,
/area/hangar)
"Yf" = (
/obj/structure/catwalk/over/plated_catwalk/dark,
/turf/open/floor/plating{
	planetary_atmos = 1
	},
/area/hangar)
"Yk" = (
/obj/effect/turf_decal/corner/opaque/bar/half,
/obj/machinery/light/floor/hangar,
/turf/open/floor/plasteel/dark,
/area/hangar)
"Yx" = (
/obj/structure/flora/rock/rockplanet,
/turf/open/floor/plating/asteroid/snow/lit,
/area/hangar)
"Zr" = (
/obj/effect/turf_decal/corner/opaque/bar/three_quarters{
	dir = 1
	},
/obj/effect/turf_decal/weather/rock{
	dir = 10
	},
/turf/open/floor/plasteel/dark,
/area/hangar)

(1,1,1) = {"
zD
zD
zD
zD
zD
zD
zD
zD
zD
zD
zD
zD
zD
zD
zD
zD
zD
zD
zD
zD
zD
zD
zD
zD
zD
zD
zD
zD
zD
zD
zD
zD
zD
zD
zD
zD
zD
zD
zD
zD
zD
zD
zD
zD
zD
zD
zD
zD
zD
zD
zD
zD
zD
zD
zD
zD
zD
zD
zD
"}
(2,1,1) = {"
zD
zD
zD
zD
zD
zD
zD
zD
zD
zD
zD
zD
zD
zD
zD
zD
zD
zD
zD
zD
zD
zD
zD
zD
zD
zD
zD
zD
zD
zD
zD
zD
zD
zD
zD
zD
zD
zD
zD
zD
zD
zD
zD
zD
zD
zD
zD
zD
zD
zD
zD
zD
zD
zD
zD
zD
zD
zD
zD
"}
(3,1,1) = {"
zD
zD
zD
zD
zD
zD
zD
zD
zD
zD
zD
zD
zD
zD
zD
zD
zD
zD
zD
zD
zD
zD
zD
zD
zD
zD
zD
zD
zD
zD
zD
zD
zD
zD
zD
zD
zD
zD
zD
zD
zD
zD
zD
zD
zD
zD
zD
zD
zD
zD
zD
zD
zD
zD
zD
zD
zD
zD
zD
"}
(4,1,1) = {"
zD
zD
zD
zD
zD
zD
zD
zD
zD
Qf
ra
NL
qh
qh
qh
qh
qh
qh
qh
qh
qh
qh
qh
qh
qh
qh
qh
qh
qh
qh
qh
qh
qh
qh
qh
qh
qh
qh
qh
qh
qh
qh
qh
qh
qh
qh
qh
qh
qh
qh
qh
qh
df
ra
Zr
zD
zD
zD
zD
"}
(5,1,1) = {"
zD
zD
zD
zD
zD
zD
zD
zD
zD
sZ
Yf
qx
sM
sM
lx
sM
Tv
sM
sM
lx
sM
sM
sM
sM
lx
sM
Tv
sM
sM
lx
sM
sM
sM
sM
lx
sM
Tv
sM
sM
lx
sM
sM
sM
sM
lx
sM
Tv
sM
sM
lx
sM
sM
fH
Yf
cR
sc
zD
zD
zD
"}
(6,1,1) = {"
zD
zD
zD
zD
zD
zD
zD
zD
zD
sZ
Yf
qx
wC
wC
wC
wC
wC
wC
wC
wC
wC
wC
wC
wC
wC
wC
wC
wC
wC
wC
wC
wC
wC
wC
wC
wC
wC
wC
wC
wC
wC
wC
wC
wC
wC
wC
wC
wC
wC
wC
wC
wC
fH
Yf
cR
HD
zD
zD
zD
"}
(7,1,1) = {"
zD
zD
zD
zD
zD
zD
zD
zD
aF
sZ
Yf
qx
ye
ye
ye
ye
ye
ye
ye
ye
ye
ye
ye
ye
ye
ye
ye
ye
ye
ye
ye
ye
ye
ye
ye
ye
ye
ye
ye
ye
ye
ye
ye
ye
ye
ye
ye
ye
ye
ye
ye
te
fH
Yf
cR
Pk
zD
zD
zD
"}
(8,1,1) = {"
zD
zD
zD
zD
zD
zD
zD
zD
Pk
sZ
Yf
qx
ye
ye
ye
ye
ye
ye
ye
ye
ye
ye
ye
ye
ye
ye
ye
ye
ye
ye
ye
ye
ye
ye
ye
ye
ye
ye
ye
ye
ye
ye
ye
ye
ye
ye
ye
ye
ye
ye
ye
ye
fH
Yf
cR
wz
zD
zD
zD
"}
(9,1,1) = {"
zD
zD
zD
zD
zD
zD
zD
zD
HD
sZ
Yf
qx
hT
ye
ye
ye
ye
ye
ye
ye
ye
ye
ye
ye
ye
ye
ye
ye
ye
ye
ye
ye
ye
ye
ye
ye
ye
ye
ye
ye
ye
ye
ye
ye
ye
ye
ye
ye
ye
ye
ye
hT
fH
Yf
cR
sc
zD
zD
zD
"}
(10,1,1) = {"
zD
zD
zD
zD
zD
zD
zD
zD
Pk
sZ
hp
wD
ye
ye
ye
ye
ye
ye
ye
ye
ye
ye
ye
ye
ye
ye
ye
ye
ye
ye
ye
ye
ye
ye
ye
ye
ye
ye
ye
ye
ye
ye
ye
ye
ye
ye
ye
ye
ye
ye
ye
ye
rc
ov
cR
sc
sc
zD
zD
"}
(11,1,1) = {"
zD
zD
zD
zD
zD
zD
zD
sc
KC
sZ
yy
JQ
ye
ye
ye
ye
ye
ye
ye
ye
ye
ye
ye
ye
ye
ye
ye
ye
ye
ye
ye
ye
ye
ye
ye
ye
ye
ye
ye
ye
ye
ye
ye
ye
ye
ye
ye
ye
ye
ye
ye
ye
vR
Qb
cR
KC
sc
zD
zD
"}
(12,1,1) = {"
zD
zD
zD
zD
zD
zD
zD
sc
KC
sZ
yy
qx
ye
ye
ye
ye
ye
ye
ye
ye
ye
ye
ye
ye
ye
ye
ye
ye
ye
ye
ye
ye
ye
ye
ye
ye
ye
ye
ye
ye
ye
ye
ye
ye
ye
ye
ye
ye
ye
ye
ye
ye
fH
Qb
cR
KC
sc
zD
zD
"}
(13,1,1) = {"
zD
zD
zD
zD
zD
zD
zD
sc
tc
sZ
yy
qx
ye
ye
ye
ye
ye
ye
ye
ye
ye
ye
ye
ye
ye
ye
ye
ye
ye
ye
ye
ye
ye
ye
ye
ye
ye
ye
ye
ye
ye
ye
ye
ye
ye
ye
ye
ye
ye
ye
ye
ye
fH
Qb
cR
gS
ts
zD
zD
"}
(14,1,1) = {"
zD
zD
zD
zD
zD
zD
sc
HD
Pk
sZ
yy
qx
hT
ye
ye
ye
ye
ye
ye
ye
ye
ye
ye
ye
ye
ye
ye
ye
ye
ye
ye
ye
ye
ye
ye
ye
ye
ye
ye
ye
ye
ye
ye
ye
ye
ye
ye
ye
ye
ye
ye
hT
fH
Qb
cR
KC
Pk
sc
zD
"}
(15,1,1) = {"
zD
zD
zD
zD
zD
zD
aF
KC
Pk
sZ
yy
qx
ye
ye
ye
ye
ye
ye
ye
ye
ye
ye
ye
ye
ye
ye
ye
ye
ye
ye
ye
ye
ye
ye
ye
ye
ye
ye
ye
ye
ye
ye
ye
ye
ye
ye
ye
ye
ye
ye
ye
ye
fH
Qb
cR
KC
tc
sc
zD
"}
(16,1,1) = {"
zD
zD
zD
zD
zD
zD
zD
zD
hz
sZ
yy
qx
ye
ye
ye
ye
ye
ye
ye
ye
ye
ye
ye
ye
ye
ye
ye
ye
ye
ye
ye
ye
ye
ye
ye
ye
ye
ye
ye
ye
ye
ye
ye
ye
ye
ye
ye
ye
ye
ye
ye
ye
fH
Qb
cR
KC
Pk
Yx
zD
"}
(17,1,1) = {"
zD
zD
zD
zD
zD
zD
zD
zD
KC
sZ
yy
qx
ye
ye
ye
ye
ye
ye
ye
ye
ye
ye
ye
ye
ye
ye
ye
ye
ye
ye
ye
ye
ye
ye
ye
ye
ye
ye
ye
ye
ye
ye
ye
ye
ye
ye
ye
ye
ye
ye
ye
ye
fH
Qb
cR
KC
KC
KC
zD
"}
(18,1,1) = {"
zD
zD
zD
zD
zD
zD
zD
zD
KC
sZ
yy
qx
ye
ye
ye
ye
ye
ye
ye
ye
ye
ye
ye
ye
ye
ye
ye
ye
ye
ye
ye
ye
ye
ye
ye
ye
ye
ye
ye
ye
ye
ye
ye
ye
ye
ye
ye
ye
ye
ye
ye
ye
fH
Qb
cR
Pk
HD
sc
zD
"}
(19,1,1) = {"
zD
zD
zD
zD
zD
zD
zD
zD
gS
sZ
yy
qx
hT
ye
ye
ye
ye
ye
ye
ye
ye
ye
ye
ye
ye
ye
ye
ye
ye
ye
ye
ye
ye
ye
ye
ye
ye
ye
ye
ye
ye
ye
ye
ye
ye
ye
ye
ye
ye
ye
ye
hT
fH
Qb
cR
KC
Pk
sc
zD
"}
(20,1,1) = {"
zD
zD
zD
zD
zD
zD
zD
zD
KC
sZ
yy
qx
ye
ye
ye
ye
ye
ye
ye
ye
ye
ye
ye
ye
ye
ye
ye
ye
ye
ye
ye
ye
ye
ye
ye
ye
ye
ye
ye
ye
ye
ye
ye
ye
ye
ye
ye
ye
ye
ye
ye
ye
fH
Qb
cR
KC
Pk
zD
zD
"}
(21,1,1) = {"
zD
zD
zD
zD
zD
zD
zD
zD
zD
sZ
yy
Yk
ye
ye
ye
ye
ye
ye
ye
ye
ye
ye
ye
ye
ye
ye
ye
ye
ye
ye
ye
ye
ye
ye
ye
ye
ye
ye
ye
ye
ye
ye
ye
ye
ye
ye
ye
ye
ye
ye
ye
ye
MA
Qb
cR
Pk
sc
zD
zD
"}
(22,1,1) = {"
zD
zD
zD
zD
zD
zD
zD
zD
zD
sZ
yy
qx
ye
ye
ye
ye
ye
ye
ye
ye
ye
ye
ye
ye
ye
ye
ye
ye
ye
ye
ye
ye
ye
ye
ye
ye
ye
ye
ye
ye
ye
ye
ye
ye
ye
ye
ye
ye
ye
ye
ye
ye
fH
Qb
cR
Pk
sc
zD
zD
"}
(23,1,1) = {"
zD
zD
zD
zD
zD
zD
zD
zD
zD
sZ
yy
qx
ye
ye
ye
ye
ye
ye
ye
ye
ye
ye
ye
ye
ye
ye
ye
ye
ye
ye
ye
ye
ye
ye
ye
ye
ye
ye
ye
ye
ye
ye
ye
ye
ye
ye
ye
ye
ye
ye
ye
ye
fH
Qb
cR
KC
aF
zD
zD
"}
(24,1,1) = {"
zD
zD
zD
zD
zD
zD
zD
zD
zD
sZ
yy
qx
hT
ye
ye
ye
ye
ye
ye
ye
ye
ye
ye
ye
ye
ye
ye
ye
ye
ye
ye
ye
ye
ye
ye
ye
ye
ye
ye
ye
ye
ye
ye
ye
ye
ye
ye
ye
ye
ye
ye
hT
fH
Qb
cR
gS
sc
zD
zD
"}
(25,1,1) = {"
zD
zD
zD
zD
zD
zD
zD
zD
wz
sZ
yy
qx
ye
ye
ye
ye
ye
ye
ye
ye
ye
ye
ye
ye
ye
ye
ye
ye
ye
ye
ye
ye
ye
ye
ye
ye
ye
ye
ye
ye
ye
ye
ye
ye
ye
ye
ye
ye
ye
ye
ye
ye
fH
Qb
cR
KC
KC
zD
zD
"}
(26,1,1) = {"
zD
zD
zD
zD
zD
zD
zD
zD
gS
sZ
rN
oh
ye
ye
ye
ye
ye
ye
ye
ye
ye
ye
ye
ye
ye
ye
ye
ye
ye
ye
ye
ye
ye
ye
ye
ye
ye
ye
ye
ye
ye
ye
ye
ye
ye
ye
ye
ye
ye
ye
ye
ye
rc
aq
cR
tc
gS
zD
zD
"}
(27,1,1) = {"
zD
zD
zD
zD
zD
zD
zD
zD
tc
sZ
jL
qx
ye
ye
ye
ye
ye
ye
ye
ye
ye
ye
ye
ye
ye
ye
ye
ye
ye
ye
ye
ye
ye
ye
ye
ye
ye
ye
ye
ye
ye
ye
ye
ye
ye
ye
ye
ye
ye
ye
ye
ye
fH
Qb
cR
KC
Yx
zD
zD
"}
(28,1,1) = {"
zD
zD
zD
zD
zD
zD
zD
zD
zD
sZ
yy
qx
ye
ye
ye
ye
ye
ye
ye
ye
ye
ye
ye
ye
ye
ye
ye
ye
ye
ye
ye
ye
ye
ye
ye
ye
ye
ye
ye
ye
ye
ye
ye
ye
ye
ye
ye
ye
ye
ye
ye
ye
fH
Qb
cR
KC
zD
zD
zD
"}
(29,1,1) = {"
zD
zD
zD
zD
zD
zD
zD
zD
zD
sZ
yy
qx
ye
ye
ye
ye
ye
ye
ye
ye
ye
ye
ye
ye
ye
ye
ye
ye
ye
ye
ye
ye
ye
ye
ye
ye
ye
ye
ye
ye
ye
ye
ye
ye
ye
ye
ye
ye
ye
ye
ye
ye
fH
Qb
cR
Pk
zD
zD
zD
"}
(30,1,1) = {"
zD
zD
zD
zD
zD
zD
zD
zD
zD
sZ
yy
qx
hT
ye
ye
ye
ye
ye
ye
ye
ye
ye
ye
ye
ye
ye
ye
ye
ye
ye
ye
ye
ye
ye
ye
ye
ye
ye
ye
ye
ye
ye
ye
ye
ye
ye
ye
ye
ye
ye
ye
hT
fH
Qb
cR
HD
zD
zD
zD
"}
(31,1,1) = {"
zD
zD
zD
zD
zD
zD
zD
zD
gS
sZ
yy
JQ
ye
ye
ye
ye
ye
ye
ye
ye
ye
ye
ye
ye
ye
ye
ye
ye
ye
ye
ye
ye
ye
ye
ye
ye
ye
ye
ye
ye
ye
ye
ye
ye
ye
ye
ye
ye
ye
ye
ye
ye
MA
Qb
cR
Pk
zD
zD
zD
"}
(32,1,1) = {"
zD
zD
zD
zD
zD
zD
zD
zD
Pk
sZ
yy
qx
ye
ye
ye
ye
ye
ye
ye
ye
ye
ye
ye
ye
ye
ye
ye
ye
ye
ye
ye
ye
ye
ye
ye
ye
ye
ye
ye
ye
ye
ye
ye
ye
ye
ye
ye
ye
ye
ye
ye
ye
fH
Qb
cR
Pk
zD
zD
zD
"}
(33,1,1) = {"
zD
zD
zD
zD
zD
zD
zD
zD
WX
sZ
yy
qx
ye
ye
ye
ye
ye
ye
ye
ye
ye
ye
ye
ye
ye
ye
ye
ye
ye
ye
ye
ye
ye
ye
ye
ye
ye
ye
ye
ye
ye
ye
ye
ye
ye
ye
ye
ye
ye
ye
ye
ye
fH
Qb
cR
KC
zD
zD
zD
"}
(34,1,1) = {"
zD
zD
zD
zD
zD
zD
zD
zD
Pk
sZ
yy
qx
ye
ye
ye
ye
ye
ye
ye
ye
ye
ye
ye
ye
ye
ye
ye
ye
ye
ye
ye
ye
ye
ye
ye
ye
ye
ye
ye
ye
ye
ye
ye
ye
ye
ye
ye
ye
ye
ye
ye
ye
fH
Qb
cR
tc
zD
zD
zD
"}
(35,1,1) = {"
zD
zD
zD
zD
zD
zD
zD
zD
KC
sZ
yy
qx
hT
ye
ye
ye
ye
ye
ye
ye
ye
ye
ye
ye
ye
ye
ye
ye
ye
ye
ye
ye
ye
ye
ye
ye
ye
ye
ye
ye
ye
ye
ye
ye
ye
ye
ye
ye
ye
ye
ye
hT
fH
Qb
cR
ts
zD
zD
zD
"}
(36,1,1) = {"
zD
zD
zD
zD
zD
zD
zD
sc
KC
sZ
yy
qx
ye
ye
ye
ye
ye
ye
ye
ye
ye
ye
ye
ye
ye
ye
ye
ye
ye
ye
ye
ye
ye
ye
ye
ye
ye
ye
ye
ye
ye
ye
ye
ye
ye
ye
ye
ye
ye
ye
ye
ye
fH
Qb
cR
gS
zD
zD
zD
"}
(37,1,1) = {"
zD
zD
zD
zD
zD
zD
zD
Uu
KC
sZ
yy
qx
ye
ye
ye
ye
ye
ye
ye
ye
ye
ye
ye
ye
ye
ye
ye
ye
ye
ye
ye
ye
ye
ye
ye
ye
ye
ye
ye
ye
ye
ye
ye
ye
ye
ye
ye
ye
ye
ye
ye
ye
fH
Qb
cR
zD
zD
zD
zD
"}
(38,1,1) = {"
zD
zD
zD
zD
zD
zD
zD
sc
tc
sZ
yy
qx
ye
ye
ye
ye
ye
ye
ye
ye
ye
ye
ye
ye
ye
ye
ye
ye
ye
ye
ye
ye
ye
ye
ye
ye
ye
ye
ye
ye
ye
ye
ye
ye
ye
ye
ye
ye
ye
ye
ye
ye
fH
Qb
cR
zD
zD
zD
zD
"}
(39,1,1) = {"
zD
zD
zD
zD
zD
zD
zD
zD
sc
sZ
yy
qx
ye
ye
ye
ye
ye
ye
ye
ye
ye
ye
ye
ye
ye
ye
ye
ye
ye
ye
ye
ye
ye
ye
ye
ye
ye
ye
ye
ye
ye
ye
ye
ye
ye
ye
ye
ye
ye
ye
ye
ye
fH
Qb
cR
zD
zD
zD
zD
"}
(40,1,1) = {"
zD
zD
zD
zD
zD
zD
zD
zD
Pk
sZ
yy
qx
hT
ye
ye
ye
ye
ye
ye
ye
ye
ye
ye
ye
ye
ye
ye
ye
ye
ye
ye
ye
ye
ye
ye
ye
ye
ye
ye
ye
ye
ye
ye
ye
ye
ye
ye
ye
ye
ye
ye
hT
fH
Qb
cR
Pk
zD
zD
zD
"}
(41,1,1) = {"
zD
zD
zD
zD
zD
zD
zD
zD
HD
sZ
yy
Yk
ye
ye
ye
ye
ye
ye
ye
ye
ye
ye
ye
ye
ye
ye
ye
ye
ye
ye
ye
ye
ye
ye
ye
ye
ye
ye
ye
ye
ye
ye
ye
ye
ye
ye
ye
ye
ye
ye
ye
ye
MA
Qb
cR
HD
zD
zD
zD
"}
(42,1,1) = {"
zD
zD
zD
zD
zD
zD
zD
zD
zD
sZ
rN
oh
ye
ye
ye
ye
ye
ye
ye
ye
ye
ye
ye
ye
ye
ye
ye
ye
ye
ye
ye
ye
ye
ye
ye
ye
ye
ye
ye
ye
ye
ye
ye
ye
ye
ye
ye
ye
ye
ye
ye
ye
rc
aq
cR
KC
KC
zD
zD
"}
(43,1,1) = {"
zD
zD
zD
zD
zD
zD
zD
zD
zD
sZ
yy
qx
ye
ye
ye
ye
ye
ye
ye
ye
ye
ye
ye
ye
ye
ye
ye
ye
ye
ye
ye
ye
ye
ye
ye
ye
ye
ye
ye
ye
ye
ye
ye
ye
ye
ye
ye
ye
ye
ye
ye
ye
fH
Qb
cR
KC
KC
zD
zD
"}
(44,1,1) = {"
zD
zD
zD
zD
zD
zD
zD
zD
zD
sZ
yy
qx
ye
ye
ye
ye
ye
ye
ye
ye
ye
ye
ye
ye
ye
ye
ye
ye
ye
ye
ye
ye
ye
ye
ye
ye
ye
ye
ye
ye
ye
ye
ye
ye
ye
ye
ye
ye
ye
ye
ye
ye
fH
Qb
cR
KC
sc
zD
zD
"}
(45,1,1) = {"
zD
zD
zD
zD
zD
zD
zD
zD
zD
sZ
yy
qx
hT
ye
ye
ye
ye
ye
ye
ye
ye
ye
ye
ye
ye
ye
ye
ye
ye
ye
ye
ye
ye
ye
ye
ye
ye
ye
ye
ye
ye
ye
ye
ye
ye
ye
ye
ye
ye
ye
ye
hT
fH
Qb
cR
KC
sc
zD
zD
"}
(46,1,1) = {"
zD
zD
zD
zD
zD
zD
zD
zD
zD
sZ
yy
qx
ye
ye
ye
ye
ye
ye
ye
ye
ye
ye
ye
ye
ye
ye
ye
ye
ye
ye
ye
ye
ye
ye
ye
ye
ye
ye
ye
ye
ye
ye
ye
ye
ye
ye
ye
ye
ye
ye
ye
ye
fH
Qb
cR
gS
sc
zD
zD
"}
(47,1,1) = {"
zD
zD
zD
zD
zD
zD
zD
zD
zD
sZ
yy
Yk
ye
ye
ye
ye
ye
ye
ye
ye
ye
ye
ye
ye
ye
ye
ye
ye
ye
ye
ye
ye
ye
ye
ye
ye
ye
ye
ye
ye
ye
ye
ye
ye
ye
ye
ye
ye
ye
ye
ye
ye
MA
Qb
cR
KC
gS
aF
zD
"}
(48,1,1) = {"
zD
zD
zD
zD
zD
zD
zD
zD
zD
sZ
yy
qx
ye
ye
ye
ye
ye
ye
ye
ye
ye
ye
ye
ye
ye
ye
ye
ye
ye
ye
ye
ye
ye
ye
ye
ye
ye
ye
ye
ye
ye
ye
ye
ye
ye
ye
ye
ye
ye
ye
ye
ye
fH
Qb
cR
KC
Pk
sc
zD
"}
(49,1,1) = {"
zD
zD
zD
zD
zD
zD
zD
zD
zD
sZ
yy
qx
ye
ye
ye
ye
ye
ye
ye
ye
ye
ye
ye
ye
ye
ye
ye
ye
ye
ye
ye
ye
ye
ye
ye
ye
ye
ye
ye
ye
ye
ye
ye
ye
ye
ye
ye
ye
ye
ye
ye
ye
fH
Qb
cR
Pk
KC
sc
zD
"}
(50,1,1) = {"
zD
zD
zD
zD
zD
zD
zD
zD
zD
sZ
yy
qx
hT
ye
ye
ye
ye
ye
ye
ye
ye
ye
ye
ye
ye
ye
ye
ye
ye
ye
ye
ye
ye
ye
ye
ye
ye
ye
ye
ye
ye
ye
ye
ye
ye
ye
ye
ye
ye
ye
ye
hT
fH
Qb
cR
KC
nO
KC
zD
"}
(51,1,1) = {"
zD
zD
zD
zD
zD
zD
zD
zD
ts
sZ
yy
qx
ye
ye
ye
ye
ye
ye
ye
ye
ye
ye
ye
ye
ye
ye
ye
ye
ye
ye
ye
ye
ye
ye
ye
ye
ye
ye
ye
ye
ye
ye
ye
ye
ye
ye
ye
ye
ye
ye
ye
ye
fH
Qb
cR
gS
Pk
KC
zD
"}
(52,1,1) = {"
zD
zD
zD
zD
zD
zD
zD
zD
gS
sZ
yy
qx
ye
ye
ye
ye
ye
ye
ye
ye
ye
ye
ye
ye
ye
ye
ye
ye
ye
ye
ye
ye
ye
ye
ye
ye
ye
ye
ye
ye
ye
ye
ye
ye
ye
ye
ye
ye
ye
ye
ye
ye
fH
Qb
cR
KC
KC
Pk
zD
"}
(53,1,1) = {"
zD
zD
zD
zD
zD
zD
zD
zD
sc
sZ
yy
qx
ye
ye
ye
ye
ye
ye
ye
ye
ye
ye
ye
ye
ye
ye
ye
ye
ye
ye
ye
ye
ye
ye
ye
ye
ye
ye
ye
ye
ye
ye
ye
ye
ye
ye
ye
ye
ye
ye
ye
ye
fH
Qb
cR
KC
HD
aF
zD
"}
(54,1,1) = {"
zD
zD
zD
zD
zD
zD
zD
zD
zD
sZ
yy
qx
ye
ye
ye
ye
ye
ye
ye
ye
ye
ye
ye
ye
ye
ye
ye
ye
ye
ye
ye
ye
ye
ye
ye
ye
ye
ye
ye
ye
ye
ye
ye
ye
ye
ye
ye
ye
ye
ye
ye
ye
fH
Qb
cR
Pk
sc
zD
zD
"}
(55,1,1) = {"
zD
zD
zD
zD
zD
zD
zD
zD
zD
Fv
yy
qx
hT
ye
ye
ye
ye
ye
ye
ye
ye
ye
ye
ye
ye
ye
ye
ye
ye
ye
ye
ye
ye
ye
ye
ye
ye
ye
ye
ye
ye
ye
ye
ye
ye
ye
ye
ye
ye
ye
ye
hT
fH
Qb
cR
HD
zD
zD
zD
"}
(56,1,1) = {"
zD
if
if
if
if
if
zD
if
BD
mz
jL
qx
ye
ye
ye
ye
ye
ye
ye
ye
ye
ye
ye
ye
ye
ye
ye
ye
ye
ye
ye
ye
ye
ye
ye
ye
ye
ye
ye
ye
ye
ye
ye
ye
ye
ye
ye
ye
ye
ye
ye
ye
fH
Qb
cR
gS
zD
zD
zD
"}
(57,1,1) = {"
zD
if
tc
KC
tc
if
if
if
Xf
iN
jL
JQ
ye
ye
ye
ye
ye
ye
ye
ye
ye
ye
ye
ye
ye
ye
ye
ye
ye
ye
ye
ye
ye
ye
ye
ye
ye
ye
ye
ye
ye
ye
ye
ye
ye
ye
ye
ye
ye
ye
ye
ye
vR
Qb
cR
sc
zD
zD
zD
"}
(58,1,1) = {"
zD
if
KC
ue
KC
KC
hC
UL
vm
Vt
BQ
qx
ye
ye
ye
ye
ye
ye
ye
ye
ye
ye
ye
ye
ye
ye
ye
ye
ye
ye
ye
ye
ye
ye
ye
ye
ye
ye
ye
ye
ye
ye
ye
ye
ye
ye
ye
ye
ye
ye
ye
ye
fH
Qb
cR
sc
zD
zD
zD
"}
(59,1,1) = {"
zD
if
tc
KC
tc
if
if
jC
Gh
El
rN
wD
ye
ye
ye
ye
ye
ye
ye
ye
ye
ye
ye
ye
ye
ye
ye
ye
ye
ye
ye
ye
ye
ye
ye
ye
ye
ye
ye
ye
ye
ye
ye
ye
ye
ye
ye
ye
ye
ye
ye
ye
rc
aq
cR
zD
zD
zD
zD
"}
(60,1,1) = {"
zD
if
if
if
if
if
if
Da
uo
El
yy
qx
hT
ye
ye
ye
ye
ye
ye
ye
ye
ye
ye
ye
ye
ye
ye
ye
ye
ye
ye
ye
ye
ye
ye
ye
ye
ye
ye
ye
ye
ye
ye
ye
ye
ye
ye
ye
ye
ye
ye
hT
fH
Qb
cR
zD
zD
zD
zD
"}
(61,1,1) = {"
zD
zD
zD
zD
zD
zD
if
if
zD
oW
jL
qx
ye
ye
ye
ye
ye
ye
ye
ye
ye
ye
ye
ye
ye
ye
ye
ye
ye
ye
ye
ye
ye
ye
ye
ye
ye
ye
ye
ye
ye
ye
ye
ye
ye
ye
ye
ye
ye
ye
ye
ye
fH
Qb
cR
zD
zD
zD
zD
"}
(62,1,1) = {"
zD
zD
zD
zD
zD
zD
zD
zD
zD
zD
Ak
qx
ye
ye
ye
ye
ye
ye
ye
ye
ye
ye
ye
ye
ye
ye
ye
ye
ye
ye
ye
ye
ye
ye
ye
ye
ye
ye
ye
ye
ye
ye
ye
ye
ye
ye
ye
ye
ye
ye
ye
ye
fH
Qb
cR
zD
zD
zD
zD
"}
(63,1,1) = {"
zD
zD
zD
zD
zD
zD
zD
zD
zD
KC
XG
fI
Rf
Rf
Rf
Rf
AZ
Rf
Rf
Rf
Rf
Rf
Rf
Rf
Rf
Rf
AZ
Rf
Rf
Rf
Rf
Rf
Rf
Rf
Rf
Rf
AZ
Rf
Rf
Rf
Rf
Rf
Rf
Rf
Rf
Rf
AZ
Rf
Rf
Rf
Rf
Rf
Si
Qb
cR
zD
zD
zD
zD
"}
(64,1,1) = {"
zD
zD
zD
zD
zD
zD
zD
zD
gS
KC
tv
LG
LG
LG
LG
LG
LG
LG
LG
LG
LG
KH
LG
LG
LG
LG
LG
LG
LG
KH
LG
LG
LG
LG
LG
LG
LG
LG
LG
LG
LG
KH
LG
LG
LG
LG
LG
LG
LG
LG
LG
LG
LG
Rc
cR
sc
zD
zD
zD
"}
(65,1,1) = {"
zD
zD
zD
zD
zD
zD
zD
zD
zD
wz
dl
Mj
Mj
Mj
Mj
Mj
Mj
Mj
Mj
Mj
Mj
Mj
Mj
Mj
Mj
Mj
Mj
Mj
Mj
Mj
Mj
Mj
Mj
Mj
Mj
Mj
Mj
Mj
Mj
Mj
Mj
Mj
Mj
Mj
Mj
Mj
Mj
Mj
Mj
Mj
Mj
Mj
Mj
Mj
zC
gS
zD
zD
zD
"}
(66,1,1) = {"
zD
zD
zD
zD
zD
zD
zD
zD
zD
zD
zD
zD
zD
zD
zD
zD
zD
zD
HD
Pk
KC
KC
gS
Pk
Pk
zD
zD
zD
zD
zD
zD
zD
zD
gS
KC
KC
KC
zD
zD
zD
zD
KC
KC
tc
KC
zD
zD
zD
zD
sc
HD
KC
KC
KC
Pk
WX
sc
zD
zD
"}
(67,1,1) = {"
zD
zD
zD
if
zD
zD
if
zD
zD
if
zD
zD
if
zD
zD
if
if
if
if
if
VK
wx
wx
SB
Pk
zD
zD
zD
zD
zD
zD
zD
zD
zD
zD
Pk
tc
HD
zD
zD
zD
KC
Pk
zD
zD
zD
zD
zD
zD
sc
sc
nO
hz
gS
sc
zD
zD
zD
zD
"}
(68,1,1) = {"
zD
zD
zD
Bw
pT
pT
Co
pT
pT
Co
pT
pT
Co
pT
pT
sF
pT
pT
eV
eR
EG
mR
DR
Eo
HD
KC
zD
zD
zD
zD
zD
zD
zD
zD
zD
zD
Pk
Pk
Pk
zD
KC
KC
HD
zD
zD
zD
zD
zD
zD
zD
sc
sc
sc
sc
zD
zD
zD
zD
zD
"}
(69,1,1) = {"
zD
zD
zD
Bw
Mv
Mv
Ox
Mv
Mv
Ox
Mv
Mv
Ox
Mv
Mv
if
pT
pT
pT
eR
Pu
bJ
uc
Eo
KC
tc
zD
zD
zD
zD
zD
zD
zD
zD
zD
zD
zD
Pk
gS
Pk
KC
Pk
zD
zD
zD
zD
zD
zD
zD
zD
zD
sc
zD
zD
zD
zD
zD
zD
zD
"}
(70,1,1) = {"
zD
zD
zD
Bw
pT
pT
Co
pT
pT
Co
pT
pT
Co
pT
pT
sF
pT
pT
pT
eR
BZ
fs
fB
Eo
KC
zD
zD
zD
zD
zD
zD
zD
zD
zD
zD
zD
zD
zD
zD
zD
zD
zD
zD
zD
zD
zD
zD
zD
zD
zD
zD
zD
zD
zD
zD
zD
zD
zD
zD
"}
(71,1,1) = {"
zD
zD
zD
if
zD
zD
if
zD
zD
if
zD
zD
if
zD
zD
if
if
if
if
if
Ne
Ne
Ne
uD
Pk
zD
zD
zD
zD
zD
zD
zD
zD
zD
zD
zD
zD
zD
zD
zD
zD
zD
zD
zD
zD
zD
zD
zD
zD
zD
zD
zD
zD
zD
zD
zD
zD
zD
zD
"}
(72,1,1) = {"
zD
zD
zD
zD
zD
zD
zD
zD
zD
zD
zD
zD
zD
zD
zD
zD
zD
zD
zD
zD
zD
zD
zD
wz
WX
zD
zD
zD
zD
zD
zD
zD
zD
zD
zD
zD
zD
zD
zD
zD
zD
zD
zD
zD
zD
zD
zD
zD
zD
zD
zD
zD
zD
zD
zD
zD
zD
zD
zD
"}
(73,1,1) = {"
zD
zD
zD
zD
zD
zD
zD
zD
zD
zD
zD
zD
zD
zD
zD
zD
zD
zD
zD
zD
zD
zD
zD
zD
zD
zD
zD
zD
zD
zD
zD
zD
zD
zD
zD
zD
zD
zD
zD
zD
zD
zD
zD
zD
zD
zD
zD
zD
zD
zD
zD
zD
zD
zD
zD
zD
zD
zD
zD
"}
(74,1,1) = {"
zD
zD
zD
zD
zD
zD
zD
zD
zD
zD
zD
zD
zD
zD
zD
zD
zD
zD
zD
zD
zD
zD
zD
zD
zD
zD
zD
zD
zD
zD
zD
zD
zD
zD
zD
zD
zD
zD
zD
zD
zD
zD
zD
zD
zD
zD
zD
zD
zD
zD
zD
zD
zD
zD
zD
zD
zD
zD
zD
"}
(75,1,1) = {"
zD
zD
zD
zD
zD
zD
zD
zD
zD
zD
zD
zD
zD
zD
zD
zD
zD
zD
zD
zD
zD
zD
zD
zD
zD
zD
zD
zD
zD
zD
zD
zD
zD
zD
zD
zD
zD
zD
zD
zD
zD
zD
zD
zD
zD
zD
zD
zD
zD
zD
zD
zD
zD
zD
zD
zD
zD
zD
zD
"}
(76,1,1) = {"
zD
zD
zD
zD
zD
zD
zD
zD
zD
zD
zD
zD
zD
zD
zD
zD
zD
zD
zD
zD
zD
zD
zD
zD
zD
zD
zD
zD
zD
zD
zD
zD
zD
zD
zD
zD
zD
zD
zD
zD
zD
zD
zD
zD
zD
zD
zD
zD
zD
zD
zD
zD
zD
zD
zD
zD
zD
zD
zD
"}
