//MAP CONVERTED BY dmm2tgm.py THIS HEADER COMMENT PREVENTS RECONVERSION, DO NOT REMOVE
"fv" = (
/obj/effect/turf_decal/corner/opaque/bar{
	dir = 8
	},
/turf/open/floor/plasteel/dark,
/area/hangar)
"gg" = (
/obj/effect/turf_decal/corner/opaque/bar{
	dir = 1
	},
/turf/open/floor/plasteel/dark,
/area/hangar)
"gD" = (
/obj/effect/landmark/outpost/elevator_machine,
/obj/machinery/elevator_call_button{
	pixel_y = 25
	},
/obj/effect/turf_decal/weather/rock{
	dir = 8
	},
/obj/effect/turf_decal/techfloor{
	dir = 4
	},
/turf/open/floor/plasteel/dark,
/area/hangar)
"hv" = (
/obj/effect/turf_decal/corner/opaque/bar/half{
	dir = 1
	},
/turf/open/floor/plasteel/dark,
/area/hangar)
"iC" = (
/obj/effect/turf_decal/corner/opaque/bar/half{
	dir = 1
	},
/obj/machinery/light/floor/hangar,
/turf/open/floor/plasteel/dark,
/area/hangar)
"jq" = (
/obj/effect/turf_decal/corner/opaque/tan{
	dir = 6
	},
/obj/effect/turf_decal/trimline/opaque/bar/line{
	dir = 4
	},
/obj/effect/turf_decal/siding/wideplating/dark{
	dir = 4
	},
/turf/open/floor/plasteel/tech,
/area/hangar)
"jA" = (
/obj/structure/catwalk/over/plated_catwalk/dark,
/turf/open/floor/plating{
	planetary_atmos = 1
	},
/area/hangar)
"kb" = (
/obj/effect/turf_decal/corner/opaque/bar/half{
	dir = 8
	},
/obj/effect/turf_decal/weather/rock{
	dir = 8
	},
/turf/open/floor/plasteel/dark,
/area/hangar)
"kx" = (
/obj/structure/catwalk/over/plated_catwalk/dark,
/obj/effect/turf_decal/weather/rock{
	dir = 1
	},
/turf/open/floor/plating{
	planetary_atmos = 1
	},
/area/hangar)
"kE" = (
/obj/structure/flora/rock/pile/rockplanet,
/turf/open/floor/plating/asteroid/rockplanet/safe/cracked/lit,
/area/hangar)
"lf" = (
/obj/structure/flora/grass/rockplanet/dead,
/turf/open/floor/plating/asteroid/rockplanet/safe/cracked/lit,
/area/hangar)
"lp" = (
/obj/machinery/door/poddoor/ert,
/turf/open/floor/plasteel/elevatorshaft{
	planetary_atmos = 1
	},
/area/hangar)
"lG" = (
/obj/effect/turf_decal/weather/rock,
/obj/effect/turf_decal/techfloor{
	dir = 1
	},
/turf/open/floor/plasteel/dark,
/area/hangar)
"mm" = (
/obj/effect/turf_decal/corner/opaque/bar/three_quarters,
/obj/effect/turf_decal/weather/rock{
	dir = 6
	},
/turf/open/floor/plasteel/dark,
/area/hangar)
"oA" = (
/obj/effect/turf_decal/trimline/opaque/yellow/warning{
	dir = 8
	},
/obj/effect/turf_decal/weather/rock{
	dir = 8
	},
/turf/open/floor/plasteel/tech{
	planetary_atmos = 1
	},
/area/hangar)
"pu" = (
/obj/effect/landmark/outpost/hangar_dock,
/turf/open/floor/plating{
	planetary_atmos = 1
	},
/area/hangar)
"qc" = (
/obj/effect/turf_decal/corner/opaque/tan/three_quarters{
	dir = 8
	},
/obj/effect/turf_decal/trimline/opaque/bar/line{
	dir = 5
	},
/obj/effect/turf_decal/siding/wideplating/dark{
	dir = 4
	},
/turf/open/floor/plasteel/tech,
/area/hangar)
"qq" = (
/turf/open/floor/plasteel/elevatorshaft{
	planetary_atmos = 1
	},
/area/hangar)
"rA" = (
/turf/closed/indestructible/rock/rockplanet,
/area/hangar)
"rB" = (
/obj/effect/turf_decal/corner/opaque/bar/half{
	dir = 4
	},
/obj/effect/turf_decal/weather/rock{
	dir = 5
	},
/turf/open/floor/plasteel/dark,
/area/hangar)
"sr" = (
/obj/structure/flora/rock/rockplanet,
/turf/open/floor/plating/asteroid/rockplanet/safe/lit,
/area/hangar)
"sE" = (
/turf/open/floor/plating/asteroid/rockplanet/safe/lit,
/area/hangar)
"sP" = (
/turf/open/floor/plasteel/tech{
	planetary_atmos = 1
	},
/area/hangar)
"tA" = (
/obj/effect/decal/fakelattice,
/turf/open/floor/plasteel/elevatorshaft{
	planetary_atmos = 1
	},
/area/hangar)
"tK" = (
/turf/open/floor/plating/asteroid/snow/lit,
/area/hangar)
"vQ" = (
/obj/structure/flora/rock/pile/rockplanet,
/turf/open/floor/plating/asteroid/rockplanet/safe/lit,
/area/hangar)
"xj" = (
/obj/effect/turf_decal/weather/rock{
	dir = 8
	},
/obj/effect/turf_decal/techfloor{
	dir = 4
	},
/turf/open/floor/plasteel/dark,
/area/hangar)
"xL" = (
/turf/open/floor/plating/asteroid/rockplanet/safe/cracked/lit,
/area/hangar)
"yI" = (
/obj/effect/turf_decal/corner/opaque/bar/half,
/obj/machinery/light/floor/hangar,
/turf/open/floor/plasteel/dark,
/area/hangar)
"zN" = (
/obj/structure/flora/grass/rockplanet/dead,
/turf/open/floor/plating/asteroid/rockplanet/safe/lit,
/area/hangar)
"zT" = (
/obj/effect/decal/fakelattice,
/turf/open/floor/plasteel/stairs/mid{
	dir = 1;
	color = "#2e2e2e"
	},
/area/hangar)
"Ab" = (
/obj/effect/turf_decal/arrows{
	dir = 1
	},
/turf/open/floor/plasteel/tech{
	planetary_atmos = 1
	},
/area/hangar)
"AF" = (
/obj/effect/turf_decal/corner/opaque/tan/three_quarters,
/obj/effect/turf_decal/trimline/opaque/bar/line{
	dir = 6
	},
/obj/effect/turf_decal/siding/wideplating/dark{
	dir = 4
	},
/turf/open/floor/plasteel/tech,
/area/hangar)
"DR" = (
/obj/effect/turf_decal/corner/opaque/bar/half{
	dir = 8
	},
/turf/open/floor/plasteel/dark,
/area/hangar)
"DU" = (
/obj/machinery/door/poddoor/ert,
/turf/open/space/basic,
/area/hangar)
"EA" = (
/obj/effect/turf_decal/corner/opaque/tan{
	dir = 9
	},
/obj/effect/turf_decal/trimline/opaque/bar/line{
	dir = 8
	},
/obj/effect/turf_decal/siding/wideplating/dark{
	dir = 8
	},
/turf/open/floor/plasteel/tech,
/area/hangar)
"Fo" = (
/obj/effect/turf_decal/corner/opaque/bar/three_quarters{
	dir = 4
	},
/obj/effect/turf_decal/weather/rock{
	dir = 9
	},
/turf/open/floor/plasteel/dark,
/area/hangar)
"Go" = (
/obj/effect/turf_decal/weather/rock{
	dir = 1
	},
/turf/open/floor/plasteel/dark,
/area/hangar)
"Hk" = (
/obj/structure/flora/grass/rockplanet/dead,
/turf/open/floor/plating/asteroid/snow/lit,
/area/hangar)
"Hy" = (
/obj/structure/flora/tree/cactus,
/turf/open/floor/plating/asteroid/rockplanet/safe/cracked/lit,
/area/hangar)
"HK" = (
/obj/effect/turf_decal/weather/rock{
	dir = 4
	},
/obj/effect/turf_decal/techfloor{
	dir = 8
	},
/turf/open/floor/plasteel/dark,
/area/hangar)
"JO" = (
/obj/effect/landmark/outpost/hangar_numbers,
/obj/effect/turf_decal/corner/opaque/tan{
	dir = 5
	},
/obj/effect/turf_decal/trimline/opaque/bar/line{
	dir = 1
	},
/turf/open/floor/plasteel/tech,
/area/hangar)
"Ko" = (
/obj/effect/turf_decal/corner/opaque/bar/three_quarters{
	dir = 4
	},
/obj/effect/turf_decal/weather/rock{
	dir = 8
	},
/turf/open/floor/plasteel/dark,
/area/hangar)
"Kt" = (
/obj/effect/turf_decal/weather/rock{
	dir = 10
	},
/obj/effect/turf_decal/techfloor/corner{
	dir = 4
	},
/turf/open/floor/plasteel/dark,
/area/hangar)
"KX" = (
/obj/effect/turf_decal/corner/opaque/bar/half,
/turf/open/floor/plasteel/dark,
/area/hangar)
"Mf" = (
/turf/open/floor/plasteel/stairs/mid{
	dir = 1;
	color = "#2e2e2e"
	},
/area/hangar)
"Mh" = (
/turf/open/floor/plating{
	planetary_atmos = 1
	},
/area/hangar)
"MT" = (
/obj/structure/flora/tree/cactus,
/turf/open/floor/plating/asteroid/rockplanet/safe/lit,
/area/hangar)
"Nt" = (
/obj/effect/turf_decal/trimline/opaque/yellow/warning{
	dir = 4
	},
/turf/open/floor/plasteel/tech{
	planetary_atmos = 1
	},
/area/hangar)
"PE" = (
/obj/effect/turf_decal/corner/opaque/bar/half{
	dir = 4
	},
/obj/effect/turf_decal/weather/rock{
	dir = 4
	},
/turf/open/floor/plasteel/dark,
/area/hangar)
"PR" = (
/obj/structure/flora/rock/rockplanet,
/turf/open/floor/plating/asteroid/snow/lit,
/area/hangar)
"Qu" = (
/obj/effect/turf_decal/corner/opaque/bar/half{
	dir = 1
	},
/obj/effect/turf_decal/weather/rock{
	dir = 1
	},
/turf/open/floor/plasteel/dark,
/area/hangar)
"Qx" = (
/obj/machinery/light/floor/hangar,
/turf/open/floor/plasteel/tech{
	planetary_atmos = 1
	},
/area/hangar)
"Ry" = (
/obj/machinery/light/floor/hangar,
/obj/effect/turf_decal/corner/opaque/bar/half{
	dir = 4
	},
/obj/effect/turf_decal/weather/rock{
	dir = 4
	},
/turf/open/floor/plasteel/dark,
/area/hangar)
"RG" = (
/obj/machinery/light/floor/hangar,
/obj/effect/turf_decal/corner/opaque/bar/half{
	dir = 1
	},
/turf/open/floor/plasteel/dark,
/area/hangar)
"Se" = (
/obj/effect/landmark/outpost/elevator,
/turf/open/floor/plasteel/elevatorshaft{
	planetary_atmos = 1
	},
/area/hangar)
"Sm" = (
/obj/effect/turf_decal/corner/opaque/tan/three_quarters{
	dir = 4
	},
/obj/effect/turf_decal/trimline/opaque/bar/line{
	dir = 9
	},
/obj/effect/turf_decal/siding/wideplating/dark{
	dir = 8
	},
/turf/open/floor/plasteel/tech,
/area/hangar)
"TP" = (
/obj/effect/turf_decal/corner/opaque/bar/half,
/obj/effect/turf_decal/weather/rock,
/turf/open/floor/plasteel/dark,
/area/hangar)
"TY" = (
/obj/structure/flora/rock/pile/rockplanet,
/turf/open/floor/plating/asteroid/snow/lit,
/area/hangar)
"Vk" = (
/obj/effect/turf_decal/weather/rock{
	dir = 6
	},
/obj/effect/turf_decal/techfloor/corner{
	dir = 1
	},
/turf/open/floor/plasteel/dark,
/area/hangar)
"Vw" = (
/obj/effect/turf_decal/corner/opaque/bar/half{
	dir = 1
	},
/obj/effect/turf_decal/weather/rock{
	dir = 5
	},
/turf/open/floor/plasteel/dark,
/area/hangar)
"VT" = (
/obj/effect/turf_decal/corner/opaque/tan/three_quarters{
	dir = 1
	},
/obj/effect/turf_decal/trimline/opaque/bar/line{
	dir = 10
	},
/obj/effect/turf_decal/siding/wideplating/dark{
	dir = 8
	},
/turf/open/floor/plasteel/tech,
/area/hangar)
"VW" = (
/obj/structure/flora/rock/rockplanet,
/turf/open/floor/plating/asteroid/rockplanet/safe/cracked/lit,
/area/hangar)
"WF" = (
/obj/effect/turf_decal/corner/opaque/bar/three_quarters{
	dir = 1
	},
/obj/effect/turf_decal/weather/rock{
	dir = 8
	},
/turf/open/floor/plasteel/dark,
/area/hangar)
"Xb" = (
/obj/structure/marker_beacon{
	picked_color = "Teal"
	},
/turf/open/floor/plating{
	planetary_atmos = 1
	},
/area/hangar)
"Xp" = (
/obj/effect/landmark/outpost/elevator_machine,
/obj/structure/lattice/catwalk,
/obj/machinery/door/airlock/grunge,
/turf/open/floor/engine,
/area/hangar)
"Yb" = (
/obj/machinery/light/floor/hangar,
/obj/effect/turf_decal/corner/opaque/bar/half,
/turf/open/floor/plasteel/dark,
/area/hangar)
"YM" = (
/obj/effect/turf_decal/corner/opaque/bar/three_quarters{
	dir = 1
	},
/obj/effect/turf_decal/weather/rock{
	dir = 10
	},
/turf/open/floor/plasteel/dark,
/area/hangar)
"YS" = (
/turf/closed/indestructible/plastitanium/nodiagnonal,
/area/hangar)
"YZ" = (
/obj/structure/catwalk/over/plated_catwalk/dark,
/obj/machinery/light/floor/hangar,
/turf/open/floor/plating{
	planetary_atmos = 1
	},
/area/hangar)
"Zh" = (
/obj/effect/turf_decal/corner/opaque/tan{
	dir = 10
	},
/obj/effect/turf_decal/trimline/opaque/bar/line,
/turf/open/floor/plasteel/tech,
/area/hangar)

(1,1,1) = {"
rA
rA
rA
rA
rA
rA
rA
rA
rA
rA
rA
rA
rA
rA
rA
rA
rA
rA
rA
rA
rA
rA
rA
rA
rA
rA
rA
rA
rA
rA
rA
rA
rA
rA
rA
rA
rA
rA
rA
"}
(2,1,1) = {"
rA
rA
rA
rA
rA
rA
rA
rA
rA
rA
rA
rA
rA
rA
rA
rA
rA
rA
rA
rA
rA
rA
rA
rA
rA
rA
rA
rA
rA
rA
rA
rA
rA
rA
rA
rA
rA
rA
rA
"}
(3,1,1) = {"
rA
rA
rA
rA
rA
rA
rA
rA
rA
rA
rA
rA
rA
rA
rA
rA
rA
rA
rA
rA
rA
rA
rA
rA
rA
rA
rA
rA
rA
rA
rA
rA
rA
rA
rA
rA
rA
rA
rA
"}
(4,1,1) = {"
rA
rA
rA
rA
rA
rA
rA
rA
rA
Fo
kb
WF
oA
oA
oA
oA
oA
oA
oA
oA
oA
oA
oA
oA
oA
oA
oA
oA
oA
oA
oA
oA
Ko
kb
YM
rA
rA
rA
rA
"}
(5,1,1) = {"
rA
rA
rA
rA
rA
rA
rA
rA
rA
Qu
jA
KX
sP
sP
Ab
sP
Qx
sP
sP
Ab
sP
sP
sP
sP
Ab
sP
Qx
sP
sP
Ab
sP
sP
hv
jA
TP
tK
rA
rA
rA
"}
(6,1,1) = {"
rA
rA
rA
rA
rA
rA
rA
rA
rA
Qu
jA
KX
Nt
Nt
Nt
Nt
Nt
Nt
Nt
Nt
Nt
Nt
Nt
Nt
Nt
Nt
Nt
Nt
Nt
Nt
Nt
Nt
hv
jA
TP
lf
rA
rA
rA
"}
(7,1,1) = {"
rA
rA
rA
rA
rA
rA
rA
rA
TY
Qu
jA
KX
Mh
Mh
Mh
Mh
Mh
Mh
Mh
Mh
Mh
Mh
Mh
Mh
Mh
Mh
Mh
Mh
Mh
Mh
Mh
pu
hv
jA
TP
xL
rA
rA
rA
"}
(8,1,1) = {"
rA
rA
rA
rA
rA
rA
rA
rA
xL
Qu
jA
KX
Mh
Mh
Mh
Mh
Mh
Mh
Mh
Mh
Mh
Mh
Mh
Mh
Mh
Mh
Mh
Mh
Mh
Mh
Mh
Mh
hv
jA
TP
sr
rA
rA
rA
"}
(9,1,1) = {"
rA
rA
rA
rA
rA
rA
rA
rA
lf
Qu
jA
KX
Xb
Mh
Mh
Mh
Mh
Mh
Mh
Mh
Mh
Mh
Mh
Mh
Mh
Mh
Mh
Mh
Mh
Mh
Mh
Xb
hv
jA
TP
tK
rA
rA
rA
"}
(10,1,1) = {"
rA
rA
rA
rA
rA
rA
rA
rA
xL
Qu
jA
KX
Mh
Mh
Mh
Mh
Mh
Mh
Mh
Mh
Mh
Mh
Mh
Mh
Mh
Mh
Mh
Mh
Mh
Mh
Mh
Mh
hv
jA
TP
tK
tK
rA
rA
"}
(11,1,1) = {"
rA
rA
rA
rA
rA
rA
rA
tK
sE
Qu
jA
Yb
Mh
Mh
Mh
Mh
Mh
Mh
Mh
Mh
Mh
Mh
Mh
Mh
Mh
Mh
Mh
Mh
Mh
Mh
Mh
Mh
RG
jA
TP
sE
tK
rA
rA
"}
(12,1,1) = {"
rA
rA
rA
rA
rA
rA
rA
tK
sE
Qu
jA
KX
Mh
Mh
Mh
Mh
Mh
Mh
Mh
Mh
Mh
Mh
Mh
Mh
Mh
Mh
Mh
Mh
Mh
Mh
Mh
Mh
hv
jA
TP
sE
tK
rA
rA
"}
(13,1,1) = {"
rA
rA
rA
rA
rA
rA
rA
tK
MT
Qu
jA
KX
Mh
Mh
Mh
Mh
Mh
Mh
Mh
Mh
Mh
Mh
Mh
Mh
Mh
Mh
Mh
Mh
Mh
Mh
Mh
Mh
hv
jA
TP
zN
vQ
rA
rA
"}
(14,1,1) = {"
rA
rA
rA
rA
rA
rA
tK
lf
xL
Qu
jA
KX
Xb
Mh
Mh
Mh
Mh
Mh
Mh
Mh
Mh
Mh
Mh
Mh
Mh
Mh
Mh
Mh
Mh
Mh
Mh
Xb
hv
jA
TP
sE
xL
tK
rA
"}
(15,1,1) = {"
rA
rA
rA
rA
rA
rA
TY
sE
xL
Qu
jA
KX
Mh
Mh
Mh
Mh
Mh
Mh
Mh
Mh
Mh
Mh
Mh
Mh
Mh
Mh
Mh
Mh
Mh
Mh
Mh
Mh
hv
jA
TP
sE
MT
tK
rA
"}
(16,1,1) = {"
rA
rA
rA
rA
rA
rA
rA
rA
VW
Qu
jA
KX
Mh
Mh
Mh
Mh
Mh
Mh
Mh
Mh
Mh
Mh
Mh
Mh
Mh
Mh
Mh
Mh
Mh
Mh
Mh
Mh
hv
jA
TP
sE
xL
PR
rA
"}
(17,1,1) = {"
rA
rA
rA
rA
rA
rA
rA
rA
sE
Qu
jA
KX
Mh
Mh
Mh
Mh
Mh
Mh
Mh
Mh
Mh
Mh
Mh
Mh
Mh
Mh
Mh
Mh
Mh
Mh
Mh
Mh
hv
jA
TP
sE
sE
sE
rA
"}
(18,1,1) = {"
rA
rA
rA
rA
rA
rA
rA
rA
sE
Qu
jA
KX
Mh
Mh
Mh
Mh
Mh
Mh
Mh
Mh
Mh
Mh
Mh
Mh
Mh
Mh
Mh
Mh
Mh
Mh
Mh
Mh
hv
jA
TP
xL
lf
tK
rA
"}
(19,1,1) = {"
rA
rA
rA
rA
rA
rA
rA
rA
zN
Qu
jA
KX
Xb
Mh
Mh
Mh
Mh
Mh
Mh
Mh
Mh
Mh
Mh
Mh
Mh
Mh
Mh
Mh
Mh
Mh
Mh
Xb
hv
jA
TP
sE
xL
tK
rA
"}
(20,1,1) = {"
rA
rA
rA
rA
rA
rA
rA
rA
sE
Qu
jA
KX
Mh
Mh
Mh
Mh
Mh
Mh
Mh
Mh
Mh
Mh
Mh
Mh
Mh
Mh
Mh
Mh
Mh
Mh
Mh
Mh
hv
jA
TP
sE
xL
rA
rA
"}
(21,1,1) = {"
rA
rA
rA
rA
rA
rA
rA
rA
rA
Qu
jA
yI
Mh
Mh
Mh
Mh
Mh
Mh
Mh
Mh
Mh
Mh
Mh
Mh
Mh
Mh
Mh
Mh
Mh
Mh
Mh
Mh
iC
jA
TP
xL
tK
rA
rA
"}
(22,1,1) = {"
rA
rA
rA
rA
rA
rA
rA
rA
rA
Qu
jA
KX
Mh
Mh
Mh
Mh
Mh
Mh
Mh
Mh
Mh
Mh
Mh
Mh
Mh
Mh
Mh
Mh
Mh
Mh
Mh
Mh
hv
jA
TP
xL
tK
rA
rA
"}
(23,1,1) = {"
rA
rA
rA
rA
rA
rA
rA
rA
rA
Qu
jA
KX
Mh
Mh
Mh
Mh
Mh
Mh
Mh
Mh
Mh
Mh
Mh
Mh
Mh
Mh
Mh
Mh
Mh
Mh
Mh
Mh
hv
jA
TP
sE
TY
rA
rA
"}
(24,1,1) = {"
rA
rA
rA
rA
rA
rA
rA
rA
rA
Qu
jA
KX
Xb
Mh
Mh
Mh
Mh
Mh
Mh
Mh
Mh
Mh
Mh
Mh
Mh
Mh
Mh
Mh
Mh
Mh
Mh
Xb
hv
jA
TP
zN
tK
rA
rA
"}
(25,1,1) = {"
rA
rA
rA
rA
rA
rA
rA
rA
sr
Qu
jA
KX
Mh
Mh
Mh
Mh
Mh
Mh
Mh
Mh
Mh
Mh
Mh
Mh
Mh
Mh
Mh
Mh
Mh
Mh
Mh
Mh
hv
jA
TP
sE
sE
rA
rA
"}
(26,1,1) = {"
rA
rA
rA
rA
rA
rA
rA
rA
zN
Qu
jA
KX
Mh
Mh
Mh
Mh
Mh
Mh
Mh
Mh
Mh
Mh
Mh
Mh
Mh
Mh
Mh
Mh
Mh
Mh
Mh
Mh
hv
jA
TP
MT
zN
rA
rA
"}
(27,1,1) = {"
rA
rA
rA
rA
rA
rA
rA
rA
MT
Qu
jA
KX
Mh
Mh
Mh
Mh
Mh
Mh
Mh
Mh
Mh
Mh
Mh
Mh
Mh
Mh
Mh
Mh
Mh
Mh
Mh
Mh
hv
jA
TP
sE
PR
rA
rA
"}
(28,1,1) = {"
rA
rA
rA
rA
rA
rA
rA
rA
rA
Qu
jA
KX
Mh
Mh
Mh
Mh
Mh
Mh
Mh
Mh
Mh
Mh
Mh
Mh
Mh
Mh
Mh
Mh
Mh
Mh
Mh
Mh
hv
jA
TP
sE
rA
rA
rA
"}
(29,1,1) = {"
rA
rA
rA
rA
rA
rA
rA
rA
rA
Qu
jA
KX
Mh
Mh
Mh
Mh
Mh
Mh
Mh
Mh
Mh
Mh
Mh
Mh
Mh
Mh
Mh
Mh
Mh
Mh
Mh
Mh
hv
jA
TP
xL
rA
rA
rA
"}
(30,1,1) = {"
rA
rA
rA
rA
rA
rA
rA
rA
rA
Qu
jA
KX
Xb
Mh
Mh
Mh
Mh
Mh
Mh
Mh
Mh
Mh
Mh
Mh
Mh
Mh
Mh
Mh
Mh
Mh
Mh
Xb
hv
jA
TP
lf
rA
rA
rA
"}
(31,1,1) = {"
rA
rA
rA
rA
rA
rA
rA
rA
zN
Qu
jA
Yb
Mh
Mh
Mh
Mh
Mh
Mh
Mh
Mh
Mh
Mh
Mh
Mh
Mh
Mh
Mh
Mh
Mh
Mh
Mh
Mh
iC
jA
TP
xL
rA
rA
rA
"}
(32,1,1) = {"
rA
rA
rA
rA
rA
rA
rA
rA
xL
Qu
jA
KX
Mh
Mh
Mh
Mh
Mh
Mh
Mh
Mh
Mh
Mh
Mh
Mh
Mh
Mh
Mh
Mh
Mh
Mh
Mh
Mh
hv
jA
TP
xL
rA
rA
rA
"}
(33,1,1) = {"
rA
rA
rA
rA
rA
rA
rA
rA
kE
Qu
jA
KX
Mh
Mh
Mh
Mh
Mh
Mh
Mh
Mh
Mh
Mh
Mh
Mh
Mh
Mh
Mh
Mh
Mh
Mh
Mh
Mh
hv
jA
TP
sE
rA
rA
rA
"}
(34,1,1) = {"
rA
rA
rA
rA
rA
rA
rA
rA
xL
Qu
jA
KX
Mh
Mh
Mh
Mh
Mh
Mh
Mh
Mh
Mh
Mh
Mh
Mh
Mh
Mh
Mh
Mh
Mh
Mh
Mh
Mh
hv
jA
TP
MT
rA
rA
rA
"}
(35,1,1) = {"
rA
rA
rA
rA
rA
rA
rA
rA
sE
Qu
jA
KX
Xb
Mh
Mh
Mh
Mh
Mh
Mh
Mh
Mh
Mh
Mh
Mh
Mh
Mh
Mh
Mh
Mh
Mh
Mh
Xb
hv
jA
TP
vQ
rA
rA
rA
"}
(36,1,1) = {"
rA
rA
rA
rA
rA
rA
rA
tK
sE
Qu
jA
KX
Mh
Mh
Mh
Mh
Mh
Mh
Mh
Mh
Mh
Mh
Mh
Mh
Mh
Mh
Mh
Mh
Mh
Mh
Mh
Mh
hv
jA
TP
zN
rA
rA
rA
"}
(37,1,1) = {"
rA
rA
rA
rA
rA
rA
rA
Hk
sE
Qu
jA
KX
Mh
Mh
Mh
Mh
Mh
Mh
Mh
Mh
Mh
Mh
Mh
Mh
Mh
Mh
Mh
Mh
Mh
Mh
Mh
Mh
hv
jA
TP
rA
rA
rA
rA
"}
(38,1,1) = {"
rA
rA
rA
rA
rA
rA
rA
tK
MT
Qu
jA
KX
Mh
Mh
Mh
Mh
Mh
Mh
Mh
Mh
Mh
Mh
Mh
Mh
Mh
Mh
Mh
Mh
Mh
Mh
Mh
Mh
hv
jA
TP
rA
rA
rA
rA
"}
(39,1,1) = {"
rA
rA
rA
rA
rA
rA
rA
rA
tK
Qu
jA
KX
Mh
Mh
Mh
Mh
Mh
Mh
Mh
Mh
Mh
Mh
Mh
Mh
Mh
Mh
Mh
Mh
Mh
Mh
Mh
Mh
hv
jA
TP
rA
rA
rA
rA
"}
(40,1,1) = {"
rA
rA
rA
rA
rA
rA
rA
rA
xL
Qu
jA
KX
Xb
Mh
Mh
Mh
Mh
Mh
Mh
Mh
Mh
Mh
Mh
Mh
Mh
Mh
Mh
Mh
Mh
Mh
Mh
Xb
hv
jA
TP
xL
rA
rA
rA
"}
(41,1,1) = {"
rA
rA
rA
rA
rA
rA
rA
rA
lf
Qu
jA
yI
Mh
Mh
Mh
Mh
Mh
Mh
Mh
Mh
Mh
Mh
Mh
Mh
Mh
Mh
Mh
Mh
Mh
Mh
Mh
Mh
iC
jA
TP
lf
rA
rA
rA
"}
(42,1,1) = {"
rA
rA
rA
rA
rA
rA
rA
rA
rA
Qu
jA
KX
Mh
Mh
Mh
Mh
Mh
Mh
Mh
Mh
Mh
Mh
Mh
Mh
Mh
Mh
Mh
Mh
Mh
Mh
Mh
Mh
hv
jA
TP
sE
sE
rA
rA
"}
(43,1,1) = {"
rA
rA
rA
rA
rA
rA
rA
rA
rA
Qu
jA
KX
Mh
Mh
Mh
Mh
Mh
Mh
Mh
Mh
Mh
Mh
Mh
Mh
Mh
Mh
Mh
Mh
Mh
Mh
Mh
Mh
hv
jA
TP
sE
sE
rA
rA
"}
(44,1,1) = {"
rA
rA
rA
rA
rA
rA
rA
rA
rA
Qu
jA
KX
Mh
Mh
Mh
Mh
Mh
Mh
Mh
Mh
Mh
Mh
Mh
Mh
Mh
Mh
Mh
Mh
Mh
Mh
Mh
Mh
hv
jA
TP
sE
tK
rA
rA
"}
(45,1,1) = {"
rA
rA
rA
rA
rA
rA
rA
rA
rA
Qu
jA
KX
Xb
Mh
Mh
Mh
Mh
Mh
Mh
Mh
Mh
Mh
Mh
Mh
Mh
Mh
Mh
Mh
Mh
Mh
Mh
Xb
hv
jA
TP
sE
tK
rA
rA
"}
(46,1,1) = {"
rA
rA
rA
rA
rA
rA
rA
rA
rA
Qu
jA
KX
Mh
Mh
Mh
Mh
Mh
Mh
Mh
Mh
Mh
Mh
Mh
Mh
Mh
Mh
Mh
Mh
Mh
Mh
Mh
Mh
hv
jA
TP
zN
tK
rA
rA
"}
(47,1,1) = {"
rA
rA
rA
rA
rA
rA
rA
rA
rA
Qu
jA
yI
Mh
Mh
Mh
Mh
Mh
Mh
Mh
Mh
Mh
Mh
Mh
Mh
Mh
Mh
Mh
Mh
Mh
Mh
Mh
Mh
iC
jA
TP
sE
zN
TY
rA
"}
(48,1,1) = {"
rA
rA
rA
rA
rA
rA
rA
rA
rA
Qu
jA
KX
Mh
Mh
Mh
Mh
Mh
Mh
Mh
Mh
Mh
Mh
Mh
Mh
Mh
Mh
Mh
Mh
Mh
Mh
Mh
Mh
hv
jA
TP
sE
xL
tK
rA
"}
(49,1,1) = {"
rA
rA
rA
rA
rA
rA
rA
rA
rA
Qu
jA
KX
Mh
Mh
Mh
Mh
Mh
Mh
Mh
Mh
Mh
Mh
Mh
Mh
Mh
Mh
Mh
Mh
Mh
Mh
Mh
Mh
hv
jA
TP
xL
sE
tK
rA
"}
(50,1,1) = {"
rA
rA
rA
rA
rA
rA
rA
rA
rA
Qu
jA
KX
Xb
Mh
Mh
Mh
Mh
Mh
Mh
Mh
Mh
Mh
Mh
Mh
Mh
Mh
Mh
Mh
Mh
Mh
Mh
Xb
hv
jA
TP
sE
Hy
sE
rA
"}
(51,1,1) = {"
rA
rA
rA
rA
rA
rA
rA
rA
vQ
Qu
jA
KX
Mh
Mh
Mh
Mh
Mh
Mh
Mh
Mh
Mh
Mh
Mh
Mh
Mh
Mh
Mh
Mh
Mh
Mh
Mh
Mh
hv
jA
TP
zN
xL
sE
rA
"}
(52,1,1) = {"
rA
rA
rA
rA
rA
rA
rA
rA
zN
Qu
jA
KX
Mh
Mh
Mh
Mh
Mh
Mh
Mh
Mh
Mh
Mh
Mh
Mh
Mh
Mh
Mh
Mh
Mh
Mh
Mh
Mh
hv
jA
TP
sE
sE
xL
rA
"}
(53,1,1) = {"
rA
rA
rA
rA
rA
rA
rA
rA
tK
Qu
jA
KX
Mh
Mh
Mh
Mh
Mh
Mh
Mh
Mh
Mh
Mh
Mh
Mh
Mh
Mh
Mh
Mh
Mh
Mh
Mh
Mh
hv
jA
TP
sE
lf
TY
rA
"}
(54,1,1) = {"
rA
rA
rA
rA
rA
rA
rA
rA
rA
Qu
jA
KX
Mh
Mh
Mh
Mh
Mh
Mh
Mh
Mh
Mh
Mh
Mh
Mh
Mh
Mh
Mh
Mh
Mh
Mh
Mh
Mh
hv
jA
TP
xL
tK
rA
rA
"}
(55,1,1) = {"
rA
rA
rA
rA
rA
rA
rA
rA
rA
Qu
jA
KX
Xb
Mh
Mh
Mh
Mh
Mh
Mh
Mh
Mh
Mh
Mh
Mh
Mh
Mh
Mh
Mh
Mh
Mh
Mh
Xb
hv
jA
TP
lf
rA
rA
rA
"}
(56,1,1) = {"
rA
rA
rA
rA
rA
rA
rA
rA
rA
Qu
jA
KX
Mh
Mh
Mh
Mh
Mh
Mh
Mh
Mh
Mh
Mh
Mh
Mh
Mh
Mh
Mh
Mh
Mh
Mh
Mh
Mh
hv
jA
TP
zN
rA
rA
rA
"}
(57,1,1) = {"
rA
rA
rA
rA
rA
rA
rA
rA
rA
Qu
jA
Yb
Mh
Mh
Mh
Mh
Mh
Mh
Mh
Mh
Mh
Mh
Mh
Mh
Mh
Mh
Mh
Mh
Mh
Mh
Mh
Mh
RG
jA
TP
tK
rA
rA
rA
"}
(58,1,1) = {"
rA
rA
rA
rA
rA
rA
rA
rA
rA
Qu
jA
KX
Mh
Mh
Mh
Mh
Mh
Mh
Mh
Mh
Mh
Mh
Mh
Mh
Mh
Mh
Mh
Mh
Mh
Mh
Mh
Mh
hv
jA
TP
tK
rA
rA
rA
"}
(59,1,1) = {"
rA
rA
rA
rA
rA
rA
rA
rA
rA
Qu
jA
KX
Mh
Mh
Mh
Mh
Mh
Mh
Mh
Mh
Mh
Mh
Mh
Mh
Mh
Mh
Mh
Mh
Mh
Mh
Mh
Mh
hv
jA
TP
rA
rA
rA
rA
"}
(60,1,1) = {"
rA
rA
rA
rA
rA
rA
rA
rA
rA
Qu
jA
KX
Xb
Mh
Mh
Mh
Mh
Mh
Mh
Mh
Mh
Mh
Mh
Mh
Mh
Mh
Mh
Mh
Mh
Mh
Mh
Xb
hv
jA
TP
rA
rA
rA
rA
"}
(61,1,1) = {"
rA
rA
rA
rA
rA
rA
rA
rA
rA
Vw
jA
KX
Mh
Mh
Mh
Mh
Mh
Mh
Mh
Mh
Mh
Mh
Mh
Mh
Mh
Mh
Mh
Mh
Mh
Mh
Mh
Mh
hv
jA
TP
rA
rA
rA
rA
"}
(62,1,1) = {"
rA
rA
rA
rA
rA
rA
rA
rA
rA
rA
kx
KX
Mh
Mh
Mh
Mh
Mh
Mh
Mh
Mh
Mh
Mh
Mh
Mh
Mh
Mh
Mh
Mh
Mh
Mh
Mh
Mh
hv
jA
TP
rA
rA
rA
rA
"}
(63,1,1) = {"
rA
rA
rA
rA
rA
rA
rA
rA
rA
sE
Go
fv
DR
DR
DR
DR
DR
DR
DR
DR
DR
DR
DR
DR
DR
DR
DR
DR
DR
DR
DR
DR
gg
jA
TP
rA
rA
rA
rA
"}
(64,1,1) = {"
rA
rA
rA
rA
rA
rA
rA
rA
zN
sE
Go
jA
jA
jA
jA
jA
jA
jA
jA
jA
jA
jA
jA
jA
jA
jA
jA
jA
jA
jA
jA
jA
jA
jA
TP
tK
rA
rA
rA
"}
(65,1,1) = {"
rA
rA
rA
rA
rA
rA
rA
rA
rA
sr
rB
PE
PE
Ry
PE
PE
PE
PE
PE
PE
PE
PE
PE
PE
PE
PE
PE
PE
PE
PE
Ry
PE
PE
PE
mm
zN
rA
rA
rA
"}
(66,1,1) = {"
rA
rA
rA
rA
rA
rA
rA
rA
rA
rA
rA
rA
rA
rA
rA
rA
rA
rA
lf
xL
sE
sE
zN
xL
xL
rA
rA
rA
rA
tK
lf
sE
sE
sE
xL
kE
tK
rA
rA
"}
(67,1,1) = {"
rA
rA
rA
YS
rA
rA
YS
rA
rA
YS
rA
rA
YS
rA
rA
YS
YS
YS
YS
YS
gD
xj
xj
Kt
xL
rA
rA
rA
rA
tK
tK
Hy
VW
zN
tK
rA
rA
rA
rA
"}
(68,1,1) = {"
rA
rA
rA
DU
qq
qq
Mf
qq
qq
Mf
qq
qq
Mf
qq
qq
lp
qq
qq
Se
Xp
Sm
EA
VT
lG
lf
sE
rA
rA
rA
rA
tK
tK
tK
tK
rA
rA
rA
rA
rA
"}
(69,1,1) = {"
rA
rA
rA
DU
tA
tA
zT
tA
tA
zT
tA
tA
zT
tA
tA
YS
qq
qq
qq
Xp
JO
YZ
Zh
lG
sE
MT
rA
rA
rA
rA
rA
tK
rA
rA
rA
rA
rA
rA
rA
"}
(70,1,1) = {"
rA
rA
rA
DU
qq
qq
Mf
qq
qq
Mf
qq
qq
Mf
qq
qq
lp
qq
qq
qq
Xp
qc
jq
AF
lG
sE
rA
rA
rA
rA
rA
rA
rA
rA
rA
rA
rA
rA
rA
rA
"}
(71,1,1) = {"
rA
rA
rA
YS
rA
rA
YS
rA
rA
YS
rA
rA
YS
rA
rA
YS
YS
YS
YS
YS
HK
HK
HK
Vk
xL
rA
rA
rA
rA
rA
rA
rA
rA
rA
rA
rA
rA
rA
rA
"}
(72,1,1) = {"
rA
rA
rA
rA
rA
rA
rA
rA
rA
rA
rA
rA
rA
rA
rA
rA
rA
rA
rA
rA
rA
rA
rA
sr
kE
rA
rA
rA
rA
rA
rA
rA
rA
rA
rA
rA
rA
rA
rA
"}
(73,1,1) = {"
rA
rA
rA
rA
rA
rA
rA
rA
rA
rA
rA
rA
rA
rA
rA
rA
rA
rA
rA
rA
rA
rA
rA
rA
rA
rA
rA
rA
rA
rA
rA
rA
rA
rA
rA
rA
rA
rA
rA
"}
(74,1,1) = {"
rA
rA
rA
rA
rA
rA
rA
rA
rA
rA
rA
rA
rA
rA
rA
rA
rA
rA
rA
rA
rA
rA
rA
rA
rA
rA
rA
rA
rA
rA
rA
rA
rA
rA
rA
rA
rA
rA
rA
"}
(75,1,1) = {"
rA
rA
rA
rA
rA
rA
rA
rA
rA
rA
rA
rA
rA
rA
rA
rA
rA
rA
rA
rA
rA
rA
rA
rA
rA
rA
rA
rA
rA
rA
rA
rA
rA
rA
rA
rA
rA
rA
rA
"}
(76,1,1) = {"
rA
rA
rA
rA
rA
rA
rA
rA
rA
rA
rA
rA
rA
rA
rA
rA
rA
rA
rA
rA
rA
rA
rA
rA
rA
rA
rA
rA
rA
rA
rA
rA
rA
rA
rA
rA
rA
rA
rA
"}
