//MAP CONVERTED BY dmm2tgm.py THIS HEADER COMMENT PREVENTS RECONVERSION, DO NOT REMOVE
"aB" = (
/obj/structure/flora/grass/rockplanet/dead,
/turf/open/floor/plating/asteroid/snow/safe/lit,
/area/hangar)
"bB" = (
/obj/effect/turf_decal/corner/opaque/tan/three_quarters{
	dir = 4
	},
/obj/effect/turf_decal/trimline/opaque/bar/filled/shrink_ccw{
	dir = 1
	},
/turf/open/floor/hangar/plasteel/dark,
/area/hangar)
"cD" = (
/turf/open/floor/plasteel/tech{
	planetary_atmos = 1
	},
/area/hangar)
"cX" = (
/turf/open/floor/hangar/plasteel/dark,
/area/hangar)
"dr" = (
/obj/machinery/conveyor/auto/outpost,
/obj/structure/plasticflaps/outpost,
/turf/open/floor/plasteel/tech,
/area/hangar)
"ea" = (
/obj/effect/turf_decal/corner/opaque/tan{
	dir = 4
	},
/obj/effect/turf_decal/trimline/opaque/bar/corner{
	dir = 4
	},
/turf/open/floor/hangar/plasteel/dark,
/area/hangar)
"em" = (
/obj/effect/landmark/outpost/elevator_machine,
/obj/structure/lattice/catwalk,
/obj/machinery/door/airlock/grunge,
/turf/open/floor/engine,
/area/hangar)
"hh" = (
/obj/structure/chair/bench/red/directional/south,
/obj/structure/sign/poster/contraband/random{
	pixel_y = 32
	},
/turf/open/floor/hangar/plasteel/dark,
/area/hangar)
"iA" = (
/obj/structure/catwalk/over/plated_catwalk/dark,
/obj/machinery/light/floor/hangar,
/turf/open/floor/hangar,
/area/hangar)
"jp" = (
/obj/machinery/conveyor/auto/outpost{
	dir = 8
	},
/turf/open/floor/plasteel/tech,
/area/hangar)
"jJ" = (
/obj/effect/turf_decal/corner/opaque/tan{
	dir = 10
	},
/obj/effect/turf_decal/trimline/opaque/bar/line,
/turf/open/floor/hangar/plasteel/dark,
/area/hangar)
"kr" = (
/obj/structure/flora/grass/rockplanet/dead,
/turf/open/floor/plating/asteroid/rockplanet/safe/lit,
/area/hangar)
"kT" = (
/obj/structure/marker_beacon{
	picked_color = "Teal"
	},
/turf/open/floor/hangar,
/area/hangar)
"mt" = (
/turf/open/floor/plasteel/tech,
/area/hangar)
"nA" = (
/obj/structure/plasticflaps/outpost,
/obj/machinery/conveyor/auto/outpost{
	dir = 8
	},
/turf/open/floor/plasteel/tech,
/area/hangar)
"nQ" = (
/obj/effect/turf_decal/corner/opaque/tan{
	dir = 8
	},
/obj/effect/turf_decal/trimline/opaque/bar/corner{
	dir = 8
	},
/turf/open/floor/hangar/plasteel/dark,
/area/hangar)
"oK" = (
/obj/effect/turf_decal/corner/opaque/tan{
	dir = 5
	},
/obj/effect/turf_decal/trimline/opaque/bar/line{
	dir = 1
	},
/turf/open/floor/plasteel/tech,
/area/hangar)
"pI" = (
/obj/structure/flora/rock/pile/rockplanet,
/turf/open/floor/plating/asteroid/rockplanet/safe/lit,
/area/hangar)
"pZ" = (
/obj/structure/chair/bench/red/directional/south,
/turf/open/floor/hangar/plasteel/dark,
/area/hangar)
"qb" = (
/obj/effect/turf_decal/corner/opaque/tan{
	dir = 1
	},
/obj/effect/turf_decal/trimline/opaque/bar/corner{
	dir = 1
	},
/turf/open/floor/hangar/plasteel/dark,
/area/hangar)
"qn" = (
/obj/effect/turf_decal/corner/opaque/tan{
	dir = 9
	},
/turf/open/floor/hangar/plasteel/dark,
/area/hangar)
"rv" = (
/obj/effect/turf_decal/corner/opaque/tan/three_quarters{
	dir = 8
	},
/obj/effect/turf_decal/trimline/opaque/bar/line{
	dir = 5
	},
/turf/open/floor/plasteel/tech,
/area/hangar)
"rC" = (
/obj/structure/sign/departments/cargo,
/turf/closed/indestructible/plastitanium/nodiagnonal,
/area/hangar)
"rT" = (
/obj/structure/disposalpipe/segment{
	dir = 4
	},
/turf/closed/indestructible/plastitanium/nodiagnonal,
/area/hangar)
"sl" = (
/obj/structure/flora/tree/cactus,
/turf/open/floor/plating/asteroid/rockplanet/cracked/safe/lit,
/area/hangar)
"sq" = (
/obj/effect/decal/fakelattice,
/turf/open/floor/plasteel/stairs/mid{
	dir = 1;
	color = "#2e2e2e"
	},
/area/hangar)
"sz" = (
/obj/machinery/disposal/deliveryChute{
	dir = 1
	},
/obj/structure/disposalpipe/trunk{
	dir = 8
	},
/turf/open/floor/plasteel/tech,
/area/hangar)
"sD" = (
/obj/structure/disposalpipe/trunk{
	dir = 4
	},
/obj/machinery/conveyor/auto/outpost{
	dir = 1
	},
/obj/structure/disposaloutlet{
	dir = 1
	},
/turf/open/floor/plasteel/tech,
/area/hangar)
"sT" = (
/turf/open/floor/plasteel/stairs/mid{
	dir = 1;
	color = "#2e2e2e"
	},
/area/hangar)
"tF" = (
/obj/effect/turf_decal/corner/opaque/tan{
	dir = 5
	},
/obj/effect/turf_decal/trimline/opaque/bar/line{
	dir = 1
	},
/obj/machinery/light/floor/hangar,
/turf/open/floor/hangar/plasteel/dark,
/area/hangar)
"tH" = (
/obj/machinery/light/floor/hangar,
/obj/effect/turf_decal/corner/opaque/tan{
	dir = 6
	},
/obj/effect/turf_decal/trimline/opaque/bar/line{
	dir = 4
	},
/turf/open/floor/hangar/plasteel/dark,
/area/hangar)
"tU" = (
/turf/open/floor/plating/asteroid/snow/safe/lit,
/area/hangar)
"tZ" = (
/obj/effect/turf_decal/corner/opaque/tan{
	dir = 5
	},
/obj/effect/turf_decal/trimline/opaque/bar/line{
	dir = 1
	},
/turf/open/floor/hangar/plasteel/dark,
/area/hangar)
"uT" = (
/obj/structure/flora/rock/rockplanet,
/turf/open/floor/plating/asteroid/rockplanet/cracked/safe/lit,
/area/hangar)
"vm" = (
/obj/effect/turf_decal/corner/opaque/tan/three_quarters{
	dir = 4
	},
/obj/effect/turf_decal/trimline/opaque/bar/line{
	dir = 9
	},
/turf/open/floor/plasteel/tech,
/area/hangar)
"vq" = (
/obj/effect/landmark/outpost/elevator,
/turf/open/floor/plasteel/elevatorshaft{
	planetary_atmos = 1
	},
/area/hangar)
"vO" = (
/obj/effect/decal/fakelattice,
/turf/open/floor/plasteel/elevatorshaft{
	planetary_atmos = 1
	},
/area/hangar)
"vZ" = (
/obj/effect/turf_decal/corner/opaque/tan{
	dir = 6
	},
/obj/effect/turf_decal/trimline/opaque/bar/line{
	dir = 4
	},
/turf/open/floor/hangar/plasteel/dark,
/area/hangar)
"wV" = (
/obj/structure/flora/grass/rockplanet/dead,
/turf/open/floor/plating/asteroid/rockplanet/cracked/safe/lit,
/area/hangar)
"wY" = (
/obj/effect/turf_decal/corner/opaque/tan{
	dir = 9
	},
/obj/effect/turf_decal/trimline/opaque/bar/line{
	dir = 8
	},
/turf/open/floor/plasteel/tech,
/area/hangar)
"xh" = (
/obj/effect/turf_decal/corner/opaque/tan/three_quarters{
	dir = 1
	},
/obj/effect/turf_decal/trimline/opaque/bar/filled/shrink_cw{
	layer = 2.032
	},
/turf/open/floor/hangar/plasteel/dark,
/area/hangar)
"xx" = (
/obj/machinery/conveyor/auto/outpost{
	dir = 6;
	verted = -1
	},
/turf/open/floor/plasteel/tech,
/area/hangar)
"xD" = (
/turf/open/floor/plating/asteroid/rockplanet/cracked/safe/lit,
/area/hangar)
"yo" = (
/obj/effect/landmark/outpost/hangar_dock,
/turf/open/floor/hangar,
/area/hangar)
"yG" = (
/obj/machinery/conveyor/auto/outpost{
	dir = 10
	},
/obj/structure/railing/thin,
/turf/open/floor/plasteel/tech,
/area/hangar)
"AZ" = (
/obj/effect/turf_decal/techfloor/corner{
	dir = 4
	},
/turf/open/floor/hangar/plasteel/dark,
/area/hangar)
"Ba" = (
/obj/structure/plasticflaps/outpost,
/obj/machinery/conveyor/auto/outpost{
	dir = 5;
	verted = -1
	},
/turf/open/floor/plasteel/tech,
/area/hangar)
"Bq" = (
/obj/effect/landmark/outpost/elevator_machine,
/obj/machinery/elevator_call_button{
	pixel_y = 25
	},
/obj/effect/turf_decal/techfloor{
	dir = 4
	},
/turf/open/floor/hangar/plasteel/dark,
/area/hangar)
"BO" = (
/obj/effect/turf_decal/industrial/loading/stripes/red,
/turf/open/floor/plasteel/tech,
/area/hangar)
"Cz" = (
/obj/effect/turf_decal/corner/opaque/tan/three_quarters,
/obj/effect/turf_decal/trimline/opaque/bar/line{
	dir = 6
	},
/turf/open/floor/plasteel/tech,
/area/hangar)
"Dz" = (
/obj/structure/flora/tree/cactus,
/turf/open/floor/plating/asteroid/rockplanet/safe/lit,
/area/hangar)
"DC" = (
/obj/machinery/light/floor/hangar,
/turf/open/floor/plasteel/tech{
	planetary_atmos = 1
	},
/area/hangar)
"Gn" = (
/obj/effect/turf_decal/techfloor{
	dir = 8
	},
/turf/open/floor/hangar/plasteel/dark,
/area/hangar)
"HX" = (
/turf/open/floor/plasteel/elevatorshaft{
	planetary_atmos = 1
	},
/area/hangar)
"Il" = (
/obj/effect/turf_decal/corner/opaque/tan/three_quarters{
	dir = 1
	},
/obj/effect/turf_decal/trimline/opaque/bar/line{
	dir = 10
	},
/obj/effect/landmark/outpost/shaft_number,
/turf/open/floor/plasteel/tech,
/area/hangar)
"IZ" = (
/obj/structure/flora/rock/rockplanet,
/turf/open/floor/plating/asteroid/snow/safe/lit,
/area/hangar)
"Jj" = (
/obj/machinery/door/poddoor/ert,
/turf/open/floor/plasteel/elevatorshaft{
	planetary_atmos = 1
	},
/area/hangar)
"Jw" = (
/obj/machinery/light/floor/hangar,
/obj/effect/turf_decal/corner/opaque/tan{
	dir = 10
	},
/obj/effect/turf_decal/trimline/opaque/bar/line,
/turf/open/floor/hangar/plasteel/dark,
/area/hangar)
"Jz" = (
/obj/machinery/conveyor/auto/outpost{
	dir = 8
	},
/obj/structure/railing/thin,
/turf/open/floor/plasteel/tech,
/area/hangar)
"JI" = (
/turf/closed/indestructible/plastitanium/nodiagnonal,
/area/hangar)
"JK" = (
/obj/structure/flora/rock/pile/rockplanet,
/turf/open/floor/plating/asteroid/rockplanet/cracked/safe/lit,
/area/hangar)
"Kf" = (
/obj/structure/flora/rock/pile/rockplanet,
/turf/open/floor/plating/asteroid/snow/safe/lit,
/area/hangar)
"Ks" = (
/obj/effect/turf_decal/corner/opaque/tan{
	dir = 10
	},
/obj/effect/turf_decal/trimline/opaque/bar/line,
/obj/effect/landmark/outpost/hangar_numbers,
/turf/open/floor/plasteel/tech,
/area/hangar)
"KV" = (
/turf/closed/indestructible/rock/rockplanet,
/area/hangar)
"Ld" = (
/obj/effect/turf_decal/trimline/opaque/yellow/warning{
	dir = 8
	},
/turf/open/floor/plasteel/tech{
	planetary_atmos = 1
	},
/area/hangar)
"Lt" = (
/obj/structure/catwalk/over/plated_catwalk/dark,
/turf/open/floor/hangar,
/area/hangar)
"Mf" = (
/obj/effect/turf_decal/corner/opaque/tan{
	dir = 6
	},
/obj/effect/turf_decal/trimline/opaque/bar/line{
	dir = 4
	},
/obj/structure/sign/directions/supply{
	dir = 1;
	pixel_x = 32;
	pixel_y = -5;
	desc = "A direction sign, pointing out which way the Cargo Delivery Chute is."
	},
/turf/open/floor/hangar/plasteel/dark,
/area/hangar)
"Op" = (
/obj/effect/turf_decal/techfloor{
	dir = 4
	},
/turf/open/floor/hangar/plasteel/dark,
/area/hangar)
"ON" = (
/obj/machinery/conveyor/auto/outpost,
/obj/effect/landmark/outpost/hangar_crate_spawner,
/turf/open/floor/plasteel/tech,
/area/hangar)
"OT" = (
/obj/effect/turf_decal/corner/opaque/tan/three_quarters,
/obj/effect/turf_decal/trimline/opaque/bar/line{
	dir = 6
	},
/turf/open/floor/hangar/plasteel/dark,
/area/hangar)
"PD" = (
/obj/effect/turf_decal/trimline/opaque/yellow/warning{
	dir = 4
	},
/turf/open/floor/plasteel/tech{
	planetary_atmos = 1
	},
/area/hangar)
"Ra" = (
/obj/effect/turf_decal/techfloor{
	dir = 1
	},
/turf/open/floor/hangar/plasteel/dark,
/area/hangar)
"Rr" = (
/obj/effect/turf_decal/industrial/outline/red,
/turf/open/floor/plasteel/tech,
/area/hangar)
"Si" = (
/obj/structure/flora/rock/rockplanet,
/turf/open/floor/plating/asteroid/rockplanet/safe/lit,
/area/hangar)
"Sk" = (
/turf/open/floor/plating/asteroid/rockplanet/safe/lit,
/area/hangar)
"Ss" = (
/obj/machinery/light/dim/directional/north,
/obj/machinery/conveyor/auto/outpost{
	dir = 8
	},
/obj/structure/railing/thin/corner,
/turf/open/floor/plasteel/tech,
/area/hangar)
"SL" = (
/obj/effect/turf_decal/corner/opaque/tan/three_quarters{
	dir = 8
	},
/obj/effect/turf_decal/trimline/opaque/bar/line{
	dir = 5
	},
/turf/open/floor/hangar/plasteel/dark,
/area/hangar)
"TO" = (
/obj/effect/turf_decal/industrial/hatch/red,
/turf/open/floor/plasteel/tech,
/area/hangar)
"Vm" = (
/obj/effect/turf_decal/arrows{
	dir = 1
	},
/turf/open/floor/plasteel/tech{
	planetary_atmos = 1
	},
/area/hangar)
"Xh" = (
/obj/effect/turf_decal/corner/opaque/tan{
	dir = 9
	},
/obj/effect/turf_decal/trimline/opaque/bar/line{
	dir = 8
	},
/turf/open/floor/hangar/plasteel/dark,
/area/hangar)
"Yv" = (
/obj/effect/turf_decal/techfloor/corner{
	dir = 1
	},
/turf/open/floor/hangar/plasteel/dark,
/area/hangar)
"YB" = (
/obj/effect/turf_decal/techfloor{
	dir = 8
	},
/obj/structure/rack,
/obj/item/clothing/suit/hooded/wintercoat,
/obj/item/clothing/suit/hooded/wintercoat,
/obj/item/clothing/suit/hooded/wintercoat,
/obj/item/clothing/suit/hooded/wintercoat,
/obj/item/clothing/suit/hooded/wintercoat,
/turf/open/floor/hangar/plasteel/dark,
/area/hangar)
"YG" = (
/obj/effect/turf_decal/corner/opaque/tan{
	dir = 6
	},
/obj/effect/turf_decal/trimline/opaque/bar/line{
	dir = 4
	},
/turf/open/floor/plasteel/tech,
/area/hangar)
"Zd" = (
/turf/open/floor/hangar,
/area/hangar)

(1,1,1) = {"
KV
KV
KV
KV
KV
KV
KV
KV
KV
KV
KV
KV
KV
KV
KV
KV
KV
KV
KV
KV
KV
KV
KV
KV
KV
KV
KV
KV
KV
KV
KV
KV
KV
KV
KV
KV
KV
KV
KV
"}
(2,1,1) = {"
KV
KV
KV
KV
KV
KV
KV
KV
KV
KV
KV
KV
KV
KV
KV
KV
KV
KV
KV
KV
KV
KV
KV
KV
KV
KV
KV
KV
KV
KV
KV
KV
KV
KV
KV
KV
KV
KV
KV
"}
(3,1,1) = {"
KV
KV
KV
KV
KV
KV
KV
KV
KV
KV
KV
KV
KV
KV
KV
KV
KV
KV
KV
KV
KV
KV
KV
KV
KV
KV
KV
KV
KV
KV
KV
KV
KV
KV
KV
KV
KV
KV
KV
"}
(4,1,1) = {"
KV
KV
KV
KV
KV
KV
KV
KV
KV
bB
qn
xh
Ld
Ld
Ld
Ld
Ld
Ld
Ld
Ld
Ld
Ld
Ld
Ld
Ld
Ld
Ld
Ld
Ld
Ld
Ld
Ld
bB
qn
xh
KV
KV
KV
KV
"}
(5,1,1) = {"
KV
KV
KV
KV
KV
KV
KV
KV
KV
tZ
Lt
jJ
cD
cD
Vm
cD
DC
cD
cD
Vm
cD
cD
cD
cD
Vm
cD
DC
cD
cD
Vm
cD
cD
tZ
Lt
jJ
tU
KV
KV
KV
"}
(6,1,1) = {"
KV
KV
KV
KV
KV
KV
KV
KV
KV
tZ
Lt
jJ
PD
PD
PD
PD
PD
PD
PD
PD
PD
PD
PD
PD
PD
PD
PD
PD
PD
PD
PD
PD
tZ
Lt
jJ
wV
KV
KV
KV
"}
(7,1,1) = {"
KV
KV
KV
KV
KV
KV
KV
KV
Kf
tZ
Lt
jJ
Zd
Zd
Zd
Zd
Zd
Zd
Zd
Zd
Zd
Zd
Zd
Zd
Zd
Zd
Zd
Zd
Zd
Zd
Zd
yo
tZ
Lt
jJ
xD
KV
KV
KV
"}
(8,1,1) = {"
KV
KV
KV
KV
KV
KV
KV
KV
xD
tZ
Lt
jJ
Zd
Zd
Zd
Zd
Zd
Zd
Zd
Zd
Zd
Zd
Zd
Zd
Zd
Zd
Zd
Zd
Zd
Zd
Zd
Zd
tZ
Lt
jJ
Si
KV
KV
KV
"}
(9,1,1) = {"
KV
KV
KV
KV
KV
KV
KV
KV
wV
tZ
Lt
jJ
kT
Zd
Zd
Zd
Zd
Zd
Zd
Zd
Zd
Zd
Zd
Zd
Zd
Zd
Zd
Zd
Zd
Zd
Zd
kT
tZ
Lt
jJ
tU
KV
KV
KV
"}
(10,1,1) = {"
KV
KV
KV
KV
KV
KV
KV
KV
xD
tZ
Lt
jJ
Zd
Zd
Zd
Zd
Zd
Zd
Zd
Zd
Zd
Zd
Zd
Zd
Zd
Zd
Zd
Zd
Zd
Zd
Zd
Zd
tZ
Lt
jJ
tU
tU
KV
KV
"}
(11,1,1) = {"
KV
KV
KV
KV
KV
KV
KV
tU
Sk
tZ
Lt
Jw
Zd
Zd
Zd
Zd
Zd
Zd
Zd
Zd
Zd
Zd
Zd
Zd
Zd
Zd
Zd
Zd
Zd
Zd
Zd
Zd
tF
Lt
jJ
Sk
tU
KV
KV
"}
(12,1,1) = {"
KV
KV
KV
KV
KV
KV
KV
tU
Sk
tZ
Lt
jJ
Zd
Zd
Zd
Zd
Zd
Zd
Zd
Zd
Zd
Zd
Zd
Zd
Zd
Zd
Zd
Zd
Zd
Zd
Zd
Zd
tZ
Lt
jJ
Sk
tU
KV
KV
"}
(13,1,1) = {"
KV
KV
KV
KV
KV
KV
KV
tU
Dz
tZ
Lt
jJ
Zd
Zd
Zd
Zd
Zd
Zd
Zd
Zd
Zd
Zd
Zd
Zd
Zd
Zd
Zd
Zd
Zd
Zd
Zd
Zd
tZ
Lt
jJ
kr
pI
KV
KV
"}
(14,1,1) = {"
KV
KV
KV
KV
KV
KV
tU
wV
xD
tZ
Lt
jJ
kT
Zd
Zd
Zd
Zd
Zd
Zd
Zd
Zd
Zd
Zd
Zd
Zd
Zd
Zd
Zd
Zd
Zd
Zd
kT
tZ
Lt
jJ
Sk
xD
tU
KV
"}
(15,1,1) = {"
KV
KV
KV
KV
KV
KV
Kf
Sk
xD
tZ
Lt
jJ
Zd
Zd
Zd
Zd
Zd
Zd
Zd
Zd
Zd
Zd
Zd
Zd
Zd
Zd
Zd
Zd
Zd
Zd
Zd
Zd
tZ
Lt
jJ
Sk
Dz
tU
KV
"}
(16,1,1) = {"
KV
KV
KV
KV
KV
KV
KV
KV
uT
tZ
Lt
jJ
Zd
Zd
Zd
Zd
Zd
Zd
Zd
Zd
Zd
Zd
Zd
Zd
Zd
Zd
Zd
Zd
Zd
Zd
Zd
Zd
tZ
Lt
jJ
Sk
xD
IZ
KV
"}
(17,1,1) = {"
KV
KV
KV
KV
KV
KV
KV
KV
Sk
tZ
Lt
jJ
Zd
Zd
Zd
Zd
Zd
Zd
Zd
Zd
Zd
Zd
Zd
Zd
Zd
Zd
Zd
Zd
Zd
Zd
Zd
Zd
tZ
Lt
jJ
Sk
Sk
Sk
KV
"}
(18,1,1) = {"
KV
KV
KV
KV
KV
KV
KV
KV
Sk
tZ
Lt
jJ
Zd
Zd
Zd
Zd
Zd
Zd
Zd
Zd
Zd
Zd
Zd
Zd
Zd
Zd
Zd
Zd
Zd
Zd
Zd
Zd
tZ
Lt
jJ
xD
wV
tU
KV
"}
(19,1,1) = {"
KV
KV
KV
KV
KV
KV
KV
KV
kr
tZ
Lt
jJ
kT
Zd
Zd
Zd
Zd
Zd
Zd
Zd
Zd
Zd
Zd
Zd
Zd
Zd
Zd
Zd
Zd
Zd
Zd
kT
tZ
Lt
jJ
Sk
xD
tU
KV
"}
(20,1,1) = {"
KV
KV
KV
KV
KV
KV
KV
KV
Sk
tZ
Lt
jJ
Zd
Zd
Zd
Zd
Zd
Zd
Zd
Zd
Zd
Zd
Zd
Zd
Zd
Zd
Zd
Zd
Zd
Zd
Zd
Zd
tZ
Lt
jJ
Sk
xD
KV
KV
"}
(21,1,1) = {"
KV
KV
KV
KV
KV
KV
KV
KV
KV
tZ
Lt
Jw
Zd
Zd
Zd
Zd
Zd
Zd
Zd
Zd
Zd
Zd
Zd
Zd
Zd
Zd
Zd
Zd
Zd
Zd
Zd
Zd
tF
Lt
jJ
xD
tU
KV
KV
"}
(22,1,1) = {"
KV
KV
KV
KV
KV
KV
KV
KV
KV
tZ
Lt
jJ
Zd
Zd
Zd
Zd
Zd
Zd
Zd
Zd
Zd
Zd
Zd
Zd
Zd
Zd
Zd
Zd
Zd
Zd
Zd
Zd
tZ
Lt
jJ
xD
tU
KV
KV
"}
(23,1,1) = {"
KV
KV
KV
KV
KV
KV
KV
KV
KV
tZ
Lt
jJ
Zd
Zd
Zd
Zd
Zd
Zd
Zd
Zd
Zd
Zd
Zd
Zd
Zd
Zd
Zd
Zd
Zd
Zd
Zd
Zd
tZ
Lt
jJ
Sk
Kf
KV
KV
"}
(24,1,1) = {"
KV
KV
KV
KV
KV
KV
KV
KV
KV
tZ
Lt
jJ
kT
Zd
Zd
Zd
Zd
Zd
Zd
Zd
Zd
Zd
Zd
Zd
Zd
Zd
Zd
Zd
Zd
Zd
Zd
kT
tZ
Lt
jJ
kr
tU
KV
KV
"}
(25,1,1) = {"
KV
KV
KV
KV
KV
KV
KV
KV
Si
tZ
Lt
jJ
Zd
Zd
Zd
Zd
Zd
Zd
Zd
Zd
Zd
Zd
Zd
Zd
Zd
Zd
Zd
Zd
Zd
Zd
Zd
Zd
tZ
Lt
jJ
Sk
Sk
KV
KV
"}
(26,1,1) = {"
KV
KV
KV
KV
KV
KV
KV
KV
kr
tZ
Lt
jJ
Zd
Zd
Zd
Zd
Zd
Zd
Zd
Zd
Zd
Zd
Zd
Zd
Zd
Zd
Zd
Zd
Zd
Zd
Zd
Zd
tZ
Lt
jJ
Dz
kr
KV
KV
"}
(27,1,1) = {"
KV
KV
KV
KV
KV
KV
KV
KV
Dz
tZ
Lt
jJ
Zd
Zd
Zd
Zd
Zd
Zd
Zd
Zd
Zd
Zd
Zd
Zd
Zd
Zd
Zd
Zd
Zd
Zd
Zd
Zd
tZ
Lt
jJ
Sk
IZ
KV
KV
"}
(28,1,1) = {"
KV
KV
KV
KV
KV
KV
KV
KV
KV
tZ
Lt
jJ
Zd
Zd
Zd
Zd
Zd
Zd
Zd
Zd
Zd
Zd
Zd
Zd
Zd
Zd
Zd
Zd
Zd
Zd
Zd
Zd
tZ
Lt
jJ
Sk
tU
KV
KV
"}
(29,1,1) = {"
KV
KV
KV
KV
KV
KV
KV
KV
KV
tZ
Lt
jJ
kT
Zd
Zd
Zd
Zd
Zd
Zd
Zd
Zd
Zd
Zd
Zd
Zd
Zd
Zd
Zd
Zd
Zd
Zd
kT
tZ
Lt
jJ
Sk
tU
KV
KV
"}
(30,1,1) = {"
KV
KV
KV
KV
KV
KV
KV
KV
KV
tZ
Lt
jJ
Zd
Zd
Zd
Zd
Zd
Zd
Zd
Zd
Zd
Zd
Zd
Zd
Zd
Zd
Zd
Zd
Zd
Zd
Zd
Zd
tZ
Lt
jJ
kr
tU
KV
KV
"}
(31,1,1) = {"
KV
KV
KV
KV
KV
KV
KV
KV
KV
tZ
Lt
Jw
Zd
Zd
Zd
Zd
Zd
Zd
Zd
Zd
Zd
Zd
Zd
Zd
Zd
Zd
Zd
Zd
Zd
Zd
Zd
Zd
tF
Lt
jJ
Sk
kr
Kf
KV
"}
(32,1,1) = {"
KV
KV
KV
KV
KV
KV
KV
KV
KV
tZ
Lt
jJ
Zd
Zd
Zd
Zd
Zd
Zd
Zd
Zd
Zd
Zd
Zd
Zd
Zd
Zd
Zd
Zd
Zd
Zd
Zd
Zd
tZ
Lt
jJ
Sk
xD
tU
KV
"}
(33,1,1) = {"
KV
KV
KV
KV
KV
KV
KV
KV
KV
tZ
Lt
jJ
Zd
Zd
Zd
Zd
Zd
Zd
Zd
Zd
Zd
Zd
Zd
Zd
Zd
Zd
Zd
Zd
Zd
Zd
Zd
Zd
tZ
Lt
jJ
xD
Sk
tU
KV
"}
(34,1,1) = {"
KV
KV
KV
KV
KV
KV
KV
KV
KV
tZ
Lt
jJ
kT
Zd
Zd
Zd
Zd
Zd
Zd
Zd
Zd
Zd
Zd
Zd
Zd
Zd
Zd
Zd
Zd
Zd
Zd
kT
tZ
Lt
jJ
Sk
sl
Sk
KV
"}
(35,1,1) = {"
KV
KV
KV
KV
KV
KV
KV
KV
Kf
tZ
Lt
jJ
Zd
Zd
Zd
Zd
Zd
Zd
Zd
Zd
Zd
Zd
Zd
Zd
Zd
Zd
Zd
Zd
Zd
Zd
Zd
Zd
tZ
Lt
jJ
kr
xD
Sk
KV
"}
(36,1,1) = {"
KV
KV
KV
KV
KV
KV
KV
KV
aB
tZ
Lt
jJ
Zd
Zd
Zd
Zd
Zd
Zd
Zd
Zd
Zd
Zd
Zd
Zd
Zd
Zd
Zd
Zd
Zd
Zd
Zd
Zd
tZ
Lt
jJ
Sk
Sk
xD
KV
"}
(37,1,1) = {"
KV
KV
KV
KV
KV
KV
KV
KV
tU
tZ
Lt
jJ
Zd
Zd
Zd
Zd
Zd
Zd
Zd
Zd
Zd
Zd
Zd
Zd
Zd
Zd
Zd
Zd
Zd
Zd
Zd
Zd
tZ
Lt
jJ
Sk
wV
Kf
KV
"}
(38,1,1) = {"
KV
KV
KV
KV
KV
KV
KV
KV
KV
tZ
Lt
jJ
Zd
Zd
Zd
Zd
Zd
Zd
Zd
Zd
Zd
Zd
Zd
Zd
Zd
Zd
Zd
Zd
Zd
Zd
Zd
Zd
tZ
Lt
jJ
xD
tU
KV
KV
"}
(39,1,1) = {"
KV
KV
KV
KV
KV
KV
KV
JI
rC
qb
Lt
jJ
kT
Zd
Zd
Zd
Zd
Zd
Zd
Zd
Zd
Zd
Zd
Zd
Zd
Zd
Zd
Zd
Zd
Zd
Zd
kT
tZ
Lt
jJ
wV
KV
KV
KV
"}
(40,1,1) = {"
KV
KV
KV
KV
KV
KV
KV
JI
TO
BO
Lt
jJ
Zd
Zd
Zd
Zd
Zd
Zd
Zd
Zd
Zd
Zd
Zd
Zd
Zd
Zd
Zd
Zd
Zd
Zd
Zd
Zd
tZ
Lt
jJ
kr
KV
KV
KV
"}
(41,1,1) = {"
KV
KV
KV
KV
KV
KV
KV
JI
jp
mt
Lt
Jw
Zd
Zd
Zd
Zd
Zd
Zd
Zd
Zd
Zd
Zd
Zd
Zd
Zd
Zd
Zd
Zd
Zd
Zd
Zd
Zd
tF
Lt
jJ
tU
KV
KV
KV
"}
(42,1,1) = {"
KV
KV
KV
KV
KV
KV
KV
JI
Ss
mt
Lt
jJ
Zd
Zd
Zd
Zd
Zd
Zd
Zd
Zd
Zd
Zd
Zd
Zd
Zd
Zd
Zd
Zd
Zd
Zd
Zd
Zd
tZ
Lt
jJ
tU
KV
KV
KV
"}
(43,1,1) = {"
KV
KV
KV
KV
KV
JI
JI
JI
Jz
Rr
Lt
jJ
Zd
Zd
Zd
Zd
Zd
Zd
Zd
Zd
Zd
Zd
Zd
Zd
Zd
Zd
Zd
Zd
Zd
Zd
Zd
Zd
tZ
Lt
jJ
KV
KV
KV
KV
"}
(44,1,1) = {"
KV
KV
KV
KV
KV
JI
Ba
dr
yG
Rr
Lt
jJ
kT
Zd
Zd
Zd
Zd
Zd
Zd
Zd
Zd
Zd
Zd
Zd
Zd
Zd
Zd
Zd
Zd
Zd
Zd
kT
tZ
Lt
jJ
KV
KV
KV
KV
"}
(45,1,1) = {"
KV
KV
KV
KV
KV
JI
nA
JI
rC
mt
Lt
jJ
Zd
Zd
Zd
Zd
Zd
Zd
Zd
Zd
Zd
Zd
Zd
Zd
Zd
Zd
Zd
Zd
Zd
Zd
Zd
Zd
tZ
Lt
jJ
KV
KV
KV
KV
"}
(46,1,1) = {"
KV
KV
KV
KV
KV
JI
xx
sD
JI
pZ
Lt
jJ
Zd
Zd
Zd
Zd
Zd
Zd
Zd
Zd
Zd
Zd
Zd
Zd
Zd
Zd
Zd
Zd
Zd
Zd
Zd
Zd
tZ
Lt
jJ
KV
KV
KV
KV
"}
(47,1,1) = {"
KV
KV
KV
KV
KV
JI
JI
rT
JI
hh
cX
nQ
Xh
Xh
Xh
Xh
Xh
Xh
Xh
Xh
Xh
Xh
Xh
Xh
Xh
Xh
Xh
Xh
Xh
Xh
Xh
Xh
qb
Lt
jJ
KV
KV
KV
KV
"}
(48,1,1) = {"
KV
KV
KV
KV
KV
JI
ON
sz
JI
ea
cX
Lt
Lt
Lt
Lt
Lt
Lt
Lt
Lt
Lt
Lt
Lt
Lt
Lt
Lt
Lt
Lt
Lt
Lt
Lt
Lt
Lt
Lt
Lt
jJ
tU
KV
KV
KV
"}
(49,1,1) = {"
KV
KV
KV
KV
KV
JI
JI
JI
JI
SL
vZ
vZ
vZ
tH
vZ
vZ
vZ
Mf
vZ
vZ
vZ
vZ
vZ
vZ
vZ
vZ
vZ
vZ
vZ
vZ
tH
vZ
vZ
vZ
OT
kr
KV
KV
KV
"}
(50,1,1) = {"
KV
KV
KV
KV
KV
KV
KV
KV
KV
KV
KV
KV
KV
KV
KV
KV
KV
JI
wV
xD
Sk
Sk
kr
xD
xD
KV
KV
KV
KV
tU
wV
Sk
Sk
Sk
xD
JK
tU
KV
KV
"}
(51,1,1) = {"
KV
KV
KV
JI
KV
KV
JI
KV
KV
JI
KV
KV
JI
KV
KV
JI
JI
JI
JI
JI
Bq
Op
Op
AZ
xD
KV
KV
KV
KV
tU
tU
sl
uT
kr
tU
KV
KV
KV
KV
"}
(52,1,1) = {"
KV
KV
KV
Jj
HX
HX
sT
HX
HX
sT
HX
HX
sT
HX
HX
Jj
HX
HX
vq
em
vm
wY
Il
Ra
wV
Sk
KV
KV
KV
KV
tU
tU
tU
tU
KV
KV
KV
KV
KV
"}
(53,1,1) = {"
KV
KV
KV
Jj
vO
vO
sq
vO
vO
sq
vO
vO
sq
vO
vO
JI
HX
HX
HX
em
oK
iA
Ks
Ra
Sk
Dz
KV
KV
KV
KV
KV
tU
KV
KV
KV
KV
KV
KV
KV
"}
(54,1,1) = {"
KV
KV
KV
Jj
HX
HX
sT
HX
HX
sT
HX
HX
sT
HX
HX
Jj
HX
HX
HX
em
rv
YG
Cz
Ra
Sk
KV
KV
KV
KV
KV
KV
KV
KV
KV
KV
KV
KV
KV
KV
"}
(55,1,1) = {"
KV
KV
KV
JI
KV
KV
JI
KV
KV
JI
KV
KV
JI
KV
KV
JI
JI
JI
JI
JI
YB
YB
Gn
Yv
xD
KV
KV
KV
KV
KV
KV
KV
KV
KV
KV
KV
KV
KV
KV
"}
(56,1,1) = {"
KV
KV
KV
KV
KV
KV
KV
KV
KV
KV
KV
KV
KV
KV
KV
KV
KV
KV
KV
KV
KV
KV
KV
Si
JK
KV
KV
KV
KV
KV
KV
KV
KV
KV
KV
KV
KV
KV
KV
"}
(57,1,1) = {"
KV
KV
KV
KV
KV
KV
KV
KV
KV
KV
KV
KV
KV
KV
KV
KV
KV
KV
KV
KV
KV
KV
KV
KV
KV
KV
KV
KV
KV
KV
KV
KV
KV
KV
KV
KV
KV
KV
KV
"}
(58,1,1) = {"
KV
KV
KV
KV
KV
KV
KV
KV
KV
KV
KV
KV
KV
KV
KV
KV
KV
KV
KV
KV
KV
KV
KV
KV
KV
KV
KV
KV
KV
KV
KV
KV
KV
KV
KV
KV
KV
KV
KV
"}
(59,1,1) = {"
KV
KV
KV
KV
KV
KV
KV
KV
KV
KV
KV
KV
KV
KV
KV
KV
KV
KV
KV
KV
KV
KV
KV
KV
KV
KV
KV
KV
KV
KV
KV
KV
KV
KV
KV
KV
KV
KV
KV
"}
(60,1,1) = {"
KV
KV
KV
KV
KV
KV
KV
KV
KV
KV
KV
KV
KV
KV
KV
KV
KV
KV
KV
KV
KV
KV
KV
KV
KV
KV
KV
KV
KV
KV
KV
KV
KV
KV
KV
KV
KV
KV
KV
"}
