//MAP CONVERTED BY dmm2tgm.py THIS HEADER COMMENT PREVENTS RECONVERSION, DO NOT REMOVE
"aF" = (
/obj/structure/flora/rock/pile/rockplanet,
/turf/open/floor/plating/asteroid/snow/safe/lit,
/area/hangar)
"bJ" = (
/obj/structure/catwalk/over/plated_catwalk/dark,
/obj/machinery/light/floor/hangar,
/turf/open/floor/plating{
	planetary_atmos = 1
	},
/area/hangar)
"eR" = (
/obj/effect/landmark/outpost/elevator_machine,
/obj/structure/lattice/catwalk,
/obj/machinery/door/airlock/grunge,
/turf/open/floor/engine,
/area/hangar)
"eV" = (
/obj/effect/landmark/outpost/elevator,
/turf/open/floor/plasteel/elevatorshaft{
	planetary_atmos = 1
	},
/area/hangar)
"fs" = (
/obj/effect/turf_decal/corner/opaque/tan{
	dir = 6
	},
/obj/effect/turf_decal/trimline/opaque/bar/line{
	dir = 4
	},
/obj/effect/turf_decal/siding/wideplating/dark{
	dir = 4
	},
/turf/open/floor/plasteel/tech,
/area/hangar)
"fB" = (
/obj/effect/turf_decal/corner/opaque/tan/three_quarters,
/obj/effect/turf_decal/trimline/opaque/bar/line{
	dir = 6
	},
/obj/effect/turf_decal/siding/wideplating/dark{
	dir = 4
	},
/turf/open/floor/plasteel/tech,
/area/hangar)
"fH" = (
/obj/effect/turf_decal/corner/opaque/bar/half{
	dir = 1
	},
/turf/open/floor/plasteel/dark,
/area/hangar)
"fI" = (
/obj/effect/turf_decal/corner/opaque/bar{
	dir = 8
	},
/turf/open/floor/plasteel/dark,
/area/hangar)
"gc" = (
/obj/effect/turf_decal/techfloor{
	dir = 8
	},
/obj/structure/rack,
/obj/item/clothing/suit/hooded/wintercoat,
/obj/item/clothing/suit/hooded/wintercoat,
/obj/item/clothing/suit/hooded/wintercoat,
/obj/item/clothing/suit/hooded/wintercoat,
/obj/item/clothing/suit/hooded/wintercoat,
/turf/open/floor/plasteel/dark,
/area/hangar)
"gS" = (
/obj/structure/flora/grass/rockplanet/dead,
/turf/open/floor/plating/asteroid/rockplanet/safe/lit,
/area/hangar)
"hz" = (
/obj/structure/flora/rock/rockplanet,
/turf/open/floor/plating/asteroid/rockplanet/cracked/safe/lit,
/area/hangar)
"hT" = (
/obj/structure/marker_beacon{
	picked_color = "Teal"
	},
/turf/open/floor/plating{
	planetary_atmos = 1
	},
/area/hangar)
"if" = (
/turf/closed/indestructible/plastitanium/nodiagnonal,
/area/hangar)
"lx" = (
/obj/effect/turf_decal/arrows{
	dir = 1
	},
/turf/open/floor/plasteel/tech{
	planetary_atmos = 1
	},
/area/hangar)
"mR" = (
/obj/effect/turf_decal/corner/opaque/tan{
	dir = 9
	},
/obj/effect/turf_decal/trimline/opaque/bar/line{
	dir = 8
	},
/obj/effect/turf_decal/siding/wideplating/dark{
	dir = 8
	},
/turf/open/floor/plasteel/tech,
/area/hangar)
"nO" = (
/obj/structure/flora/tree/cactus,
/turf/open/floor/plating/asteroid/rockplanet/cracked/safe/lit,
/area/hangar)
"pT" = (
/turf/open/floor/plasteel/elevatorshaft{
	planetary_atmos = 1
	},
/area/hangar)
"qh" = (
/obj/effect/turf_decal/trimline/opaque/yellow/warning{
	dir = 8
	},
/turf/open/floor/plasteel/tech{
	planetary_atmos = 1
	},
/area/hangar)
"qx" = (
/obj/effect/turf_decal/corner/opaque/bar/half,
/turf/open/floor/plasteel/dark,
/area/hangar)
"sc" = (
/turf/open/floor/plating/asteroid/snow/safe/lit,
/area/hangar)
"sF" = (
/obj/machinery/door/poddoor/ert,
/turf/open/floor/plasteel/elevatorshaft{
	planetary_atmos = 1
	},
/area/hangar)
"sM" = (
/turf/open/floor/plasteel/tech{
	planetary_atmos = 1
	},
/area/hangar)
"tc" = (
/obj/structure/flora/tree/cactus,
/turf/open/floor/plating/asteroid/rockplanet/safe/lit,
/area/hangar)
"te" = (
/obj/effect/landmark/outpost/hangar_dock,
/turf/open/floor/plating{
	planetary_atmos = 1
	},
/area/hangar)
"ts" = (
/obj/structure/flora/rock/pile/rockplanet,
/turf/open/floor/plating/asteroid/rockplanet/safe/lit,
/area/hangar)
"tv" = (
/turf/open/floor/plasteel/dark,
/area/hangar)
"uc" = (
/obj/effect/turf_decal/corner/opaque/tan{
	dir = 10
	},
/obj/effect/turf_decal/trimline/opaque/bar/line,
/turf/open/floor/plasteel/tech,
/area/hangar)
"uD" = (
/obj/effect/turf_decal/techfloor/corner{
	dir = 1
	},
/turf/open/floor/plasteel/dark,
/area/hangar)
"vR" = (
/obj/machinery/light/floor/hangar,
/obj/effect/turf_decal/corner/opaque/bar/half{
	dir = 1
	},
/turf/open/floor/plasteel/dark,
/area/hangar)
"wx" = (
/obj/effect/turf_decal/techfloor{
	dir = 4
	},
/turf/open/floor/plasteel/dark,
/area/hangar)
"wz" = (
/obj/structure/flora/rock/rockplanet,
/turf/open/floor/plating/asteroid/rockplanet/safe/lit,
/area/hangar)
"wC" = (
/obj/effect/turf_decal/trimline/opaque/yellow/warning{
	dir = 4
	},
/turf/open/floor/plasteel/tech{
	planetary_atmos = 1
	},
/area/hangar)
"ye" = (
/turf/open/floor/plating{
	planetary_atmos = 1
	},
/area/hangar)
"zC" = (
/obj/effect/turf_decal/corner/opaque/bar/three_quarters,
/turf/open/floor/plasteel/dark,
/area/hangar)
"zD" = (
/turf/closed/indestructible/rock/rockplanet,
/area/hangar)
"AZ" = (
/obj/effect/turf_decal/corner/opaque/bar/half{
	dir = 8
	},
/obj/machinery/light/floor/hangar,
/turf/open/floor/plasteel/dark,
/area/hangar)
"Bw" = (
/obj/effect/turf_decal/corner/opaque/bar/half{
	dir = 4
	},
/turf/open/floor/plasteel/dark,
/area/hangar)
"BZ" = (
/obj/effect/turf_decal/corner/opaque/tan/three_quarters{
	dir = 8
	},
/obj/effect/turf_decal/trimline/opaque/bar/line{
	dir = 5
	},
/obj/effect/turf_decal/siding/wideplating/dark{
	dir = 4
	},
/turf/open/floor/plasteel/tech,
/area/hangar)
"Co" = (
/turf/open/floor/plasteel/stairs/mid{
	dir = 1;
	color = "#2e2e2e"
	},
/area/hangar)
"DR" = (
/obj/effect/turf_decal/corner/opaque/tan/three_quarters{
	dir = 1
	},
/obj/effect/turf_decal/trimline/opaque/bar/line{
	dir = 10
	},
/obj/effect/turf_decal/siding/wideplating/dark{
	dir = 8
	},
/turf/open/floor/plasteel/tech,
/area/hangar)
"Eo" = (
/obj/effect/turf_decal/techfloor{
	dir = 1
	},
/turf/open/floor/plasteel/dark,
/area/hangar)
"EG" = (
/obj/effect/turf_decal/corner/opaque/tan/three_quarters{
	dir = 4
	},
/obj/effect/turf_decal/trimline/opaque/bar/line{
	dir = 9
	},
/obj/effect/turf_decal/siding/wideplating/dark{
	dir = 8
	},
/turf/open/floor/plasteel/tech,
/area/hangar)
"HD" = (
/obj/structure/flora/grass/rockplanet/dead,
/turf/open/floor/plating/asteroid/rockplanet/cracked/safe/lit,
/area/hangar)
"JQ" = (
/obj/machinery/light/floor/hangar,
/obj/effect/turf_decal/corner/opaque/bar/half,
/turf/open/floor/plasteel/dark,
/area/hangar)
"KC" = (
/turf/open/floor/plating/asteroid/rockplanet/safe/lit,
/area/hangar)
"Mv" = (
/obj/effect/decal/fakelattice,
/turf/open/floor/plasteel/elevatorshaft{
	planetary_atmos = 1
	},
/area/hangar)
"MA" = (
/obj/effect/turf_decal/corner/opaque/bar/half{
	dir = 1
	},
/obj/machinery/light/floor/hangar,
/turf/open/floor/plasteel/dark,
/area/hangar)
"Ne" = (
/obj/effect/turf_decal/techfloor{
	dir = 8
	},
/turf/open/floor/plasteel/dark,
/area/hangar)
"Ox" = (
/obj/effect/decal/fakelattice,
/turf/open/floor/plasteel/stairs/mid{
	dir = 1;
	color = "#2e2e2e"
	},
/area/hangar)
"Pk" = (
/turf/open/floor/plating/asteroid/rockplanet/cracked/safe/lit,
/area/hangar)
"Pu" = (
/obj/effect/landmark/outpost/hangar_numbers,
/obj/effect/turf_decal/corner/opaque/tan{
	dir = 5
	},
/obj/effect/turf_decal/trimline/opaque/bar/line{
	dir = 1
	},
/turf/open/floor/plasteel/tech,
/area/hangar)
"Qf" = (
/obj/effect/turf_decal/corner/opaque/bar/three_quarters{
	dir = 4
	},
/turf/open/floor/plasteel/dark,
/area/hangar)
"Rf" = (
/obj/effect/turf_decal/corner/opaque/bar/half{
	dir = 8
	},
/turf/open/floor/plasteel/dark,
/area/hangar)
"Si" = (
/obj/effect/turf_decal/corner/opaque/bar{
	dir = 1
	},
/turf/open/floor/plasteel/dark,
/area/hangar)
"SB" = (
/obj/effect/turf_decal/techfloor/corner{
	dir = 4
	},
/turf/open/floor/plasteel/dark,
/area/hangar)
"Tv" = (
/obj/machinery/light/floor/hangar,
/turf/open/floor/plasteel/tech{
	planetary_atmos = 1
	},
/area/hangar)
"Uu" = (
/obj/structure/flora/grass/rockplanet/dead,
/turf/open/floor/plating/asteroid/snow/safe/lit,
/area/hangar)
"VK" = (
/obj/effect/landmark/outpost/elevator_machine,
/obj/machinery/elevator_call_button{
	pixel_y = 25
	},
/obj/effect/turf_decal/techfloor{
	dir = 4
	},
/turf/open/floor/plasteel/dark,
/area/hangar)
"WX" = (
/obj/structure/flora/rock/pile/rockplanet,
/turf/open/floor/plating/asteroid/rockplanet/cracked/safe/lit,
/area/hangar)
"Yf" = (
/obj/structure/catwalk/over/plated_catwalk/dark,
/turf/open/floor/plating{
	planetary_atmos = 1
	},
/area/hangar)
"Yk" = (
/obj/effect/turf_decal/corner/opaque/bar/half,
/obj/machinery/light/floor/hangar,
/turf/open/floor/plasteel/dark,
/area/hangar)
"Yx" = (
/obj/structure/flora/rock/rockplanet,
/turf/open/floor/plating/asteroid/snow/safe/lit,
/area/hangar)
"Zr" = (
/obj/effect/turf_decal/corner/opaque/bar/three_quarters{
	dir = 1
	},
/turf/open/floor/plasteel/dark,
/area/hangar)

(1,1,1) = {"
zD
zD
zD
zD
zD
zD
zD
zD
zD
zD
zD
zD
zD
zD
zD
zD
zD
zD
zD
zD
zD
zD
zD
zD
zD
zD
zD
zD
zD
zD
zD
zD
zD
zD
zD
zD
zD
zD
zD
zD
zD
zD
zD
zD
zD
zD
zD
zD
zD
zD
zD
zD
zD
zD
zD
zD
zD
zD
zD
"}
(2,1,1) = {"
zD
zD
zD
zD
zD
zD
zD
zD
zD
zD
zD
zD
zD
zD
zD
zD
zD
zD
zD
zD
zD
zD
zD
zD
zD
zD
zD
zD
zD
zD
zD
zD
zD
zD
zD
zD
zD
zD
zD
zD
zD
zD
zD
zD
zD
zD
zD
zD
zD
zD
zD
zD
zD
zD
zD
zD
zD
zD
zD
"}
(3,1,1) = {"
zD
zD
zD
zD
zD
zD
zD
zD
zD
zD
zD
zD
zD
zD
zD
zD
zD
zD
zD
zD
zD
zD
zD
zD
zD
zD
zD
zD
zD
zD
zD
zD
zD
zD
zD
zD
zD
zD
zD
zD
zD
zD
zD
zD
zD
zD
zD
zD
zD
zD
zD
zD
zD
zD
zD
zD
zD
zD
zD
"}
(4,1,1) = {"
zD
zD
zD
zD
zD
zD
zD
zD
zD
Qf
Rf
Zr
qh
qh
qh
qh
qh
qh
qh
qh
qh
qh
qh
qh
qh
qh
qh
qh
qh
qh
qh
qh
qh
qh
qh
qh
qh
qh
qh
qh
qh
qh
qh
qh
qh
qh
qh
qh
qh
qh
qh
qh
Qf
Rf
Zr
zD
zD
zD
zD
"}
(5,1,1) = {"
zD
zD
zD
zD
zD
zD
zD
zD
zD
fH
Yf
qx
sM
sM
lx
sM
Tv
sM
sM
lx
sM
sM
sM
sM
lx
sM
Tv
sM
sM
lx
sM
sM
sM
sM
lx
sM
Tv
sM
sM
lx
sM
sM
sM
sM
lx
sM
Tv
sM
sM
lx
sM
sM
fH
Yf
qx
sc
zD
zD
zD
"}
(6,1,1) = {"
zD
zD
zD
zD
zD
zD
zD
zD
zD
fH
Yf
qx
wC
wC
wC
wC
wC
wC
wC
wC
wC
wC
wC
wC
wC
wC
wC
wC
wC
wC
wC
wC
wC
wC
wC
wC
wC
wC
wC
wC
wC
wC
wC
wC
wC
wC
wC
wC
wC
wC
wC
wC
fH
Yf
qx
HD
zD
zD
zD
"}
(7,1,1) = {"
zD
zD
zD
zD
zD
zD
zD
zD
aF
fH
Yf
qx
ye
ye
ye
ye
ye
ye
ye
ye
ye
ye
ye
ye
ye
ye
ye
ye
ye
ye
ye
ye
ye
ye
ye
ye
ye
ye
ye
ye
ye
ye
ye
ye
ye
ye
ye
ye
ye
ye
ye
te
fH
Yf
qx
Pk
zD
zD
zD
"}
(8,1,1) = {"
zD
zD
zD
zD
zD
zD
zD
zD
Pk
fH
Yf
qx
ye
ye
ye
ye
ye
ye
ye
ye
ye
ye
ye
ye
ye
ye
ye
ye
ye
ye
ye
ye
ye
ye
ye
ye
ye
ye
ye
ye
ye
ye
ye
ye
ye
ye
ye
ye
ye
ye
ye
ye
fH
Yf
qx
wz
zD
zD
zD
"}
(9,1,1) = {"
zD
zD
zD
zD
zD
zD
zD
zD
HD
fH
Yf
qx
hT
ye
ye
ye
ye
ye
ye
ye
ye
ye
ye
ye
ye
ye
ye
ye
ye
ye
ye
ye
ye
ye
ye
ye
ye
ye
ye
ye
ye
ye
ye
ye
ye
ye
ye
ye
ye
ye
ye
hT
fH
Yf
qx
sc
zD
zD
zD
"}
(10,1,1) = {"
zD
zD
zD
zD
zD
zD
zD
zD
Pk
fH
Yf
qx
ye
ye
ye
ye
ye
ye
ye
ye
ye
ye
ye
ye
ye
ye
ye
ye
ye
ye
ye
ye
ye
ye
ye
ye
ye
ye
ye
ye
ye
ye
ye
ye
ye
ye
ye
ye
ye
ye
ye
ye
fH
Yf
qx
sc
sc
zD
zD
"}
(11,1,1) = {"
zD
zD
zD
zD
zD
zD
zD
sc
KC
fH
Yf
JQ
ye
ye
ye
ye
ye
ye
ye
ye
ye
ye
ye
ye
ye
ye
ye
ye
ye
ye
ye
ye
ye
ye
ye
ye
ye
ye
ye
ye
ye
ye
ye
ye
ye
ye
ye
ye
ye
ye
ye
ye
vR
Yf
qx
KC
sc
zD
zD
"}
(12,1,1) = {"
zD
zD
zD
zD
zD
zD
zD
sc
KC
fH
Yf
qx
ye
ye
ye
ye
ye
ye
ye
ye
ye
ye
ye
ye
ye
ye
ye
ye
ye
ye
ye
ye
ye
ye
ye
ye
ye
ye
ye
ye
ye
ye
ye
ye
ye
ye
ye
ye
ye
ye
ye
ye
fH
Yf
qx
KC
sc
zD
zD
"}
(13,1,1) = {"
zD
zD
zD
zD
zD
zD
zD
sc
tc
fH
Yf
qx
ye
ye
ye
ye
ye
ye
ye
ye
ye
ye
ye
ye
ye
ye
ye
ye
ye
ye
ye
ye
ye
ye
ye
ye
ye
ye
ye
ye
ye
ye
ye
ye
ye
ye
ye
ye
ye
ye
ye
ye
fH
Yf
qx
gS
ts
zD
zD
"}
(14,1,1) = {"
zD
zD
zD
zD
zD
zD
sc
HD
Pk
fH
Yf
qx
hT
ye
ye
ye
ye
ye
ye
ye
ye
ye
ye
ye
ye
ye
ye
ye
ye
ye
ye
ye
ye
ye
ye
ye
ye
ye
ye
ye
ye
ye
ye
ye
ye
ye
ye
ye
ye
ye
ye
hT
fH
Yf
qx
KC
Pk
sc
zD
"}
(15,1,1) = {"
zD
zD
zD
zD
zD
zD
aF
KC
Pk
fH
Yf
qx
ye
ye
ye
ye
ye
ye
ye
ye
ye
ye
ye
ye
ye
ye
ye
ye
ye
ye
ye
ye
ye
ye
ye
ye
ye
ye
ye
ye
ye
ye
ye
ye
ye
ye
ye
ye
ye
ye
ye
ye
fH
Yf
qx
KC
tc
sc
zD
"}
(16,1,1) = {"
zD
zD
zD
zD
zD
zD
zD
zD
hz
fH
Yf
qx
ye
ye
ye
ye
ye
ye
ye
ye
ye
ye
ye
ye
ye
ye
ye
ye
ye
ye
ye
ye
ye
ye
ye
ye
ye
ye
ye
ye
ye
ye
ye
ye
ye
ye
ye
ye
ye
ye
ye
ye
fH
Yf
qx
KC
Pk
Yx
zD
"}
(17,1,1) = {"
zD
zD
zD
zD
zD
zD
zD
zD
KC
fH
Yf
qx
ye
ye
ye
ye
ye
ye
ye
ye
ye
ye
ye
ye
ye
ye
ye
ye
ye
ye
ye
ye
ye
ye
ye
ye
ye
ye
ye
ye
ye
ye
ye
ye
ye
ye
ye
ye
ye
ye
ye
ye
fH
Yf
qx
KC
KC
KC
zD
"}
(18,1,1) = {"
zD
zD
zD
zD
zD
zD
zD
zD
KC
fH
Yf
qx
ye
ye
ye
ye
ye
ye
ye
ye
ye
ye
ye
ye
ye
ye
ye
ye
ye
ye
ye
ye
ye
ye
ye
ye
ye
ye
ye
ye
ye
ye
ye
ye
ye
ye
ye
ye
ye
ye
ye
ye
fH
Yf
qx
Pk
HD
sc
zD
"}
(19,1,1) = {"
zD
zD
zD
zD
zD
zD
zD
zD
gS
fH
Yf
qx
hT
ye
ye
ye
ye
ye
ye
ye
ye
ye
ye
ye
ye
ye
ye
ye
ye
ye
ye
ye
ye
ye
ye
ye
ye
ye
ye
ye
ye
ye
ye
ye
ye
ye
ye
ye
ye
ye
ye
hT
fH
Yf
qx
KC
Pk
sc
zD
"}
(20,1,1) = {"
zD
zD
zD
zD
zD
zD
zD
zD
KC
fH
Yf
qx
ye
ye
ye
ye
ye
ye
ye
ye
ye
ye
ye
ye
ye
ye
ye
ye
ye
ye
ye
ye
ye
ye
ye
ye
ye
ye
ye
ye
ye
ye
ye
ye
ye
ye
ye
ye
ye
ye
ye
ye
fH
Yf
qx
KC
Pk
zD
zD
"}
(21,1,1) = {"
zD
zD
zD
zD
zD
zD
zD
zD
zD
fH
Yf
Yk
ye
ye
ye
ye
ye
ye
ye
ye
ye
ye
ye
ye
ye
ye
ye
ye
ye
ye
ye
ye
ye
ye
ye
ye
ye
ye
ye
ye
ye
ye
ye
ye
ye
ye
ye
ye
ye
ye
ye
ye
MA
Yf
qx
Pk
sc
zD
zD
"}
(22,1,1) = {"
zD
zD
zD
zD
zD
zD
zD
zD
zD
fH
Yf
qx
ye
ye
ye
ye
ye
ye
ye
ye
ye
ye
ye
ye
ye
ye
ye
ye
ye
ye
ye
ye
ye
ye
ye
ye
ye
ye
ye
ye
ye
ye
ye
ye
ye
ye
ye
ye
ye
ye
ye
ye
fH
Yf
qx
Pk
sc
zD
zD
"}
(23,1,1) = {"
zD
zD
zD
zD
zD
zD
zD
zD
zD
fH
Yf
qx
ye
ye
ye
ye
ye
ye
ye
ye
ye
ye
ye
ye
ye
ye
ye
ye
ye
ye
ye
ye
ye
ye
ye
ye
ye
ye
ye
ye
ye
ye
ye
ye
ye
ye
ye
ye
ye
ye
ye
ye
fH
Yf
qx
KC
aF
zD
zD
"}
(24,1,1) = {"
zD
zD
zD
zD
zD
zD
zD
zD
zD
fH
Yf
qx
hT
ye
ye
ye
ye
ye
ye
ye
ye
ye
ye
ye
ye
ye
ye
ye
ye
ye
ye
ye
ye
ye
ye
ye
ye
ye
ye
ye
ye
ye
ye
ye
ye
ye
ye
ye
ye
ye
ye
hT
fH
Yf
qx
gS
sc
zD
zD
"}
(25,1,1) = {"
zD
zD
zD
zD
zD
zD
zD
zD
wz
fH
Yf
qx
ye
ye
ye
ye
ye
ye
ye
ye
ye
ye
ye
ye
ye
ye
ye
ye
ye
ye
ye
ye
ye
ye
ye
ye
ye
ye
ye
ye
ye
ye
ye
ye
ye
ye
ye
ye
ye
ye
ye
ye
fH
Yf
qx
KC
KC
zD
zD
"}
(26,1,1) = {"
zD
zD
zD
zD
zD
zD
zD
zD
gS
fH
Yf
qx
ye
ye
ye
ye
ye
ye
ye
ye
ye
ye
ye
ye
ye
ye
ye
ye
ye
ye
ye
ye
ye
ye
ye
ye
ye
ye
ye
ye
ye
ye
ye
ye
ye
ye
ye
ye
ye
ye
ye
ye
fH
Yf
qx
tc
gS
zD
zD
"}
(27,1,1) = {"
zD
zD
zD
zD
zD
zD
zD
zD
tc
fH
Yf
qx
ye
ye
ye
ye
ye
ye
ye
ye
ye
ye
ye
ye
ye
ye
ye
ye
ye
ye
ye
ye
ye
ye
ye
ye
ye
ye
ye
ye
ye
ye
ye
ye
ye
ye
ye
ye
ye
ye
ye
ye
fH
Yf
qx
KC
Yx
zD
zD
"}
(28,1,1) = {"
zD
zD
zD
zD
zD
zD
zD
zD
zD
fH
Yf
qx
ye
ye
ye
ye
ye
ye
ye
ye
ye
ye
ye
ye
ye
ye
ye
ye
ye
ye
ye
ye
ye
ye
ye
ye
ye
ye
ye
ye
ye
ye
ye
ye
ye
ye
ye
ye
ye
ye
ye
ye
fH
Yf
qx
KC
zD
zD
zD
"}
(29,1,1) = {"
zD
zD
zD
zD
zD
zD
zD
zD
zD
fH
Yf
qx
ye
ye
ye
ye
ye
ye
ye
ye
ye
ye
ye
ye
ye
ye
ye
ye
ye
ye
ye
ye
ye
ye
ye
ye
ye
ye
ye
ye
ye
ye
ye
ye
ye
ye
ye
ye
ye
ye
ye
ye
fH
Yf
qx
Pk
zD
zD
zD
"}
(30,1,1) = {"
zD
zD
zD
zD
zD
zD
zD
zD
zD
fH
Yf
qx
hT
ye
ye
ye
ye
ye
ye
ye
ye
ye
ye
ye
ye
ye
ye
ye
ye
ye
ye
ye
ye
ye
ye
ye
ye
ye
ye
ye
ye
ye
ye
ye
ye
ye
ye
ye
ye
ye
ye
hT
fH
Yf
qx
HD
zD
zD
zD
"}
(31,1,1) = {"
zD
zD
zD
zD
zD
zD
zD
zD
gS
fH
Yf
JQ
ye
ye
ye
ye
ye
ye
ye
ye
ye
ye
ye
ye
ye
ye
ye
ye
ye
ye
ye
ye
ye
ye
ye
ye
ye
ye
ye
ye
ye
ye
ye
ye
ye
ye
ye
ye
ye
ye
ye
ye
MA
Yf
qx
Pk
zD
zD
zD
"}
(32,1,1) = {"
zD
zD
zD
zD
zD
zD
zD
zD
Pk
fH
Yf
qx
ye
ye
ye
ye
ye
ye
ye
ye
ye
ye
ye
ye
ye
ye
ye
ye
ye
ye
ye
ye
ye
ye
ye
ye
ye
ye
ye
ye
ye
ye
ye
ye
ye
ye
ye
ye
ye
ye
ye
ye
fH
Yf
qx
Pk
zD
zD
zD
"}
(33,1,1) = {"
zD
zD
zD
zD
zD
zD
zD
zD
WX
fH
Yf
qx
ye
ye
ye
ye
ye
ye
ye
ye
ye
ye
ye
ye
ye
ye
ye
ye
ye
ye
ye
ye
ye
ye
ye
ye
ye
ye
ye
ye
ye
ye
ye
ye
ye
ye
ye
ye
ye
ye
ye
ye
fH
Yf
qx
KC
zD
zD
zD
"}
(34,1,1) = {"
zD
zD
zD
zD
zD
zD
zD
zD
Pk
fH
Yf
qx
ye
ye
ye
ye
ye
ye
ye
ye
ye
ye
ye
ye
ye
ye
ye
ye
ye
ye
ye
ye
ye
ye
ye
ye
ye
ye
ye
ye
ye
ye
ye
ye
ye
ye
ye
ye
ye
ye
ye
ye
fH
Yf
qx
tc
zD
zD
zD
"}
(35,1,1) = {"
zD
zD
zD
zD
zD
zD
zD
zD
KC
fH
Yf
qx
hT
ye
ye
ye
ye
ye
ye
ye
ye
ye
ye
ye
ye
ye
ye
ye
ye
ye
ye
ye
ye
ye
ye
ye
ye
ye
ye
ye
ye
ye
ye
ye
ye
ye
ye
ye
ye
ye
ye
hT
fH
Yf
qx
ts
zD
zD
zD
"}
(36,1,1) = {"
zD
zD
zD
zD
zD
zD
zD
sc
KC
fH
Yf
qx
ye
ye
ye
ye
ye
ye
ye
ye
ye
ye
ye
ye
ye
ye
ye
ye
ye
ye
ye
ye
ye
ye
ye
ye
ye
ye
ye
ye
ye
ye
ye
ye
ye
ye
ye
ye
ye
ye
ye
ye
fH
Yf
qx
gS
zD
zD
zD
"}
(37,1,1) = {"
zD
zD
zD
zD
zD
zD
zD
Uu
KC
fH
Yf
qx
ye
ye
ye
ye
ye
ye
ye
ye
ye
ye
ye
ye
ye
ye
ye
ye
ye
ye
ye
ye
ye
ye
ye
ye
ye
ye
ye
ye
ye
ye
ye
ye
ye
ye
ye
ye
ye
ye
ye
ye
fH
Yf
qx
zD
zD
zD
zD
"}
(38,1,1) = {"
zD
zD
zD
zD
zD
zD
zD
sc
tc
fH
Yf
qx
ye
ye
ye
ye
ye
ye
ye
ye
ye
ye
ye
ye
ye
ye
ye
ye
ye
ye
ye
ye
ye
ye
ye
ye
ye
ye
ye
ye
ye
ye
ye
ye
ye
ye
ye
ye
ye
ye
ye
ye
fH
Yf
qx
zD
zD
zD
zD
"}
(39,1,1) = {"
zD
zD
zD
zD
zD
zD
zD
zD
sc
fH
Yf
qx
ye
ye
ye
ye
ye
ye
ye
ye
ye
ye
ye
ye
ye
ye
ye
ye
ye
ye
ye
ye
ye
ye
ye
ye
ye
ye
ye
ye
ye
ye
ye
ye
ye
ye
ye
ye
ye
ye
ye
ye
fH
Yf
qx
zD
zD
zD
zD
"}
(40,1,1) = {"
zD
zD
zD
zD
zD
zD
zD
zD
Pk
fH
Yf
qx
hT
ye
ye
ye
ye
ye
ye
ye
ye
ye
ye
ye
ye
ye
ye
ye
ye
ye
ye
ye
ye
ye
ye
ye
ye
ye
ye
ye
ye
ye
ye
ye
ye
ye
ye
ye
ye
ye
ye
hT
fH
Yf
qx
Pk
zD
zD
zD
"}
(41,1,1) = {"
zD
zD
zD
zD
zD
zD
zD
zD
HD
fH
Yf
Yk
ye
ye
ye
ye
ye
ye
ye
ye
ye
ye
ye
ye
ye
ye
ye
ye
ye
ye
ye
ye
ye
ye
ye
ye
ye
ye
ye
ye
ye
ye
ye
ye
ye
ye
ye
ye
ye
ye
ye
ye
MA
Yf
qx
HD
zD
zD
zD
"}
(42,1,1) = {"
zD
zD
zD
zD
zD
zD
zD
zD
zD
fH
Yf
qx
ye
ye
ye
ye
ye
ye
ye
ye
ye
ye
ye
ye
ye
ye
ye
ye
ye
ye
ye
ye
ye
ye
ye
ye
ye
ye
ye
ye
ye
ye
ye
ye
ye
ye
ye
ye
ye
ye
ye
ye
fH
Yf
qx
KC
KC
zD
zD
"}
(43,1,1) = {"
zD
zD
zD
zD
zD
zD
zD
zD
zD
fH
Yf
qx
ye
ye
ye
ye
ye
ye
ye
ye
ye
ye
ye
ye
ye
ye
ye
ye
ye
ye
ye
ye
ye
ye
ye
ye
ye
ye
ye
ye
ye
ye
ye
ye
ye
ye
ye
ye
ye
ye
ye
ye
fH
Yf
qx
KC
KC
zD
zD
"}
(44,1,1) = {"
zD
zD
zD
zD
zD
zD
zD
zD
zD
fH
Yf
qx
ye
ye
ye
ye
ye
ye
ye
ye
ye
ye
ye
ye
ye
ye
ye
ye
ye
ye
ye
ye
ye
ye
ye
ye
ye
ye
ye
ye
ye
ye
ye
ye
ye
ye
ye
ye
ye
ye
ye
ye
fH
Yf
qx
KC
sc
zD
zD
"}
(45,1,1) = {"
zD
zD
zD
zD
zD
zD
zD
zD
zD
fH
Yf
qx
hT
ye
ye
ye
ye
ye
ye
ye
ye
ye
ye
ye
ye
ye
ye
ye
ye
ye
ye
ye
ye
ye
ye
ye
ye
ye
ye
ye
ye
ye
ye
ye
ye
ye
ye
ye
ye
ye
ye
hT
fH
Yf
qx
KC
sc
zD
zD
"}
(46,1,1) = {"
zD
zD
zD
zD
zD
zD
zD
zD
zD
fH
Yf
qx
ye
ye
ye
ye
ye
ye
ye
ye
ye
ye
ye
ye
ye
ye
ye
ye
ye
ye
ye
ye
ye
ye
ye
ye
ye
ye
ye
ye
ye
ye
ye
ye
ye
ye
ye
ye
ye
ye
ye
ye
fH
Yf
qx
gS
sc
zD
zD
"}
(47,1,1) = {"
zD
zD
zD
zD
zD
zD
zD
zD
zD
fH
Yf
Yk
ye
ye
ye
ye
ye
ye
ye
ye
ye
ye
ye
ye
ye
ye
ye
ye
ye
ye
ye
ye
ye
ye
ye
ye
ye
ye
ye
ye
ye
ye
ye
ye
ye
ye
ye
ye
ye
ye
ye
ye
MA
Yf
qx
KC
gS
aF
zD
"}
(48,1,1) = {"
zD
zD
zD
zD
zD
zD
zD
zD
zD
fH
Yf
qx
ye
ye
ye
ye
ye
ye
ye
ye
ye
ye
ye
ye
ye
ye
ye
ye
ye
ye
ye
ye
ye
ye
ye
ye
ye
ye
ye
ye
ye
ye
ye
ye
ye
ye
ye
ye
ye
ye
ye
ye
fH
Yf
qx
KC
Pk
sc
zD
"}
(49,1,1) = {"
zD
zD
zD
zD
zD
zD
zD
zD
zD
fH
Yf
qx
ye
ye
ye
ye
ye
ye
ye
ye
ye
ye
ye
ye
ye
ye
ye
ye
ye
ye
ye
ye
ye
ye
ye
ye
ye
ye
ye
ye
ye
ye
ye
ye
ye
ye
ye
ye
ye
ye
ye
ye
fH
Yf
qx
Pk
KC
sc
zD
"}
(50,1,1) = {"
zD
zD
zD
zD
zD
zD
zD
zD
zD
fH
Yf
qx
hT
ye
ye
ye
ye
ye
ye
ye
ye
ye
ye
ye
ye
ye
ye
ye
ye
ye
ye
ye
ye
ye
ye
ye
ye
ye
ye
ye
ye
ye
ye
ye
ye
ye
ye
ye
ye
ye
ye
hT
fH
Yf
qx
KC
nO
KC
zD
"}
(51,1,1) = {"
zD
zD
zD
zD
zD
zD
zD
zD
aF
fH
Yf
qx
ye
ye
ye
ye
ye
ye
ye
ye
ye
ye
ye
ye
ye
ye
ye
ye
ye
ye
ye
ye
ye
ye
ye
ye
ye
ye
ye
ye
ye
ye
ye
ye
ye
ye
ye
ye
ye
ye
ye
ye
fH
Yf
qx
gS
Pk
KC
zD
"}
(52,1,1) = {"
zD
zD
zD
zD
zD
zD
zD
zD
Uu
fH
Yf
qx
ye
ye
ye
ye
ye
ye
ye
ye
ye
ye
ye
ye
ye
ye
ye
ye
ye
ye
ye
ye
ye
ye
ye
ye
ye
ye
ye
ye
ye
ye
ye
ye
ye
ye
ye
ye
ye
ye
ye
ye
fH
Yf
qx
KC
KC
Pk
zD
"}
(53,1,1) = {"
zD
zD
zD
zD
zD
zD
zD
zD
sc
fH
Yf
qx
ye
ye
ye
ye
ye
ye
ye
ye
ye
ye
ye
ye
ye
ye
ye
ye
ye
ye
ye
ye
ye
ye
ye
ye
ye
ye
ye
ye
ye
ye
ye
ye
ye
ye
ye
ye
ye
ye
ye
ye
fH
Yf
qx
KC
HD
aF
zD
"}
(54,1,1) = {"
zD
zD
zD
zD
zD
zD
zD
zD
zD
fH
Yf
qx
ye
ye
ye
ye
ye
ye
ye
ye
ye
ye
ye
ye
ye
ye
ye
ye
ye
ye
ye
ye
ye
ye
ye
ye
ye
ye
ye
ye
ye
ye
ye
ye
ye
ye
ye
ye
ye
ye
ye
ye
fH
Yf
qx
Pk
sc
zD
zD
"}
(55,1,1) = {"
zD
zD
zD
zD
zD
zD
zD
zD
zD
fH
Yf
qx
hT
ye
ye
ye
ye
ye
ye
ye
ye
ye
ye
ye
ye
ye
ye
ye
ye
ye
ye
ye
ye
ye
ye
ye
ye
ye
ye
ye
ye
ye
ye
ye
ye
ye
ye
ye
ye
ye
ye
hT
fH
Yf
qx
HD
zD
zD
zD
"}
(56,1,1) = {"
zD
zD
zD
zD
zD
zD
zD
zD
zD
fH
Yf
qx
ye
ye
ye
ye
ye
ye
ye
ye
ye
ye
ye
ye
ye
ye
ye
ye
ye
ye
ye
ye
ye
ye
ye
ye
ye
ye
ye
ye
ye
ye
ye
ye
ye
ye
ye
ye
ye
ye
ye
ye
fH
Yf
qx
gS
zD
zD
zD
"}
(57,1,1) = {"
zD
zD
zD
zD
zD
zD
zD
zD
zD
fH
Yf
JQ
ye
ye
ye
ye
ye
ye
ye
ye
ye
ye
ye
ye
ye
ye
ye
ye
ye
ye
ye
ye
ye
ye
ye
ye
ye
ye
ye
ye
ye
ye
ye
ye
ye
ye
ye
ye
ye
ye
ye
ye
vR
Yf
qx
sc
zD
zD
zD
"}
(58,1,1) = {"
zD
zD
zD
zD
zD
zD
zD
zD
zD
fH
Yf
qx
ye
ye
ye
ye
ye
ye
ye
ye
ye
ye
ye
ye
ye
ye
ye
ye
ye
ye
ye
ye
ye
ye
ye
ye
ye
ye
ye
ye
ye
ye
ye
ye
ye
ye
ye
ye
ye
ye
ye
ye
fH
Yf
qx
sc
zD
zD
zD
"}
(59,1,1) = {"
zD
zD
zD
zD
zD
zD
zD
zD
zD
fH
Yf
qx
ye
ye
ye
ye
ye
ye
ye
ye
ye
ye
ye
ye
ye
ye
ye
ye
ye
ye
ye
ye
ye
ye
ye
ye
ye
ye
ye
ye
ye
ye
ye
ye
ye
ye
ye
ye
ye
ye
ye
ye
fH
Yf
qx
zD
zD
zD
zD
"}
(60,1,1) = {"
zD
zD
zD
zD
zD
zD
zD
zD
zD
fH
Yf
qx
hT
ye
ye
ye
ye
ye
ye
ye
ye
ye
ye
ye
ye
ye
ye
ye
ye
ye
ye
ye
ye
ye
ye
ye
ye
ye
ye
ye
ye
ye
ye
ye
ye
ye
ye
ye
ye
ye
ye
hT
fH
Yf
qx
zD
zD
zD
zD
"}
(61,1,1) = {"
zD
zD
zD
zD
zD
zD
zD
zD
zD
fH
Yf
qx
ye
ye
ye
ye
ye
ye
ye
ye
ye
ye
ye
ye
ye
ye
ye
ye
ye
ye
ye
ye
ye
ye
ye
ye
ye
ye
ye
ye
ye
ye
ye
ye
ye
ye
ye
ye
ye
ye
ye
ye
fH
Yf
qx
zD
zD
zD
zD
"}
(62,1,1) = {"
zD
zD
zD
zD
zD
zD
zD
zD
zD
zD
Yf
qx
ye
ye
ye
ye
ye
ye
ye
ye
ye
ye
ye
ye
ye
ye
ye
ye
ye
ye
ye
ye
ye
ye
ye
ye
ye
ye
ye
ye
ye
ye
ye
ye
ye
ye
ye
ye
ye
ye
ye
ye
fH
Yf
qx
zD
zD
zD
zD
"}
(63,1,1) = {"
zD
zD
zD
zD
zD
zD
zD
zD
zD
KC
tv
fI
Rf
Rf
Rf
Rf
AZ
Rf
Rf
Rf
Rf
Rf
Rf
Rf
Rf
Rf
AZ
Rf
Rf
Rf
Rf
Rf
Rf
Rf
Rf
Rf
AZ
Rf
Rf
Rf
Rf
Rf
Rf
Rf
Rf
Rf
AZ
Rf
Rf
Rf
Rf
Rf
Si
Yf
qx
zD
zD
zD
zD
"}
(64,1,1) = {"
zD
zD
zD
zD
zD
zD
zD
zD
gS
KC
tv
Yf
Yf
Yf
Yf
Yf
Yf
Yf
Yf
Yf
Yf
Yf
Yf
Yf
Yf
Yf
Yf
Yf
Yf
Yf
Yf
Yf
Yf
Yf
Yf
Yf
Yf
Yf
Yf
Yf
Yf
Yf
Yf
Yf
Yf
Yf
Yf
Yf
Yf
Yf
Yf
Yf
Yf
Yf
qx
sc
zD
zD
zD
"}
(65,1,1) = {"
zD
zD
zD
zD
zD
zD
zD
zD
zD
wz
Bw
Bw
Bw
Bw
Bw
Bw
Bw
Bw
Bw
Bw
Bw
Bw
Bw
Bw
Bw
Bw
Bw
Bw
Bw
Bw
Bw
Bw
Bw
Bw
Bw
Bw
Bw
Bw
Bw
Bw
Bw
Bw
Bw
Bw
Bw
Bw
Bw
Bw
Bw
Bw
Bw
Bw
Bw
Bw
zC
gS
zD
zD
zD
"}
(66,1,1) = {"
zD
zD
zD
zD
zD
zD
zD
zD
zD
zD
zD
zD
zD
zD
zD
zD
zD
zD
HD
Pk
KC
KC
gS
Pk
Pk
zD
zD
zD
zD
zD
zD
zD
zD
gS
KC
KC
KC
zD
zD
zD
zD
KC
KC
tc
KC
zD
zD
zD
zD
sc
HD
KC
KC
KC
Pk
WX
sc
zD
zD
"}
(67,1,1) = {"
zD
zD
zD
if
zD
zD
if
zD
zD
if
zD
zD
if
zD
zD
if
if
if
if
if
VK
wx
wx
SB
Pk
zD
zD
zD
zD
zD
zD
zD
zD
zD
zD
Pk
tc
HD
zD
zD
zD
KC
Pk
zD
zD
zD
zD
zD
zD
sc
sc
nO
hz
gS
sc
zD
zD
zD
zD
"}
(68,1,1) = {"
zD
zD
zD
sF
pT
pT
Co
pT
pT
Co
pT
pT
Co
pT
pT
sF
pT
pT
eV
eR
EG
mR
DR
Eo
HD
KC
zD
zD
zD
zD
zD
zD
zD
zD
zD
zD
Pk
Pk
Pk
zD
KC
KC
HD
zD
zD
zD
zD
zD
zD
zD
sc
sc
sc
sc
zD
zD
zD
zD
zD
"}
(69,1,1) = {"
zD
zD
zD
sF
Mv
Mv
Ox
Mv
Mv
Ox
Mv
Mv
Ox
Mv
Mv
if
pT
pT
pT
eR
Pu
bJ
uc
Eo
KC
tc
zD
zD
zD
zD
zD
zD
zD
zD
zD
zD
zD
Pk
gS
Pk
KC
Pk
zD
zD
zD
zD
zD
zD
zD
zD
zD
sc
zD
zD
zD
zD
zD
zD
zD
"}
(70,1,1) = {"
zD
zD
zD
sF
pT
pT
Co
pT
pT
Co
pT
pT
Co
pT
pT
sF
pT
pT
pT
eR
BZ
fs
fB
Eo
KC
zD
zD
zD
zD
zD
zD
zD
zD
zD
zD
zD
zD
zD
zD
zD
zD
zD
zD
zD
zD
zD
zD
zD
zD
zD
zD
zD
zD
zD
zD
zD
zD
zD
zD
"}
(71,1,1) = {"
zD
zD
zD
if
zD
zD
if
zD
zD
if
zD
zD
if
zD
zD
if
if
if
if
if
gc
gc
Ne
uD
Pk
zD
zD
zD
zD
zD
zD
zD
zD
zD
zD
zD
zD
zD
zD
zD
zD
zD
zD
zD
zD
zD
zD
zD
zD
zD
zD
zD
zD
zD
zD
zD
zD
zD
zD
"}
(72,1,1) = {"
zD
zD
zD
zD
zD
zD
zD
zD
zD
zD
zD
zD
zD
zD
zD
zD
zD
zD
zD
zD
zD
zD
zD
wz
WX
zD
zD
zD
zD
zD
zD
zD
zD
zD
zD
zD
zD
zD
zD
zD
zD
zD
zD
zD
zD
zD
zD
zD
zD
zD
zD
zD
zD
zD
zD
zD
zD
zD
zD
"}
(73,1,1) = {"
zD
zD
zD
zD
zD
zD
zD
zD
zD
zD
zD
zD
zD
zD
zD
zD
zD
zD
zD
zD
zD
zD
zD
zD
zD
zD
zD
zD
zD
zD
zD
zD
zD
zD
zD
zD
zD
zD
zD
zD
zD
zD
zD
zD
zD
zD
zD
zD
zD
zD
zD
zD
zD
zD
zD
zD
zD
zD
zD
"}
(74,1,1) = {"
zD
zD
zD
zD
zD
zD
zD
zD
zD
zD
zD
zD
zD
zD
zD
zD
zD
zD
zD
zD
zD
zD
zD
zD
zD
zD
zD
zD
zD
zD
zD
zD
zD
zD
zD
zD
zD
zD
zD
zD
zD
zD
zD
zD
zD
zD
zD
zD
zD
zD
zD
zD
zD
zD
zD
zD
zD
zD
zD
"}
(75,1,1) = {"
zD
zD
zD
zD
zD
zD
zD
zD
zD
zD
zD
zD
zD
zD
zD
zD
zD
zD
zD
zD
zD
zD
zD
zD
zD
zD
zD
zD
zD
zD
zD
zD
zD
zD
zD
zD
zD
zD
zD
zD
zD
zD
zD
zD
zD
zD
zD
zD
zD
zD
zD
zD
zD
zD
zD
zD
zD
zD
zD
"}
(76,1,1) = {"
zD
zD
zD
zD
zD
zD
zD
zD
zD
zD
zD
zD
zD
zD
zD
zD
zD
zD
zD
zD
zD
zD
zD
zD
zD
zD
zD
zD
zD
zD
zD
zD
zD
zD
zD
zD
zD
zD
zD
zD
zD
zD
zD
zD
zD
zD
zD
zD
zD
zD
zD
zD
zD
zD
zD
zD
zD
zD
zD
"}
