//MAP CONVERTED BY dmm2tgm.py THIS HEADER COMMENT PREVENTS RECONVERSION, DO NOT REMOVE
"ac" = (
/turf/closed/mineral/random/snow,
/area/hangar)
"ad" = (
/obj/machinery/light/floor,
/turf/open/floor/plating{
	planetary_atmos = 1
	},
/area/hangar)
"al" = (
/obj/effect/decal/fakelattice,
/obj/effect/decal/cleanable/dirt{
	color = "#808080"
	},
/turf/open/floor/plasteel/elevatorshaft{
	planetary_atmos = 1
	},
/area/hangar)
"am" = (
/turf/closed/indestructible/reinforced,
/area/hangar)
"ao" = (
/obj/effect/turf_decal/industrial/traffic{
	dir = 1
	},
/obj/effect/turf_decal/industrial/traffic,
/obj/machinery/door/poddoor/ert,
/turf/open/floor/plasteel/patterned/brushed{
	planetary_atmos = 1
	},
/area/hangar)
"ap" = (
/obj/effect/turf_decal/borderfloor{
	dir = 4
	},
/obj/effect/turf_decal/siding/white{
	dir = 8
	},
/turf/open/floor/plasteel/patterned/brushed{
	planetary_atmos = 1
	},
/area/hangar)
"aq" = (
/obj/effect/turf_decal/borderfloor,
/obj/effect/turf_decal/siding/white{
	dir = 1
	},
/obj/machinery/light/small/directional/north,
/turf/open/floor/plasteel/patterned/brushed{
	planetary_atmos = 1
	},
/area/hangar)
"av" = (
/obj/effect/turf_decal/borderfloor/corner{
	dir = 8
	},
/obj/effect/turf_decal/siding/white{
	dir = 5
	},
/turf/open/floor/plasteel/patterned/brushed{
	planetary_atmos = 1
	},
/area/hangar)
"ax" = (
/obj/machinery/door/airlock,
/obj/effect/landmark/outpost/elevator_machine,
/obj/effect/turf_decal/industrial/traffic{
	dir = 1
	},
/obj/effect/turf_decal/industrial/traffic,
/turf/open/floor/plasteel/patterned/brushed{
	planetary_atmos = 1
	},
/area/hangar)
"ay" = (
/obj/machinery/door/poddoor/multi_tile/four_tile_ver,
/turf/closed/indestructible/reinforced,
/area/hangar)
"az" = (
/obj/effect/spawner/structure/window/reinforced/indestructable,
/turf/open/floor/plating{
	planetary_atmos = 1
	},
/area/hangar)
"aA" = (
/obj/effect/turf_decal/siding/white{
	dir = 1
	},
/obj/effect/turf_decal/trimline/transparent/neutral/warning,
/turf/open/floor/plasteel/patterned/ridged{
	planetary_atmos = 1
	},
/area/hangar)
"aB" = (
/obj/effect/landmark/outpost/hangar_dock,
/turf/open/floor/plating{
	planetary_atmos = 1
	},
/area/hangar)
"aC" = (
/obj/effect/turf_decal/borderfloor{
	dir = 1
	},
/obj/effect/turf_decal/siding/white,
/obj/machinery/light/small/directional/south,
/turf/open/floor/plasteel/patterned/brushed{
	planetary_atmos = 1
	},
/area/hangar)
"aE" = (
/obj/structure/chair{
	dir = 1
	},
/obj/effect/turf_decal/corner/opaque/neutral,
/obj/effect/turf_decal/siding/white,
/obj/machinery/newscaster/directional/south,
/turf/open/floor/plasteel/patterned{
	planetary_atmos = 1
	},
/area/hangar)
"aH" = (
/turf/template_noop,
/area/template_noop)
"aJ" = (
/turf/open/floor/plating{
	planetary_atmos = 1
	},
/area/hangar)
"aL" = (
/obj/effect/turf_decal/borderfloor/full,
/obj/effect/turf_decal/industrial/warning{
	dir = 8
	},
/turf/open/floor/plasteel/patterned{
	planetary_atmos = 1
	},
/area/hangar)
"aM" = (
/obj/effect/turf_decal/borderfloor/full,
/obj/effect/turf_decal/industrial/warning{
	dir = 4
	},
/turf/open/floor/plasteel/patterned{
	planetary_atmos = 1
	},
/area/hangar)
"aN" = (
/obj/effect/turf_decal/borderfloor{
	dir = 1
	},
/obj/effect/turf_decal/siding/white,
/turf/open/floor/plasteel/patterned/brushed{
	planetary_atmos = 1
	},
/area/hangar)
"aO" = (
/obj/effect/turf_decal/borderfloor{
	dir = 8
	},
/obj/effect/turf_decal/siding/white{
	dir = 4
	},
/turf/open/floor/plasteel/patterned/brushed{
	planetary_atmos = 1
	},
/area/hangar)
"aP" = (
/obj/effect/decal/fakelattice,
/obj/effect/decal/cleanable/dirt{
	color = "#808080"
	},
/obj/effect/decal/cleanable/dirt{
	color = "#808080"
	},
/obj/effect/decal/cleanable/dirt{
	color = "#808080"
	},
/turf/open/floor/plasteel/elevatorshaft{
	planetary_atmos = 1
	},
/area/hangar)
"aT" = (
/obj/structure/catwalk/over/plated_catwalk,
/turf/open/floor/plating{
	planetary_atmos = 1
	},
/area/hangar)
"aY" = (
/obj/effect/decal/fakelattice,
/turf/open/floor/plasteel/elevatorshaft{
	planetary_atmos = 1
	},
/area/hangar)
"aZ" = (
/obj/effect/turf_decal/borderfloor,
/obj/effect/turf_decal/siding/white{
	dir = 1
	},
/turf/open/floor/plasteel/patterned/brushed{
	planetary_atmos = 1
	},
/area/hangar)
"cD" = (
/obj/effect/turf_decal/borderfloor{
	dir = 8
	},
/obj/effect/turf_decal/siding/white{
	dir = 4
	},
/obj/machinery/light/small/directional/east,
/turf/open/floor/plasteel/patterned/brushed{
	planetary_atmos = 1
	},
/area/hangar)
"dv" = (
/obj/effect/turf_decal/borderfloor{
	dir = 4
	},
/obj/effect/turf_decal/siding/white{
	dir = 10
	},
/obj/machinery/firealarm/directional/south,
/turf/open/floor/plasteel/patterned/brushed{
	planetary_atmos = 1
	},
/area/hangar)
"dM" = (
/obj/effect/decal/fakelattice,
/obj/effect/decal/cleanable/sprayweb{
	color = "#808080";
	name = "web"
	},
/turf/open/floor/plasteel/elevatorshaft{
	planetary_atmos = 1
	},
/area/hangar)
"fN" = (
/obj/structure/chair{
	dir = 1
	},
/obj/effect/turf_decal/corner/opaque/neutral,
/obj/effect/turf_decal/siding/white{
	dir = 6
	},
/turf/open/floor/plasteel/patterned{
	planetary_atmos = 1
	},
/area/hangar)
"hg" = (
/obj/effect/turf_decal/borderfloor{
	dir = 5
	},
/obj/effect/turf_decal/siding/white/corner{
	dir = 8
	},
/turf/open/floor/plasteel/patterned/brushed{
	planetary_atmos = 1
	},
/area/hangar)
"hv" = (
/obj/effect/turf_decal/borderfloor/full,
/obj/machinery/light/floor,
/turf/open/floor/plasteel/patterned/cargo_one{
	light_color = "#1B1D2E";
	light_range = 2
	},
/area/hangar)
"hG" = (
/obj/effect/decal/fakelattice,
/obj/machinery/light/small/directional/east,
/obj/effect/decal/cleanable/dirt{
	color = "#808080"
	},
/turf/open/floor/plasteel/elevatorshaft{
	planetary_atmos = 1
	},
/area/hangar)
"hL" = (
/obj/structure/table/reinforced,
/obj/effect/turf_decal/corner/opaque/neutral,
/obj/effect/turf_decal/siding/white,
/obj/item/newspaper{
	pixel_x = 4;
	pixel_y = 3
	},
/obj/item/reagent_containers/food/drinks/coffee{
	pixel_x = -2;
	pixel_y = 3
	},
/turf/open/floor/plasteel/patterned{
	planetary_atmos = 1
	},
/area/hangar)
"ic" = (
/obj/effect/decal/fakelattice,
/obj/effect/decal/cleanable/dirt{
	color = "#808080"
	},
/obj/effect/decal/cleanable/glass{
	dir = 8;
	color = "#808080"
	},
/turf/open/floor/plasteel/elevatorshaft{
	planetary_atmos = 1
	},
/area/hangar)
"jk" = (
/obj/effect/turf_decal/siding/white{
	dir = 4
	},
/obj/effect/turf_decal/siding/white{
	dir = 8
	},
/obj/machinery/light/directional/east,
/obj/machinery/vending/coffee,
/turf/open/floor/plasteel/telecomms_floor{
	planetary_atmos = 1
	},
/area/hangar)
"nr" = (
/obj/effect/decal/fakelattice,
/obj/effect/decal/cleanable/wrapping{
	color = "#808080"
	},
/obj/effect/decal/cleanable/dirt{
	color = "#808080"
	},
/turf/open/floor/plasteel/elevatorshaft{
	planetary_atmos = 1
	},
/area/hangar)
"oi" = (
/obj/effect/decal/fakelattice,
/obj/effect/decal/cleanable/dirt{
	color = "#808080"
	},
/obj/effect/decal/cleanable/dirt{
	color = "#808080"
	},
/obj/effect/decal/cleanable/wrapping{
	color = "#808080"
	},
/turf/open/floor/plasteel/elevatorshaft{
	planetary_atmos = 1
	},
/area/hangar)
"oo" = (
/obj/effect/decal/fakelattice,
/obj/effect/decal/cleanable/greenglow{
	color = "#808080"
	},
/obj/effect/decal/cleanable/dirt{
	color = "#808080"
	},
/obj/effect/decal/cleanable/dirt{
	color = "#808080"
	},
/turf/open/floor/plasteel/elevatorshaft{
	planetary_atmos = 1
	},
/area/hangar)
"qz" = (
/obj/effect/decal/fakelattice{
	layer = 2.010
	},
/turf/open/floor/plasteel/elevatorshaft{
	planetary_atmos = 1
	},
/area/hangar)
"rQ" = (
/obj/effect/decal/fakelattice,
/obj/effect/decal/cleanable/greenglow{
	color = "#808080"
	},
/turf/open/floor/plasteel/elevatorshaft{
	planetary_atmos = 1
	},
/area/hangar)
"rY" = (
/obj/effect/decal/fakelattice,
/obj/effect/decal/cleanable/glass{
	dir = 8;
	color = "#808080"
	},
/turf/open/floor/plasteel/elevatorshaft{
	planetary_atmos = 1
	},
/area/hangar)
"tm" = (
/obj/effect/turf_decal/trimline/transparent/neutral/line{
	dir = 10
	},
/obj/effect/turf_decal/siding/white{
	dir = 1
	},
/turf/open/floor/plasteel/patterned/ridged{
	planetary_atmos = 1
	},
/area/hangar)
"uC" = (
/obj/effect/turf_decal/borderfloor{
	dir = 6
	},
/obj/effect/turf_decal/siding/white/corner{
	dir = 1
	},
/turf/open/floor/plasteel/patterned/brushed{
	planetary_atmos = 1
	},
/area/hangar)
"xl" = (
/obj/effect/turf_decal/borderfloor{
	dir = 8
	},
/obj/effect/turf_decal/siding/white{
	dir = 6
	},
/turf/open/floor/plasteel/patterned/brushed{
	planetary_atmos = 1
	},
/area/hangar)
"xp" = (
/obj/effect/turf_decal/siding/white{
	dir = 1
	},
/obj/machinery/elevator_call_button{
	pixel_y = 25;
	pixel_x = 5
	},
/obj/effect/landmark/outpost/elevator_machine{
	shaft = "1"
	},
/obj/effect/landmark/outpost/hangar_numbers,
/turf/open/floor/plasteel/patterned{
	planetary_atmos = 1
	},
/area/hangar)
"BW" = (
/obj/effect/turf_decal/corner/opaque/neutral,
/obj/effect/turf_decal/siding/white,
/obj/item/kirbyplants{
	icon_state = "plant-22"
	},
/turf/open/floor/plasteel/patterned{
	planetary_atmos = 1
	},
/area/hangar)
"Dh" = (
/obj/effect/decal/fakelattice,
/obj/effect/decal/cleanable/dirt{
	color = "#808080"
	},
/obj/effect/decal/cleanable/dirt{
	color = "#808080"
	},
/turf/open/floor/plasteel/elevatorshaft{
	planetary_atmos = 1
	},
/area/hangar)
"EQ" = (
/obj/effect/decal/fakelattice,
/obj/machinery/light/small/directional/east,
/turf/open/floor/plasteel/elevatorshaft{
	planetary_atmos = 1
	},
/area/hangar)
"Fi" = (
/obj/effect/decal/fakelattice,
/obj/effect/decal/cleanable/dirt{
	color = "#808080"
	},
/obj/effect/decal/cleanable/dirt{
	color = "#808080"
	},
/obj/effect/decal/cleanable/oil,
/turf/open/floor/plasteel/elevatorshaft{
	planetary_atmos = 1
	},
/area/hangar)
"FS" = (
/obj/effect/decal/fakelattice,
/obj/effect/decal/cleanable/dirt{
	color = "#808080"
	},
/obj/effect/decal/cleanable/greenglow{
	color = "#808080"
	},
/turf/open/floor/plasteel/elevatorshaft{
	planetary_atmos = 1
	},
/area/hangar)
"HX" = (
/obj/effect/decal/fakelattice,
/obj/effect/decal/cleanable/dirt{
	color = "#808080"
	},
/obj/effect/decal/cleanable/sprayweb{
	color = "#808080";
	name = "web"
	},
/turf/open/floor/plasteel/elevatorshaft{
	planetary_atmos = 1
	},
/area/hangar)
"JL" = (
/turf/closed/wall/r_wall/yesdiag,
/area/hangar)
"KM" = (
/obj/effect/landmark/outpost/elevator{
	shaft = "1"
	},
/obj/effect/decal/fakelattice{
	layer = 2.010
	},
/turf/open/floor/plasteel/elevatorshaft{
	planetary_atmos = 1
	},
/area/hangar)
"KO" = (
/obj/structure/catwalk/over/plated_catwalk,
/obj/structure/extinguisher_cabinet/directional/south,
/turf/open/floor/plating{
	planetary_atmos = 1
	},
/area/hangar)
"ME" = (
/obj/effect/turf_decal/trimline/transparent/neutral/line,
/obj/effect/turf_decal/siding/white{
	dir = 5
	},
/turf/open/floor/plasteel/patterned/ridged{
	planetary_atmos = 1
	},
/area/hangar)
"XT" = (
/obj/effect/decal/fakelattice,
/obj/effect/decal/cleanable/oil,
/turf/open/floor/plasteel/elevatorshaft{
	planetary_atmos = 1
	},
/area/hangar)
"ZY" = (
/obj/structure/rack,
/obj/structure/window/reinforced,
/obj/item/clothing/suit/hooded/wintercoat,
/obj/item/clothing/suit/hooded/wintercoat,
/obj/item/clothing/suit/hooded/wintercoat{
	pixel_y = 3
	},
/obj/item/clothing/suit/hooded/wintercoat{
	pixel_y = 3
	},
/obj/item/clothing/suit/hooded/wintercoat{
	pixel_y = 6
	},
/obj/item/clothing/suit/hooded/wintercoat{
	pixel_y = 6
	},
/obj/effect/turf_decal/siding/white/end{
	dir = 1
	},
/turf/open/floor/plasteel/telecomms_floor{
	planetary_atmos = 1
	},
/area/hangar)

(1,1,1) = {"
aH
aH
aH
am
am
am
am
am
am
am
am
ay
am
am
am
ay
am
am
am
ay
am
am
am
ay
am
am
am
ay
am
am
am
am
am
am
am
aH
"}
(2,1,1) = {"
aH
aH
am
am
ac
ac
ac
ac
aL
aL
aL
aL
aL
aL
aL
aL
aL
aL
aL
aL
aL
aL
aL
aL
aL
aL
aL
aL
ac
ac
ac
ac
ac
ac
am
aH
"}
(3,1,1) = {"
aH
aH
am
ac
ac
ac
am
aT
aM
aM
aM
aM
aM
aM
aM
aM
aM
aM
aM
aM
aM
aM
aM
aM
aM
aM
aM
aM
aT
am
ac
ac
ac
ac
am
aH
"}
(4,1,1) = {"
aH
aH
am
ac
ac
ac
aT
aT
aJ
aJ
ad
aJ
aJ
aJ
aJ
ad
aJ
aJ
aJ
aJ
ad
aJ
aJ
aJ
aJ
ad
aJ
aB
aT
aT
ac
ac
ac
ac
am
aH
"}
(5,1,1) = {"
aH
aH
am
ac
am
aq
aT
aN
aJ
aJ
aJ
aJ
aJ
aJ
aJ
aJ
aJ
aJ
aJ
aJ
aJ
aJ
aJ
aJ
aJ
aJ
aJ
aJ
aZ
aT
aC
am
ac
ac
am
aH
"}
(6,1,1) = {"
aH
aH
am
ac
ac
aZ
aT
aN
ad
aJ
aJ
aJ
aJ
aJ
aJ
aJ
aJ
aJ
aJ
aJ
aJ
aJ
aJ
aJ
aJ
aJ
aJ
ad
aZ
aT
aN
ac
ac
ac
am
aH
"}
(7,1,1) = {"
aH
aH
am
ac
ac
aZ
aT
aN
aJ
aJ
aJ
aJ
aJ
aJ
aJ
aJ
aJ
aJ
aJ
aJ
aJ
aJ
aJ
aJ
aJ
aJ
aJ
aJ
aZ
aT
aN
ac
ac
ac
am
aH
"}
(8,1,1) = {"
aH
aH
am
ac
ac
aZ
aT
aN
aJ
aJ
aJ
aJ
aJ
aJ
aJ
aJ
aJ
aJ
aJ
aJ
aJ
aJ
aJ
aJ
aJ
aJ
aJ
aJ
aZ
aT
aN
ac
ac
ac
am
aH
"}
(9,1,1) = {"
aH
aH
am
ac
ac
aZ
aT
aN
aJ
aJ
aJ
aJ
aJ
aJ
aJ
aJ
aJ
aJ
aJ
aJ
aJ
aJ
aJ
aJ
aJ
aJ
aJ
aJ
aZ
aT
aN
ac
ac
ac
am
aH
"}
(10,1,1) = {"
aH
aH
am
ac
ac
aZ
aT
aN
aJ
aJ
aJ
aJ
aJ
aJ
aJ
aJ
aJ
aJ
aJ
aJ
aJ
aJ
aJ
aJ
aJ
aJ
aJ
aJ
aZ
aT
aN
ac
ac
ac
am
aH
"}
(11,1,1) = {"
aH
aH
am
ac
am
aq
aT
aN
ad
aJ
aJ
aJ
aJ
aJ
aJ
aJ
aJ
aJ
aJ
aJ
aJ
aJ
aJ
aJ
aJ
aJ
aJ
ad
aZ
aT
aC
am
ac
ac
am
aH
"}
(12,1,1) = {"
aH
aH
am
ac
ac
aZ
aT
aN
aJ
aJ
aJ
aJ
aJ
aJ
aJ
aJ
aJ
aJ
aJ
aJ
aJ
aJ
aJ
aJ
aJ
aJ
aJ
aJ
aZ
aT
aN
ac
ac
ac
am
aH
"}
(13,1,1) = {"
aH
aH
am
ac
ac
aZ
aT
aN
aJ
aJ
aJ
aJ
aJ
aJ
aJ
aJ
aJ
aJ
aJ
aJ
aJ
aJ
aJ
aJ
aJ
aJ
aJ
aJ
aZ
aT
aN
ac
ac
ac
am
aH
"}
(14,1,1) = {"
aH
aH
am
ac
ac
aZ
aT
aN
aJ
aJ
aJ
aJ
aJ
aJ
aJ
aJ
aJ
aJ
aJ
aJ
aJ
aJ
aJ
aJ
aJ
aJ
aJ
aJ
aZ
aT
aN
ac
ac
ac
am
aH
"}
(15,1,1) = {"
aH
aH
am
ac
ac
aZ
aT
aN
aJ
aJ
aJ
aJ
aJ
aJ
aJ
aJ
aJ
aJ
aJ
aJ
aJ
aJ
aJ
aJ
aJ
aJ
aJ
aJ
aZ
aT
aN
ac
ac
ac
am
aH
"}
(16,1,1) = {"
aH
aH
am
ac
ac
aZ
aT
aN
ad
aJ
aJ
aJ
aJ
aJ
aJ
aJ
aJ
aJ
aJ
aJ
aJ
aJ
aJ
aJ
aJ
aJ
aJ
ad
aZ
aT
aN
ac
ac
ac
am
aH
"}
(17,1,1) = {"
aH
aH
am
ac
am
aq
aT
aN
aJ
aJ
aJ
aJ
aJ
aJ
aJ
aJ
aJ
aJ
aJ
aJ
aJ
aJ
aJ
aJ
aJ
aJ
aJ
aJ
aZ
aT
aC
am
ac
ac
am
aH
"}
(18,1,1) = {"
aH
aH
am
ac
ac
aZ
aT
aN
aJ
aJ
aJ
aJ
aJ
aJ
aJ
aJ
aJ
aJ
aJ
aJ
aJ
aJ
aJ
aJ
aJ
aJ
aJ
aJ
aZ
aT
aN
ac
ac
ac
am
aH
"}
(19,1,1) = {"
aH
aH
am
ac
ac
aZ
aT
aN
aJ
aJ
aJ
aJ
aJ
aJ
aJ
aJ
aJ
aJ
aJ
aJ
aJ
aJ
aJ
aJ
aJ
aJ
aJ
aJ
aZ
aT
aN
ac
ac
ac
am
aH
"}
(20,1,1) = {"
aH
aH
am
ac
ac
aZ
aT
aN
aJ
aJ
aJ
aJ
aJ
aJ
aJ
aJ
aJ
aJ
aJ
aJ
aJ
aJ
aJ
aJ
aJ
aJ
aJ
aJ
aZ
aT
aN
ac
ac
ac
am
am
"}
(21,1,1) = {"
aH
aH
am
ac
ac
aZ
aT
aN
ad
aJ
aJ
aJ
aJ
aJ
aJ
aJ
aJ
aJ
aJ
aJ
aJ
aJ
aJ
aJ
aJ
aJ
aJ
ad
aZ
aT
aN
ac
ac
ac
ac
am
"}
(22,1,1) = {"
aH
aH
am
ac
ac
aZ
aT
aN
aJ
aJ
aJ
aJ
aJ
aJ
aJ
aJ
aJ
aJ
aJ
aJ
aJ
aJ
aJ
aJ
aJ
aJ
aJ
aJ
aZ
aT
aC
am
ac
ac
ac
am
"}
(23,1,1) = {"
aH
aH
am
ac
am
aq
aT
aN
aJ
aJ
ad
aJ
aJ
aJ
aJ
ad
aJ
aJ
aJ
aJ
ad
aJ
aJ
aJ
aJ
ad
aJ
aJ
aZ
aT
aN
am
am
ac
ac
am
"}
(24,1,1) = {"
aH
aH
am
ac
ac
aZ
aT
hg
ap
ap
ap
ap
ap
ap
ap
ap
ap
ap
ap
ap
ap
ap
ap
ap
ap
ap
ap
ap
uC
aT
hg
dv
am
ac
ac
am
"}
(25,1,1) = {"
aH
aH
am
ac
ac
aZ
hv
aT
aT
aT
aT
aT
aT
aT
aT
aT
aT
aT
aT
aT
aT
aT
aT
aT
aT
aT
aT
aT
aT
hv
aT
KO
am
ac
ac
am
"}
(26,1,1) = {"
aH
aH
am
ac
am
av
cD
aO
aO
aO
aO
cD
aO
aO
aO
aO
aO
aO
cD
aO
aO
aO
aO
aO
cD
aO
aO
aO
cD
aO
aO
xl
ac
ac
ac
am
"}
(27,1,1) = {"
am
am
am
am
am
am
am
az
az
az
az
am
am
az
az
az
az
am
am
az
az
az
az
am
am
am
am
am
am
am
xp
BW
ac
ac
ac
am
"}
(28,1,1) = {"
am
aY
aY
aY
ao
dM
Dh
Dh
Dh
FS
al
rY
aY
al
al
ic
al
al
aY
al
al
oo
al
Dh
HX
ao
qz
qz
KM
ax
tm
aE
am
ac
ac
am
"}
(29,1,1) = {"
am
aY
aY
aY
ao
aY
Dh
Dh
aP
oi
Fi
aY
Dh
Dh
Dh
Dh
al
al
aY
ic
al
aY
XT
Dh
al
ao
qz
qz
qz
ax
aA
hL
ac
ac
ac
am
"}
(30,1,1) = {"
am
aY
aY
aY
ao
aY
dM
EQ
rY
al
Dh
al
aY
hG
al
nr
rQ
al
al
EQ
aY
aY
al
Dh
Dh
ao
qz
qz
qz
ax
ME
fN
ac
ac
ac
am
"}
(31,1,1) = {"
am
am
am
ac
am
ac
ac
am
ac
ac
JL
ac
ac
am
ac
ac
JL
ac
ac
am
ac
ac
JL
ac
ac
am
am
am
am
am
ZY
jk
am
ac
ac
am
"}
(32,1,1) = {"
aH
aH
am
ac
ac
ac
ac
ac
ac
ac
ac
ac
ac
ac
ac
ac
ac
ac
ac
ac
ac
ac
ac
ac
ac
ac
ac
ac
ac
am
am
am
am
ac
ac
am
"}
(33,1,1) = {"
aH
aH
am
am
am
am
am
am
am
am
am
am
am
am
am
am
am
am
am
am
am
am
am
am
am
am
am
am
am
am
aH
aH
am
am
am
am
"}
