//MAP CONVERTED BY dmm2tgm.py THIS HEADER COMMENT PREVENTS RECONVERSION, DO NOT REMOVE
"a" = (
/turf/closed/indestructible/reinforced,
/area/hangar)
"d" = (
/obj/effect/turf_decal/trimline/opaque/yellow/warning{
	dir = 8
	},
/turf/open/floor/plasteel/tech,
/area/hangar)
"e" = (
/obj/effect/turf_decal/trimline/opaque/yellow/warning{
	dir = 4
	},
/turf/open/floor/plasteel/tech,
/area/hangar)
"f" = (
/obj/machinery/atmospherics/components/binary/pump/on,
/turf/open/floor/plasteel,
/area/hangar)
"i" = (
/obj/effect/turf_decal/trimline/opaque/yellow/filled/warning{
	dir = 1
	},
/obj/machinery/light/floor/hangar,
/turf/open/floor/plasteel,
/area/hangar)
"j" = (
/obj/effect/turf_decal/arrows{
	dir = 1
	},
/turf/open/floor/plasteel/tech,
/area/hangar)
"l" = (
/obj/effect/landmark/outpost/hangar_numbers,
/turf/open/floor/plasteel,
/area/hangar)
"o" = (
/obj/effect/turf_decal/trimline/opaque/yellow/filled/corner{
	dir = 8
	},
/turf/open/floor/plasteel,
/area/hangar)
"p" = (
/obj/machinery/door/poddoor/multi_tile/four_tile_ver,
/turf/closed/indestructible/reinforced,
/area/hangar)
"q" = (
/obj/item/pipe/binary,
/turf/closed/indestructible/reinforced,
/area/hangar)
"r" = (
/obj/effect/turf_decal/trimline/opaque/yellow/filled/warning,
/obj/machinery/light/floor/hangar,
/turf/open/floor/plasteel,
/area/hangar)
"u" = (
/turf/template_noop,
/area/template_noop)
"v" = (
/obj/machinery/door/airlock,
/obj/effect/landmark/outpost/elevator_machine,
/turf/open/floor/plasteel,
/area/hangar)
"z" = (
/obj/effect/turf_decal/trimline/opaque/yellow/filled/warning{
	dir = 8
	},
/turf/open/floor/plasteel,
/area/hangar)
"A" = (
/obj/effect/turf_decal/trimline/opaque/yellow/filled/warning,
/turf/open/floor/plasteel,
/area/hangar)
"B" = (
/obj/machinery/light/floor/hangar,
/turf/open/floor/plasteel,
/area/hangar)
"D" = (
/turf/open/floor/plating,
/area/hangar)
"E" = (
/turf/open/floor/plasteel,
/area/hangar)
"G" = (
/obj/machinery/elevator_call_button{
	pixel_y = 25
	},
/obj/effect/landmark/outpost/elevator_machine,
/turf/open/floor/plasteel,
/area/hangar)
"I" = (
/turf/open/floor/plasteel/tech,
/area/hangar)
"J" = (
/obj/effect/turf_decal/trimline/opaque/yellow/filled/warning{
	dir = 1
	},
/turf/open/floor/plasteel,
/area/hangar)
"K" = (
/obj/machinery/atmospherics/components/unary/tank/air{
	volume = 10000000
	},
/turf/open/floor/plasteel,
/area/hangar)
"L" = (
/obj/effect/turf_decal/arrows{
	dir = 1
	},
/turf/open/floor/plasteel,
/area/hangar)
"M" = (
/obj/effect/turf_decal/trimline/opaque/yellow/filled/corner{
	dir = 1
	},
/turf/open/floor/plasteel,
/area/hangar)
"N" = (
/obj/effect/landmark/outpost/elevator,
/turf/open/floor/plasteel/elevatorshaft,
/area/hangar)
"O" = (
/obj/effect/landmark/outpost/hangar_dock,
/turf/open/floor/plating,
/area/hangar)
"R" = (
/obj/effect/turf_decal/arrows{
	dir = 4
	},
/turf/open/floor/plasteel,
/area/hangar)
"U" = (
/obj/machinery/atmospherics/components/unary/passive_vent{
	dir = 1
	},
/turf/open/floor/plasteel,
/area/hangar)
"V" = (
/turf/open/floor/plasteel/elevatorshaft,
/area/hangar)
"W" = (
/obj/structure/marker_beacon{
	picked_color = "Teal"
	},
/turf/open/floor/plating,
/area/hangar)

(1,1,1) = {"
u
u
u
a
a
a
a
a
a
a
p
a
a
a
p
a
a
a
p
a
a
a
p
a
a
a
p
a
a
a
p
a
a
a
p
a
a
a
p
a
a
a
p
a
a
a
p
a
a
a
a
"}
(2,1,1) = {"
u
u
u
a
E
E
A
d
d
d
d
d
d
d
d
d
d
d
d
d
d
d
d
d
d
d
d
d
d
d
d
d
d
d
d
d
d
d
d
d
d
d
d
d
d
d
d
J
E
E
a
"}
(3,1,1) = {"
u
u
u
a
E
E
A
I
I
j
I
I
I
I
j
I
I
I
I
j
I
I
I
I
j
I
I
I
I
j
I
I
I
I
j
I
I
I
I
j
I
I
I
I
j
I
I
J
E
E
a
"}
(4,1,1) = {"
u
u
u
a
E
E
A
e
e
e
e
e
e
e
e
e
e
e
e
e
e
e
e
e
e
e
e
e
e
e
e
e
e
e
e
e
e
e
e
e
e
e
e
e
e
e
e
J
E
E
a
"}
(5,1,1) = {"
u
u
u
a
E
E
A
D
D
D
D
D
D
D
D
D
D
D
D
D
D
D
D
D
D
D
D
D
D
D
D
D
D
D
D
D
D
D
D
D
D
D
D
D
D
D
O
J
E
E
a
"}
(6,1,1) = {"
u
u
u
a
E
E
A
D
D
D
D
D
D
D
D
D
D
D
D
D
D
D
D
D
D
D
D
D
D
D
D
D
D
D
D
D
D
D
D
D
D
D
D
D
D
D
D
J
E
E
a
"}
(7,1,1) = {"
u
u
u
a
E
R
A
W
D
D
D
D
D
D
D
D
D
D
D
D
D
D
D
D
D
D
D
D
D
D
D
D
D
D
D
D
D
D
D
D
D
D
D
D
D
D
W
J
R
E
a
"}
(8,1,1) = {"
u
u
u
a
E
E
A
D
D
D
D
D
D
D
D
D
D
D
D
D
D
D
D
D
D
D
D
D
D
D
D
D
D
D
D
D
D
D
D
D
D
D
D
D
D
D
D
J
E
E
a
"}
(9,1,1) = {"
u
u
u
a
E
E
r
D
D
D
D
D
D
D
D
D
D
D
D
D
D
D
D
D
D
D
D
D
D
D
D
D
D
D
D
D
D
D
D
D
D
D
D
D
D
D
D
i
E
E
a
"}
(10,1,1) = {"
u
u
u
a
E
E
A
D
D
D
D
D
D
D
D
D
D
D
D
D
D
D
D
D
D
D
D
D
D
D
D
D
D
D
D
D
D
D
D
D
D
D
D
D
D
D
D
J
E
E
a
"}
(11,1,1) = {"
u
u
u
a
E
E
A
D
D
D
D
D
D
D
D
D
D
D
D
D
D
D
D
D
D
D
D
D
D
D
D
D
D
D
D
D
D
D
D
D
D
D
D
D
D
D
D
J
E
E
a
"}
(12,1,1) = {"
u
u
u
a
E
R
A
W
D
D
D
D
D
D
D
D
D
D
D
D
D
D
D
D
D
D
D
D
D
D
D
D
D
D
D
D
D
D
D
D
D
D
D
D
D
D
W
J
R
E
a
"}
(13,1,1) = {"
u
u
u
a
E
E
A
D
D
D
D
D
D
D
D
D
D
D
D
D
D
D
D
D
D
D
D
D
D
D
D
D
D
D
D
D
D
D
D
D
D
D
D
D
D
D
D
J
E
E
a
"}
(14,1,1) = {"
u
u
u
a
E
E
A
D
D
D
D
D
D
D
D
D
D
D
D
D
D
D
D
D
D
D
D
D
D
D
D
D
D
D
D
D
D
D
D
D
D
D
D
D
D
D
D
J
E
E
a
"}
(15,1,1) = {"
u
u
u
a
E
E
A
D
D
D
D
D
D
D
D
D
D
D
D
D
D
D
D
D
D
D
D
D
D
D
D
D
D
D
D
D
D
D
D
D
D
D
D
D
D
D
D
J
E
E
a
"}
(16,1,1) = {"
u
u
u
a
E
E
A
D
D
D
D
D
D
D
D
D
D
D
D
D
D
D
D
D
D
D
D
D
D
D
D
D
D
D
D
D
D
D
D
D
D
D
D
D
D
D
D
J
E
E
a
"}
(17,1,1) = {"
u
u
u
a
E
R
A
W
D
D
D
D
D
D
D
D
D
D
D
D
D
D
D
D
D
D
D
D
D
D
D
D
D
D
D
D
D
D
D
D
D
D
D
D
D
D
W
J
R
E
a
"}
(18,1,1) = {"
u
u
u
a
E
E
A
D
D
D
D
D
D
D
D
D
D
D
D
D
D
D
D
D
D
D
D
D
D
D
D
D
D
D
D
D
D
D
D
D
D
D
D
D
D
D
D
J
E
E
a
"}
(19,1,1) = {"
u
u
u
a
E
E
r
D
D
D
D
D
D
D
D
D
D
D
D
D
D
D
D
D
D
D
D
D
D
D
D
D
D
D
D
D
D
D
D
D
D
D
D
D
D
D
D
i
E
E
a
"}
(20,1,1) = {"
u
u
u
a
E
E
A
D
D
D
D
D
D
D
D
D
D
D
D
D
D
D
D
D
D
D
D
D
D
D
D
D
D
D
D
D
D
D
D
D
D
D
D
D
D
D
D
J
E
E
a
"}
(21,1,1) = {"
u
u
u
a
E
E
A
D
D
D
D
D
D
D
D
D
D
D
D
D
D
D
D
D
D
D
D
D
D
D
D
D
D
D
D
D
D
D
D
D
D
D
D
D
D
D
D
J
E
E
a
"}
(22,1,1) = {"
u
u
u
a
E
R
A
W
D
D
D
D
D
D
D
D
D
D
D
D
D
D
D
D
D
D
D
D
D
D
D
D
D
D
D
D
D
D
D
D
D
D
D
D
D
D
W
J
R
E
a
"}
(23,1,1) = {"
u
u
u
a
E
E
A
D
D
D
D
D
D
D
D
D
D
D
D
D
D
D
D
D
D
D
D
D
D
D
D
D
D
D
D
D
D
D
D
D
D
D
D
D
D
D
D
J
E
E
a
"}
(24,1,1) = {"
u
u
u
a
E
E
A
D
D
D
D
D
D
D
D
D
D
D
D
D
D
D
D
D
D
D
D
D
D
D
D
D
D
D
D
D
D
D
D
D
D
D
D
D
D
D
D
J
E
E
a
"}
(25,1,1) = {"
u
u
u
a
E
E
A
D
D
D
D
D
D
D
D
D
D
D
D
D
D
D
D
D
D
D
D
D
D
D
D
D
D
D
D
D
D
D
D
D
D
D
D
D
D
D
D
J
E
E
a
"}
(26,1,1) = {"
u
u
u
a
E
E
A
D
D
D
D
D
D
D
D
D
D
D
D
D
D
D
D
D
D
D
D
D
D
D
D
D
D
D
D
D
D
D
D
D
D
D
D
D
D
D
D
J
E
E
a
"}
(27,1,1) = {"
u
u
u
a
E
R
A
W
D
D
D
D
D
D
D
D
D
D
D
D
D
D
D
D
D
D
D
D
D
D
D
D
D
D
D
D
D
D
D
D
D
D
D
D
D
D
W
J
R
E
a
"}
(28,1,1) = {"
u
u
u
a
E
E
A
D
D
D
D
D
D
D
D
D
D
D
D
D
D
D
D
D
D
D
D
D
D
D
D
D
D
D
D
D
D
D
D
D
D
D
D
D
D
D
D
J
E
E
a
"}
(29,1,1) = {"
u
u
u
a
E
E
r
D
D
D
D
D
D
D
D
D
D
D
D
D
D
D
D
D
D
D
D
D
D
D
D
D
D
D
D
D
D
D
D
D
D
D
D
D
D
D
D
i
E
E
a
"}
(30,1,1) = {"
u
u
u
a
E
E
A
D
D
D
D
D
D
D
D
D
D
D
D
D
D
D
D
D
D
D
D
D
D
D
D
D
D
D
D
D
D
D
D
D
D
D
D
D
D
D
D
J
E
E
a
"}
(31,1,1) = {"
u
u
u
a
E
E
A
D
D
D
D
D
D
D
D
D
D
D
D
D
D
D
D
D
D
D
D
D
D
D
D
D
D
D
D
D
D
D
D
D
D
D
D
D
D
D
D
J
E
E
a
"}
(32,1,1) = {"
u
u
u
a
E
R
A
W
D
D
D
D
D
D
D
D
D
D
D
D
D
D
D
D
D
D
D
D
D
D
D
D
D
D
D
D
D
D
D
D
D
D
D
D
D
D
W
J
R
E
a
"}
(33,1,1) = {"
u
u
u
a
E
E
A
D
D
D
D
D
D
D
D
D
D
D
D
D
D
D
D
D
D
D
D
D
D
D
D
D
D
D
D
D
D
D
D
D
D
D
D
D
D
D
D
J
E
E
a
"}
(34,1,1) = {"
u
u
u
a
E
E
A
D
D
D
D
D
D
D
D
D
D
D
D
D
D
D
D
D
D
D
D
D
D
D
D
D
D
D
D
D
D
D
D
D
D
D
D
D
D
D
D
J
E
E
a
"}
(35,1,1) = {"
u
u
u
a
E
E
A
D
D
D
D
D
D
D
D
D
D
D
D
D
D
D
D
D
D
D
D
D
D
D
D
D
D
D
D
D
D
D
D
D
D
D
D
D
D
D
D
J
E
E
a
"}
(36,1,1) = {"
u
u
u
a
E
E
A
D
D
D
D
D
D
D
D
D
D
D
D
D
D
D
D
D
D
D
D
D
D
D
D
D
D
D
D
D
D
D
D
D
D
D
D
D
D
D
D
J
E
E
a
"}
(37,1,1) = {"
u
u
u
a
E
R
A
W
D
D
D
D
D
D
D
D
D
D
D
D
D
D
D
D
D
D
D
D
D
D
D
D
D
D
D
D
D
D
D
D
D
D
D
D
D
D
W
J
R
E
a
"}
(38,1,1) = {"
u
u
u
a
E
E
A
D
D
D
D
D
D
D
D
D
D
D
D
D
D
D
D
D
D
D
D
D
D
D
D
D
D
D
D
D
D
D
D
D
D
D
D
D
D
D
D
J
E
E
a
"}
(39,1,1) = {"
u
u
u
a
E
E
r
D
D
D
D
D
D
D
D
D
D
D
D
D
D
D
D
D
D
D
D
D
D
D
D
D
D
D
D
D
D
D
D
D
D
D
D
D
D
D
D
i
E
E
a
"}
(40,1,1) = {"
u
u
u
a
E
E
A
D
D
D
D
D
D
D
D
D
D
D
D
D
D
D
D
D
D
D
D
D
D
D
D
D
D
D
D
D
D
D
D
D
D
D
D
D
D
D
D
J
E
E
a
"}
(41,1,1) = {"
u
u
u
a
E
E
A
D
D
D
D
D
D
D
D
D
D
D
D
D
D
D
D
D
D
D
D
D
D
D
D
D
D
D
D
D
D
D
D
D
D
D
D
D
D
D
D
J
E
E
a
"}
(42,1,1) = {"
u
u
u
a
E
R
A
W
D
D
D
D
D
D
D
D
D
D
D
D
D
D
D
D
D
D
D
D
D
D
D
D
D
D
D
D
D
D
D
D
D
D
D
D
D
D
W
J
R
E
a
"}
(43,1,1) = {"
u
K
f
q
U
E
A
D
D
D
D
D
D
D
D
D
D
D
D
D
D
D
D
D
D
D
D
D
D
D
D
D
D
D
D
D
D
D
D
D
D
D
D
D
D
D
D
J
E
E
a
"}
(44,1,1) = {"
a
a
a
a
a
G
A
D
D
D
D
D
D
D
D
D
D
D
D
D
D
D
D
D
D
D
D
D
D
D
D
D
D
D
D
D
D
D
D
D
D
D
D
D
D
D
D
J
E
E
a
"}
(45,1,1) = {"
a
V
V
N
v
E
o
z
z
z
z
z
z
z
z
z
z
z
z
z
z
z
z
z
z
z
z
z
z
z
z
z
z
z
z
z
z
z
z
z
z
z
z
z
z
z
z
M
E
E
a
"}
(46,1,1) = {"
a
V
V
V
v
l
E
E
E
L
E
E
E
E
L
E
E
E
E
L
E
E
E
E
L
E
E
E
E
L
E
E
E
E
L
E
E
E
E
L
E
E
E
E
L
E
E
E
E
E
a
"}
(47,1,1) = {"
a
V
V
V
v
E
E
B
E
E
E
E
E
E
E
E
E
B
E
E
E
E
E
E
E
E
B
B
E
E
E
E
E
E
E
E
B
E
E
E
E
E
E
E
E
E
B
E
E
E
a
"}
(48,1,1) = {"
a
a
a
a
a
a
a
a
a
a
a
a
a
a
a
a
a
a
a
a
a
a
a
a
a
a
a
a
a
a
a
a
a
a
a
a
a
a
a
a
a
a
a
a
a
a
a
a
a
a
a
"}
