//MAP CONVERTED BY dmm2tgm.py THIS HEADER COMMENT PREVENTS RECONVERSION, DO NOT REMOVE
"a" = (
/turf/open/floor/plating,
/area/hangar)
"b" = (
/turf/closed/indestructible/reinforced,
/area/hangar)
"c" = (
/obj/effect/turf_decal/arrows{
	dir = 1
	},
/turf/open/floor/plasteel,
/area/hangar)
"d" = (
/obj/machinery/atmospherics/components/binary/pump/on,
/turf/open/floor/plasteel,
/area/hangar)
"g" = (
/obj/machinery/atmospherics/components/unary/passive_vent{
	dir = 1
	},
/turf/open/floor/plasteel,
/area/hangar)
"h" = (
/obj/effect/turf_decal/trimline/opaque/yellow/filled/corner{
	dir = 8
	},
/turf/open/floor/plasteel,
/area/hangar)
"k" = (
/obj/effect/turf_decal/trimline/opaque/yellow/filled/warning{
	dir = 1
	},
/turf/open/floor/plasteel,
/area/hangar)
"n" = (
/obj/item/pipe/binary,
/turf/closed/indestructible/reinforced,
/area/hangar)
"o" = (
/obj/machinery/atmospherics/components/unary/tank/air{
	volume = 10000000
	},
/turf/open/floor/plasteel,
/area/hangar)
"q" = (
/turf/open/floor/plasteel,
/area/hangar)
"r" = (
/obj/effect/turf_decal/trimline/opaque/yellow/filled/corner{
	dir = 1
	},
/turf/open/floor/plasteel,
/area/hangar)
"t" = (
/obj/effect/turf_decal/trimline/opaque/yellow/filled/warning,
/obj/machinery/light/floor/hangar,
/turf/open/floor/plasteel,
/area/hangar)
"u" = (
/obj/effect/landmark/outpost/elevator,
/turf/open/floor/plasteel/elevatorshaft,
/area/hangar)
"x" = (
/obj/effect/turf_decal/trimline/opaque/yellow/warning{
	dir = 4
	},
/turf/open/floor/plasteel/tech,
/area/hangar)
"y" = (
/obj/machinery/elevator_call_button{
	pixel_y = 25
	},
/obj/effect/landmark/outpost/elevator_machine,
/turf/open/floor/plasteel,
/area/hangar)
"z" = (
/obj/effect/landmark/outpost/hangar_numbers,
/turf/open/floor/plasteel,
/area/hangar)
"B" = (
/obj/effect/turf_decal/arrows{
	dir = 4
	},
/turf/open/floor/plasteel,
/area/hangar)
"C" = (
/obj/machinery/light/floor/hangar,
/turf/open/floor/plasteel,
/area/hangar)
"E" = (
/obj/machinery/door/airlock,
/obj/effect/landmark/outpost/elevator_machine,
/turf/open/floor/plasteel,
/area/hangar)
"I" = (
/obj/effect/turf_decal/trimline/opaque/yellow/filled/warning{
	dir = 1
	},
/obj/machinery/light/floor/hangar,
/turf/open/floor/plasteel,
/area/hangar)
"J" = (
/obj/effect/landmark/outpost/hangar_dock,
/turf/open/floor/plating,
/area/hangar)
"K" = (
/obj/structure/marker_beacon{
	picked_color = "Teal"
	},
/turf/open/floor/plating,
/area/hangar)
"N" = (
/obj/effect/turf_decal/trimline/opaque/yellow/filled/warning,
/turf/open/floor/plasteel,
/area/hangar)
"P" = (
/turf/template_noop,
/area/template_noop)
"Q" = (
/turf/open/floor/plasteel/tech,
/area/hangar)
"S" = (
/obj/effect/turf_decal/trimline/opaque/yellow/warning{
	dir = 8
	},
/turf/open/floor/plasteel/tech,
/area/hangar)
"T" = (
/obj/machinery/door/poddoor/multi_tile/four_tile_ver,
/turf/closed/indestructible/reinforced,
/area/hangar)
"V" = (
/obj/effect/turf_decal/trimline/opaque/yellow/filled/warning{
	dir = 8
	},
/turf/open/floor/plasteel,
/area/hangar)
"W" = (
/turf/open/floor/plasteel/elevatorshaft,
/area/hangar)
"Z" = (
/obj/effect/turf_decal/arrows{
	dir = 1
	},
/turf/open/floor/plasteel/tech,
/area/hangar)

(1,1,1) = {"
P
P
P
b
b
b
b
b
b
b
T
b
b
b
T
b
b
b
T
b
b
b
T
b
b
b
T
b
b
b
b
"}
(2,1,1) = {"
P
P
P
b
q
q
N
S
S
S
S
S
S
S
S
S
S
S
S
S
S
S
S
S
S
S
S
k
q
q
b
"}
(3,1,1) = {"
P
P
P
b
q
q
N
Q
Q
Z
Q
Q
Q
Q
Z
Q
Q
Q
Q
Z
Q
Q
Q
Q
Z
Q
Q
k
q
q
b
"}
(4,1,1) = {"
P
P
P
b
q
q
N
x
x
x
x
x
x
x
x
x
x
x
x
x
x
x
x
x
x
x
x
k
q
q
b
"}
(5,1,1) = {"
P
P
P
b
q
q
N
a
a
a
a
a
a
a
a
a
a
a
a
a
a
a
a
a
a
a
J
k
q
q
b
"}
(6,1,1) = {"
P
P
P
b
q
q
N
a
a
a
a
a
a
a
a
a
a
a
a
a
a
a
a
a
a
a
a
k
q
q
b
"}
(7,1,1) = {"
P
P
P
b
q
B
N
K
a
a
a
a
a
a
a
a
a
a
a
a
a
a
a
a
a
a
K
k
B
q
b
"}
(8,1,1) = {"
P
P
P
b
q
q
N
a
a
a
a
a
a
a
a
a
a
a
a
a
a
a
a
a
a
a
a
k
q
q
b
"}
(9,1,1) = {"
P
P
P
b
q
q
t
a
a
a
a
a
a
a
a
a
a
a
a
a
a
a
a
a
a
a
a
I
q
q
b
"}
(10,1,1) = {"
P
P
P
b
q
q
N
a
a
a
a
a
a
a
a
a
a
a
a
a
a
a
a
a
a
a
a
k
q
q
b
"}
(11,1,1) = {"
P
P
P
b
q
q
N
a
a
a
a
a
a
a
a
a
a
a
a
a
a
a
a
a
a
a
a
k
q
q
b
"}
(12,1,1) = {"
P
P
P
b
q
B
N
K
a
a
a
a
a
a
a
a
a
a
a
a
a
a
a
a
a
a
K
k
B
q
b
"}
(13,1,1) = {"
P
P
P
b
q
q
N
a
a
a
a
a
a
a
a
a
a
a
a
a
a
a
a
a
a
a
a
k
q
q
b
"}
(14,1,1) = {"
P
P
P
b
q
q
N
a
a
a
a
a
a
a
a
a
a
a
a
a
a
a
a
a
a
a
a
k
q
q
b
"}
(15,1,1) = {"
P
P
P
b
q
q
N
a
a
a
a
a
a
a
a
a
a
a
a
a
a
a
a
a
a
a
a
k
q
q
b
"}
(16,1,1) = {"
P
P
P
b
q
q
N
a
a
a
a
a
a
a
a
a
a
a
a
a
a
a
a
a
a
a
a
k
q
q
b
"}
(17,1,1) = {"
P
P
P
b
q
B
N
K
a
a
a
a
a
a
a
a
a
a
a
a
a
a
a
a
a
a
K
k
B
q
b
"}
(18,1,1) = {"
P
P
P
b
q
q
N
a
a
a
a
a
a
a
a
a
a
a
a
a
a
a
a
a
a
a
a
k
q
q
b
"}
(19,1,1) = {"
P
P
P
b
q
q
t
a
a
a
a
a
a
a
a
a
a
a
a
a
a
a
a
a
a
a
a
I
q
q
b
"}
(20,1,1) = {"
P
P
P
b
q
q
N
a
a
a
a
a
a
a
a
a
a
a
a
a
a
a
a
a
a
a
a
k
q
q
b
"}
(21,1,1) = {"
P
P
P
b
q
q
N
a
a
a
a
a
a
a
a
a
a
a
a
a
a
a
a
a
a
a
a
k
q
q
b
"}
(22,1,1) = {"
P
P
P
b
q
B
N
K
a
a
a
a
a
a
a
a
a
a
a
a
a
a
a
a
a
a
K
k
B
q
b
"}
(23,1,1) = {"
P
P
P
b
q
q
N
a
a
a
a
a
a
a
a
a
a
a
a
a
a
a
a
a
a
a
a
k
q
q
b
"}
(24,1,1) = {"
P
P
P
b
q
q
N
a
a
a
a
a
a
a
a
a
a
a
a
a
a
a
a
a
a
a
a
k
q
q
b
"}
(25,1,1) = {"
P
P
P
b
q
q
N
a
a
a
a
a
a
a
a
a
a
a
a
a
a
a
a
a
a
a
a
k
q
q
b
"}
(26,1,1) = {"
P
P
P
b
q
q
N
a
a
a
a
a
a
a
a
a
a
a
a
a
a
a
a
a
a
a
a
k
q
q
b
"}
(27,1,1) = {"
P
P
P
b
q
B
N
K
a
a
a
a
a
a
a
a
a
a
a
a
a
a
a
a
a
a
K
k
B
q
b
"}
(28,1,1) = {"
P
P
P
b
q
q
N
a
a
a
a
a
a
a
a
a
a
a
a
a
a
a
a
a
a
a
a
k
q
q
b
"}
(29,1,1) = {"
P
P
P
b
q
q
t
a
a
a
a
a
a
a
a
a
a
a
a
a
a
a
a
a
a
a
a
I
q
q
b
"}
(30,1,1) = {"
P
P
P
b
q
q
N
a
a
a
a
a
a
a
a
a
a
a
a
a
a
a
a
a
a
a
a
k
q
q
b
"}
(31,1,1) = {"
P
P
P
b
q
q
N
a
a
a
a
a
a
a
a
a
a
a
a
a
a
a
a
a
a
a
a
k
q
q
b
"}
(32,1,1) = {"
P
P
P
b
q
B
N
K
a
a
a
a
a
a
a
a
a
a
a
a
a
a
a
a
a
a
K
k
B
q
b
"}
(33,1,1) = {"
P
P
P
b
q
q
N
a
a
a
a
a
a
a
a
a
a
a
a
a
a
a
a
a
a
a
a
k
q
q
b
"}
(34,1,1) = {"
P
P
P
b
q
q
N
a
a
a
a
a
a
a
a
a
a
a
a
a
a
a
a
a
a
a
a
k
q
q
b
"}
(35,1,1) = {"
P
P
P
b
q
q
N
a
a
a
a
a
a
a
a
a
a
a
a
a
a
a
a
a
a
a
a
k
q
q
b
"}
(36,1,1) = {"
P
P
P
b
q
q
N
a
a
a
a
a
a
a
a
a
a
a
a
a
a
a
a
a
a
a
a
k
q
q
b
"}
(37,1,1) = {"
P
P
P
b
q
B
N
K
a
a
a
a
a
a
a
a
a
a
a
a
a
a
a
a
a
a
K
k
B
q
b
"}
(38,1,1) = {"
P
P
P
b
q
q
N
a
a
a
a
a
a
a
a
a
a
a
a
a
a
a
a
a
a
a
a
k
q
q
b
"}
(39,1,1) = {"
P
P
P
b
q
q
t
a
a
a
a
a
a
a
a
a
a
a
a
a
a
a
a
a
a
a
a
I
q
q
b
"}
(40,1,1) = {"
P
P
P
b
q
q
N
a
a
a
a
a
a
a
a
a
a
a
a
a
a
a
a
a
a
a
a
k
q
q
b
"}
(41,1,1) = {"
P
P
P
b
q
q
N
a
a
a
a
a
a
a
a
a
a
a
a
a
a
a
a
a
a
a
a
k
q
q
b
"}
(42,1,1) = {"
P
P
P
b
q
B
N
K
a
a
a
a
a
a
a
a
a
a
a
a
a
a
a
a
a
a
K
k
B
q
b
"}
(43,1,1) = {"
P
o
d
n
g
q
N
a
a
a
a
a
a
a
a
a
a
a
a
a
a
a
a
a
a
a
a
k
q
q
b
"}
(44,1,1) = {"
b
b
b
b
b
y
N
a
a
a
a
a
a
a
a
a
a
a
a
a
a
a
a
a
a
a
a
k
q
q
b
"}
(45,1,1) = {"
b
W
W
u
E
q
h
V
V
V
V
V
V
V
V
V
V
V
V
V
V
V
V
V
V
V
V
r
q
q
b
"}
(46,1,1) = {"
b
W
W
W
E
z
q
q
q
c
q
q
q
q
c
q
q
q
q
c
q
q
q
q
c
q
q
q
q
q
b
"}
(47,1,1) = {"
b
W
W
W
E
q
q
q
C
q
q
q
q
q
q
q
q
q
q
q
q
q
q
q
q
C
q
q
q
q
b
"}
(48,1,1) = {"
b
b
b
b
b
b
b
b
b
b
b
b
b
b
b
b
b
b
b
b
b
b
b
b
b
b
b
b
b
b
b
"}
