//MAP CONVERTED BY dmm2tgm.py THIS HEADER COMMENT PREVENTS RECONVERSION, DO NOT REMOVE
"a" = (
/obj/structure/grille,
/obj/effect/spawner/structure/window/shuttle,
/turf/open/space/basic,
/area/shuttle/arrival)
"b" = (
/turf/open/space/basic,
/area/space)
"f" = (
/obj/structure/closet/wardrobe/grey,
/turf/open/floor/mineral/titanium,
/area/shuttle/arrival)
"h" = (
/obj/structure/table,
/obj/item/paper_bin,
/obj/item/clipboard,
/obj/item/pen,
/turf/open/floor/mineral/titanium,
/area/shuttle/arrival)
"k" = (
/obj/machinery/door/window{
	dir = 8
	},
/turf/open/floor/mineral/titanium/blue,
/area/shuttle/arrival)
"l" = (
/obj/structure/closet/wardrobe/green,
/obj/machinery/light{
	dir = 1
	},
/turf/open/floor/mineral/titanium,
/area/shuttle/arrival)
"n" = (
/obj/item/radio/off,
/obj/structure/table,
/turf/open/floor/mineral/titanium,
/area/shuttle/arrival)
"o" = (
/obj/structure/chair/comfy/shuttle{
	dir = 8
	},
/turf/open/floor/mineral/titanium/blue,
/area/shuttle/arrival)
"q" = (
/turf/closed/wall/mineral/titanium,
/area/shuttle/arrival)
"r" = (
/obj/structure/shuttle/engine/heater{
	dir = 4
	},
/turf/open/floor/plating/airless,
/area/shuttle/arrival)
"s" = (
/obj/effect/spawner/structure/window/shuttle,
/obj/structure/grille,
/turf/open/space/basic,
/area/shuttle/arrival)
"u" = (
/obj/machinery/door/airlock/titanium{
	name = "Arrivals Shuttle Airlock"
	},
/obj/docking_port/mobile,
/obj/structure/fans/tiny/invisible,
/turf/open/floor/plating,
/area/shuttle/arrival)
"z" = (
/turf/open/floor/mineral/titanium/blue,
/area/shuttle/arrival)
"F" = (
/turf/open/floor/mineral/titanium,
/area/shuttle/arrival)
"G" = (
/obj/structure/closet/wardrobe/black,
/turf/open/floor/mineral/titanium,
/area/shuttle/arrival)
"H" = (
/obj/structure/chair/comfy/shuttle{
	dir = 8
	},
/obj/structure/window/reinforced{
	dir = 8;
	layer = 2.9
	},
/turf/open/floor/mineral/titanium/blue,
/area/shuttle/arrival)
"J" = (
/obj/structure/chair/comfy/shuttle{
	dir = 8
	},
/turf/open/floor/mineral/titanium,
/area/shuttle/arrival)
"P" = (
/obj/machinery/computer/shuttle{
	dir = 4
	},
/turf/open/floor/mineral/titanium,
/area/shuttle/arrival)
"S" = (
/obj/structure/shuttle/engine/propulsion/burst/right{
	dir = 4
	},
/turf/open/floor/plating/airless,
/area/shuttle/arrival)
"U" = (
/obj/structure/closet/wardrobe/mixed,
/obj/machinery/light,
/turf/open/floor/mineral/titanium,
/area/shuttle/arrival)

(1,1,1) = {"
b
b
q
a
q
b
b
"}
(2,1,1) = {"
b
q
q
P
q
q
b
"}
(3,1,1) = {"
q
q
n
J
h
q
q
"}
(4,1,1) = {"
q
H
H
k
H
H
q
"}
(5,1,1) = {"
a
o
o
z
o
o
a
"}
(6,1,1) = {"
a
l
o
z
o
U
a
"}
(7,1,1) = {"
q
G
o
z
o
f
q
"}
(8,1,1) = {"
q
q
q
F
q
q
q
"}
(9,1,1) = {"
q
r
s
u
s
r
q
"}
(10,1,1) = {"
q
S
b
b
b
S
q
"}
